calling_number,called_number,start_date,end_date,duration,cell_site
3465175876,3464542698,1660989068,1660989719,651,4001
3913107092,3892631572,1645764031,1645764764,733,4463
3603012013,3370912359,1667234821,1667235002,181,3060
3187108153,3319682397,1647289154,1647290036,882,3607
3880922714,3558199998,1642799978,1642800519,541,1293
3541296112,3354563339,1660705301,1660706281,980,809
3135990699,3546025674,1664878214,1664878966,752,1156
3943820422,3623911857,1646866983,1646867332,349,1680
3638954405,3703444892,1650359120,1650359889,769,4979
3388592739,3065847601,1653509442,1653510344,902,4083
3206868670,3189574947,1660673179,1660673607,428,1464
3421786342,3920203627,1668207625,1668207876,251,3482
3594157687,3283298924,1646960789,1646961349,560,909
3907017920,3554578305,1665154378,1665155189,811,1124
3995243810,3344732159,1668885107,1668885628,521,2948
3917335333,3302525350,1658236094,1658236646,552,3078
3275346838,3575676165,1650952405,1650952470,65,4957
3309245311,3351524171,1653482165,1653483015,850,2701
3391354986,3785718090,1649928908,1649929241,333,2409
3114502193,3209717743,1652133488,1652134203,715,691
3452648626,3488548545,1662762179,1662762928,749,4620
3438900911,3389170259,1661493579,1661494499,920,1567
3414557859,3048921999,1664042348,1664042858,510,44
3006811535,3830522971,1644071511,1644072475,964,3002
3324736500,3919968816,1666212520,1666213449,929,4281
3810030484,3297938817,1643611041,1643611214,173,1812
3060886739,3932614300,1649987398,1649987753,355,456
3917602595,3444240419,1667991963,1667992575,612,3156
3865893489,3667385468,1665225649,1665225850,201,1059
3740279779,3261284857,1647349245,1647349346,101,1333
3515045021,3356393089,1667214955,1667215584,629,4237
3273338120,3118267599,1641371434,1641372253,819,4707
3973340999,3675616224,1641299561,1641299874,313,1362
3287800021,3442809134,1665113804,1665113953,149,2896
3409498864,3574900884,1645092176,1645092378,202,4169
3402432079,3085549783,1654861480,1654861582,102,3430
3435565500,3691687105,1663348364,1663348931,567,26
3953886127,3448195241,1661930004,1661930973,969,1015
3724260668,3151463294,1659685629,1659685937,308,4705
3205514055,3368830279,1667846637,1667846751,114,4429
3166107186,3830779206,1642695680,1642696045,365,763
3383638489,3141740687,1648599284,1648600033,749,2209
3093270958,3130223696,1668961093,1668961546,453,1192
3814266542,3516837793,1645517117,1645517898,781,3675
3254233464,3905959229,1659248978,1659249823,845,3938
3230143794,3965926135,1645712502,1645712877,375,902
3533704219,3990132970,1655054864,1655055735,871,1635
3612656677,3409745466,1649373504,1649373876,372,2786
3658912807,3985143816,1666859736,1666859873,137,4426
3154028487,3610248543,1647375748,1647376163,415,2656
3496685412,3872442982,1667261009,1667261441,432,2144
3481684045,3263300881,1666456073,1666456697,624,1411
3207875792,3054696246,1641390504,1641391276,772,3807
3314043173,3206934854,1660178674,1660179361,687,4863
3799393235,3489216209,1669470190,1669470917,727,427
3130952816,3845922108,1646902702,1646903237,535,341
3310624561,3254478931,1653357136,1653358023,887,4660
3771567416,3884745887,1655270127,1655271022,895,3899
3274049641,3402901982,1657673818,1657673951,133,4224
3934196534,3650547602,1643442971,1643443055,84,1500
3457498965,3524506003,1652091838,1652092741,903,4649
3684219332,3845270609,1645980408,1645981323,915,638
3412912768,3988739626,1662979418,1662980241,823,1962
3061645026,3524249145,1659771764,1659772203,439,3819
3761567545,3232816973,1657727928,1657728777,849,480
3379226514,3938052834,1645608458,1645608964,506,4194
3138415480,3870506073,1665254077,1665254692,615,462
3979742903,3189324797,1664737278,1664737458,180,2431
3924672244,3064117318,1642901234,1642901743,509,1392
3316032372,3892197161,1661907495,1661907917,422,3400
3487407006,3374451311,1643401284,1643402276,992,3247
3110704410,3260739316,1666221037,1666221434,397,4275
3282565168,3003853057,1666689317,1666690184,867,3699
3397914411,3911480291,1665065326,1665065442,116,1563
3225135519,3144572992,1660568898,1660569086,188,4522
3694651326,3240519527,1645688363,1645688829,466,81
3071516257,3904992432,1662743873,1662744036,163,298
3849349988,3238117617,1655190776,1655190867,91,3429
3781502217,3669707448,1646398402,1646399201,799,3359
3883807664,3984907490,1660892248,1660892280,32,3034
3388944343,3935943702,1661588957,1661589271,314,4556
3447366453,3937178898,1643405692,1643405895,203,1939
3902220494,3921804333,1663628226,1663629132,906,2644
3401072403,3340285756,1649096010,1649096854,844,2135
3493216841,3421019468,1651438929,1651439444,515,3415
3886427152,3488484725,1653741743,1653742302,559,4490
3253530115,3097660691,1659340851,1659341467,616,616
3627755759,3055651480,1656170015,1656170207,192,3506
3833898017,3130384062,1667855956,1667856814,858,3790
3051343655,3884023662,1666980515,1666981346,831,1828
3055354724,3742497099,1656334168,1656334373,205,1155
3552469321,3731210239,1660718049,1660718329,280,4265
3774188907,3784206294,1641464751,1641465206,455,2559
3113645076,3882730123,1650268861,1650269539,678,2062
3370013488,3515833727,1647658115,1647658386,271,2564
3853832193,3069405162,1656431067,1656431827,760,2828
3481438384,3038946560,1658909303,1658909694,391,135
3125600926,3394625809,1646768848,1646769136,288,1619
3989945642,3734844545,1654417160,1654417554,394,3828
3129766342,3288273992,1663750946,1663751102,156,4476
3816891564,3627523511,1644777003,1644777945,942,1144
3657518767,3729276086,1642305783,1642306326,543,1803
3175162225,3791467848,1667309500,1667310112,612,2037
3116999399,3727059664,1644439606,1644439899,293,2037
3335449906,3976988698,1668933884,1668934799,915,3725
3529774720,3499026026,1644211396,1644211673,277,2511
3602696939,3330610282,1651839131,1651839625,494,534
3093186680,3953493142,1655000822,1655001416,594,3004
3376038004,3386168302,1659541471,1659541759,288,3657
3319015093,3946614832,1656219524,1656219744,220,3657
3311859019,3531014729,1645888928,1645889926,998,68
3107383885,3230919307,1652613204,1652613958,754,1186
3959603448,3432377249,1653164064,1653164329,265,4739
3641178744,3474356342,1644931621,1644931743,122,2404
3923374904,3030817432,1642819258,1642819431,173,2220
3916804528,3598477467,1667522743,1667522841,98,2552
3416790003,3654956952,1668069798,1668070507,709,2168
3039694023,3453146616,1655931506,1655931688,182,1714
3059532048,3642181084,1648995932,1648996529,597,4004
3142747866,3471496137,1651229576,1651230324,748,2965
3995034428,3864438109,1643355975,1643356139,164,1751
3059587991,3351939013,1654395953,1654396866,913,4436
3828116667,3884809424,1662192863,1662193562,699,3664
3319377346,3706084816,1657070009,1657070689,680,1332
3274234845,3413955961,1657180186,1657180189,3,2035
3562275388,3462659948,1646391678,1646392124,446,4523
3330490223,3452201180,1645200770,1645201122,352,473
3117944287,3679043294,1652235868,1652236342,474,882
3138082523,3115884246,1667664640,1667665360,720,2900
3914673133,3285886911,1664892211,1664892755,544,3062
3660470032,3843382501,1666608104,1666608238,134,3372
3562982970,3595056202,1651847134,1651847506,372,1836
3425941241,3953442901,1669585606,1669586493,887,4926
3830481508,3564524597,1665689481,1665690294,813,225
3821458305,3926378990,1641043678,1641043903,225,2383
3098844449,3831589758,1643934449,1643934714,265,1443
3473206365,3137449297,1662063855,1662064137,282,1759
3908485389,3492970710,1660173172,1660173932,760,4967
3139826171,3717168026,1645392916,1645393641,725,2353
3896515196,3233878136,1643384870,1643385669,799,3223
3019833255,3795193524,1643476417,1643476994,577,4091
3411352083,3264886208,1646041511,1646042371,860,3567
3434282566,3222251533,1647594768,1647595189,421,4548
3573302749,3964246491,1652065909,1652066649,740,737
3443650003,3702899556,1669072256,1669072326,70,3426
3478162300,3623847884,1647712629,1647713054,425,4336
3878584107,3532193527,1651927988,1651928171,183,2163
3976430455,3577858329,1648687220,1648687435,215,3698
3838262581,3380831015,1649430166,1649430841,675,58
3485981972,3355318202,1641656552,1641656974,422,2736
3784846836,3490599093,1641567513,1641567698,185,4647
3275772642,3746427679,1651521172,1651521447,275,4858
3380096826,3254608338,1668433342,1668434051,709,3743
3828716607,3524614760,1662645619,1662646164,545,3585
3329728047,3287246696,1657908430,1657909353,923,286
3902431137,3161590941,1644908644,1644909479,835,1668
3492898661,3806920507,1652008024,1652008756,732,1253
3267551569,3133759357,1644050323,1644051224,901,2673
3030290673,3970498740,1654440561,1654440792,231,1405
3225337837,3644543005,1667713433,1667713986,553,2261
3505112218,3871523359,1653940164,1653940978,814,766
3767075795,3658519327,1653994983,1653995192,209,44
3394134947,3804839992,1656225081,1656225705,624,4916
3948887362,3956222310,1654797249,1654797920,671,3728
3386541829,3271979679,1662387227,1662388005,778,834
3382941075,3052938860,1668816368,1668816900,532,1524
3759613820,3341030469,1659355872,1659356377,505,3386
3228131764,3143070114,1659310200,1659310634,434,434
3612326551,3491957195,1659908883,1659909477,594,1355
3170622267,3199131659,1661567353,1661568121,768,373
3381674082,3391499986,1661641197,1661641986,789,3151
3282573194,3075179573,1650852673,1650853494,821,4047
3978354438,3441785101,1651315888,1651316672,784,4835
3419255200,3616790749,1667762626,1667763484,858,3660
3246850608,3715885217,1644845761,1644845866,105,4968
3296895942,3967145295,1665675341,1665675760,419,1955
3681079946,3305622578,1664945628,1664946178,550,4048
3266823250,3009257475,1653416279,1653417263,984,4934
3636206641,3094134640,1643524333,1643525072,739,4200
3372488000,3371841300,1641740395,1641740620,225,1365
3596042178,3248158661,1654950257,1654951107,850,1459
3517963674,3432028944,1655496936,1655497632,696,2985
3938962126,3756155344,1642835292,1642835683,391,354
3869552090,3232214620,1645287941,1645288920,979,930
3442391735,3876105685,1650314538,1650314667,129,2105
3997815093,3467696983,1645444655,1645444866,211,2109
3243222633,3438910335,1652981072,1652981766,694,1782
3366454291,3350885815,1659033143,1659033513,370,4298
3924029041,3491442333,1668328757,1668329085,328,189
3315720226,3550321333,1651334246,1651334909,663,155
3254906080,3539287985,1658304265,1658304384,119,1951
3840502107,3215477180,1651151103,1651151676,573,1691
3705093066,3384257165,1667369885,1667370420,535,1200
3073629364,3038015916,1649823680,1649823691,11,207
3354325176,3599648649,1654327767,1654327892,125,1206
3511231024,3533696928,1652288833,1652289016,183,1233
3793382958,3109029631,1650676027,1650676190,163,4503
3726917007,3654219328,1666298347,1666298893,546,2884
3678153435,3317418709,1666321092,1666321494,402,2411
3815831763,3530045766,1643474604,1643474946,342,1714
3355831327,3549005079,1663680207,1663680368,161,934
3649292111,3011568912,1655762327,1655762388,61,1501
3563469235,3015118504,1666856422,1666857124,702,3809
3740827309,3708320985,1655757299,1655757894,595,1407
3685039352,3017735026,1666880618,1666880916,298,3021
3331949673,3117656841,1646267334,1646267963,629,3018
3378926657,3852602104,1662918236,1662919007,771,4212
3030102457,3394702621,1642861126,1642861421,295,2009
3953629936,3416644906,1657527368,1657527579,211,1099
3284638426,3484960997,1642601676,1642602243,567,2613
3963854580,3638484490,1646005508,1646006196,688,3594
3356720852,3683841782,1645936901,1645937514,613,599
3481709027,3661408646,1654554967,1654555759,792,1785
3055295623,3351685662,1667514733,1667515149,416,4465
3240510810,3943562200,1665970165,1665970234,69,3860
3501351070,3716555342,1666614207,1666614788,581,757
3543528025,3946703804,1663847130,1663847260,130,435
3577371539,3782160300,1653122084,1653122619,535,3812
3370937154,3425438343,1646996169,1646997070,901,1661
3570373414,3537403070,1646699967,1646699972,5,4195
3082894021,3887775881,1651996103,1651996407,304,4502
3549160561,3054838204,1649640845,1649640958,113,3412
3455702288,3321493523,1652042181,1652042451,270,1737
3487407006,3413241176,1662861904,1662862306,402,4621
3662755264,3463342204,1663898190,1663898852,662,4257
3526497899,3376260770,1666648495,1666649307,812,3354
3477452109,3247453446,1669015088,1669015658,570,946
3101157288,3618435973,1666505969,1666506689,720,1494
3625214699,3588729711,1650749582,1650750184,602,165
3965414530,3751124443,1651604067,1651605001,934,1184
3846810065,3541474507,1666685482,1666685493,11,3234
3737466604,3645141575,1668467103,1668467293,190,3742
3093190981,3055365223,1652872255,1652872479,224,4431
3540906244,3296856305,1667562937,1667563812,875,1127
3483760763,3598729974,1646711402,1646711743,341,3667
3675928135,3317739310,1644457503,1644458273,770,2967
3779675639,3890100338,1656721570,1656721606,36,3766
3515004368,3833845586,1663060223,1663060924,701,1518
3697081873,3967329890,1657555109,1657555623,514,3891
3764264274,3466482767,1650636099,1650636685,586,2193
3772863393,3107588894,1643581343,1643582010,667,4939
3558941948,3331228360,1665688236,1665688469,233,4979
3783750485,3368628028,1641750386,1641750912,526,106
3115589918,3565112568,1655578412,1655578619,207,4115
3414939886,3360613443,1666219360,1666220114,754,4346
3845600482,3680041920,1662026040,1662026430,390,3164
3119488424,3740493138,1650297565,1650298106,541,151
3517711619,3487304770,1643039731,1643040691,960,3857
3620280552,3070702621,1654299920,1654300226,306,1510
3024080340,3756879759,1644550206,1644550331,125,4030
3050774245,3565820634,1665706248,1665706696,448,3689
3658734373,3935040483,1666147178,1666147195,17,2263
3993877994,3121536925,1650093115,1650093268,153,764
3765290335,3165686516,1652071352,1652071613,261,4056
3021475950,3116457351,1651495020,1651495051,31,2573
3882106450,3400415542,1643490320,1643490784,464,1982
3431058353,3227749209,1641894832,1641895083,251,1930
3987625535,3621478193,1663580893,1663581450,557,1552
3164704373,3550638414,1665628432,1665629219,787,4391
3943887123,3136466533,1648024376,1648024428,52,4439
3219836709,3380264418,1668338252,1668339131,879,2410
3572075286,3032603493,1648943370,1648943660,290,3719
3242008419,3371335947,1669012487,1669013223,736,349
3897367919,3272189628,1666480118,1666480917,799,1461
3907646355,3313424896,1657738860,1657739448,588,2013
3030907219,3529943617,1657095727,1657095837,110,649
3562831078,3428751793,1656480874,1656481557,683,2931
3160727779,3687015714,1647329301,1647329483,182,1053
3476514630,3301710694,1650997336,1650997970,634,1498
3166013630,3335144039,1653639096,1653639875,779,4307
3655521863,3641906480,1644198082,1644198985,903,1784
3606408329,3037112198,1653340695,1653341524,829,639
3710598438,3884318874,1655526111,1655526966,855,2661
3250147813,3652075075,1649360202,1649360907,705,2083
3648445183,3919660046,1651541956,1651542633,677,3875
3331976012,3488222394,1656529838,1656530230,392,1113
3143661755,3093077197,1650456566,1650457102,536,292
3712756170,3067066401,1655506532,1655506846,314,1488
3853332360,3990736039,1649771645,1649772170,525,1173
3399625784,3945202674,1668386580,1668386627,47,3195
3368431701,3576266252,1665835656,1665836264,608,2966
3667542309,3934454988,1660629562,1660629715,153,1840
3733970031,3549677358,1662828382,1662828792,410,1581
3933882767,3560587368,1642607159,1642607882,723,4877
3489970613,3579172284,1656617167,1656617999,832,4369
3874403523,3718644082,1654022684,1654022895,211,1281
3504752106,3818850766,1660201319,1660201610,291,4799
3364312276,3034235767,1648401860,1648402445,585,4816
3541526067,3529709498,1656148680,1656148714,34,1547
3208483015,3109294232,1653260809,1653261242,433,4266
3795613747,3342501600,1643233888,1643234330,442,2008
3822175315,3017565540,1663420402,1663421096,694,1731
3849980902,3055438731,1664788539,1664789462,923,1126
3237188411,3561407364,1654566085,1654567024,939,3052
3562310728,3160939878,1662488615,1662488867,252,2781
3500418925,3680677740,1667790157,1667790634,477,1064
3966921548,3441825750,1644639037,1644639374,337,435
3996085937,3169543132,1663791203,1663792070,867,1899
3573567075,3105680338,1661744342,1661744987,645,137
3940057263,3629927142,1655054385,1655055099,714,1068
3520641005,3435521711,1660396619,1660397294,675,624
3919798845,3246469645,1643199744,1643200545,801,301
3499524415,3443058267,1668143252,1668143550,298,2193
3827552425,3550551782,1657205670,1657206445,775,4936
3727416464,3363102037,1647046563,1647047228,665,1968
3022792503,3796146434,1654719512,1654720013,501,2138
3673868508,3786012641,1669605194,1669605439,245,4380
3268596804,3826299330,1668136685,1668137350,665,4054
3910717294,3412966919,1651958019,1651958134,115,1424
3495135271,3357694829,1645341650,1645342271,621,3533
3358448155,3045842967,1644475822,1644476439,617,335
3066063652,3885451097,1663617645,1663618187,542,947
3369550681,3467730446,1657642039,1657642177,138,3910
3476471998,3119569212,1659890323,1659890385,62,2624
3724157198,3909649840,1658012532,1658013162,630,3236
3634480445,3032462333,1669000035,1669000840,805,2880
3554608380,3715841744,1657484461,1657485103,642,2396
3206772638,3670350430,1664307649,1664307736,87,3899
3217058784,3024910421,1648839340,1648840015,675,4114
3963687385,3877750088,1668533398,1668533702,304,381
3610689817,3392110402,1655279433,1655280323,890,4360
3274098807,3215694443,1658350237,1658350562,325,1246
3425526581,3343160043,1659241016,1659241239,223,2165
3132114157,3318192592,1655359188,1655359706,518,613
3661234452,3351472152,1659156268,1659156559,291,1300
3870357978,3279498450,1646576380,1646577129,749,1039
3779119896,3100196964,1669072334,1669073291,957,4854
3904715339,3425225510,1646640636,1646641276,640,2333
3950332990,3049005336,1667464093,1667464979,886,64
3005493420,3196422633,1667985997,1667986887,890,1550
3758704860,3456036438,1665989950,1665990633,683,4821
3450914467,3154923766,1652518675,1652519563,888,1808
3774991835,3416312948,1644172029,1644172503,474,4256
3168843088,3043441164,1652821983,1652822907,924,974
3290949672,3984924769,1659763801,1659764376,575,2365
3854834105,3941253926,1657661728,1657662474,746,4914
3515822618,3044070140,1656245064,1656245064,0,3204
3172605402,3518557531,1655402852,1655403136,284,4904
3093425209,3321353836,1664628296,1664628420,124,4273
3901251975,3936845614,1665387637,1665388427,790,3359
3744714049,3766852261,1665089995,1665090268,273,4506
3345432125,3938029108,1644465890,1644466298,408,1917
3943318567,3579102374,1666385477,1666386092,615,3827
3703386872,3196154257,1655489494,1655490431,937,1037
3777285210,3768624075,1648559083,1648560051,968,2153
3780244997,3766921373,1650814206,1650814980,774,194
3386385764,3349869497,1669539947,1669540759,812,2018
3474016011,3082869546,1648607847,1648608558,711,3947
3692498197,3927345925,1653353585,1653354223,638,2592
3015997907,3014158490,1643974740,1643975326,586,2595
3524341436,3552831057,1650990248,1650990949,701,2261
3556520593,3593880563,1650908619,1650909518,899,1470
3689703199,3516529406,1643384085,1643384565,480,1342
3813303822,3893390038,1651134367,1651135077,710,2794
3115563021,3116242551,1668103050,1668103232,182,3728
3025556696,3530615438,1647154636,1647155353,717,815
3917799724,3156006588,1666357077,1666357302,225,4770
3326256105,3743007368,1667416149,1667416387,238,216
3230097860,3872865775,1654133038,1654133503,465,2772
3274375036,3927258530,1645569099,1645569729,630,1395
3733691622,3802248361,1659927077,1659927359,282,292
3758463280,3145481149,1644753601,1644753602,1,3507
3883336854,3107082529,1650373265,1650373640,375,3339
3510392339,3795396165,1655361046,1655361670,624,1321
3663181225,3321937222,1667217221,1667217639,418,3052
3744019254,3532775220,1647782617,1647783150,533,4403
3164378727,3722125978,1654193909,1654194199,290,93
3416875158,3955938671,1646734859,1646734913,54,1742
3450446845,3513768830,1666051273,1666051557,284,2995
3103275447,3215141380,1664837249,1664837498,249,1387
3930648290,3710157938,1644363472,1644364111,639,2551
3235183235,3406695165,1669524481,1669525080,599,2191
3548151258,3712565828,1641919393,1641920258,865,4609
3266449971,3923633701,1653113597,1653114264,667,223
3290096696,3671361102,1643450462,1643450945,483,965
3741482073,3880064346,1659417655,1659418289,634,4418
3006464137,3969009658,1659622079,1659622311,232,517
3287987854,3266196284,1661474071,1661475026,955,2788
3125161402,3109462804,1655808360,1655808491,131,4369
3126275800,3773864902,1659413550,1659414179,629,2354
3187442319,3836747886,1668255458,1668256061,603,1775
3794977628,3559236742,1662939638,1662940390,752,778
3006937193,3017836827,1655063556,1655063831,275,1481
3526162301,3066510559,1660170898,1660171572,674,3069
3670569790,3957813871,1658658949,1658659804,855,255
3028216356,3136751566,1658091964,1658092394,430,2729
3187464386,3283626799,1665847494,1665848117,623,1095
3980889163,3685579859,1659304661,1659305612,951,4120
3779438912,3341637468,1653157439,1653158030,591,1679
3453687234,3011515140,1645497385,1645498025,640,1817
3404757176,3088562441,1648933385,1648933499,114,3449
3523678483,3332317897,1645704133,1645704557,424,156
3389210395,3366003225,1666246387,1666247347,960,2572
3234670949,3179490374,1646613721,1646614174,453,4000
3150407354,3056444640,1657634225,1657634473,248,1906
3807197836,3486385774,1653682637,1653683124,487,12
3257623468,3958051988,1662208097,1662209005,908,2063
3293882191,3576133666,1642292659,1642293602,943,4634
3992088400,3372540881,1654872151,1654872990,839,3510
3696014653,3249515323,1651003413,1651003976,563,3492
3450144262,3748624973,1655224184,1655224664,480,191
3536807767,3070495003,1656139664,1656140413,749,3975
3083725561,3740244573,1659989793,1659989896,103,104
3379338052,3746755053,1641162714,1641162783,69,867
3065448370,3249248382,1648651214,1648651674,460,3135
3807459597,3577301217,1656564124,1656564257,133,4839
3815518159,3554063600,1642991145,1642991628,483,4571
3831517430,3196697702,1652494298,1652494433,135,2956
3853590826,3164872084,1645246295,1645246663,368,4141
3301831964,3975566469,1657998526,1657998562,36,3474
3962831559,3639258362,1662626886,1662627725,839,1345
3757102761,3650061155,1663580954,1663581694,740,3006
3371312434,3324502311,1659489932,1659490331,399,2872
3081885035,3907832175,1659303294,1659304044,750,906
3751207055,3860902594,1657354122,1657354960,838,2968
3070916664,3275727136,1648277480,1648277661,181,3581
3736296441,3552208990,1663092664,1663092814,150,2806
3317667556,3295998576,1659339157,1659339412,255,1827
3520968707,3790241750,1669471810,1669472594,784,4089
3785932235,3603384854,1667377635,1667378526,891,4010
3335522273,3435259828,1657182966,1657183793,827,1323
3791857372,3350042076,1645622434,1645623112,678,2271
3983252894,3104815180,1667812629,1667812837,208,2729
3155873542,3701514808,1654136950,1654137049,99,460
3563186474,3418909121,1668398146,1668398384,238,427
3942684335,3736528445,1654817122,1654817310,188,4067
3583068590,3059919910,1669257106,1669257499,393,4876
3762456114,3934743105,1658803380,1658803615,235,3137
3841122111,3505108449,1657731332,1657732217,885,855
3930623131,3671988333,1651601004,1651601104,100,1980
3525879275,3949195710,1661113036,1661113618,582,487
3503758756,3529559657,1651232285,1651233224,939,774
3323267681,3084714735,1660121705,1660122632,927,2392
3523430506,3135838407,1663711953,1663712246,293,392
3634825543,3132376911,1664867022,1664867561,539,756
3306304280,3853565094,1665935595,1665936525,930,3002
3330311670,3173279418,1643890796,1643891124,328,1891
3240759018,3792222937,1651569919,1651569947,28,2056
3636612774,3255927330,1669209722,1669210682,960,3485
3451503035,3009520662,1658268684,1658268994,310,516
3959969297,3226595603,1662431594,1662432345,751,1150
3903776825,3163991020,1654212457,1654212792,335,3454
3492985644,3854944951,1641755341,1641756287,946,1073
3656266466,3228217721,1663456005,1663456448,443,4741
3163068564,3807359316,1648017278,1648018265,987,4684
3520746292,3819245922,1662887452,1662887873,421,54
3401835989,3242602202,1641334828,1641335464,636,3502
3944656242,3165207274,1647338025,1647338792,767,2223
3699299304,3620129477,1665578292,1665578827,535,3905
3703383120,3907180782,1642304720,1642305495,775,4616
3801260901,3006753497,1668348657,1668349520,863,2457
3520314592,3210092856,1666385452,1666386396,944,1641
3889313007,3538305129,1656823658,1656824187,529,3749
3503158165,3511231024,1651988714,1651989103,389,3259
3133026545,3661388494,1668122861,1668122892,31,1911
3324736500,3297181177,1665901086,1665901292,206,1926
3192658875,3531116261,1666420909,1666421495,586,297
3975943348,3985261723,1642345514,1642346477,963,913
3301080862,3868327930,1661225451,1661226124,673,108
3623661520,3737549830,1641459626,1641460425,799,660
3049820512,3637115759,1666567117,1666567299,182,3168
3694622061,3189903744,1661109823,1661110409,586,2465
3876146844,3340985561,1660590733,1660591192,459,282
3115884246,3327820149,1662501974,1662502113,139,3126
3168928941,3504279381,1651397567,1651398553,986,3752
3332312439,3536753113,1662352605,1662352692,87,3521
3384644709,3329714914,1655814691,1655815533,842,1516
3154638321,3251041679,1669078719,1669078785,66,490
3476195259,3978391150,1645196613,1645197503,890,772
3094977139,3251430992,1664396240,1664396582,342,584
3322901875,3559808767,1665295966,1665296940,974,3120
3824483627,3663564006,1664683789,1664683920,131,341
3418499982,3501508344,1649269561,1649270094,533,4742
3659486017,3167402148,1652483066,1652483831,765,678
3045976677,3828975516,1663640317,1663641104,787,3886
3874803426,3651357152,1644343420,1644343763,343,3895
3360742965,3619066577,1664962697,1664963119,422,4130
3969795898,3053313370,1663846470,1663846603,133,3360
3689570841,3820360289,1657795943,1657795979,36,4285
3938841055,3691759874,1645275269,1645276217,948,3676
3335277314,3412700967,1660100862,1660101031,169,782
3204307448,3384406363,1649090160,1649090930,770,4744
3194643348,3229124250,1645904152,1645904983,831,737
3816314087,3796528330,1668847625,1668848423,798,2173
3738611471,3275804085,1669143721,1669144150,429,4186
3632057433,3933121804,1665568361,1665568493,132,3186
3420598303,3445054360,1649484343,1649485024,681,2941
3440102869,3060258117,1666974709,1666975521,812,3093
3105667306,3863635159,1654635225,1654635330,105,2898
3920772340,3063888012,1665598537,1665598613,76,4283
3321325364,3716000638,1651460204,1651460990,786,3018
3903560907,3278110171,1654598997,1654599637,640,1548
3261999483,3659621413,1650486746,1650487541,795,4558
3199666930,3228471846,1653999218,1653999791,573,1687
3453702104,3489154702,1649451723,1649452674,951,4970
3961187632,3494101220,1659938029,1659938615,586,1020
3482421144,3997393166,1654068719,1654069638,919,3614
3623178219,3301171497,1653625054,1653625919,865,4271
3750793779,3567629592,1653741668,1653742489,821,4742
3509621160,3470491347,1650614131,1650614339,208,4601
3785932235,3709240516,1642577114,1642577541,427,1270
3007624065,3958739133,1659686164,1659686551,387,2347
3454128725,3870327066,1667570317,1667571076,759,1676
3483971874,3948930784,1659280505,1659280784,279,2796
3935259848,3870749230,1650449024,1650449042,18,2444
3475046694,3685939833,1660250679,1660250985,306,3968
3246731281,3665483077,1668184063,1668184215,152,2201
3406429595,3784659312,1653468349,1653469324,975,3240
3488046386,3082155245,1646509165,1646509687,522,1711
3510074277,3287779741,1654916543,1654916679,136,636
3126006041,3239686776,1658744448,1658744858,410,4745
3424456956,3505669375,1657410990,1657411139,149,1101
3734267506,3308307785,1669510312,1669510963,651,1515
3864720349,3497945612,1650479934,1650480559,625,2683
3529389687,3849319208,1666030624,1666030930,306,3584
3158392385,3341886522,1658212405,1658212504,99,2585
3205533184,3215578953,1659444474,1659444601,127,1913
3955832871,3784338740,1668963215,1668963539,324,2811
3691655351,3909315969,1646380919,1646381711,792,2163
3383134049,3980753059,1648127363,1648127647,284,3086
3252861633,3852940628,1657792950,1657793376,426,3060
3503379485,3088073083,1656893305,1656894004,699,2743
3878696864,3363975987,1649080622,1649081499,877,2807
3245089699,3197025750,1649991663,1649992353,690,3362
3667923558,3386385764,1668662641,1668663128,487,4556
3494211176,3898131860,1660583375,1660583481,106,2033
3973985375,3399977376,1664525050,1664525809,759,4876
3767263553,3309864397,1658253128,1658253251,123,4235
3185842036,3370380493,1663446628,1663447586,958,4476
3525335790,3172289156,1652948040,1652948705,665,381
3349630291,3369751530,1644685551,1644686160,609,614
3982004583,3673476948,1661370979,1661371888,909,270
3561976068,3669999211,1661518003,1661518487,484,3462
3692084771,3753707897,1657205438,1657206411,973,4824
3699960988,3629590861,1650408076,1650409076,1000,3608
3361551080,3245157380,1660494748,1660494816,68,4059
3939962691,3388960479,1659458276,1659458596,320,4239
3620093730,3668892410,1642174182,1642174513,331,2934
3908640703,3651674657,1656757990,1656758619,629,1541
3797293272,3480131178,1661232792,1661233160,368,3527
3961960469,3080692429,1656921632,1656922293,661,2850
3930480302,3882887435,1666985001,1666985688,687,4049
3312878158,3276869800,1667096816,1667096949,133,900
3281065527,3606088473,1646331561,1646331753,192,4997
3339636725,3470933595,1650250625,1650251035,410,4975
3454548733,3397358982,1665450934,1665451531,597,2095
3253238128,3768065484,1658594299,1658595262,963,104
3626592600,3933052429,1664206981,1664207567,586,129
3257319404,3596024184,1658005460,1658005619,159,4056
3771425079,3090184356,1641316857,1641316889,32,231
3743600464,3961239772,1663456565,1663457442,877,2260
3227862843,3164234288,1659521065,1659521073,8,2359
3292349573,3321913328,1660710770,1660710967,197,916
3636846044,3471346318,1666421431,1666422190,759,4118
3164197754,3040770684,1644223871,1644224022,151,4607
3024351190,3513686728,1660446421,1660446849,428,4418
3862328080,3282950549,1651914204,1651915167,963,4853
3489658940,3501935007,1646002895,1646003419,524,594
3389118931,3128162604,1643067710,1643068171,461,68
3949545606,3915598092,1656934648,1656935596,948,2850
3798242250,3845132567,1645591664,1645592031,367,2928
3912662874,3894760467,1658213516,1658214375,859,2285
3709232131,3711736976,1648132129,1648132206,77,4510
3784546770,3384993802,1662239722,1662240034,312,1117
3488499570,3250551564,1664739584,1664740292,708,1572
3559228371,3262005357,1646451979,1646452574,595,3851
3865632476,3093387219,1654526296,1654526378,82,1653
3116867346,3132284742,1652013018,1652013992,974,1748
3833609255,3614206850,1651978206,1651978233,27,2945
3384069326,3195270337,1648769727,1648770197,470,2999
3668634476,3001205652,1651351115,1651351278,163,870
3175732060,3100351389,1659845477,1659845574,97,2304
3980733272,3465634250,1652340522,1652341088,566,994
3856791929,3807359316,1664566656,1664566794,138,4558
3910012116,3702606713,1646575298,1646575336,38,2554
3648144483,3570710791,1655124164,1655125053,889,3319
3884036915,3999062965,1662739126,1662739268,142,1577
3087937469,3156155190,1643469719,1643470367,648,322
3174941585,3863442706,1654161848,1654162742,894,3638
3210369483,3958093450,1664873463,1664873771,308,887
3751686596,3573430832,1657972677,1657973268,591,964
3677781404,3561187681,1648916845,1648916870,25,1882
3065642139,3410774472,1642739849,1642740779,930,2903
3500055386,3397327045,1668679172,1668679311,139,4523
3410590155,3935498309,1666586461,1666586809,348,4199
3323854420,3767824027,1645635790,1645636786,996,1849
3969473373,3399681145,1660557391,1660557934,543,4255
3986566438,3302502861,1641708681,1641709365,684,3356
3712966846,3923492543,1653950803,1653951396,593,4889
3504808864,3477791460,1668036827,1668036938,111,3737
3613585509,3338361070,1660727716,1660728037,321,3283
3728784233,3076273469,1651539818,1651540357,539,1855
3398467559,3871353458,1664223499,1664224387,888,2979
3684731486,3525006756,1648817558,1648818049,491,1250
3843210787,3927020278,1667249122,1667249294,172,4900
3853920999,3335371735,1652392041,1652392421,380,534
3263422452,3595077968,1663867957,1663868873,916,4856
3277471951,3366013464,1658372465,1658372640,175,2485
3046928660,3575219759,1650410811,1650411141,330,2753
3400323562,3834447336,1652362438,1652363378,940,600
3832509101,3132883451,1648789030,1648789493,463,2110
3332107906,3446125233,1647828879,1647829827,948,336
3746515327,3666688105,1659370293,1659370816,523,4439
3555950852,3933957060,1650383906,1650384699,793,2198
3865789461,3909315969,1669250116,1669250894,778,3736
3011851057,3294532428,1669671183,1669671617,434,2095
3301121920,3222596235,1657329172,1657329590,418,2489
3630750336,3094498062,1652444146,1652444824,678,2203
3183553792,3912011790,1664453095,1664453754,659,4168
3487511824,3181608898,1657951561,1657951962,401,3171
3427898710,3474467290,1642855922,1642856297,375,2753
3224470159,3113550697,1654571663,1654571852,189,3708
3540382486,3499932593,1658820605,1658820834,229,4047
3601075626,3921276521,1658368052,1658368459,407,1295
3976944560,3714782021,1648672230,1648672456,226,4569
3391853193,3148615082,1660945563,1660945765,202,3665
3812545158,3411349563,1663185415,1663185538,123,1606
3568177893,3123210855,1646800435,1646801214,779,1764
3587781734,3591809520,1645675493,1645676076,583,3643
3812113377,3846547261,1641446094,1641446906,812,1423
3633513674,3894400553,1669102747,1669102772,25,4085
3034942750,3416629045,1642990890,1642991540,650,2525
3033748186,3154803157,1651782309,1651782524,215,4748
3628375335,3253460222,1653245056,1653245970,914,4721
3693844139,3135338868,1643238575,1643238827,252,3185
3266566393,3365981782,1649595823,1649596801,978,285
3588605396,3964573709,1656924310,1656924345,35,3537
3941511587,3524977226,1651796596,1651797086,490,3840
3356005298,3612895264,1665762720,1665763505,785,2999
3230062436,3713745528,1649472291,1649472729,438,2601
3631570133,3034611924,1645631362,1645632133,771,3196
3545851623,3451901750,1646014917,1646015308,391,2168
3998845318,3162287487,1659169191,1659169842,651,1249
3638961204,3288488848,1668312751,1668312870,119,336
3470028646,3028790651,1651917956,1651918233,277,165
3203298672,3367755762,1647479617,1647480039,422,183
3680322941,3237814703,1654978201,1654978550,349,3039
3917319917,3868506090,1652924071,1652924238,167,1878
3442387012,3985172792,1665754466,1665754467,1,4311
3434166876,3911638319,1645762919,1645763688,769,4573
3391822376,3795640755,1660340789,1660341271,482,4275
3919596041,3553313980,1658318580,1658318627,47,2064
3346086197,3336431032,1664348753,1664349176,423,3969
3587649420,3272754130,1641410637,1641411224,587,2336
3948329631,3795268924,1663569290,1663570112,822,2223
3084312635,3246147416,1668810191,1668810251,60,3859
3438844424,3777727032,1651813895,1651814073,178,903
3584089820,3173345763,1656435925,1656436578,653,381
3129273872,3030027260,1657652979,1657653197,218,1646
3935374508,3095876291,1643576359,1643576374,15,1011
3284293161,3852908304,1655425098,1655425268,170,4045
3667030254,3065574309,1657223639,1657223763,124,2137
3405812712,3630336512,1666355367,1666355798,431,3299
3253599769,3843281706,1648003242,1648003828,586,544
3690549054,3835722429,1665886544,1665886870,326,3392
3761161380,3383112373,1665308377,1665308711,334,3723
3259701194,3743452697,1653134653,1653135422,769,842
3184759287,3772923056,1666076553,1666077520,967,1208
3531779645,3871113256,1649136003,1649136766,763,203
3560528944,3250968144,1650883943,1650884931,988,2592
3484231635,3620096754,1643656509,1643656591,82,779
3065367746,3217911474,1665337285,1665337328,43,1064
3938050638,3695828367,1650130645,1650131114,469,3331
3357294927,3409242403,1657084302,1657084452,150,630
3351892316,3286874781,1648201843,1648202360,517,2422
3787639201,3729435605,1642726521,1642727111,590,4337
3782824117,3955953678,1653932890,1653932953,63,4941
3765152893,3900602441,1665475654,1665475726,72,3262
3513901270,3247105684,1641226279,1641226878,599,4222
3594146794,3266026948,1644627567,1644628431,864,1747
3095747216,3264937530,1667479050,1667479689,639,2169
3445800532,3706944795,1653849363,1653849674,311,2921
3321012476,3508658866,1666686786,1666687292,506,4897
3580921392,3055965802,1661106557,1661107487,930,4694
3584309441,3237839232,1641975780,1641976300,520,370
3243859000,3526288388,1645541150,1645541844,694,2180
3667346913,3868898593,1647528237,1647529191,954,4665
3211134596,3142638582,1666153493,1666153854,361,4143
3783011764,3234645683,1659053079,1659053798,719,3107
3972281490,3497474793,1658918468,1658919251,783,2270
3942661220,3740684163,1642514200,1642515138,938,711
3267922786,3113217458,1649190789,1649190843,54,789
3241474982,3689815625,1657115071,1657115994,923,1841
3966106502,3038993104,1644825490,1644825692,202,2209
3277560904,3336749380,1667554083,1667554505,422,1880
3502869036,3372498524,1669215266,1669215536,270,34
3537783466,3549187317,1644049977,1644050936,959,4392
3599811290,3335144039,1657808547,1657808977,430,72
3978886695,3568314615,1643937808,1643937995,187,4758
3885169174,3772753981,1661538703,1661539544,841,1160
3709100035,3509446048,1660430999,1660431501,502,4151
3126352860,3278773367,1661651201,1661651261,60,1028
3771924237,3914247348,1647714929,1647715351,422,536
3502395541,3763417579,1645328160,1645328970,810,298
3198478250,3821541795,1651749711,1651749932,221,1085
3735509526,3888312181,1644753104,1644753342,238,1843
3311492347,3544895309,1655769495,1655770455,960,333
3096382279,3088234719,1662641219,1662641889,670,3315
3207959130,3434582559,1642176421,1642176776,355,155
3323708845,3042239818,1657648944,1657649507,563,3737
3939776640,3430443949,1646750266,1646751211,945,651
3349034816,3878510624,1654734925,1654735404,479,3129
3651867591,3846598273,1653716459,1653716917,458,3675
3852851317,3019375956,1665476965,1665477500,535,3668
3964626037,3459014785,1651303298,1651303822,524,37
3421120915,3983253081,1668201309,1668201967,658,1791
3374167887,3912378716,1656084889,1656085454,565,309
3940732451,3345102521,1666287055,1666287976,921,1629
3665674843,3201115641,1667727344,1667727473,129,2570
3545865232,3473515406,1657826425,1657827328,903,375
3961206234,3318182884,1647838955,1647838990,35,3197
3141641523,3301102707,1655628094,1655628635,541,1928
3645917259,3329261723,1662719124,1662719894,770,1816
3453360527,3556880259,1664443245,1664444234,989,777
3486363928,3553500462,1641519281,1641520254,973,3380
3007671556,3488659995,1654167165,1654167798,633,3588
3494948355,3718644082,1667806478,1667807375,897,2107
3753082236,3983957045,1661766178,1661766508,330,4703
3222401690,3159333416,1656043021,1656043767,746,2953
3688725822,3978083413,1642214042,1642214884,842,3394
3210554654,3138428017,1654948507,1654948779,272,821
3795920185,3796338864,1668718927,1668719650,723,402
3552870603,3896627335,1668420802,1668421473,671,3560
3267005351,3774454294,1651035316,1651035443,127,2921
3200654685,3351899861,1669242202,1669242445,243,2568
3259004005,3791012488,1661874888,1661875249,361,3495
3871278184,3066510559,1657689341,1657689603,262,3246
3139952924,3086841302,1650696525,1650696661,136,2695
3469745486,3211013773,1660463224,1660463893,669,457
3495428480,3720117772,1660929253,1660930030,777,2027
3938365566,3347814796,1657747831,1657748656,825,1280
3292052764,3952414565,1663960480,1663960489,9,1353
3954608232,3637648220,1657238721,1657239390,669,4162
3506991278,3622859080,1644217784,1644218045,261,4580
3486338691,3456130441,1661993299,1661994110,811,286
3391969479,3099489301,1659553570,1659553610,40,2309
3117227360,3919468221,1657591546,1657592423,877,3496
3911052912,3458871589,1649387640,1649387740,100,2083
3912273762,3023174113,1642046041,1642046253,212,1412
3849395048,3789002011,1664907986,1664908365,379,65
3495334987,3171924108,1654233249,1654233814,565,4535
3791017416,3229945234,1645092177,1645092727,550,2591
3400161930,3789665160,1655001199,1655001800,601,2040
3705604541,3438685918,1666068341,1666068930,589,660
3354562915,3082502963,1657335032,1657335658,626,657
3148033553,3304172618,1663934102,1663934852,750,2982
3168139364,3932989659,1667344583,1667344748,165,1179
3284378232,3464577059,1643382300,1643382499,199,498
3821689493,3135838407,1646957457,1646958333,876,1489
3927261134,3417214775,1652000324,1652000441,117,3960
3803422217,3174298366,1663485636,1663486031,395,1457
3988173734,3773491306,1651355027,1651355409,382,4570
3394240750,3217991086,1667020229,1667020555,326,3611
3456389216,3828373321,1659166824,1659167821,997,4872
3495959013,3944489859,1643166069,1643166362,293,4025
3205373004,3872515146,1660747399,1660747934,535,838
3787094801,3453328814,1641652268,1641652284,16,1632
3480361961,3691434365,1647808444,1647808543,99,3762
3761051293,3437712160,1658756622,1658757082,460,2993
3859408437,3461321371,1648433585,1648434522,937,4738
3884646899,3604388567,1647929848,1647930504,656,1621
3477791519,3532885668,1664576332,1664577083,751,2769
3525916653,3521292174,1650509582,1650510098,516,3629
3718126340,3304788937,1656501093,1656501100,7,3537
3396151782,3888295232,1662556786,1662557696,910,4120
3583895221,3541160099,1655633551,1655633757,206,116
3365229323,3321323126,1644313986,1644314137,151,163
3495207356,3335599960,1645706357,1645706429,72,1375
3706568442,3136763617,1655556206,1655557044,838,404
3343193466,3369477332,1640997886,1640998387,501,3701
3443521682,3225498580,1641068092,1641068407,315,2777
3631570133,3054152527,1660270234,1660270240,6,604
3896634881,3666218394,1663797380,1663798362,982,4009
3437820424,3824744156,1647920718,1647921448,730,766
3057652497,3333865156,1648001432,1648002416,984,149
3605772683,3840914939,1649527052,1649527089,37,4861
3338890488,3207380066,1653456269,1653456785,516,4580
3593880563,3721922015,1667861555,1667862413,858,2802
3774205093,3030437574,1645492716,1645492773,57,2770
3471299918,3078364968,1658802955,1658803075,120,2167
3383663544,3405900529,1665863123,1665864088,965,4098
3972014541,3970120619,1643433775,1643434443,668,2838
3448797551,3652899938,1652895467,1652896294,827,3174
3490731960,3720376448,1651940648,1651941472,824,123
3582899039,3967695813,1652893005,1652893993,988,3578
3328899358,3401215391,1667899071,1667899297,226,1053
3370482825,3496545354,1652991091,1652991448,357,4975
3801256514,3412850400,1666923869,1666924274,405,1147
3365738527,3077822113,1662257556,1662258220,664,1134
3976255143,3904708545,1648132412,1648133162,750,579
3165799497,3983089472,1661808174,1661808442,268,3207
3013672534,3613269908,1655376707,1655376902,195,1507
3414830461,3740776172,1668066259,1668066345,86,1822
3505503440,3737594861,1654285831,1654286467,636,3709
3499822844,3593085729,1649243405,1649243618,213,160
3528997161,3705108011,1643952065,1643952536,471,4296
3800568710,3098227316,1662569093,1662569368,275,3346
3934937518,3370859166,1657672770,1657673605,835,2379
3544980268,3365375653,1641894209,1641895111,902,638
3011734796,3552688686,1644949896,1644950230,334,335
3007153662,3680019007,1657205953,1657206141,188,902
3033544813,3482129436,1651255095,1651255181,86,3062
3804763865,3221314277,1669331868,1669332017,149,4166
3101579141,3305929907,1658110189,1658110355,166,2659
3593730662,3450126909,1659688166,1659688207,41,3340
3018173496,3200014499,1667467371,1667467415,44,3269
3722897562,3759755239,1646561475,1646561967,492,1408
3772552951,3865923498,1642962807,1642963399,592,1101
3165864999,3384508592,1651617523,1651618353,830,595
3006503652,3567100647,1659799686,1659800623,937,1430
3874540239,3900029073,1641795392,1641796271,879,4729
3967973715,3779272913,1663985963,1663986567,604,2114
3858793204,3426937273,1649972365,1649973241,876,3814
3155640525,3953893004,1656184575,1656185389,814,4843
3495024347,3948345081,1649527061,1649527397,336,2413
3205111928,3870742499,1656907226,1656907730,504,439
3702967397,3394127608,1643005387,1643005980,593,4536
3054854418,3238205831,1650868141,1650868631,490,2220
3007804170,3743994366,1658960501,1658961062,561,1000
3475289897,3289490806,1655103882,1655104461,579,4637
3347075156,3084700913,1645114817,1645115671,854,3100
3867508089,3130270265,1641655239,1641655752,513,4812
3997738241,3617617622,1661377835,1661378044,209,3799
3508516834,3866669576,1662355620,1662356404,784,449
3097687491,3695653353,1646162945,1646163001,56,576
3673907941,3323653639,1668321930,1668322575,645,1488
3723894025,3875902526,1652495521,1652495720,199,2552
3721842197,3013297825,1653751080,1653752010,930,2625
3945126387,3835508048,1656632196,1656632238,42,4528
3931351284,3211425956,1651458224,1651458352,128,642
3894879680,3678276737,1655212405,1655212802,397,1646
3643984788,3498274842,1643321827,1643322207,380,1960
3111793685,3800367189,1647433381,1647434119,738,3233
3719461921,3880145174,1654281178,1654281761,583,3088
3906997298,3896506378,1649253839,1649254760,921,4042
3762071860,3459632289,1654831871,1654832765,894,2666
3004681292,3011372969,1656097245,1656097986,741,3112
3604036849,3428380284,1656766429,1656766709,280,3580
3359376440,3766620199,1650254770,1650255337,567,519
3082275571,3553945290,1646942709,1646943597,888,1752
3228390423,3135034434,1647703158,1647703825,667,4043
3784546770,3619309445,1662458815,1662459382,567,1019
3320159141,3754534443,1650859870,1650859921,51,3906
3542834680,3924727842,1660770346,1660770642,296,4710
3943213139,3184318136,1660554330,1660554843,513,3623
3283650121,3381446343,1663938216,1663938802,586,1017
3442334065,3062562498,1664244842,1664245607,765,754
3520649880,3845783053,1664568338,1664568857,519,1190
3270642416,3261330088,1662730569,1662731387,818,1806
3386772739,3462158109,1663334052,1663335016,964,3800
3139050377,3416875158,1655592651,1655593497,846,3187
3983550022,3602146369,1666971266,1666971288,22,4913
3059222002,3028253067,1668144701,1668145135,434,3568
3867408749,3026332023,1665657703,1665658165,462,4949
3422223252,3688228461,1657122591,1657123382,791,4322
3863774953,3965790792,1652529174,1652529274,100,1639
3705846920,3819864410,1656005261,1656005768,507,2162
3743199884,3807540644,1664401846,1664401892,46,1366
3036433393,3492617188,1668636634,1668637596,962,575
3130980798,3876837068,1655508877,1655509686,809,4183
3279492158,3532985428,1665219756,1665219792,36,4051
3749837804,3939304480,1653751537,1653752406,869,3138
3320279228,3812045637,1655846318,1655847037,719,1198
3771369161,3722694531,1661831222,1661832091,869,3863
3939133475,3601854391,1646053770,1646054593,823,915
3356507147,3032462333,1656848186,1656848729,543,1771
3038332247,3568752138,1657562570,1657563160,590,1634
3620428587,3962831559,1649401001,1649401329,328,4764
3331600091,3069879289,1650469221,1650469494,273,595
3768155447,3135838407,1654551643,1654552065,422,375
3765413020,3802245982,1660803493,1660803756,263,3991
3823960806,3970145638,1651118021,1651118402,381,2904
3176534815,3789470263,1652254815,1652255599,784,504
3529022724,3331564514,1658381302,1658381488,186,2546
3234879526,3366121789,1645002792,1645002946,154,2561
3989243895,3376850873,1648353302,1648353690,388,3212
3460467655,3882713228,1647537436,1647538193,757,4196
3974043717,3720230196,1649086217,1649086398,181,2834
3440408027,3518623298,1641457060,1641457174,114,4936
3201468879,3753619109,1661108381,1661108934,553,1039
3401743730,3327377659,1654060826,1654061369,543,4178
3352317105,3320401907,1648978855,1648979526,671,1398
3929983721,3836524679,1644352867,1644353675,808,3376
3348168022,3125029338,1645996244,1645996786,542,4061
3296348139,3329932676,1641081521,1641081734,213,2726
3333906220,3198663606,1656199146,1656199806,660,1074
3580592997,3607787899,1660995409,1660995589,180,3839
3104419832,3175960289,1654095396,1654095640,244,2828
3493494232,3856334489,1655291701,1655291910,209,342
3310765993,3615338494,1653677155,1653677510,355,1026
3470771422,3231018379,1657964257,1657964839,582,3169
3863778000,3087673025,1658884677,1658885415,738,3654
3506518135,3154979720,1662695599,1662695752,153,3937
3856356133,3058925951,1659967732,1659968286,554,565
3366443639,3375338206,1656248524,1656248938,414,1211
3412481225,3565968811,1663521368,1663521563,195,1761
3035311011,3317594456,1645373375,1645374193,818,4807
3080746869,3956427224,1660525568,1660525808,240,4030
3795372299,3365321934,1643881064,1643881216,152,3762
3063513678,3540778011,1662348033,1662348797,764,2503
3881314829,3501068011,1655722225,1655722556,331,2265
3913030686,3320111483,1656720207,1656720455,248,962
3964264741,3364154808,1644767618,1644767812,194,1739
3121175783,3655516532,1645187502,1645188157,655,4775
3199475975,3004652712,1641224684,1641224761,77,1777
3665435407,3442331238,1663827697,1663828275,578,1565
3250987193,3750904517,1646590811,1646590961,150,1687
3821926323,3059608802,1644957039,1644957880,841,2793
3685711288,3280864853,1654687897,1654688717,820,1298
3191880142,3828373321,1647360319,1647360858,539,1946
3001313583,3040612176,1648479557,1648480102,545,1379
3223274718,3196119135,1643184946,1643185394,448,646
3968255363,3460261266,1664179466,1664180461,995,3181
3014567323,3715540652,1644911002,1644911837,835,1214
3363362880,3694754390,1654283243,1654284048,805,3080
3842106836,3116098489,1647364467,1647365431,964,3143
3505550267,3207227196,1668003823,1668004719,896,2772
3446928581,3793225772,1659586475,1659586792,317,1754
3744522824,3813594344,1660712039,1660712834,795,4368
3831276285,3487473503,1654182357,1654182671,314,3651
3660124992,3073930327,1667662661,1667662942,281,4736
3559494813,3791554905,1663053432,1663054351,919,3984
3686064301,3196758204,1659770118,1659770142,24,2603
3150617418,3622846494,1646773702,1646774675,973,367
3562463611,3874482818,1656058149,1656058203,54,174
3798099862,3995432712,1657472084,1657472413,329,4592
3855168254,3544210287,1646479206,1646479781,575,519
3503519703,3431953832,1668002808,1668002881,73,4888
3761367202,3562581746,1663624729,1663625132,403,3140
3773341153,3958487689,1665388968,1665389863,895,3607
3090625135,3882303568,1658585944,1658586499,555,726
3387475625,3734804561,1657813173,1657813745,572,1204
3547234018,3703924259,1651742707,1651742915,208,2877
3986946661,3622079698,1665643667,1665644124,457,3582
3264834528,3860204451,1668388216,1668388231,15,2441
3954645579,3299525116,1643747991,1643748441,450,2993
3642270110,3523427088,1656347841,1656348598,757,582
3886442844,3246480884,1659086263,1659087021,758,3026
3760317597,3061050026,1663442253,1663442705,452,1387
3464959756,3306960031,1646400576,1646401068,492,4842
3403520215,3229145940,1653724095,1653724509,414,1148
3511905675,3812845936,1665253362,1665254141,779,1860
3448960838,3519167916,1641584913,1641585667,754,4868
3045162377,3347376561,1660223046,1660223444,398,3859
3453279975,3357721643,1656949728,1656950284,556,1142
3669432282,3577411468,1645791997,1645792523,526,3417
3716376007,3823851895,1661909719,1661910269,550,1760
3405234947,3969034381,1645940845,1645941096,251,2186
3637283459,3531597857,1651612431,1651613385,954,4754
3901549129,3853275008,1667711490,1667711836,346,4046
3135253842,3212873835,1664992597,1664992745,148,1736
3212957887,3926008862,1661871612,1661872549,937,3984
3368886501,3356285521,1646464137,1646464516,379,1093
3386367596,3150727971,1651104069,1651105006,937,140
3927788300,3935589255,1659897694,1659898252,558,2253
3180763341,3781364092,1648951358,1648951812,454,1147
3557309758,3882663489,1654196511,1654196983,472,2681
3634521271,3345694009,1641651266,1641651948,682,3094
3198915697,3331777351,1642419329,1642420027,698,2079
3382354082,3830387031,1652198328,1652198831,503,3756
3093770014,3424347482,1650534447,1650535010,563,3078
3024257435,3822755987,1655700172,1655701033,861,1371
3235519745,3329114356,1643703728,1643704429,701,4977
3943114376,3270680339,1651733013,1651733262,249,2858
3409227229,3706612235,1650426802,1650427076,274,1304
3129878991,3132491724,1656962040,1656962997,957,298
3038017243,3261229792,1642865433,1642865486,53,19
3133089330,3546928251,1663709757,1663710538,781,3506
3588921055,3327894836,1662618351,1662618651,300,1225
3222271394,3131162674,1656779919,1656780794,875,3097
3008275329,3544388818,1642746604,1642746810,206,3927
3173544680,3671601284,1649938828,1649939462,634,2896
3445351463,3593844274,1659898213,1659899147,934,4371
3610085486,3869764682,1644339705,1644340205,500,2648
3415819093,3694235802,1646848752,1646848781,29,4017
3495846661,3519158711,1652310534,1652311258,724,3690
3575219759,3799864667,1647976284,1647977070,786,1642
3249953248,3901288530,1662374655,1662375265,610,568
3276056647,3844918426,1655850081,1655850712,631,2206
3708100440,3347499679,1648541870,1648542499,629,13
3408137661,3518557531,1661179941,1661180178,237,4305
3513653993,3618360613,1641214953,1641215070,117,3620
3485073219,3965588401,1648237299,1648237390,91,3596
3260662473,3714595599,1655468674,1655469517,843,4892
3594925855,3627153004,1642450754,1642451132,378,4458
3458043539,3210529166,1665880442,1665881060,618,2530
3271829344,3955189980,1660255749,1660256635,886,2969
3768307407,3957729660,1669006931,1669007744,813,1077
3420507127,3617784204,1663230783,1663231590,807,4451
3454576693,3393738674,1667505591,1667505695,104,3116
3338989508,3890991753,1658963020,1658963899,879,3826
3058402470,3748367576,1648536558,1648537153,595,3616
3175965214,3631716848,1652568231,1652568758,527,3424
3976480023,3918616111,1655278098,1655278218,120,532
3980946239,3868571797,1641043561,1641043616,55,4017
3090986232,3311681406,1652682221,1652683108,887,299
3670261344,3141431176,1662067925,1662068597,672,4527
3810102378,3824114420,1663599422,1663599480,58,1306
3537542979,3259322102,1641365538,1641365915,377,358
3215279922,3115816199,1662433347,1662433814,467,3540
3419331476,3045601620,1643862051,1643862813,762,498
3273854902,3717281700,1663115990,1663116051,61,3614
3539336681,3915066274,1654977609,1654978264,655,2353
3883523801,3457598115,1647824611,1647825314,703,493
3119802065,3956894051,1664286164,1664286728,564,1846
3019162557,3685374692,1668831687,1668831822,135,3995
3007176392,3541292082,1662597235,1662597466,231,2819
3095497543,3951830089,1648427346,1648427371,25,2590
3347301254,3465264051,1656984596,1656985446,850,2291
3875101606,3673688489,1650292687,1650293100,413,3589
3388592739,3558429593,1645708276,1645708754,478,4402
3486515445,3266269262,1642354490,1642355092,602,4444
3859748042,3440737763,1645407364,1645407394,30,1460
3122302437,3086054878,1668127649,1668128239,590,3218
3288952132,3479975139,1666278869,1666279769,900,4863
3285161956,3829542940,1655803989,1655804486,497,3872
3126415536,3090700287,1668921158,1668921287,129,1580
3199577600,3934299354,1649966118,1649966162,44,481
3041993287,3687882210,1662752377,1662753232,855,250
3025469215,3542766864,1665233328,1665233982,654,1537
3788127250,3687040206,1658720747,1658721355,608,1557
3496157930,3965386379,1644419071,1644420047,976,4088
3381205426,3959413726,1650064108,1650064185,77,1218
3700290083,3702120089,1668620732,1668621202,470,3582
3586783153,3287660561,1657286940,1657287432,492,2100
3609957352,3644522328,1666945428,1666946163,735,1029
3539336681,3823370335,1652201343,1652201673,330,423
3855525613,3440153731,1644020828,1644021783,955,4972
3667955712,3292803804,1652371414,1652371945,531,2384
3757907406,3700263948,1668639258,1668640082,824,3499
3296896742,3725321069,1647672359,1647672392,33,3632
3625387024,3055151815,1653695242,1653695721,479,2332
3168175802,3160061488,1661269640,1661269761,121,4803
3420083053,3840293769,1659275229,1659276130,901,769
3188718986,3581430281,1642848729,1642848791,62,4128
3573390683,3357654605,1661594574,1661595134,560,2155
3473692260,3713004786,1642807542,1642807927,385,1
3335809340,3358100784,1648875977,1648876576,599,4050
3376850873,3827217579,1646201523,1646201548,25,4283
3814020454,3716309103,1657559785,1657559925,140,4665
3452644168,3015328797,1663790303,1663790416,113,3383
3893024264,3147757043,1657383453,1657383479,26,4124
3781283986,3853428083,1651549446,1651550397,951,394
3046448783,3549916929,1667520799,1667521115,316,1966
3269551723,3026370288,1658534096,1658534677,581,854
3516893526,3242144521,1669347537,1669347748,211,3805
3183699805,3703092681,1663998538,1663998858,320,2407
3370084411,3141359541,1651066862,1651067206,344,4359
3545754900,3693392189,1658493596,1658494263,667,1572
3570938441,3966492278,1667552463,1667552685,222,4168
3417878617,3104390683,1657802801,1657803424,623,3109
3328410169,3674553036,1650150106,1650150436,330,4344
3966716259,3232848619,1659595062,1659595386,324,3706
3188042624,3633295632,1658715809,1658716474,665,2488
3006227047,3505144903,1663661114,1663662030,916,544
3996195291,3837236321,1661607510,1661608217,707,4233
3870662674,3547058721,1662340479,1662340710,231,4866
3417210451,3696028145,1648381667,1648381748,81,4722
3175095546,3220604196,1653032386,1653032715,329,4449
3938788517,3924389934,1661712125,1661712992,867,3834
3187235926,3404172795,1646437107,1646437587,480,2349
3282852943,3998902278,1648579948,1648580554,606,4008
3196386825,3945146977,1642289976,1642290004,28,3675
3882510684,3970156869,1646657760,1646658323,563,1530
3387511665,3817726834,1666367129,1666367990,861,763
3985710306,3331689492,1661342401,1661343365,964,4633
3252929927,3961054113,1652285759,1652286650,891,4256
3306278125,3383681838,1662417380,1662417669,289,310
3007561486,3835480652,1666781354,1666782225,871,1811
3688031763,3103303297,1668261326,1668261360,34,362
3127050212,3317627922,1661430420,1661430991,571,409
3951713253,3017059795,1653818407,1653818425,18,960
3659522196,3315368626,1643637703,1643637821,118,713
3430072489,3811546376,1647535482,1647536046,564,232
3029754747,3060748730,1645891163,1645892138,975,2040
3257634428,3188530906,1653020693,1653020832,139,2333
3150462709,3427300507,1658143101,1658143403,302,1029
3082295865,3708877971,1664889527,1664890375,848,525
3862415807,3133556368,1641218172,1641219129,957,661
3171690962,3074066146,1667580802,1667581534,732,4947
3367261161,3482921040,1650619916,1650620661,745,23
3445929166,3989945642,1660450436,1660450641,205,4055
3220925171,3224364503,1663771966,1663772956,990,687
3514110817,3335128811,1644960578,1644961003,425,3284
3078405645,3245221857,1642391782,1642392767,985,2845
3151427223,3619786433,1648265480,1648265812,332,1456
3894030309,3149834452,1643453808,1643454454,646,343
3759128245,3445654058,1641468387,1641469003,616,1402
3621857070,3559569966,1646136266,1646136621,355,4721
3353382874,3317283512,1666467857,1666468250,393,2138
3958134339,3060957829,1655452487,1655453028,541,1536
3843463497,3671654447,1662733333,1662734092,759,191
3761522769,3370013488,1667701082,1667701450,368,3013
3552649584,3541072275,1650913953,1650914886,933,3684
3443512621,3836721437,1658765019,1658765901,882,2465
3195820845,3567340284,1642130542,1642130898,356,3564
3563941418,3916427661,1662355801,1662355905,104,3131
3955291739,3862733158,1658346113,1658346114,1,1998
3298967690,3115971914,1656956088,1656956868,780,1872
3579629247,3585991117,1651171654,1651172323,669,3796
3809561099,3403410173,1654491386,1654491706,320,4586
3342055729,3838568249,1667928620,1667929547,927,54
3374496229,3720416383,1649019958,1649020450,492,1211
3258401840,3165837793,1647960893,1647961345,452,93
3608896953,3029046769,1649362535,1649362708,173,1877
3550874184,3661298405,1645623174,1645624055,881,4375
3269034746,3863823598,1643993683,1643994207,524,3226
3118358759,3959004400,1654623978,1654624713,735,2628
3139657792,3247245837,1668633923,1668634235,312,3152
3275203126,3815414116,1668216848,1668217438,590,705
3984663569,3485077220,1646376122,1646376444,322,748
3958654230,3660902868,1642456279,1642456781,502,2563
3075065029,3537027311,1667804552,1667804940,388,214
3478634745,3833973864,1669415803,1669415918,115,765
3459118075,3351701380,1647569672,1647569683,11,3418
3100837472,3023164113,1664167061,1664167977,916,2957
3802739682,3218530729,1654843401,1654844292,891,4811
3500528712,3581497539,1642550778,1642551039,261,3041
3241895383,3924274423,1648824801,1648825472,671,1273
3614013370,3165089859,1650840377,1650840942,565,2364
3029500269,3174913647,1666355355,1666355432,77,866
3360978790,3952906885,1662570225,1662571136,911,1185
3030725059,3221409833,1649871891,1649872608,717,3416
3862770581,3292254626,1643295422,1643295659,237,4346
3816217267,3875447220,1652029587,1652030126,539,3962
3814266542,3588894367,1653922555,1653923261,706,4501
3162703743,3463290754,1667259374,1667260175,801,4554
3917817410,3798437015,1647802844,1647803650,806,4973
3805926630,3486645535,1667345300,1667345637,337,4728
3774565017,3781019129,1669322729,1669323044,315,3635
3756837201,3916514532,1669252022,1669252256,234,2037
3463592347,3959064657,1656124142,1656124360,218,940
3228367332,3847592710,1653594905,1653595270,365,2101
3033883764,3979708212,1644840720,1644841468,748,1320
3270980577,3341548266,1661167592,1661168589,997,254
3864876811,3153758694,1655532382,1655532508,126,694
3135717121,3487084398,1667648995,1667649578,583,4073
3721039858,3337247965,1663964870,1663965490,620,848
3258038609,3533320737,1668909040,1668909169,129,2237
3599427767,3931328480,1652163257,1652164112,855,1687
3175305380,3795264814,1652433667,1652433693,26,4241
3758021715,3351014572,1659963602,1659964374,772,4889
3348628165,3364153562,1660528985,1660529922,937,1644
3506246331,3152444337,1660073730,1660074347,617,765
3828787138,3245383793,1654115683,1654116626,943,1824
3305896005,3927258530,1647356077,1647356148,71,2791
3127858298,3131820603,1660325636,1660326122,486,104
3462464690,3736227635,1642033615,1642033896,281,2721
3895658351,3651599435,1658999354,1658999403,49,4564
3347500101,3464236057,1652203353,1652204332,979,3777
3328974848,3058169029,1659333481,1659334453,972,4647
3117462709,3822206910,1641688016,1641688062,46,1745
3237990033,3576544508,1668989802,1668990367,565,4495
3278785861,3758557922,1652451506,1652451586,80,71
3773757523,3089483640,1641257485,1641257639,154,1975
3914452123,3521436113,1654933964,1654934917,953,307
3827113936,3842095124,1667089521,1667090388,867,4530
3592307594,3465116884,1641822828,1641823027,199,2544
3367693051,3965580965,1659955361,1659956277,916,3015
3665521168,3132689405,1667956895,1667957375,480,1120
3536809946,3465206352,1660651848,1660652452,604,938
3073679159,3744252778,1659531107,1659531309,202,816
3404814117,3996736087,1648985859,1648986700,841,2258
3712822562,3277773677,1669044310,1669045166,856,1396
3458778448,3694711779,1660477147,1660477734,587,4833
3324641408,3896062576,1649682439,1649682849,410,1425
3644240042,3906878089,1653028327,1653028651,324,4496
3750885417,3371587312,1655460971,1655461046,75,944
3348968729,3444089254,1651603177,1651603922,745,822
3277346167,3274389070,1642573615,1642573838,223,84
3839448828,3494101075,1642123282,1642123899,617,1435
3485641379,3495063950,1648854751,1648854858,107,1346
3008263777,3185501635,1643613295,1643613845,550,3883
3869687389,3629541578,1654921204,1654922111,907,409
3755099710,3993394456,1641746028,1641746910,882,3902
3288950781,3715182751,1641752393,1641752539,146,1078
3949712255,3840641204,1657219502,1657220306,804,3670
3018642737,3038605376,1643479526,1643479917,391,4127
3897457708,3936273380,1664900238,1664900656,418,1949
3211679936,3464584976,1659930440,1659930816,376,1084
3688180191,3822166752,1664582983,1664583069,86,4966
3523808384,3551789320,1658188941,1658189931,990,4477
3557194021,3336345801,1646620584,1646620978,394,109
3651466013,3043496109,1659506465,1659507382,917,4218
3296822801,3087246451,1665921807,1665922568,761,2768
3139587585,3696804508,1654823802,1654824794,992,1043
3212834649,3252431462,1653786991,1653787594,603,4609
3287473999,3047640103,1644528790,1644528926,136,4814
3820275465,3962518885,1643479580,1643479653,73,4967
3305696028,3692628708,1650952191,1650952413,222,932
3412862477,3073726824,1654636597,1654637210,613,4349
3703008794,3533390599,1650924972,1650925113,141,3098
3258341958,3471406380,1666525153,1666525857,704,2418
3655595120,3463854974,1642198356,1642198822,466,3282
3257250873,3403899069,1663411156,1663411658,502,1362
3721209272,3002853414,1654581705,1654582343,638,1034
3433432356,3392545785,1657897087,1657898020,933,2164
3103501036,3052708551,1651658128,1651658617,489,994
3628726622,3549089999,1669666125,1669666826,701,2713
3004422192,3424437298,1647171275,1647171329,54,491
3197166639,3113921306,1655432726,1655433583,857,3352
3537403070,3449894010,1669671638,1669671922,284,3918
3515917744,3930298138,1659816457,1659817354,897,3668
3325271903,3666339483,1656627416,1656627819,403,1401
3347996327,3583575117,1669343575,1669344508,933,4946
3018813533,3747093576,1649538403,1649538811,408,4030
3029262306,3816015826,1669644813,1669645365,552,4635
3881382333,3082155245,1645560570,1645560900,330,3261
3442818965,3316260418,1668750769,1668751076,307,3658
3466322281,3402326879,1657887639,1657888195,556,2712
3024666714,3105540136,1650807798,1650808479,681,2736
3796735236,3988119248,1648495464,1648496304,840,182
3563521032,3749113565,1644376407,1644377254,847,811
3491189142,3033207738,1654551495,1654551616,121,303
3597388201,3998577022,1642771867,1642772793,926,1287
3001198168,3203196831,1661306820,1661307330,510,4430
3279044118,3952799212,1658494192,1658494523,331,2725
3645065954,3606455825,1641166206,1641166512,306,2997
3777758607,3403905259,1665448194,1665449185,991,2647
3458513868,3827538326,1654101672,1654102281,609,2943
3006909886,3206376572,1662035707,1662036002,295,737
3555809184,3427503965,1641002446,1641002603,157,2522
3749236589,3694439940,1650441628,1650442077,449,2711
3739440985,3949066017,1649648979,1649649801,822,932
3261380534,3041491893,1665352924,1665353577,653,1697
3292359286,3359503677,1662047127,1662047333,206,4275
3349946914,3195519434,1661422124,1661422556,432,1236
3012149748,3398367159,1657082978,1657083118,140,2820
3506239600,3609128523,1660566255,1660567222,967,4569
3032824130,3381380929,1642400120,1642400123,3,4943
3024337979,3398492302,1641080973,1641081090,117,2850
3824794373,3396799614,1656420445,1656421277,832,1335
3373124290,3029747883,1663982055,1663982295,240,1208
3728574399,3650901394,1660850801,1660851739,938,2760
3223433707,3833265836,1652879645,1652880349,704,3674
3980866211,3705182237,1667951549,1667951847,298,2399
3571798014,3714242359,1645558620,1645558958,338,4587
3731296359,3129584498,1646077367,1646077779,412,4981
3344939794,3922173609,1668463356,1668464253,897,2357
3202195133,3678195094,1663725963,1663726852,889,3346
3437954809,3767075795,1646576704,1646577628,924,3269
3749433680,3072304893,1668199260,1668199489,229,4913
3610509582,3545016382,1641449857,1641450856,999,1865
3067571333,3012767667,1654639636,1654639878,242,1587
3378396999,3336086336,1651039773,1651040514,741,2501
3467276571,3672656116,1647706094,1647706515,421,4704
3564559703,3500857037,1651927876,1651928094,218,2352
3033581749,3699878376,1656285355,1656286185,830,3229
3440368521,3923471509,1654956107,1654956238,131,1957
3543780063,3739591319,1668115581,1668115600,19,4884
3753082236,3568166817,1664345206,1664345720,514,1361
3021998875,3097556773,1664313789,1664314506,717,2850
3808695115,3733024771,1668698653,1668699570,917,4203
3267143136,3994684279,1660402238,1660402254,16,2550
3560199031,3325379782,1654903408,1654903914,506,3407
3507774210,3421413862,1657495169,1657495928,759,1621
3234107050,3265219388,1652116032,1652116132,100,4965
3795927770,3373120246,1662685588,1662685747,159,61
3887245165,3884776195,1661928241,1661929060,819,4043
3737268603,3890725026,1649286304,1649286529,225,1038
3859408437,3769611372,1651128575,1651128894,319,3606
3808396574,3590899807,1654067252,1654067835,583,2493
3771442581,3440841461,1657961703,1657962488,785,4909
3844329875,3397167836,1650934895,1650935002,107,1022
3001401753,3509054742,1647526775,1647527680,905,581
3328804256,3257967593,1651549848,1651550217,369,1508
3391711537,3242135225,1664035672,1664036504,832,1670
3576854732,3472053164,1669115865,1669116855,990,3854
3326976710,3943469756,1658909521,1658910359,838,2266
3513258892,3679043294,1656375016,1656375461,445,1555
3259049899,3037001093,1646771764,1646771795,31,3436
3674947498,3748160366,1664766230,1664766266,36,2928
3239680874,3892732152,1641003535,1641003657,122,1948
3428408085,3422373725,1663408055,1663408819,764,4553
3467119265,3485784072,1652974486,1652974748,262,128
3936481792,3942738614,1651156306,1651156722,416,3355
3420460694,3650619387,1644984857,1644985110,253,2934
3563463425,3665590504,1651284692,1651285521,829,3546
3618274280,3651060672,1663906733,1663907664,931,4388
3217051580,3346923772,1644703925,1644704787,862,3336
3344684848,3876260205,1666813387,1666813992,605,3275
3727085519,3644223122,1649277704,1649278315,611,4799
3213541703,3746023865,1669114246,1669114744,498,603
3201934742,3916829978,1669097592,1669097633,41,106
3287501269,3721050389,1648849592,1648849699,107,2141
3305905459,3015387006,1643227786,1643227953,167,2654
3658960128,3528921898,1653503486,1653503690,204,1643
3114713380,3196952600,1655450095,1655450513,418,956
3450224724,3398991700,1647904205,1647905041,836,2958
3191634314,3001415608,1653756955,1653757615,660,650
3110738341,3099610890,1661292233,1661292695,462,3625
3744207930,3774057740,1653642814,1653643604,790,2518
3495802514,3330198380,1654039863,1654040507,644,1900
3611349853,3190520209,1666633633,1666634163,530,1874
3127054704,3406134723,1655246040,1655246057,17,2077
3416907975,3794703394,1652423096,1652423354,258,1516
3640906960,3797802913,1647281897,1647282846,949,1276
3613369531,3441220509,1655869490,1655870101,611,133
3357034171,3483450771,1645554574,1645555472,898,3076
3513943285,3674861469,1662417801,1662418055,254,1467
3214259902,3178561470,1667343585,1667343640,55,3602
3047563236,3912774728,1664126631,1664127589,958,1934
3019357577,3619537157,1666572283,1666572794,511,3121
3454428453,3172573060,1646176250,1646176735,485,3875
3212925591,3694743429,1668516591,1668516858,267,165
3449217539,3782216115,1665734160,1665734618,458,3095
3321261792,3627692085,1641993573,1641993720,147,4779
3706965442,3305428004,1658789480,1658790020,540,2736
3304750539,3442169089,1657244356,1657245350,994,1742
3060886739,3818373837,1664065956,1664066123,167,483
3033996782,3793018875,1645428991,1645429616,625,1396
3243921575,3192541295,1658265649,1658265664,15,259
3843132451,3523425264,1642804585,1642805204,619,3292
3021836928,3044708685,1659042658,1659042729,71,860
3828308854,3098227316,1659003764,1659004645,881,1750
3283132528,3577148840,1662363733,1662363919,186,3036
3871568907,3154491001,1650148979,1650149528,549,3417
3436174359,3324604205,1656439128,1656439487,359,2325
3083560793,3588495554,1661226418,1661227244,826,3970
3568067876,3450707838,1648808003,1648808644,641,4405
3904817257,3572469356,1648963046,1648963158,112,320
3315521885,3782020418,1648496206,1648496774,568,715
3538687868,3436097211,1656777137,1656777149,12,3535
3229307627,3229296177,1661987639,1661987810,171,4360
3395802916,3105957444,1657218556,1657218829,273,2652
3787854347,3496804564,1656104726,1656105249,523,1622
3195885081,3982539950,1658254486,1658255322,836,4351
3208654421,3186029177,1646365421,1646366064,643,356
3902973447,3345919012,1668414169,1668414405,236,1856
3215759935,3666219613,1664584226,1664585072,846,3058
3768187465,3963339664,1657755891,1657756431,540,4620
3302307641,3605860265,1659732479,1659732503,24,4342
3148847636,3033397136,1645307000,1645307452,452,1307
3398058205,3595142423,1643609348,1643609398,50,2289
3277475393,3828023417,1651018120,1651018319,199,1012
3684411704,3607864139,1641748143,1641748801,658,1126
3996336097,3959776013,1644886368,1644887345,977,3344
3735587476,3543780063,1649662444,1649662959,515,4345
3138411588,3880639868,1643656047,1643656629,582,1834
3210041436,3190189810,1652943185,1652943638,453,2955
3672259370,3968404146,1646793407,1646793942,535,996
3447899216,3628663111,1641004988,1641005290,302,870
3063935429,3003672364,1667335585,1667335920,335,1549
3987415063,3254019420,1669444600,1669445406,806,3404
3759128245,3474188174,1661610574,1661611211,637,2737
3350086646,3669246492,1664228192,1664229185,993,3700
3867554073,3450246376,1660777240,1660777431,191,3050
3384056390,3344480412,1647287420,1647287772,352,4511
3080755420,3681852418,1648017536,1648018058,522,4497
3913602782,3963242875,1651559673,1651560451,778,465
3331271180,3232090721,1651626669,1651627392,723,2579
3218306379,3724031439,1649545624,1649545744,120,2217
3025186279,3338256915,1653026688,1653027314,626,3786
3414062019,3088844705,1666667255,1666667920,665,533
3607333721,3171036928,1664062407,1664062519,112,1870
3386997448,3599477968,1654451850,1654452634,784,4079
3722647299,3208450668,1641252740,1641253569,829,1956
3586745768,3733564437,1658720164,1658720718,554,2165
3201251350,3134161085,1654819993,1654820339,346,3246
3058611939,3220163402,1665485762,1665486675,913,1548
3849815384,3400656983,1652830713,1652831566,853,1096
3984634398,3326752457,1654928818,1654929261,443,3892
3419022158,3558974816,1645441679,1645442526,847,3652
3552791995,3934448114,1658617302,1658617642,340,1686
3267236959,3541391109,1642568463,1642568639,176,380
3077931802,3840529717,1645154654,1645154853,199,2274
3065934956,3215675742,1668060727,1668060742,15,4300
3001619344,3250142448,1653735970,1653736907,937,987
3633968731,3816500591,1648410747,1648411533,786,1736
3317772137,3992735153,1655574267,1655574626,359,2314
3541512525,3968502615,1647972883,1647973444,561,4497
3082646558,3096795567,1647489801,1647490308,507,4899
3988217042,3382619062,1664241033,1664241648,615,1124
3704212747,3697900944,1666728467,1666729374,907,3923
3164633886,3674600446,1661327320,1661327885,565,4601
3395921925,3896704615,1641232650,1641233479,829,263
3321312817,3681310301,1653379697,1653380689,992,2500
3731872138,3932428182,1659773844,1659774546,702,509
3000951978,3932463353,1644440698,1644441534,836,3449
3774800870,3911509453,1647424236,1647425093,857,593
3810997849,3432008730,1651921120,1651921948,828,3688
3860652594,3489477432,1655663510,1655664100,590,1970
3241121815,3512280851,1656175232,1656176048,816,1607
3314945700,3529774720,1656028391,1656028841,450,4104
3014457547,3732237382,1667611298,1667612086,788,1724
3868378273,3344529439,1662030913,1662031816,903,2909
3398246006,3795638724,1646498373,1646499273,900,2500
3958719397,3833216172,1647440168,1647441052,884,4331
3093779516,3593235972,1656447634,1656448527,893,4481
3471496137,3370410323,1647077364,1647077912,548,2133
3285210608,3703799067,1650981145,1650981523,378,675
3088157888,3147245943,1646547643,1646548308,665,96
3869559905,3806212538,1642011578,1642011687,109,4681
3528735189,3718366458,1662715127,1662715453,326,1446
3865190333,3141466518,1641659424,1641659881,457,548
3348080203,3572855397,1660707591,1660707730,139,3555
3761540585,3001476567,1661762226,1661762261,35,2321
3897924460,3363647335,1657082839,1657083579,740,4037
3898851105,3281408444,1664771737,1664772586,849,2842
3528938613,3320167786,1654670661,1654670845,184,1138
3981789706,3923129978,1648745918,1648746075,157,3552
3157867248,3994684279,1654824618,1654824777,159,3109
3388008780,3386507633,1646359974,1646360936,962,533
3015346954,3409498864,1653415539,1653415765,226,1681
3174038265,3828110239,1655538075,1655538531,456,3010
3431988997,3217408288,1659475954,1659476356,402,792
3119668896,3539436828,1664061462,1664062249,787,2294
3740539017,3310396340,1662195585,1662196136,551,1254
3028523883,3162435695,1662679073,1662679898,825,2174
3498216935,3782144789,1658016886,1658017486,600,111
3729979859,3571385345,1651863967,1651864097,130,1201
3651732266,3176789573,1658558844,1658559622,778,4675
3736777708,3674472183,1668233523,1668233832,309,2131
3932164586,3762063812,1643902940,1643903162,222,4921
3916734463,3628262530,1649563709,1649563969,260,4288
3215710129,3311494111,1659747459,1659748425,966,3165
3644520488,3061084956,1667850751,1667851226,475,775
3340712713,3899642924,1647179921,1647180807,886,3080
3284819256,3470248617,1654634775,1654634950,175,1994
3273275145,3552783038,1668343119,1668343931,812,2624
3688229007,3356113624,1659133056,1659133731,675,251
3438950678,3598322781,1647055199,1647056194,995,2619
3495021433,3871957935,1652312791,1652313389,598,2471
3546354513,3817678740,1646216336,1646217295,959,588
3567861046,3691655351,1665738704,1665739346,642,618
3216042374,3512520655,1643063475,1643064182,707,3141
3799247219,3849279867,1658806698,1658807557,859,1091
3390920851,3979148419,1642934072,1642934663,591,3747
3199475975,3190783502,1654072910,1654073302,392,2924
3935412151,3739339878,1644029978,1644030376,398,2672
3585377392,3062151258,1660621726,1660621771,45,630
3564005606,3069944749,1664501311,1664501627,316,232
3878796209,3977624588,1659333455,1659333789,334,4790
3712508979,3791825228,1662431909,1662432758,849,2819
3116255922,3225497178,1668472335,1668473173,838,3783
3235800523,3304023975,1641855402,1641855535,133,2970
3634725074,3208654349,1644481136,1644482050,914,4862
3850352893,3328396170,1669221757,1669222514,757,840
3608343385,3577393633,1654774294,1654774896,602,1060
3867543599,3328302333,1667017208,1667017507,299,1763
3815298401,3843794647,1659912331,1659912563,232,914
3880253543,3660664751,1648106234,1648106358,124,3584
3346914553,3987724707,1668818487,1668818967,480,2054
3226419048,3843263973,1658868779,1658869638,859,1223
3913032071,3109725920,1651668565,1651669440,875,751
3011148323,3369863195,1647130529,1647130671,142,2626
3549151800,3402812211,1661774287,1661774646,359,2396
3863423562,3887246340,1654139027,1654139284,257,2893
3989983053,3076561254,1664979497,1664979761,264,4463
3221979922,3389447647,1662262913,1662263527,614,3691
3805169363,3336273379,1646226772,1646227474,702,4784
3768877060,3168139364,1659391554,1659391885,331,3418
3534380826,3506686843,1648973919,1648974844,925,778
3591667350,3851459455,1645731112,1645731566,454,2065
3908745723,3445715751,1665052963,1665052968,5,2525
3124352668,3353635794,1666183355,1666184276,921,4134
3678538815,3972038076,1659332595,1659333505,910,2508
3245963360,3028192441,1661345134,1661345942,808,2063
3056995350,3777758607,1667065323,1667065958,635,1773
3519066130,3960109857,1665132461,1665132769,308,948
3528861904,3819833007,1653643046,1653643707,661,3243
3608422872,3845813946,1643963710,1643963925,215,3557
3145229533,3202903414,1660258482,1660259358,876,3545
3862737038,3862841132,1650490335,1650491242,907,310
3015791973,3219718846,1662104639,1662104829,190,1362
3567740783,3074473231,1649565086,1649565282,196,1781
3427649754,3237702739,1647683250,1647683727,477,3045
3133628061,3417832084,1649755176,1649755183,7,3290
3848642708,3872004169,1651475691,1651476656,965,2431
3087620443,3039694023,1664242223,1664242255,32,1819
3977020211,3379724529,1650240024,1650240190,166,670
3112211166,3975166550,1648332874,1648333001,127,415
3492521054,3298819096,1663964756,1663965162,406,679
3818502189,3650802045,1652558137,1652558267,130,565
3056183075,3738563015,1645381008,1645381962,954,2056
3851462299,3033116958,1661671734,1661672025,291,4592
3258412743,3436487130,1665013730,1665014341,611,184
3596998905,3559251016,1668200956,1668201215,259,3742
3200055202,3136610770,1646130551,1646131172,621,3734
3696366265,3695963175,1668755332,1668755917,585,286
3418084190,3124452766,1656110291,1656111012,721,2498
3079577273,3929780801,1648884779,1648884890,111,3560
3522492413,3381552774,1663037210,1663037425,215,152
3638699747,3315207283,1647983947,1647984554,607,2419
3289219781,3745509825,1643550118,1643550361,243,4031
3446870514,3937993480,1660068573,1660069451,878,3384
3804351638,3479006107,1646927106,1646927338,232,3694
3963201012,3549743348,1661101842,1661102137,295,1146
3514748526,3552688686,1651204461,1651204750,289,4619
3506688489,3309171876,1646757529,1646757651,122,4701
3614286032,3543016647,1641317942,1641318482,540,1872
3619034066,3976410908,1657986708,1657987587,879,5
3569117147,3135226114,1659116732,1659117087,355,1727
3729747275,3254180162,1666912943,1666913635,692,803
3255719187,3492001330,1646725348,1646725961,613,1969
3675150821,3749169852,1647846868,1647847037,169,4777
3134067399,3455579270,1667573391,1667574139,748,4788
3652426880,3722282138,1656527552,1656528304,752,263
3283605942,3466768171,1663664882,1663665371,489,3274
3386947939,3871814610,1662984357,1662984503,146,2367
3796369795,3148544355,1660826053,1660826550,497,2652
3491229547,3692103808,1647093750,1647094571,821,788
3347193074,3973876985,1653261940,1653262744,804,855
3108886436,3545147835,1646896294,1646897047,753,4064
3712252467,3982560650,1661543109,1661543848,739,1682
3904443881,3442114744,1645361268,1645361521,253,699
3512753010,3129650318,1659014807,1659015720,913,3022
3726363280,3192707582,1644239723,1644240204,481,1667
3104390683,3189908654,1665219322,1665219675,353,1809
3995669624,3006518069,1658048641,1658049173,532,1725
3155555353,3266020430,1666299112,1666299157,45,2823
3376843008,3941901537,1668964720,1668964724,4,2847
3474198869,3287793517,1645779482,1645780310,828,2524
3037769041,3153787851,1659038480,1659038566,86,2544
3231387734,3548173242,1644667433,1644667909,476,3171
3270136486,3775280763,1647214492,1647215166,674,395
3317283512,3104352044,1659943937,1659944152,215,3085
3057581099,3296627824,1666883666,1666884228,562,2979
3885451097,3336877656,1667366026,1667366112,86,3613
3837942338,3434128686,1667026601,1667027470,869,129
3450224724,3828112278,1660690564,1660691496,932,2580
3604791472,3046918200,1653384823,1653385195,372,4178
3948345081,3085517833,1654657140,1654657142,2,3161
3856588586,3096303735,1667168810,1667169612,802,1308
3174299777,3289211217,1667892195,1667893183,988,2861
3057965452,3811768458,1660598816,1660599636,820,1432
3585136314,3983623660,1656871228,1656871961,733,2523
3934375085,3686911728,1650830527,1650831506,979,4362
3607389722,3620518623,1653059185,1653059309,124,4728
3443739132,3227498022,1666961783,1666961873,90,4663
3962495903,3789243562,1644205393,1644206233,840,386
3966780978,3223514692,1647887343,1647887514,171,1942
3479455066,3852052415,1642387801,1642388764,963,639
3710063004,3018051215,1656348784,1656348990,206,4523
3645698898,3586791349,1668396960,1668397256,296,4779
3940305052,3493477818,1661865977,1661866856,879,2781
3212647449,3512344488,1662362622,1662362885,263,4468
3974670570,3856207562,1669144370,1669144873,503,3496
3834389825,3456216519,1659970173,1659970904,731,1160
3023494952,3471644425,1668023061,1668023196,135,2942
3493424640,3989762503,1646602898,1646603020,122,2246
3752675272,3375436076,1658116510,1658117198,688,280
3774828267,3971356995,1649164006,1649164930,924,1319
3627250132,3434042919,1646383175,1646383872,697,4137
3486429963,3984471843,1658224350,1658224844,494,611
3301116962,3492909431,1668828665,1668829153,488,4919
3362619762,3894727692,1658178463,1658179264,801,3256
3402756575,3115272808,1644223729,1644224393,664,4270
3213437762,3365421427,1668889199,1668889774,575,3357
3208014354,3342470173,1661145008,1661145453,445,200
3830639094,3723201186,1668561519,1668561878,359,4532
3211015103,3658988874,1662890166,1662890647,481,1669
3726466996,3373869604,1663809820,1663810354,534,4857
3151805049,3387004753,1649564581,1649565130,549,440
3460121550,3407511919,1666498687,1666499607,920,4292
3477524552,3592890419,1641701803,1641702725,922,4672
3446876527,3170336907,1669592903,1669593218,315,1531
3827087943,3372488000,1664515529,1664515710,181,1027
3148398988,3001497518,1660443888,1660444536,648,75
3461254999,3328245990,1656794768,1656795247,479,2702
3076327168,3661146252,1660439060,1660439605,545,438
3716760314,3940120628,1659570074,1659570926,852,1109
3041493993,3929220943,1663999907,1664000858,951,3356
3626797537,3650172396,1653889498,1653889510,12,2443
3457866680,3590877893,1646055412,1646055427,15,4583
3139737295,3229647506,1661683154,1661683390,236,4507
3470534540,3036446596,1655176599,1655177421,822,1385
3580694005,3529022468,1657200220,1657200809,589,285
3438985366,3002418018,1649096500,1649097252,752,2643
3492725119,3274077542,1669185924,1669186573,649,2651
3250340562,3996009001,1653732955,1653733151,196,1553
3967124249,3391665641,1649915347,1649915752,405,3542
3486284322,3947741844,1648967685,1648967781,96,1480
3528804472,3176922130,1664528075,1664529058,983,2019
3301895646,3772757320,1648826293,1648826624,331,401
3723605868,3979880557,1661965750,1661966159,409,834
3114589287,3833783030,1644522305,1644523148,843,4606
3414247636,3571181447,1666426994,1666427518,524,59
3332166459,3234270752,1653837727,1653837958,231,3591
3053152879,3421213657,1644022810,1644023001,191,3772
3065990734,3558918642,1666790685,1666791573,888,977
3310219160,3649209474,1667632722,1667632986,264,1443
3623146344,3598752083,1652511694,1652511705,11,334
3664273755,3455083410,1653317047,1653317638,591,3770
3621107083,3344147385,1663487872,1663487996,124,2555
3581376409,3498261198,1651078486,1651079142,656,2551
3943226418,3744324301,1660423308,1660423909,601,292
3768440525,3449023761,1643518692,1643518732,40,1441
3736565145,3568599627,1661972663,1661972699,36,2536
3389730178,3096846632,1647994291,1647995267,976,2483
3957780147,3767024140,1660806199,1660806316,117,353
3888991810,3234588375,1666977122,1666977304,182,2864
3930782625,3631901049,1651238496,1651238619,123,2839
3286518306,3665662562,1667089552,1667090458,906,1809
3542586207,3844215342,1655050083,1655050201,118,128
3805169363,3722118362,1641898807,1641899260,453,305
3871597709,3853275008,1641882443,1641882524,81,553
3670900350,3458474585,1659702500,1659703398,898,3451
3777957301,3982155520,1653583690,1653584310,620,4673
3150390336,3955726765,1643721794,1643722187,393,884
3295811429,3768091279,1665854112,1665854225,113,449
3562011326,3328245379,1663717479,1663718408,929,1854
3412578919,3195204493,1647469059,1647469688,629,3899
3513901270,3918428668,1669273830,1669273936,106,1576
3271971595,3182087828,1656181165,1656181690,525,3816
3338370980,3919138405,1654255176,1654255699,523,1812
3277971819,3816554829,1658702378,1658702479,101,876
3595162111,3827909738,1659905199,1659905799,600,4067
3879685749,3254837492,1648681587,1648681750,163,4936
3978640579,3950923488,1645466319,1645466958,639,509
3257155636,3044315061,1665354615,1665354717,102,2425
3566622019,3767679637,1649196571,1649197285,714,2449
3910239740,3177110015,1648574759,1648575229,470,1054
3275473450,3778274811,1665624219,1665624399,180,3830
3584514909,3512075866,1650023947,1650024928,981,2407
3869877826,3978746843,1655423745,1655424237,492,1271
3160204336,3317509389,1641740979,1641741478,499,2020
3987169701,3211814273,1644893411,1644894048,637,4300
3159383504,3290285460,1644446927,1644447515,588,1870
3953816786,3774560547,1649913911,1649914371,460,2206
3811927679,3601081942,1650592753,1650593044,291,2955
3462419126,3615738957,1643913132,1643913693,561,2598
3479541198,3154618175,1654398464,1654399010,546,3988
3174340937,3414752292,1650441030,1650441115,85,2808
3716574298,3539398111,1649898859,1649899015,156,3964
3566869780,3297253814,1641526215,1641527007,792,2742
3889230424,3134067399,1649292754,1649293445,691,1116
3079033829,3907447916,1649079944,1649080213,269,177
3765516323,3537940218,1645430021,1645430576,555,3965
3343036513,3266710340,1651971068,1651971378,310,1800
3455575449,3269462138,1663806038,1663806269,231,3130
3746660203,3043691110,1641026316,1641027179,863,4043
3092082725,3671601284,1666540388,1666540556,168,4986
3643281625,3885345387,1667055082,1667055947,865,1775
3754976062,3503490921,1664631638,1664632495,857,421
3955117415,3202848659,1655099321,1655099796,475,2276
3123665302,3032562920,1645014257,1645014916,659,4994
3550208194,3441998778,1653660097,1653660672,575,3822
3943697626,3991843761,1668783548,1668784261,713,3969
3973015200,3392832628,1660125363,1660125839,476,4919
3918658234,3971129990,1662975553,1662975875,322,4982
3869173101,3224527018,1664034993,1664035050,57,2755
3645920559,3354143281,1650567661,1650568422,761,3850
3574052472,3873160764,1655476550,1655477425,875,3830
3437820424,3507194705,1651925271,1651925841,570,1609
3484729821,3218713153,1658631217,1658631818,601,4051
3003535383,3836503474,1648094876,1648095217,341,1090
3785839169,3442510979,1646264425,1646265204,779,4406
3271749617,3329728047,1650105880,1650106287,407,3946
3595507532,3749670222,1641709254,1641709490,236,3102
3495730017,3737727140,1641221199,1641222054,855,2045
3535424280,3354432570,1666198432,1666198880,448,796
3537302865,3071117722,1662519700,1662519850,150,4289
3334088248,3515711502,1657407686,1657408513,827,4052
3010623723,3115907903,1655282948,1655283328,380,1676
3534792760,3108174917,1662511686,1662512319,633,2061
3547515567,3664220053,1643976312,1643976484,172,690
3880296823,3039405794,1658220361,1658220403,42,3246
3075510120,3682687375,1661026625,1661026951,326,4563
3216055798,3076756468,1652742065,1652742504,439,1918
3186768483,3352192379,1641211269,1641211956,687,3533
3003084908,3724808630,1661596177,1661596805,628,267
3938931193,3725958534,1651335977,1651336372,395,3497
3314905021,3031188213,1642775603,1642775825,222,4912
3450086226,3627321883,1642742054,1642742390,336,302
3473334521,3067096694,1662354256,1662354935,679,2419
3239879116,3390715417,1667903877,1667904657,780,271
3533132834,3143389839,1660110857,1660111433,576,1250
3992547793,3352785308,1655911963,1655912118,155,4193
3518667862,3718239042,1658947669,1658947899,230,2329
3603375930,3091558704,1667719237,1667720166,929,4424
3423795145,3403905259,1658488868,1658489492,624,1564
3143955107,3839718096,1652992702,1652993499,797,1111
3719098374,3241124566,1664760170,1664760285,115,3397
3034066808,3627306194,1647403918,1647404647,729,4984
3153088137,3350057527,1664833120,1664833566,446,4416
3845241388,3903049099,1665800546,1665800764,218,105
3912447370,3643004433,1641349225,1641349605,380,1220
3174501599,3409865172,1646718729,1646719194,465,3348
3398028697,3010632886,1663158540,1663159539,999,2561
3411983171,3813218068,1654822280,1654822433,153,3837
3685091554,3842154678,1642833450,1642833869,419,726
3273319380,3656803843,1647605841,1647606460,619,1666
3325372844,3596672380,1646666125,1646666785,660,1202
3436321938,3925627330,1658903007,1658903547,540,2860
3776882007,3338881796,1668345019,1668345322,303,2749
3294788027,3594723856,1649736782,1649737009,227,3925
3522644215,3221583568,1667542172,1667542792,620,4022
3732875814,3894638224,1645406482,1645406546,64,1022
3862506026,3947476451,1669625379,1669626282,903,1292
3358166600,3876105685,1649655510,1649656086,576,1675
3283269197,3213913343,1651500984,1651501907,923,249
3643065625,3675355537,1657254584,1657255157,573,355
3893173898,3124333819,1662675690,1662675766,76,1748
3172755813,3728841499,1653227602,1653228428,826,1648
3324720090,3036437888,1665738912,1665739252,340,4817
3510987628,3910702239,1654122089,1654122837,748,1073
3071170008,3515002308,1659440367,1659440631,264,647
3259142446,3210105528,1654592237,1654592577,340,3953
3774188600,3537187730,1659038991,1659039151,160,3521
3981152004,3928194634,1647460441,1647460441,0,2730
3492626259,3593502411,1647861227,1647861461,234,2679
3104910648,3275030186,1659806747,1659807055,308,1877
3990971497,3047237012,1641781682,1641781768,86,3763
3542081697,3321321726,1653288308,1653288999,691,1034
3374117724,3085539942,1654128877,1654129121,244,405
3396199747,3062192646,1656509438,1656509606,168,4076
3610486498,3984426226,1652115876,1652115959,83,2399
3908084088,3684010678,1655126226,1655126695,469,2207
3401028830,3143725281,1661429224,1661429380,156,4195
3782660268,3510290264,1660017548,1660018414,866,4974
3401898467,3260342672,1654329222,1654329900,678,1355
3916766513,3290748024,1669226611,1669226928,317,2682
3980670851,3317899326,1654036409,1654036915,506,1389
3566289948,3547656396,1649667564,1649667829,265,2388
3203062335,3722479539,1651358719,1651358779,60,3982
3864896138,3016374355,1650905676,1650906056,380,4219
3847739752,3430964025,1644286824,1644286942,118,4264
3964890365,3177896856,1644088018,1644088213,195,1487
3789287874,3338210957,1648008181,1648008882,701,4888
3327289917,3673059843,1664236150,1664236235,85,4356
3997358345,3118807659,1650452969,1650453596,627,1423
3335214941,3588847538,1649379848,1649380331,483,130
3483311550,3759399149,1665180688,1665181000,312,464
3642570233,3383103163,1649494537,1649495528,991,2689
3733502345,3703327100,1666794225,1666794715,490,2252
3007289669,3972742062,1655793464,1655794367,903,829
3837646097,3062868985,1661258900,1661259869,969,2740
3522369386,3163799522,1650219033,1650219972,939,1332
3729569654,3905884012,1647021951,1647022250,299,4214
3157702763,3174764342,1662533553,1662533922,369,4041
3115429164,3051086968,1660712325,1660712696,371,1298
3307567377,3720151334,1659256379,1659256860,481,4321
3869513367,3683551336,1645696364,1645696387,23,2840
3502786578,3153107593,1654610521,1654610680,159,2225
3148888999,3549899603,1646440760,1646440798,38,2658
3258429568,3692024355,1641642759,1641642963,204,2115
3350107697,3194012118,1665622884,1665622915,31,209
3673232515,3315419960,1667818035,1667818969,934,1054
3519207261,3401853535,1664510494,1664510763,269,1474
3806881202,3814531443,1647654534,1647655355,821,2563
3073501917,3374851161,1663834522,1663835080,558,195
3918649320,3135825573,1655411803,1655412759,956,759
3623961794,3641003494,1654239196,1654239233,37,4985
3987020874,3334336929,1653379404,1653380203,799,3977
3915644488,3559382028,1645214740,1645215530,790,3386
3638484490,3285378404,1652597088,1652597640,552,956
3809970667,3531470910,1657495426,1657496225,799,2339
3634217767,3332404351,1649031829,1649032513,684,3350
3466974012,3080054084,1651459050,1651459985,935,2292
3320538679,3321211145,1645723379,1645724111,732,2177
3022767927,3501154169,1651392793,1651393354,561,1599
3677800297,3380162655,1664787263,1664787573,310,4
3687388302,3150028173,1649408019,1649408093,74,3808
3027487275,3278628476,1661888868,1661889765,897,3556
3694670400,3717686836,1666241685,1666242676,991,1834
3185732725,3270060950,1642251224,1642251884,660,1599
3721783810,3831478409,1644102670,1644103315,645,1633
3438377429,3849805202,1659871159,1659871178,19,3645
3002089399,3528662600,1662448028,1662448606,578,3313
3544161943,3133437200,1662851345,1662851465,120,4654
3301479935,3206855091,1657790840,1657791372,532,2661
3980402162,3623575978,1662396074,1662396681,607,1087
3682904744,3312402844,1641194882,1641195660,778,4679
3934400680,3612358043,1648196845,1648197757,912,1125
3985129729,3292867369,1648062379,1648062656,277,2640
3440071225,3396667251,1644051659,1644052268,609,1345
3847871952,3919781799,1667412439,1667412608,169,502
3237251356,3510994478,1669455061,1669455430,369,2600
3824794373,3781116910,1661346361,1661346381,20,3437
3155626233,3247739800,1661542104,1661542184,80,3411
3663521484,3259956368,1656646383,1656646510,127,3857
3844153150,3282627521,1666898634,1666899059,425,1384
3179017147,3076013752,1651780716,1651781502,786,1636
3319817769,3771596029,1669314531,1669315191,660,2825
3938029388,3855832440,1662988140,1662988156,16,1312
3483993965,3751322103,1654634896,1654635705,809,308
3605754311,3642679140,1656979488,1656979993,505,874
3412217251,3320880119,1666005120,1666005335,215,659
3630661600,3225329884,1656836294,1656837106,812,1908
3042583918,3630462100,1667291356,1667292337,981,4459
3750984707,3322650720,1655131993,1655132740,747,2685
3685711288,3518572865,1649932510,1649933179,669,2500
3711482639,3082001715,1666738167,1666738517,350,4885
3223923650,3153088137,1645799598,1645800484,886,3980
3885351646,3971415787,1663098633,1663099469,836,414
3964185412,3450087398,1644771585,1644772371,786,4824
3054202055,3933734444,1644442318,1644443122,804,3500
3087698815,3740943559,1669579095,1669579580,485,3255
3886985239,3680336662,1665593034,1665593835,801,1029
3355139529,3502813652,1659041865,1659042499,634,3475
3688456096,3749373316,1654986221,1654987213,992,245
3790585675,3779424145,1661960798,1661961782,984,3897
3081807070,3717365604,1642498053,1642498345,292,3293
3600788868,3937473621,1650064648,1650065422,774,3895
3966716986,3114017165,1652836043,1652836816,773,2941
3693057812,3708792544,1663896146,1663897032,886,68
3444906528,3072807569,1641030928,1641030995,67,3243
3150740912,3397429419,1651398303,1651399149,846,2207
3087278372,3754126293,1641815116,1641815892,776,2917
3633882171,3416629045,1665730597,1665731184,587,1059
3851903481,3559162588,1650075711,1650076481,770,4721
3565266813,3854007444,1645813829,1645814218,389,4305
3607363454,3279241978,1641451221,1641451969,748,4447
3469875368,3868767951,1664320708,1664321005,297,704
3847452415,3080163287,1667024454,1667024623,169,2621
3337438379,3465842031,1649887005,1649887444,439,3343
3037720348,3338663403,1652521459,1652522089,630,1083
3896995734,3739019521,1668830136,1668830333,197,2915
3646720656,3520958168,1660428233,1660428996,763,1935
3840391763,3749164112,1665150293,1665151266,973,16
3703646620,3605716799,1641741169,1641741809,640,3295
3400865473,3260506277,1641098571,1641099156,585,4099
3924081336,3186301508,1648939145,1648939213,68,3074
3750623656,3908494432,1651039563,1651040519,956,1638
3175216717,3973850647,1654306286,1654306399,113,1371
3200694238,3933943247,1644981814,1644982357,543,1283
3818266622,3949809606,1666206910,1666207522,612,1865
3865525149,3433999086,1654740870,1654741752,882,2485
3255085696,3886390431,1650197213,1650197215,2,1702
3650279417,3523997346,1645242362,1645242928,566,1316
3323854420,3166107034,1659990831,1659991723,892,4391
3320954896,3387957899,1663001879,1663002115,236,3789
3058108808,3020224300,1646852015,1646852929,914,217
3003520233,3168005242,1644762509,1644762963,454,687
3020080218,3513578786,1654659471,1654660199,728,2593
3075083880,3002938812,1661450323,1661450779,456,2468
3569930498,3759656243,1644330908,1644331079,171,3522
3754653728,3153179684,1641199474,1641199867,393,615
3421803267,3975074726,1654567041,1654567541,500,4175
3303525124,3380262596,1658601734,1658602441,707,4271
3343883342,3738413879,1653234098,1653234317,219,1536
3763568756,3453813486,1645183591,1645184359,768,3244
3760933644,3493996653,1645360430,1645360871,441,2350
3620575085,3629771113,1665281043,1665281066,23,2684
3701126500,3808937122,1647072351,1647072599,248,4835
3067922902,3899265189,1649644058,1649644335,277,1642
3463625351,3975238276,1652703307,1652703445,138,1455
3936345436,3199475975,1653962840,1653963156,316,3932
3591280994,3831249447,1643283368,1643283995,627,4709
3985742328,3326170503,1656104529,1656104693,164,2004
3993248480,3478082081,1662935012,1662935472,460,4692
3184629480,3072061712,1662607742,1662608062,320,3559
3575498456,3388800763,1662875183,1662875552,369,3463
3350516348,3179490374,1656410208,1656411042,834,1089
3265986045,3261976445,1650288291,1650288429,138,2864
3553092279,3022576192,1648406404,1648407081,677,481
3170132614,3668094282,1666597447,1666597485,38,2735
3893922497,3518476009,1661679791,1661680722,931,2215
3665483077,3637402152,1669057901,1669058139,238,3240
3441947736,3123592757,1642979882,1642980495,613,2455
3893489239,3483901228,1651839939,1651840447,508,681
3853003591,3695449798,1644071419,1644072038,619,2586
3734613294,3504323519,1662602366,1662603024,658,3607
3132555633,3505994719,1662721331,1662721425,94,1362
3768568709,3769058941,1644179917,1644179925,8,4107
3768323326,3323286475,1647288705,1647289077,372,4624
3538607068,3940135854,1641073131,1641074093,962,1886
3946619003,3593429027,1664726073,1664726181,108,3902
3304124538,3582872190,1647064026,1647064236,210,2356
3610032765,3437488139,1659701179,1659701339,160,4286
3161965108,3915467781,1662947662,1662947766,104,2614
3322384415,3150268364,1645713242,1645713413,171,2280
3949824448,3795960881,1666480703,1666481078,375,865
3915893691,3120616495,1654722611,1654723077,466,1169
3130210537,3025970576,1669590452,1669590945,493,2711
3675561608,3878401982,1658773734,1658773788,54,944
3456954824,3081404363,1647603398,1647603513,115,3644
3316260418,3139131718,1648537234,1648537911,677,934
3211094564,3835906715,1660994326,1660994561,235,2780
3403183168,3144534149,1668060969,1668061026,57,3225
3342003402,3206480319,1659415829,1659415930,101,619
3693364197,3139669709,1659908883,1659909719,836,4860
3699889701,3917646945,1663057283,1663057484,201,788
3925157777,3252312402,1654645714,1654645778,64,2348
3025413496,3831895541,1658813247,1658813467,220,2242
3291850021,3286190473,1661577663,1661578603,940,3088
3801571704,3746769040,1643087749,1643088288,539,4540
3067746996,3842403001,1666766760,1666767253,493,1777
3904277986,3578480850,1668394834,1668395313,479,4207
3503825727,3371624474,1646065756,1646066580,824,1157
3207420515,3698818243,1663454654,1663455042,388,2466
3586029110,3802418834,1653590432,1653590568,136,3032
3913346104,3479296590,1650986464,1650987048,584,1844
3001875381,3526025964,1650262698,1650262796,98,1222
3652075075,3502805345,1642070255,1642071238,983,4801
3813875866,3830522971,1653038902,1653039517,615,2338
3180734944,3670594396,1657050955,1657051752,797,218
3268129438,3215694443,1643606317,1643606550,233,3016
3962621998,3375113590,1652802153,1652802444,291,2703
3289921510,3235228657,1644860611,1644861078,467,788
3757467908,3076661753,1662532997,1662533996,999,481
3046449070,3816886083,1659337235,1659338054,819,3514
3255087804,3406927167,1650731731,1650732276,545,4298
3851572214,3748042947,1666825051,1666825236,185,1417
3533512850,3585472962,1653683439,1653683596,157,3181
3178639041,3983358696,1653339383,1653339670,287,3156
3240687880,3815098595,1644503468,1644503534,66,2111
3922569702,3015253555,1659721774,1659722317,543,3258
3959921558,3360377763,1651147326,1651147795,469,2193
3500721735,3306740330,1647246893,1647247341,448,3357
3402193437,3756931699,1653435777,1653435955,178,2437
3660955828,3281320708,1658720388,1658720684,296,2844
3016484206,3706581145,1646832775,1646832970,195,582
3774213299,3215724482,1654820520,1654820670,150,4403
3157924952,3566002676,1658617873,1658618866,993,1967
3457528713,3367186376,1649954217,1649954945,728,2662
3363793029,3001802279,1661183018,1661183762,744,283
3595973503,3219867814,1648965221,1648965620,399,2663
3472589912,3656892976,1654479594,1654479820,226,4780
3871824171,3161748376,1664358079,1664358527,448,1148
3893684443,3671639352,1662010887,1662010887,0,182
3152885593,3172052045,1654427910,1654428693,783,2717
3159927973,3515226928,1643401742,1643402281,539,4825
3785135957,3913803985,1659208665,1659208991,326,1767
3398126854,3554897982,1663106076,1663106950,874,3095
3563709460,3998134786,1667066998,1667067544,546,4681
3077575038,3244473831,1658576974,1658577166,192,4606
3731824359,3307150718,1645743289,1645743452,163,2702
3430481597,3440099648,1660973199,1660974143,944,3535
3682558979,3192432202,1660026481,1660026496,15,436
3562562929,3544283549,1660417132,1660417598,466,3042
3016583619,3254431462,1656269696,1656269966,270,3742
3643670394,3017358742,1646384545,1646385251,706,526
3547303767,3071034943,1664259264,1664260094,830,2365
3865816524,3939705108,1641610966,1641611645,679,3906
3614418672,3814604714,1648553972,1648554802,830,2784
3628441728,3728426298,1656936528,1656937258,730,4950
3303508854,3729452747,1641834632,1641834936,304,3840
3793509005,3253792795,1645122635,1645123284,649,375
3486264737,3861671619,1654817370,1654817873,503,2416
3088135490,3924480643,1666944054,1666944336,282,1752
3854758837,3587140156,1660410596,1660411504,908,3401
3784765513,3845934168,1650099653,1650099965,312,1042
3564773364,3903343683,1668176002,1668176242,240,3261
3385237655,3424828312,1659269258,1659269711,453,4019
3308236155,3191806546,1651626479,1651626972,493,1292
3136189024,3074148548,1659141648,1659142082,434,1821
3168531645,3481318757,1643232806,1643232915,109,3227
3794065130,3561979119,1641155651,1641155926,275,1697
3601057666,3656779379,1657857914,1657858624,710,4012
3707335744,3996068654,1650424970,1650425302,332,1609
3829209111,3895912828,1668926024,1668926869,845,1348
3079934640,3670609141,1647288514,1647288997,483,802
3443899670,3493364973,1656281978,1656282462,484,3226
3451315917,3625323569,1666225747,1666226055,308,3716
3229912012,3748324361,1663236105,1663236648,543,3326
3218748459,3650202692,1649275303,1649275550,247,4048
3191100372,3863200555,1650988885,1650989408,523,3686
3912716963,3697404776,1649837976,1649838531,555,2336
3729986496,3311587000,1651667480,1651667870,390,3971
3336877656,3677761458,1647332735,1647332943,208,2798
3350345347,3445027816,1668604724,1668605004,280,4881
3795393028,3855217382,1642931774,1642931967,193,3918
3820938407,3046408917,1667274570,1667275459,889,3759
3188708904,3794370946,1655156189,1655156917,728,2056
3900755281,3265268738,1648329263,1648330200,937,1271
3448562627,3313414062,1650365522,1650365633,111,4252
3424892474,3339446842,1642114941,1642114975,34,2585
3923745564,3437736444,1663973469,1663973548,79,4644
3040529932,3931380391,1663008926,1663009468,542,4935
3620251122,3438690475,1657489278,1657489974,696,2674
3228472586,3959536143,1666393546,1666394433,887,3574
3094860961,3540097907,1651726150,1651726415,265,4114
3431953327,3785086534,1645589568,1645590377,809,1267
3105513245,3609238328,1665789381,1665789502,121,908
3655337664,3808495474,1661972722,1661973197,475,2208
3525294651,3170787937,1652368790,1652369147,357,3212
3364119380,3225336811,1645043986,1645044009,23,4816
3266324297,3347378857,1665344146,1665344366,220,3654
3576265715,3076756246,1665502096,1665502354,258,4608
3066707608,3606855183,1664923280,1664923615,335,183
3738355579,3899457345,1646078155,1646078940,785,956
3074921412,3501253818,1653235307,1653236212,905,2210
3190781035,3776004489,1661545486,1661546280,794,3230
3434992114,3158496805,1669012128,1669012348,220,439
3077680487,3620613047,1649116518,1649116844,326,3940
3191118824,3579669986,1657515158,1657515852,694,3542
3703388572,3430392770,1657215663,1657216117,454,3995
3621241263,3964719945,1660879528,1660879638,110,4131
3206465520,3518501000,1659025633,1659026427,794,17
3687133980,3009518850,1654618494,1654619066,572,2072
3322383775,3439774780,1660733071,1660733153,82,4904
3939991743,3209111378,1658875271,1658875306,35,1797
3604880903,3284693245,1655788582,1655788970,388,611
3393370392,3133274954,1661975713,1661976221,508,1716
3709509116,3134566222,1641135874,1641136615,741,4400
3336114543,3079225489,1650109540,1650109600,60,3772
3434449210,3959056274,1653598475,1653599276,801,3276
3235800523,3243459168,1655611746,1655611979,233,3870
3262085569,3749754341,1655410183,1655410735,552,3253
3239629106,3509095853,1660269818,1660269908,90,2811
3464542698,3671539268,1660552075,1660552941,866,778
3800397775,3153585717,1650341789,1650342502,713,3801
3531898763,3897845376,1656182881,1656183066,185,2052
3718864971,3200331988,1656150752,1656151149,397,2400
3867508089,3608975533,1643927018,1643927877,859,1698
3724153026,3287246696,1662017671,1662018277,606,2797
3522967424,3180694800,1663285004,1663285891,887,4364
3769115324,3673588211,1645895779,1645896079,300,2997
3369593360,3202848659,1647532070,1647532332,262,2369
3250949456,3682462570,1650809184,1650809474,290,4816
3801935054,3141644082,1651723038,1651723767,729,304
3752039359,3477684481,1661797195,1661797794,599,3118
3472722031,3707033250,1642022563,1642022740,177,1711
3938214971,3905002599,1657627364,1657627899,535,4590
3471796375,3348093566,1668202494,1668202590,96,1535
3900760764,3661553300,1654381721,1654381845,124,1902
3373270786,3089522516,1668868184,1668868481,297,1967
3907244043,3722055288,1663803432,1663804306,874,729
3539291415,3734950557,1653364228,1653365015,787,140
3940706273,3172077388,1667397809,1667398532,723,1341
3258467672,3520338446,1655760858,1655761038,180,4620
3123395186,3913716857,1647151723,1647151911,188,3421
3164940307,3567403969,1654324418,1654324949,531,2559
3513560608,3669419138,1654989569,1654990301,732,1674
3921765457,3998033930,1663310544,1663310581,37,4455
3255048408,3050270831,1651553882,1651553882,0,4657
3355450768,3862806352,1642221155,1642221485,330,1919
3708324250,3006477367,1667414168,1667414509,341,2619
3633182430,3546145776,1660363283,1660363517,234,2290
3208396390,3897071406,1659123762,1659124574,812,3554
3884336829,3409244006,1650113193,1650113376,183,713
3261284857,3871853963,1649808785,1649809308,523,900
3033320352,3735147792,1652503387,1652503428,41,1244
3166349090,3014197608,1662584634,1662584691,57,3577
3461922945,3327126463,1656890932,1656891883,951,4759
3553488874,3104423725,1647168280,1647168706,426,2215
3327088625,3732228633,1663245200,1663245534,334,3607
3072421468,3137192482,1642738963,1642739515,552,854
3402533742,3303092471,1655503928,1655504454,526,3657
3219871269,3481592734,1651526726,1651527492,766,776
3480804064,3995290986,1647489786,1647489808,22,3447
3389353024,3328551602,1651336687,1651337253,566,4281
3135649965,3991638249,1659027117,1659027306,189,2863
3437200082,3362738544,1666533662,1666534438,776,2223
3104946295,3182708990,1668782728,1668783365,637,4176
3825497476,3169283795,1649349380,1649349549,169,2853
3809902810,3676617524,1659945011,1659945784,773,3843
3128332247,3716285090,1661088203,1661088841,638,4512
3130577468,3530575830,1659653706,1659654589,883,4271
3489276561,3342968924,1655519282,1655519884,602,3990
3355373301,3962518885,1643849063,1643849395,332,1353
3967108487,3635522838,1644712937,1644713093,156,1355
3589157230,3640561736,1652382621,1652383558,937,2987
3253913478,3950858782,1654737153,1654737525,372,3613
3974259071,3863259331,1663657523,1663658046,523,1172
3095761474,3249248382,1652948951,1652948977,26,58
3273875546,3859680832,1667223165,1667223330,165,3580
3819455181,3143602990,1664026770,1664027680,910,1570
3285039916,3512216228,1666201296,1666202080,784,3044
3879702373,3459029972,1666557305,1666557333,28,2413
3911578222,3341637468,1648217907,1648217967,60,2190
3351151144,3966063383,1647480210,1647480841,631,2852
3752838059,3462111474,1667531376,1667531458,82,2077
3755896048,3081053103,1651405873,1651406478,605,1098
3896941707,3319259968,1661618667,1661618898,231,4304
3895912828,3228784862,1642543408,1642544349,941,4536
3018048328,3565276046,1653094316,1653094723,407,1605
3494534571,3174505209,1649206011,1649206354,343,2933
3153835464,3720546529,1664441044,1664441049,5,1982
3595443037,3904596331,1658971383,1658971771,388,3698
3923488858,3682878682,1667135308,1667135498,190,4984
3775336064,3561801327,1663431254,1663431577,323,1192
3063768103,3171997674,1649317530,1649318451,921,3660
3523594949,3892176298,1660595348,1660596254,906,2544
3666339483,3331757176,1665147532,1665147929,397,3789
3638994470,3537665015,1666436892,1666437499,607,4868
3384406363,3238213371,1644279936,1644280266,330,1562
3148835281,3457507058,1642274905,1642275192,287,2436
3658745485,3186986676,1652128280,1652128969,689,223
3628568313,3850693120,1659171230,1659171582,352,3979
3412292699,3684604765,1665056652,1665056922,270,1391
3475583763,3968749150,1667073379,1667073894,515,1382
3225828538,3368830279,1641360705,1641361185,480,3464
3675527566,3764090657,1653415872,1653416740,868,1176
3947337342,3402491996,1645652840,1645653156,316,3354
3952820628,3609201533,1649159853,1649160291,438,4511
3591227568,3688246681,1650879105,1650879624,519,2912
3128571171,3630899785,1662619849,1662620826,977,4088
3713272743,3578295072,1652973436,1652974358,922,3668
3686258982,3383943102,1650751283,1650751679,396,3920
3281125274,3144289660,1646528773,1646529333,560,2974
3086152235,3085697770,1664232430,1664233250,820,3112
3065366652,3540949485,1664184378,1664185278,900,2688
3143397100,3440351252,1655653633,1655654459,826,3948
3433115781,3377851291,1659413585,1659414114,529,750
3854764486,3614262000,1648002939,1648003610,671,3151
3182074201,3470972963,1655872655,1655873343,688,1577
3831782123,3160211713,1659713268,1659713795,527,2085
3169352310,3086848611,1660110329,1660110704,375,3448
3345767832,3140597985,1663939969,1663940529,560,2886
3016811578,3509184428,1655739602,1655739801,199,906
3564278423,3591280994,1658904541,1658905438,897,4472
3985607679,3340794454,1659596203,1659596854,651,3314
3619055228,3957134142,1668871916,1668872603,687,2259
3003251286,3932440055,1651773510,1651773532,22,3662
3547409329,3430154622,1657109993,1657110822,829,3005
3739093516,3297857839,1659535489,1659535862,373,4240
3500038389,3334188405,1665877573,1665878004,431,2089
3734557075,3483311550,1644214425,1644214457,32,899
3628142711,3007621202,1658321273,1658321467,194,1344
3178481526,3979640265,1652575186,1652576056,870,3141
3807108704,3052976848,1644204796,1644205196,400,201
3418645821,3269177092,1657238905,1657239219,314,127
3497631575,3296856196,1668447562,1668448321,759,4452
3390265933,3412590278,1651238386,1651238503,117,3559
3342761251,3136763617,1649850794,1649851688,894,4977
3241920582,3316473618,1644196418,1644196550,132,4331
3763786130,3248968348,1661004242,1661005211,969,1446
3647229123,3079676030,1648535074,1648535395,321,375
3630486841,3145100343,1654268242,1654268793,551,3034
3418161434,3020895122,1666322058,1666322595,537,4321
3083559603,3193822471,1645077290,1645077628,338,2461
3653534193,3762162463,1657605080,1657605757,677,2936
3374601543,3749344472,1641442798,1641443571,773,4953
3944840398,3029449531,1650212996,1650213276,280,3300
3534342349,3684166872,1663383512,1663384267,755,4651
3775922754,3277429908,1646941448,1646941577,129,842
3594548782,3146741718,1644910770,1644911261,491,3727
3835058556,3364261314,1644069795,1644070128,333,559
3777551989,3743103723,1657968169,1657968654,485,848
3501323669,3653465463,1661443691,1661443764,73,134
3888994572,3961879569,1662398683,1662398924,241,3413
3598412099,3460667895,1664796495,1664797346,851,4815
3631822335,3377049160,1652295505,1652295810,305,316
3113734988,3077522731,1648518461,1648519057,596,2225
3055027294,3512873559,1641192528,1641193054,526,2516
3104858149,3396995222,1653410346,1653410983,637,1060
3619830763,3194826702,1642473098,1642473597,499,3820
3643916652,3038887733,1653801487,1653801545,58,960
3287550764,3926674904,1646613942,1646614791,849,941
3259520698,3508166501,1666145510,1666145736,226,932
3077298030,3276248703,1643421600,1643422567,967,3582
3765069699,3400449545,1641142284,1641142871,587,1782
3834568510,3115699001,1664201331,1664202182,851,2194
3975260206,3477357284,1663932604,1663932749,145,1999
3456813604,3882558534,1649446948,1649447423,475,930
3795157538,3450715386,1643009303,1643010019,716,547
3046317823,3857812473,1666970173,1666970266,93,1738
3176030233,3948870422,1655049045,1655049813,768,2183
3183058851,3807016060,1660505593,1660505947,354,3810
3678153435,3791969064,1641818921,1641819038,117,79
3924111826,3950147132,1656539839,1656540596,757,4009
3714909330,3965923855,1645182652,1645183602,950,2652
3927363608,3496205891,1646601832,1646602318,486,2714
3581556399,3556516202,1656036426,1656037146,720,4903
3401411025,3850800786,1658245234,1658245942,708,4353
3562748527,3962064852,1657088284,1657089262,978,642
3700797020,3850927484,1653280856,1653281259,403,4289
3921148124,3533639450,1644891855,1644891911,56,2005
3628164301,3215222555,1645616750,1645617575,825,3795
3986201427,3575109227,1669212591,1669212877,286,4491
3586448694,3466857744,1668937221,1668938201,980,1093
3447921869,3433206027,1652632254,1652632446,192,886
3637394198,3935039806,1647441026,1647441198,172,2417
3144683668,3691978209,1661560626,1661561317,691,1573
3814122314,3986443388,1646339105,1646339174,69,2996
3671738987,3866149811,1654982614,1654983191,577,1307
3249993747,3176485908,1647772211,1647772302,91,4276
3862541675,3868607437,1643565832,1643565980,148,2088
3405199140,3764140748,1669567737,1669568013,276,4559
3691842677,3328267731,1645894207,1645895158,951,719
3583886755,3207548800,1668027486,1668028254,768,4603
3032819730,3000544474,1654256129,1654256327,198,4632
3924241999,3218566660,1667878082,1667878482,400,2497
3317568923,3382384679,1652107241,1652108115,874,453
3364136294,3344226368,1657961321,1657961790,469,4378
3608780283,3125380393,1657591349,1657591947,598,403
3411537086,3210255946,1650705221,1650705888,667,1181
3672719330,3864584932,1661676148,1661676170,22,3422
3088157888,3561517968,1646188590,1646189048,458,2499
3805659253,3487569292,1664512531,1664512932,401,629
3967898602,3354023082,1655668076,1655668351,275,3011
3101913392,3968153541,1653510847,1653511621,774,2873
3015654313,3627428191,1652400349,1652400802,453,2488
3218097439,3955166753,1667112640,1667113537,897,4797
3544169502,3535501426,1660906494,1660907290,796,5
3140273251,3888657041,1655083497,1655084009,512,1541
3048408862,3259856309,1645781279,1645781341,62,3261
3839398811,3970059482,1664277126,1664277541,415,2982
3542745473,3846635071,1649268651,1649268789,138,2173
3938274451,3330750879,1668059255,1668059719,464,3110
3739298413,3613114415,1651698346,1651699209,863,2646
3444258836,3449307484,1652420173,1652420590,417,2352
3314291259,3704535510,1652624172,1652624568,396,1410
3308555766,3228461218,1644878843,1644879159,316,1033
3025800459,3602024735,1667172228,1667172280,52,2778
3653093904,3469329496,1663085018,1663085144,126,3600
3100837472,3865562499,1662455999,1662456161,162,1621
3992642361,3050014136,1659069320,1659070087,767,4922
3397838316,3478200811,1652173818,1652174230,412,623
3214174738,3550429242,1664176223,1664176349,126,2419
3827323102,3142739471,1646165207,1646166128,921,754
3081661276,3075264166,1665933693,1665934558,865,1948
3708346866,3004400774,1659026610,1659027193,583,3161
3854280559,3385603815,1656781077,1656781755,678,3442
3873723148,3611699606,1662790205,1662790235,30,1669
3280500101,3404108631,1642906117,1642906677,560,2588
3164523352,3912867876,1644222671,1644223671,1000,925
3265510349,3876609350,1651373568,1651373568,0,1435
3438823224,3196731547,1663879917,1663880637,720,542
3349750308,3191501835,1644036078,1644036901,823,548
3073878098,3727749190,1649737843,1649737859,16,1448
3794228358,3087666830,1648676929,1648677544,615,4720
3778070446,3659779695,1651622714,1651622856,142,4034
3505621391,3809755877,1644805769,1644806501,732,372
3522652676,3315977040,1641629481,1641629515,34,3633
3482964605,3948275902,1656260561,1656261130,569,4117
3307423298,3546914292,1668505091,1668505178,87,2418
3966967057,3267012145,1657803758,1657804419,661,3894
3482337895,3325069109,1662302686,1662302923,237,325
3614832701,3749334635,1647848002,1647848535,533,1696
3752529908,3678589669,1644760243,1644760507,264,3400
3328050062,3827862553,1643136827,1643137808,981,4975
3204909862,3355557633,1655077486,1655078285,799,3436
3274418190,3335649019,1641340828,1641341362,534,2939
3187073510,3372190605,1653432763,1653433742,979,3322
3875682430,3321811578,1668414935,1668415030,95,3402
3721315758,3588710297,1646926441,1646927160,719,4621
3458964122,3745191476,1641305473,1641305605,132,4197
3046551337,3215821760,1664772319,1664772532,213,1512
3178958906,3159984931,1651061113,1651061402,289,3566
3130157095,3711250566,1663795909,1663796289,380,4546
3208318995,3673483518,1644607617,1644608343,726,3536
3004258560,3215157767,1657219014,1657219909,895,3468
3003372003,3294366899,1659625742,1659626623,881,4005
3635228417,3393609200,1659470703,1659471279,576,3305
3219242146,3198761732,1652601346,1652601988,642,2444
3080254906,3790402100,1667204134,1667204456,322,1483
3820809405,3595448228,1645941989,1645942521,532,203
3012642193,3635195932,1644228892,1644229290,398,2410
3819385275,3669324912,1657014168,1657015083,915,2696
3148396905,3626961066,1642215301,1642215815,514,2581
3701998330,3460391425,1649891113,1649891828,715,310
3855849342,3267484634,1668007108,1668007505,397,2068
3537315991,3981401640,1665332850,1665333366,516,4063
3522105968,3767856648,1666717680,1666718337,657,3207
3769946319,3902870064,1641360548,1641361104,556,1938
3304172618,3011026391,1666725866,1666726557,691,4020
3806655028,3430265965,1656964293,1656964802,509,2202
3773989521,3513062669,1659752787,1659753483,696,1111
3933446627,3721792481,1654415559,1654415675,116,2773
3164477077,3493009548,1667936336,1667937270,934,4003
3117341837,3719750286,1662062964,1662063854,890,1435
3593054413,3127054373,1669366645,1669367165,520,4598
3528111538,3158711994,1668576763,1668577417,654,4069
3998895101,3582706823,1658430803,1658431793,990,1191
3760252389,3396050867,1665584240,1665584547,307,754
3723697826,3305951874,1641646266,1641646957,691,3661
3496666821,3895293597,1653564372,1653564483,111,3205
3790605654,3942092429,1645946756,1645947638,882,210
3680539681,3722895940,1655400113,1655401014,901,3536
3419789119,3499026026,1664696712,1664697361,649,1251
3890903748,3637112080,1657652903,1657653897,994,1571
3665371590,3825239273,1650327069,1650327780,711,1129
3904307859,3417574058,1644859436,1644859489,53,1060
3685357245,3085340994,1651042488,1651042792,304,3579
3276344196,3233649885,1645987934,1645988389,455,640
3611620604,3756189269,1665058754,1665059398,644,575
3729972410,3946292419,1666628943,1666628964,21,3030
3525474312,3366844673,1643294630,1643295256,626,236
3601926630,3307150718,1652365397,1652366060,663,143
3424593734,3006543995,1649216572,1649216609,37,2067
3772157138,3687330888,1644646143,1644646269,126,4371
3698596268,3069530892,1657563281,1657563299,18,4392
3419938419,3951467007,1649747658,1649748062,404,770
3414959656,3868912793,1659489241,1659489897,656,3521
3149291253,3880807669,1653756384,1653756900,516,242
3738131390,3052454711,1658793877,1658794680,803,1130
3506722848,3188530906,1655730628,1655731483,855,4961
3117758643,3959725335,1659033260,1659034212,952,572
3955537594,3230542632,1641929030,1641929101,71,3939
3942639738,3326450202,1649997069,1649997748,679,877
3517546674,3265388382,1655653547,1655654511,964,2975
3446025758,3189080463,1669010386,1669010946,560,1921
3410132865,3996274305,1658784276,1658784657,381,671
3870191408,3278970619,1655072974,1655073422,448,1375
3929263567,3956218497,1668755183,1668755555,372,4172
3656201148,3198663606,1647377599,1647377619,20,206
3296759235,3821531005,1660690575,1660691357,782,4175
3660512093,3702200941,1661900492,1661900720,228,4663
3192498550,3271099591,1642118963,1642119049,86,1919
3321863007,3981086318,1642837399,1642838237,838,402
3229688120,3705879914,1654502408,1654502962,554,3826
3628384089,3078611033,1664265873,1664266764,891,2740
3391877554,3205299395,1649936400,1649936747,347,302
3384968013,3227535782,1665890067,1665890843,776,4653
3478565179,3459952891,1659080648,1659080816,168,830
3190157752,3995646487,1661867685,1661868580,895,825
3711503764,3013574144,1666092435,1666092486,51,3143
3031549155,3945624010,1666554562,1666555131,569,740
3802460221,3408603800,1641158148,1641158404,256,2444
3942738614,3030352246,1650787953,1650788279,326,1422
3952622139,3885738480,1643343200,1643343736,536,734
3047722468,3866708629,1650443120,1650443885,765,4323
3870243047,3393883540,1666189513,1666190125,612,3698
3229839909,3368732747,1653778183,1653778685,502,3768
3714065617,3421282852,1647123796,1647124042,246,3692
3794333149,3316034768,1665715631,1665715661,30,4351
3917378636,3348911892,1658384857,1658385740,883,3763
3638042267,3896888935,1665572758,1665572934,176,1482
3863785391,3481710826,1651088039,1651088549,510,2625
3218595380,3147680546,1654999096,1654999961,865,434
3778404510,3082394626,1643795874,1643795877,3,1958
3524652605,3307199681,1668777780,1668777826,46,568
3427099076,3232997038,1669355764,1669356260,496,1001
3206848583,3098252479,1647616799,1647617197,398,4689
3687699454,3033011345,1649199316,1649200159,843,2298
3593279953,3284446573,1645053070,1645053126,56,2845
3501028478,3521435743,1657902747,1657903185,438,3841
3386803505,3414109700,1669431892,1669431963,71,2522
3467282016,3413244408,1646976283,1646977084,801,866
3159626197,3865586784,1668989414,1668990238,824,2694
3455937383,3058243798,1661623308,1661623460,152,1664
3102276713,3667938630,1657137445,1657138249,804,1538
3596021628,3705200384,1663180567,1663181414,847,236
3194467104,3329295032,1667861415,1667861637,222,1807
3304664726,3618478520,1658465428,1658466192,764,2945
3294306257,3349853800,1667446020,1667446908,888,4299
3003848948,3058402470,1649792703,1649793007,304,1545
3396733881,3246420786,1650217873,1650218089,216,3564
3561003471,3770944132,1648677270,1648677962,692,4662
3156046932,3237508118,1647601505,1647601540,35,2921
3297938817,3696638521,1667628791,1667629696,905,51
3894018225,3790580970,1649907972,1649908544,572,3697
3629951872,3540943024,1654828654,1654829339,685,2034
3110907341,3316192805,1655240863,1655241579,716,4156
3903778713,3848827770,1660945145,1660945810,665,1891
3289891768,3220090401,1648515448,1648515498,50,3022
3896664960,3151213393,1650633361,1650634304,943,3987
3979104797,3058808618,1647718628,1647719443,815,2153
3212593751,3531662907,1661104819,1661104859,40,1409
3369980509,3134356242,1643302810,1643302986,176,242
3435555660,3478927246,1659215969,1659216716,747,104
3316064062,3958764205,1661242588,1661242725,137,2575
3240234231,3734956178,1657649076,1657649598,522,4294
3189562891,3953470774,1649977455,1649978332,877,379
3685705420,3526097678,1649137321,1649137905,584,434
3506743860,3086958441,1642803118,1642803131,13,3480
3880436748,3389348307,1667440280,1667440960,680,203
3941191882,3405504646,1667145226,1667145613,387,4486
3867954657,3377169388,1641171170,1641171588,418,407
3235398967,3229920941,1646814356,1646814759,403,1392
3587851612,3860193519,1645572223,1645573036,813,3542
3659441057,3711846333,1663642982,1663643267,285,1862
3186010422,3426706234,1641458727,1641459273,546,4358
3430399509,3064234912,1645428334,1645428580,246,3296
3303733082,3163636158,1654191376,1654192370,994,1566
3798017232,3387562390,1652178450,1652178797,347,4468
3748590828,3513358124,1655255459,1655256202,743,4011
3479447609,3023805855,1647810020,1647810811,791,3537
3385352277,3083884908,1645039711,1645039778,67,1182
3192125583,3644456945,1669502422,1669503260,838,3219
3782943068,3954928989,1646090882,1646090883,1,3082
3663481196,3165434598,1653121450,1653122330,880,1311
3177075578,3995906273,1641110683,1641111391,708,3186
3001847803,3591014478,1665898865,1665899468,603,3833
3175498099,3187743232,1658978162,1658978879,717,3229
3428612089,3217781623,1665024781,1665025069,288,3118
3174809687,3497571484,1658563246,1658563620,374,3069
3685648646,3753082236,1642952528,1642953430,902,4882
3230021255,3033220253,1642639761,1642639894,133,2528
3193228489,3204730036,1655499673,1655500405,732,100
3019531569,3456135495,1656382109,1656382703,594,1180
3565644629,3587631849,1644167528,1644168509,981,1950
3847861809,3124021056,1655424731,1655424928,197,4020
3991479354,3568984447,1641692364,1641692983,619,338
3682467139,3920025579,1653966007,1653966117,110,2687
3701196478,3154491001,1656640509,1656641490,981,3446
3644145386,3922957717,1649488392,1649488972,580,2742
3976586559,3261940733,1658542531,1658543471,940,3202
3297959481,3374998187,1645449759,1645450442,683,3363
3328357831,3608760206,1663213158,1663213236,78,4298
3407989745,3980675157,1654582656,1654583272,616,4998
3404010075,3232599669,1642678384,1642678766,382,914
3791608064,3912052282,1665624701,1665624830,129,4242
3774081961,3594903189,1649282069,1649282109,40,3567
3145761283,3636305551,1660820706,1660821576,870,1080
3728829858,3657508012,1663049094,1663049196,102,3928
3444387721,3469070459,1667791322,1667792045,723,551
3407241059,3517103795,1653066948,1653067740,792,3959
3383297220,3837617936,1656367973,1656368923,950,315
3595701272,3625394978,1669414945,1669415166,221,2737
3159762419,3378072516,1660502808,1660503094,286,4501
3128409803,3814486572,1651116388,1651116697,309,4338
3067353412,3897700056,1646483632,1646484222,590,941
3142176516,3410516534,1664230436,1664230851,415,4230
3453558483,3478207901,1648516774,1648517378,604,4371
3715331591,3522547669,1650636239,1650636442,203,3379
3581977063,3296726252,1660124096,1660125062,966,3810
3338422311,3676562953,1661699522,1661700282,760,4945
3760564434,3506323405,1656761747,1656762530,783,2767
3342108934,3393365109,1652814077,1652814931,854,3470
3753619109,3210092856,1641167277,1641167984,707,4332
3821522386,3334574913,1648704332,1648705192,860,4029
3578287155,3083735663,1645137998,1645138319,321,2109
3680985368,3077742877,1668248738,1668249415,677,3182
3359190254,3089720213,1651809302,1651810294,992,172
3939750047,3441350264,1653810136,1653810583,447,3648
3865544470,3932708299,1667462656,1667463526,870,386
3950483287,3031320674,1645854172,1645854842,670,1003
3209680129,3345955008,1659737081,1659737602,521,833
3428417174,3935865406,1656958864,1656959784,920,2731
3577317859,3978704803,1664732391,1664732953,562,3903
3673965113,3796778603,1658794472,1658795022,550,1854
3125072064,3842403001,1664711768,1664712237,469,1660
3806054088,3685357245,1666157506,1666158215,709,3529
3023261891,3098726868,1649372144,1649372439,295,1533
3885289891,3533789036,1648422223,1648423165,942,4787
3609220698,3975903719,1645074961,1645075651,690,3437
3568077067,3141715322,1662807999,1662808519,520,2263
3630145897,3652775622,1666761015,1666761157,142,1287
3045842967,3897827804,1668364829,1668365183,354,767
3911782533,3699353456,1649429111,1649429815,704,4681
3969561828,3916356142,1651896593,1651896708,115,526
3017894356,3385170112,1658702483,1658703449,966,1072
3250894173,3159841448,1650555759,1650556079,320,1219
3536809415,3851496169,1658794478,1658794571,93,4129
3296640012,3086556403,1658236422,1658237206,784,4057
3944657709,3470848062,1664271146,1664271435,289,3985
3856150109,3047597102,1657165050,1657165319,269,1094
3210141122,3161494729,1654226461,1654226500,39,895
3153495505,3235956799,1657264806,1657264981,175,3219
3877541644,3026019286,1644259020,1644259813,793,2067
3186118803,3715492781,1649947622,1649947964,342,34
3042323539,3814344689,1645084965,1645085435,470,1286
3418992089,3657633423,1669168368,1669168982,614,4981
3516490259,3661206452,1652925062,1652925887,825,226
3991453111,3147184345,1657042862,1657043351,489,3849
3041938015,3286435892,1658003331,1658003363,32,2734
3098918633,3991797403,1668046852,1668047492,640,4184
3678096922,3384081982,1662947045,1662947092,47,3537
3465100821,3676801394,1645553403,1645553529,126,482
3765435464,3991593791,1650026494,1650026501,7,3079
3257848054,3859017034,1648372593,1648373371,778,2070
3485565845,3432784264,1650544427,1650545096,669,3506
3956218497,3338041874,1659750139,1659751079,940,3004
3433193416,3807266741,1668372227,1668372861,634,1636
3818031291,3026189732,1643756327,1643756511,184,4136
3912190749,3124918385,1648995349,1648995560,211,538
3292537647,3147829160,1654818337,1654818477,140,302
3082209316,3419144233,1653891907,1653892291,384,112
3301850238,3338368603,1668445217,1668445624,407,4960
3764686016,3804896702,1649808951,1649809929,978,745
3505881458,3240857800,1648611175,1648611273,98,3191
3939879197,3365869310,1655392784,1655393456,672,135
3522482374,3770944132,1664789652,1664790165,513,2449
3977333689,3596675999,1655896004,1655896316,312,963
3251106774,3756744906,1661351190,1661351239,49,2887
3924536969,3206222173,1668193707,1668193827,120,3687
3641467414,3051416957,1667130349,1667130618,269,2561
3525006756,3624407289,1657343321,1657344233,912,4317
3673519842,3652089444,1660806031,1660806444,413,3019
3809313019,3235800523,1658102376,1658102429,53,3816
3261792438,3323854420,1644445701,1644446554,853,1911
3454447030,3223355497,1651799824,1651800418,594,311
3361551080,3625114221,1666653682,1666654493,811,660
3269142007,3489648604,1658361740,1658362325,585,1765
3045812006,3028523883,1644976423,1644977105,682,820
3492041460,3133834213,1668166060,1668166414,354,1778
3164483273,3229673754,1665871542,1665871738,196,812
3390888108,3122421384,1647343153,1647343162,9,3959
3591924594,3737402003,1652233856,1652234541,685,2739
3015671287,3207103503,1661169786,1661170713,927,4798
3361069734,3904817257,1656757733,1656758431,698,174
3068115960,3735998242,1653076798,1653077335,537,1033
3358504309,3481380749,1649644055,1649644981,926,2592
3471496137,3782854257,1652135448,1652136152,704,3930
3378906587,3098614643,1660781386,1660781686,300,886
3859599812,3876174556,1656484551,1656485299,748,4525
3029379503,3201078688,1641528163,1641528515,352,159
3984407077,3810574913,1658706769,1658707333,564,2019
3958666442,3452363604,1665341497,1665341678,181,1484
3289640506,3515466902,1642729386,1642729703,317,817
3972382515,3911880033,1651524650,1651525304,654,4500
3444161428,3797638971,1667725503,1667725849,346,2748
3292115663,3850571947,1652618308,1652619167,859,342
3008726193,3097808696,1656930064,1656930651,587,1202
3484344895,3523437305,1657981570,1657981712,142,3503
3955198058,3108755585,1653194316,1653194978,662,1200
3842922132,3720151334,1664032570,1664032947,377,1954
3721855573,3928853713,1648776278,1648776870,592,986
3833594163,3664812118,1650444186,1650445068,882,3201
3394170492,3919130482,1652342898,1652343116,218,4813
3062026599,3834043625,1665681208,1665681249,41,3946
3038515002,3439545416,1661586557,1661586731,174,4245
3822331799,3020746304,1642205849,1642206610,761,1783
3310978412,3640840680,1658845968,1658846214,246,425
3198303696,3560309357,1649229272,1649230211,939,2643
3724716593,3551360008,1644721393,1644721523,130,4707
3912076733,3720544450,1646350761,1646351281,520,3663
3271769759,3894022788,1650045246,1650046135,889,3831
3877266983,3981365429,1664204207,1664204421,214,1172
3296823229,3973897315,1650358836,1650359808,972,3071
3409160970,3982425213,1649046683,1649047091,408,91
3508025365,3481843982,1645254947,1645255896,949,2774
3882499245,3015660972,1668892822,1668893111,289,2941
3234695549,3456884030,1659155965,1659156144,179,4587
3838033984,3820102546,1649798340,1649798614,274,2181
3086491974,3554172418,1646169737,1646169831,94,4510
3858891604,3867635426,1651270063,1651270958,895,3918
3627853566,3412888139,1642414794,1642414806,12,2839
3922594546,3618217378,1661644052,1661644767,715,2136
3473122631,3562631898,1659730728,1659731669,941,1945
3792972232,3145101147,1665291140,1665291301,161,2902
3414495395,3266643576,1641502227,1641503211,984,2159
3215279922,3969473373,1642803101,1642803968,867,3851
3636612774,3033985303,1655849227,1655849290,63,375
3828371574,3050604263,1656117643,1656118257,614,4718
3338711283,3848011879,1658471040,1658471512,472,1726
3448354086,3744534455,1663418661,1663418813,152,1248
3565649015,3634426403,1667129935,1667130542,607,4206
3696120707,3520621615,1643842093,1643842941,848,1714
3722119684,3016722968,1669675478,1669675966,488,3514
3076909534,3450526405,1669563132,1669563840,708,400
3957466538,3837930408,1665799291,1665799869,578,3674
3367820003,3751940279,1642428484,1642428840,356,4605
3186214022,3841727034,1644259258,1644259328,70,418
3455638003,3438949734,1660191006,1660191833,827,1962
3065024095,3996456431,1645745234,1645745542,308,3292
3689082552,3335781744,1658315523,1658316365,842,3660
3021458117,3558136126,1660600200,1660601000,800,4940
3168500938,3811994122,1653650113,1653650921,808,3359
3105795096,3427082024,1661954546,1661955538,992,3301
3462495187,3691900446,1648609300,1648609513,213,3035
3056087656,3961697308,1665656807,1665657765,958,713
3589249780,3690799681,1648756291,1648756725,434,4219
3841121138,3078280086,1667954243,1667954617,374,3543
3870438303,3748219993,1662709898,1662710241,343,314
3807586008,3389337096,1643980875,1643980890,15,363
3632110758,3634484780,1652080593,1652080879,286,98
3844817114,3537177106,1660648105,1660648183,78,1462
3503250192,3573060046,1665942385,1665942696,311,3933
3237242408,3129453847,1644907168,1644908048,880,4295
3956256882,3705669912,1665008135,1665008447,312,146
3993633826,3911594948,1642009998,1642010404,406,1958
3209514730,3836207422,1642359491,1642360232,741,4992
3012887795,3188061686,1662242638,1662242874,236,1327
3464864550,3692498197,1665075997,1665076453,456,2595
3417498172,3242123328,1648038263,1648038415,152,2092
3396541333,3076967743,1666388739,1666389190,451,1194
3635038903,3769471488,1643557457,1643557611,154,3375
3542745473,3542336164,1649777949,1649778853,904,4545
3405184953,3365428989,1658169471,1658170083,612,576
3780890012,3112212464,1667177256,1667177958,702,3166
3932005237,3434497168,1658625656,1658625846,190,3966
3919624135,3455691988,1658841063,1658841614,551,4743
3870742499,3542552248,1657340845,1657341422,577,4898
3933818653,3377265236,1665774174,1665774735,561,1227
3699656372,3747349773,1649959546,1649960154,608,2304
3798330586,3804936043,1658635320,1658635320,0,2119
3620244487,3274857707,1664567703,1664567766,63,2147
3382324813,3194636849,1652090192,1652090584,392,2386
3472882135,3134755805,1642596916,1642597808,892,3849
3832461966,3086799610,1650579412,1650580040,628,1356
3461507409,3242239386,1654676444,1654677324,880,386
3879143202,3643183823,1653656950,1653657410,460,3397
3926590150,3990617595,1659281763,1659282725,962,1494
3059444510,3646701225,1655064389,1655064690,301,1439
3676082852,3284697680,1645545423,1645545457,34,4559
3414247636,3833045556,1642542992,1642543148,156,3058
3663305276,3507769459,1648032795,1648032843,48,3649
3273735512,3534893545,1652597864,1652597920,56,3282
3727073021,3159967645,1653775194,1653776112,918,3154
3370704007,3055998592,1654780469,1654781350,881,1226
3962468960,3663181827,1661247730,1661248559,829,4562
3049164954,3733561057,1654648185,1654648373,188,3466
3359686462,3751633244,1656026099,1656026190,91,4116
3097703049,3576573129,1663893103,1663893803,700,3085
3699200769,3187540904,1650475147,1650475261,114,2242
3609901695,3823702086,1652659260,1652660019,759,547
3496925966,3769663579,1655891107,1655891442,335,1659
3386904915,3834295880,1659511880,1659512620,740,1194
3982111417,3577762633,1658831746,1658832523,777,2415
3817098387,3154937635,1652756592,1652757125,533,3595
3377350375,3123796360,1646358600,1646358655,55,2883
3702785626,3865486865,1647685778,1647686287,509,3837
3878802796,3647821199,1667965242,1667965555,313,1951
3477386551,3533673579,1661925867,1661926594,727,4871
3104815180,3914343214,1656725393,1656726201,808,2259
3281723875,3838789769,1641086329,1641087281,952,2169
3877847314,3242757350,1663649089,1663649703,614,3893
3650822815,3179329367,1667886113,1667886240,127,4023
3877063575,3878546446,1662802122,1662802787,665,1206
3161890916,3061431648,1664489458,1664489562,104,3142
3092228099,3567053698,1644601566,1644602192,626,1915
3762357146,3970367154,1642751538,1642751806,268,3165
3471668872,3803588968,1646058961,1646059196,235,2255
3682683513,3221985331,1646718982,1646719392,410,2035
3788781995,3559207452,1651123436,1651124238,802,1119
3196348305,3142490449,1650447790,1650448755,965,392
3566943074,3261900082,1654870491,1654870855,364,4669
3290307555,3634388171,1652942219,1652942429,210,1013
3005844187,3443004864,1650982197,1650983075,878,2832
3515597666,3778939952,1662725714,1662725858,144,1854
3736341717,3392833863,1656615909,1656616527,618,4301
3199366002,3375724915,1660180158,1660180230,72,131
3236168629,3644795959,1659608489,1659608604,115,1977
3098422604,3378605672,1666315913,1666316259,346,4383
3312629967,3898391909,1665730059,1665730091,32,4503
3890270046,3522182297,1657185036,1657185756,720,1829
3905576795,3765175532,1655050083,1655050457,374,2832
3209267394,3041848167,1655966370,1655967035,665,3223
3529570529,3501154169,1650725915,1650726484,569,3021
3304108602,3506006885,1644295373,1644296188,815,4984
3624001936,3585253163,1667709983,1667710833,850,1466
3280958908,3229364979,1646923276,1646923827,551,1837
3783562709,3586823584,1654924901,1654925774,873,2985
3278637204,3822362242,1643554558,1643554794,236,4478
3015919264,3478590152,1667576010,1667576574,564,1685
3203902421,3351737112,1667624226,1667624390,164,4738
3000102465,3412061521,1654965531,1654965629,98,81
3039861068,3691812636,1653927084,1653927604,520,2208
3979829110,3624243118,1660564217,1660564264,47,1874
3185903771,3459689978,1655514707,1655515204,497,1711
3764273434,3444089254,1665708971,1665709439,468,1495
3224305600,3302155604,1643113535,1643114221,686,4787
3103685887,3599470403,1647184641,1647185525,884,531
3250825064,3954382542,1659065886,1659066224,338,747
3627793589,3396760149,1661830460,1661831250,790,4078
3189620545,3201853355,1648257742,1648257930,188,766
3191345787,3920574238,1658074507,1658075357,850,1056
3087333524,3170559012,1645331834,1645332422,588,2968
3241863139,3186029177,1655540461,1655541109,648,1808
3111819033,3564338573,1664310683,1664310866,183,1714
3888905253,3108282234,1660647719,1660648640,921,4936
3002404482,3817502847,1643602095,1643602170,75,4224
3787224108,3634195091,1655116473,1655117229,756,1982
3624427296,3529957029,1661758992,1661759249,257,4714
3065603170,3156279812,1644170470,1644171013,543,331
3538553412,3947241153,1656206878,1656206886,8,4613
3819820861,3378017385,1652484600,1652484753,153,3398
3691056860,3065837370,1667097962,1667098700,738,326
3810268115,3225685095,1652381391,1652381746,355,38
3385807856,3983763206,1641373064,1641373185,121,3473
3022781033,3764912522,1645558303,1645558670,367,2044
3429040565,3767754270,1654398703,1654399267,564,1014
3189422733,3175187074,1661191647,1661191862,215,2804
3004194475,3725425871,1656162672,1656163617,945,4356
3667352343,3312496114,1665055834,1665056826,992,2912
3122421384,3251040613,1658487870,1658488790,920,1835
3686568388,3200150830,1646866741,1646867277,536,2036
3689470659,3301102707,1663784980,1663785968,988,2809
3711800451,3524389277,1669493221,1669493583,362,4733
3343602824,3578782827,1644671221,1644671893,672,808
3720406994,3317210084,1659383267,1659384226,959,388
3690436690,3400606138,1653610571,1653610683,112,697
3459256192,3170569506,1667749769,1667750624,855,2101
3127742159,3175072597,1662889288,1662889775,487,3964
3676213550,3601462192,1663916504,1663916746,242,3563
3989418093,3338083305,1644268533,1644269063,530,145
3081307566,3884755311,1657766916,1657767358,442,4632
3464308676,3918743288,1652928572,1652929217,645,176
3269986546,3561409132,1645722604,1645723191,587,834
3206292373,3060903525,1654005307,1654005669,362,2115
3106603011,3468663705,1643512269,1643513067,798,4683
3411300147,3843869993,1646738131,1646739114,983,3744
3084983545,3854134625,1645138512,1645139496,984,2478
3390965463,3977239076,1656418669,1656419392,723,4181
3117855047,3482134667,1642437866,1642438020,154,2929
3270222216,3568428280,1651185438,1651185573,135,874
3398599402,3425996202,1659028734,1659028899,165,1311
3407402534,3630112462,1649278507,1649278587,80,2756
3933263597,3572773677,1660914532,1660915510,978,4604
3126331290,3734680109,1660367861,1660368443,582,3736
3548883534,3322640970,1660649088,1660649503,415,2779
3261014761,3054326756,1657324554,1657324881,327,1158
3938966889,3808849129,1642031544,1642032506,962,2107
3465918976,3895022839,1657084266,1657084844,578,876
3342274163,3621217402,1650584418,1650585241,823,3778
3901161780,3361398222,1668721940,1668722003,63,234
3341722228,3277183864,1660251178,1660251718,540,1290
3721187883,3301428299,1643324914,1643325369,455,3142
3170157229,3939750047,1660820448,1660820480,32,1510
3988597455,3259891484,1653212703,1653213677,974,4765
3863211445,3967329890,1661445471,1661445747,276,2742
3075398084,3123043946,1642561082,1642561764,682,4790
3199969381,3948057981,1646492016,1646492309,293,2438
3050138827,3998719895,1668437546,1668438080,534,3824
3553048411,3251157898,1660504291,1660504857,566,1823
3369837585,3217777867,1642339917,1642340604,687,2395
3361095086,3152107607,1660205064,1660205217,153,1544
3088707622,3552496460,1656009244,1656009702,458,787
3415309013,3691774832,1648206768,1648207447,679,1737
3354325176,3077461557,1650278560,1650279392,832,39
3379150192,3192650062,1663297174,1663297224,50,4450
3645577595,3556030989,1650432754,1650433575,821,3240
3722895940,3891702502,1652339446,1652339545,99,1414
3560984995,3947732280,1652078258,1652078740,482,1136
3555247420,3167366829,1667831266,1667831688,422,4511
3496346055,3201977363,1642889535,1642889846,311,877
3395163352,3926577525,1668981446,1668981797,351,3414
3341436179,3837433351,1643072487,1643073038,551,1664
3454790445,3808392395,1668878202,1668878257,55,3287
3198624345,3407980104,1650768287,1650769215,928,4530
3657508012,3157150280,1642199471,1642199680,209,2565
3490303473,3284390769,1663153184,1663154064,880,1401
3923170849,3405974548,1667468027,1667468442,415,2380
3992417214,3748142678,1641659155,1641659557,402,3728
3458440387,3043094189,1657573470,1657574120,650,3373
3658610011,3128097611,1641191603,1641192446,843,2522
3746101803,3283341234,1663896236,1663896613,377,1085
3096534454,3114283104,1664918038,1664918744,706,2261
3317921480,3266026948,1643745534,1643745629,95,2822
3922255223,3019902323,1648385488,1648386157,669,2006
3963386457,3238177035,1669260556,1669261454,898,3191
3416952397,3626202134,1647996017,1647996296,279,2281
3071234482,3890870968,1660843755,1660843784,29,7
3167247863,3096054788,1662667010,1662667549,539,3597
3922247360,3742045476,1658244364,1658244602,238,3711
3076127711,3119352367,1665529463,1665530348,885,1100
3665934922,3687058041,1653217548,1653217710,162,2205
3761026772,3200805480,1658313443,1658314230,787,4439
3426810111,3429544668,1641978432,1641978490,58,482
3459909099,3334685502,1642262403,1642263082,679,3717
3007091340,3175533354,1654215629,1654215663,34,873
3505910546,3264548376,1644569678,1644569985,307,541
3664680710,3587882176,1651739403,1651740243,840,1257
3179080459,3138198182,1668124695,1668124945,250,2046
3034243111,3696391448,1665361368,1665361660,292,3490
3591825975,3307721130,1648735167,1648735398,231,532
3524517791,3915964658,1642700223,1642700956,733,3586
3997648475,3006353171,1647437364,1647437477,113,4896
3688139266,3206284547,1665961205,1665961514,309,2165
3625966582,3668376488,1648790443,1648790465,22,2297
3740444990,3966967057,1669276017,1669276719,702,2687
3663564006,3067802058,1663937909,1663938242,333,1696
3416001819,3856642256,1647412593,1647412725,132,1415
3165478948,3937209174,1653149755,1653150518,763,4908
3563975495,3951289208,1647010759,1647011752,993,2138
3818289894,3660875344,1653641242,1653641715,473,2588
3527876602,3270221194,1668589959,1668590381,422,2433
3649195459,3585968543,1652765228,1652765519,291,2985
3398888440,3006811535,1659455958,1659456181,223,854
3289975002,3304811865,1645895742,1645896007,265,2457
3970156869,3859092763,1666928471,1666928550,79,1344
3449423330,3611574602,1653540956,1653541038,82,2968
3572919611,3498939160,1649667460,1649667779,319,2914
3680927541,3814283686,1666422374,1666423143,769,2827
3561805086,3209998151,1659647275,1659647993,718,2649
3720469516,3079371824,1652488806,1652489251,445,2408
3198624345,3521896299,1663969699,1663970096,397,4442
3086071473,3304152897,1658453030,1658453797,767,995
3381010517,3400129424,1645218043,1645218340,297,4899
3026918133,3533742406,1642847790,1642848560,770,4299
3060156209,3970037622,1651811102,1651811790,688,4255
3554530221,3800238008,1662627992,1662628700,708,1430
3889808485,3687123581,1650556826,1650557429,603,864
3670855623,3177160767,1644264499,1644265277,778,3850
3780387494,3080356500,1648155210,1648155694,484,532
3358987320,3527079602,1651883018,1651883518,500,1882
3593213050,3046233447,1664030852,1664031765,913,3004
3735829791,3721879112,1649117426,1649117470,44,3456
3781179498,3381896779,1653934666,1653935575,909,4169
3419262331,3997451148,1656333873,1656333927,54,3148
3290428693,3457220513,1643616165,1643617160,995,3871
3630392437,3101689841,1656980624,1656980920,296,2968
3844215342,3559740720,1647538714,1647539241,527,1559
3313803359,3393547362,1663494903,1663495795,892,3379
3269705875,3021991439,1651688379,1651689310,931,2553
3604982417,3723887476,1655877420,1655878043,623,3591
3621897919,3566959959,1646963459,1646964134,675,8
3502105330,3350505694,1650680830,1650681684,854,3629
3958719397,3541102890,1655201873,1655202871,998,4545
3479895208,3121290516,1648121164,1648121560,396,1011
3183243056,3565927763,1655985520,1655985603,83,4490
3520140260,3070916664,1661365073,1661365826,753,383
3797011172,3781697655,1662894933,1662895622,689,2672
3069721048,3729848938,1654785613,1654786598,985,3713
3242132373,3015692340,1645249143,1645250080,937,4281
3040629280,3997997200,1645056688,1645056905,217,1672
3889271406,3252510223,1644927861,1644927948,87,1238
3897326654,3445714993,1664592158,1664592541,383,4832
3227621641,3119284333,1647510618,1647510743,125,881
3588388175,3585483442,1659823408,1659824132,724,3942
3564574520,3158241752,1644754888,1644755281,393,2327
3720588514,3331122888,1651303507,1651303797,290,1352
3884207723,3395779598,1647628569,1647628577,8,2224
3275253879,3353235541,1645587153,1645587562,409,337
3850283100,3094897454,1648614833,1648615287,454,3901
3673519842,3739093516,1663821657,1663822587,930,622
3423094207,3208014354,1641628945,1641629290,345,2037
3126339352,3732036582,1658355973,1658356604,631,2981
3414545127,3687500341,1643398389,1643398848,459,607
3952720708,3534517425,1647918359,1647918752,393,3038
3214673336,3723580596,1653418662,1653419496,834,3359
3324088206,3762807270,1650955146,1650955870,724,1811
3169920620,3487466536,1667893409,1667893495,86,731
3662275837,3629895763,1654389452,1654389743,291,3717
3798218833,3323213232,1668336271,1668337137,866,2652
3474057579,3701152375,1660254754,1660255016,262,3334
3760188146,3229756286,1667683540,1667684324,784,3765
3207198958,3631853877,1664026183,1664026390,207,2641
3831243125,3499875495,1642808212,1642808846,634,454
3657478238,3468690818,1664471787,1664471994,207,4839
3485073219,3349217070,1666184587,1666185302,715,3364
3852325067,3095528731,1651049861,1651050303,442,1090
3588928420,3863116847,1647986669,1647987134,465,1841
3862290736,3726441564,1668584848,1668585794,946,2133
3238088851,3017031642,1641878220,1641878483,263,278
3696843417,3324720090,1644062388,1644062658,270,2239
3570892104,3462748857,1654240788,1654241293,505,4143
3286719536,3116075127,1668944780,1668945756,976,275
3814073736,3782474471,1649464175,1649464368,193,3404
3441527119,3368252985,1661526544,1661527312,768,4954
3947618053,3591024355,1669308515,1669309138,623,246
3758822955,3078747770,1664500164,1664500215,51,972
3127029877,3756501396,1660160868,1660161515,647,1624
3999004301,3666203877,1652769814,1652770042,228,2499
3761287837,3336916927,1661253587,1661253779,192,2661
3877471405,3088158779,1667348875,1667349076,201,3153
3261186649,3321284584,1651982967,1651983815,848,3863
3079145260,3953629936,1650657090,1650657772,682,1177
3381354040,3376505502,1655148952,1655149490,538,848
3190467643,3448086796,1650406653,1650407459,806,3443
3687198390,3524781191,1644685999,1644686279,280,473
3227429251,3020337592,1661527718,1661528017,299,3408
3290818362,3915323349,1642660795,1642660827,32,4219
3645280093,3646652020,1660532263,1660532479,216,3392
3032845148,3308087630,1647979017,1647979477,460,3205
3604573450,3915640220,1660556296,1660557040,744,3207
3693687377,3802215994,1651174845,1651175636,791,2067
3738867923,3437187241,1653249105,1653250084,979,315
3838170630,3750073501,1663400655,1663401510,855,4056
3121447930,3601832128,1653667591,1653668084,493,534
3972659482,3758537390,1661417548,1661418361,813,4803
3545942387,3984897672,1646158366,1646159315,949,4407
3351939013,3603543371,1665569727,1665570190,463,479
3841097828,3965802661,1654156519,1654156676,157,4351
3907460190,3122454905,1657796951,1657796965,14,1385
3123921729,3943152002,1645415886,1645416662,776,4700
3076328172,3258179845,1647883785,1647883826,41,2084
3113629941,3664009501,1654885257,1654885490,233,971
3991235738,3184693580,1648608976,1648609959,983,771
3501068011,3393532647,1660159396,1660159675,279,3684
3304579869,3138198613,1646865122,1646865990,868,2064
3533941949,3410625429,1666899934,1666900104,170,4186
3213531087,3156415378,1664950358,1664950508,150,2475
3512542819,3832524458,1663221745,1663222630,885,3524
3553946462,3211478989,1653587559,1653588380,821,220
3011820150,3641346574,1662904799,1662905544,745,3383
3492482454,3743680980,1660854424,1660854484,60,1133
3089024805,3352639962,1655005224,1655005700,476,163
3743490821,3508308351,1668319648,1668320235,587,4674
3620381436,3128188239,1653343091,1653343268,177,1132
3161866929,3807353728,1656173334,1656173875,541,548
3625297801,3530554646,1663066413,1663067157,744,1778
3849745757,3498552875,1642508025,1642508671,646,1016
3077392323,3111978328,1647785349,1647785590,241,1169
3787830106,3195691322,1668987515,1668988190,675,624
3419667345,3206688181,1655554873,1655555661,788,1487
3231903980,3351269001,1656808156,1656808714,558,298
3851748035,3155692735,1657787761,1657788583,822,3412
3192419049,3030984055,1668740690,1668741036,346,2933
3960207786,3853404138,1642317237,1642317366,129,2864
3991270257,3660998751,1655999878,1655999909,31,2290
3197131470,3399594990,1660257292,1660257811,519,3506
3310544186,3165207274,1660820664,1660821047,383,604
3513452315,3957589412,1643035509,1643035858,349,2292
3875596561,3130405114,1655291924,1655292535,611,4399
3801178617,3688396230,1663414719,1663415694,975,1214
3809694244,3254353553,1647574244,1647574538,294,1561
3406554800,3071933558,1661998232,1661998433,201,35
3322119114,3038674512,1666802362,1666803318,956,2367
3911617323,3183302811,1647755049,1647755480,431,2887
3100148487,3830697809,1666746027,1666746910,883,4843
3160306216,3242145671,1645787017,1645787597,580,1437
3887708032,3916532947,1643802667,1643802747,80,964
3127770632,3952562133,1653420576,1653420815,239,4889
3442466978,3763743466,1652816031,1652816923,892,3304
3902022650,3968101095,1649313593,1649313651,58,3659
3164935031,3302552684,1657250953,1657251870,917,208
3015623194,3443096121,1659295860,1659295882,22,1468
3860688796,3315384832,1648665376,1648665795,419,1235
3434151912,3535096063,1667347419,1667348031,612,3252
3967040879,3005610084,1661123421,1661123535,114,4971
3408618170,3805336380,1654453224,1654453747,523,828
3096165152,3442557225,1644727810,1644728728,918,1955
3972374362,3763093148,1658310606,1658311386,780,237
3931368985,3188071926,1651398281,1651399173,892,3453
3135876675,3330722541,1645098126,1645098551,425,2018
3791974282,3697112215,1644846892,1644847487,595,2499
3381948669,3341701232,1652925560,1652926460,900,3034
3136834252,3811929507,1641103763,1641104635,872,4805
3175188502,3368846862,1651751533,1651751748,215,871
3079916451,3961061091,1654821513,1654822400,887,645
3148823411,3419255200,1649896171,1649897045,874,3846
3853102147,3839033370,1642311415,1642311615,200,4198
3543092388,3798461331,1660851463,1660852191,728,3071
3793201742,3155300842,1667349444,1667349791,347,2415
3982652058,3567929780,1660759494,1660759780,286,4067
3636626107,3131778312,1655813056,1655813900,844,4471
3256060628,3019749515,1659431423,1659431734,311,3175
3591746198,3368425899,1652447757,1652447906,149,214
3461206035,3070500488,1649284828,1649285245,417,1970
3082685031,3447636911,1645120554,1645121542,988,4730
3166804055,3349126504,1664861159,1664861288,129,1634
3072062389,3241233693,1643292066,1643292221,155,1871
3015933971,3331689492,1661083027,1661083944,917,3376
3524154109,3050467787,1659396104,1659396535,431,2426
3405974548,3583033387,1668775617,1668776491,874,3105
3009801644,3893361434,1667861841,1667862609,768,977
3122510830,3177586694,1658805298,1658805435,137,1919
3471039135,3721986277,1646666068,1646666779,711,1786
3724631184,3230868730,1664708850,1664709630,780,2343
3929001909,3464670639,1641853916,1641854445,529,1813
3248398318,3240882363,1658681762,1658682340,578,1765
3273633257,3692667258,1657786409,1657786866,457,3901
3674182955,3647711851,1649968282,1649968378,96,1390
3580722719,3846216432,1668214511,1668215006,495,1660
3483479599,3126212802,1648975701,1648976140,439,2762
3345014427,3126864916,1668613698,1668614690,992,2905
3651379183,3779590993,1645442955,1645443164,209,2104
3386190217,3768520855,1668455955,1668456631,676,2654
3913102856,3894996786,1649348341,1649348415,74,309
3545138794,3170050127,1653769059,1653769821,762,1353
3484238916,3510550332,1646918519,1646918763,244,1633
3640914630,3095364179,1663159322,1663159506,184,4052
3427586094,3635629334,1661243831,1661244281,450,1245
3140820958,3372498524,1641180304,1641181252,948,4522
3416913829,3550575674,1651490795,1651491309,514,2005
3930082337,3287638640,1667601849,1667602020,171,1677
3709922852,3355795111,1659552199,1659552968,769,3877
3613005846,3225665127,1669390364,1669390426,62,4734
3598872038,3366833408,1662736861,1662737202,341,4239
3742440797,3717856400,1655569605,1655570584,979,2955
3909179774,3712486522,1660470748,1660471239,491,3738
3515375730,3066828599,1668116461,1668117104,643,261
3886973631,3013006013,1648415424,1648415551,127,2977
3757623530,3992612218,1652158857,1652159704,847,3896
3026618734,3368444391,1653347246,1653347594,348,844
3739390834,3369311415,1650307320,1650307503,183,3483
3973970878,3336358256,1656381129,1656382056,927,431
3891658998,3912716963,1662467218,1662467959,741,4350
3648047683,3624359594,1659817531,1659817651,120,2279
3472910519,3468148222,1644456413,1644456936,523,43
3794703394,3032993490,1658190764,1658191493,729,3810
3966972393,3918165829,1645128408,1645128916,508,2458
3508843750,3371078696,1646834990,1646835261,271,857
3699751064,3354973937,1660162761,1660163364,603,3383
3601241018,3176551927,1642517395,1642518384,989,4131
3746175714,3830610074,1668179407,1668179920,513,2423
3452901546,3689039984,1666031933,1666032502,569,1858
3280041015,3781438916,1644338395,1644339380,985,3386
3642883980,3152416218,1643190796,1643191124,328,2780
3859717699,3387934739,1646738502,1646738914,412,1736
3568253482,3038541174,1653507777,1653508166,389,3997
3350529723,3630698467,1669408611,1669408770,159,4025
3469795746,3464152483,1646329181,1646330000,819,244
3493043629,3382512318,1641336253,1641336584,331,4950
3003259058,3521157119,1660842403,1660843194,791,821
3134590090,3492042961,1653185164,1653185212,48,2882
3876693917,3998364265,1668714884,1668715524,640,2256
3381380929,3053306872,1663765137,1663766081,944,1262
3502805345,3613581272,1647715999,1647716464,465,4577
3103603047,3447089260,1643299174,1643299902,728,1376
3042257332,3809902810,1642712916,1642713470,554,4659
3448183115,3773979762,1646680969,1646681750,781,1623
3471179178,3225989113,1641421823,1641422480,657,2143
3302336250,3573267855,1655077175,1655077959,784,4343
3879985975,3032824130,1665178885,1665179683,798,4689
3997393166,3176805161,1651758538,1651758604,66,4393
3098729242,3140355503,1649915649,1649915836,187,2784
3093387219,3315574379,1653760631,1653761054,423,1734
3547303767,3883506432,1657011825,1657012772,947,117
3480473023,3303081121,1660099882,1660100864,982,4654
3894400553,3569479825,1648746244,1648746697,453,1986
3952010088,3042923371,1656764466,1656764790,324,1927
3528346011,3189586408,1653622968,1653623619,651,4065
3550487892,3213255686,1657526815,1657527187,372,3850
3430006191,3496425914,1642845319,1642845563,244,537
3485039176,3026019154,1665239537,1665240279,742,2486
3429875558,3300773998,1660023501,1660023503,2,1754
3892395545,3923335853,1653925493,1653925659,166,4353
3984935764,3161568450,1654735292,1654736100,808,652
3544531399,3355091218,1648771072,1648771519,447,2889
3832302061,3087189150,1659382920,1659383748,828,4904
3355935002,3615042096,1666791136,1666791227,91,796
3732828416,3271463836,1652106328,1652107086,758,27
3691115510,3420759451,1653441034,1653442005,971,4269
3774259373,3204616845,1664969831,1664970817,986,3530
3206629964,3448457385,1663785629,1663785785,156,1223
3311544704,3085230756,1663428349,1663428909,560,3344
3379504014,3970079722,1653950225,1653950658,433,172
3204581799,3398028697,1651643762,1651644492,730,4639
3524026400,3783808577,1664713832,1664713921,89,2637
3812494983,3339833232,1664257277,1664258215,938,2423
3034379774,3090550202,1662797846,1662798369,523,3381
3714923533,3303862271,1660046942,1660047013,71,1866
3325255768,3795585706,1644439655,1644440371,716,578
3420549612,3805206184,1665723829,1665724609,780,4309
3798745235,3046959525,1641973579,1641973597,18,240
3499170633,3620262271,1666105284,1666105727,443,3977
3675225741,3442400384,1643919257,1643919779,522,157
3998671234,3999757853,1664037979,1664038972,993,4720
3001809797,3441384600,1646192355,1646192630,275,3855
3575579500,3186452798,1644531191,1644531961,770,3240
3343070027,3392906595,1651824920,1651825897,977,3300
3920131063,3470848062,1663006748,1663006872,124,3971
3197074521,3542752085,1648336726,1648336782,56,978
3438262680,3375690353,1669641028,1669641035,7,434
3441146675,3178089736,1668711072,1668711927,855,4947
3220174853,3258081543,1644736137,1644736793,656,569
3045842967,3352930571,1660508528,1660509437,909,4460
3974830583,3363357001,1644940054,1644940372,318,2492
3877996149,3441785129,1643166836,1643167717,881,2916
3740376735,3093829646,1664501622,1664501978,356,1250
3210732822,3563808183,1664245916,1664246686,770,2198
3257360139,3554122036,1659270989,1659271650,661,588
3795632696,3417214775,1667681346,1667682065,719,2790
3325531799,3737148776,1645674962,1645675352,390,2456
3935396168,3869518810,1645185967,1645186702,735,2563
3218981593,3887439843,1655182868,1655183620,752,1911
3340472924,3828148148,1649186781,1649187406,625,484
3417129337,3764634607,1647042468,1647043263,795,686
3363321969,3819789268,1644233542,1644234388,846,1385
3991618539,3828662877,1668966088,1668967079,991,2905
3389903624,3414374280,1650961337,1650961355,18,584
3465424120,3791306227,1662959284,1662960106,822,1125
3000419153,3367573384,1642381591,1642381758,167,4100
3953442901,3490208508,1644116521,1644116749,228,3375
3610658700,3558583699,1662284862,1662285594,732,3758
3798745235,3474764768,1645497928,1645498681,753,1531
3590807222,3734613294,1643450012,1643450457,445,274
3528460250,3015118504,1663962341,1663963241,900,1881
3787884274,3625739361,1667521126,1667521591,465,2565
3983824976,3776309036,1663934896,1663934915,19,4243
3001189845,3364449636,1647187784,1647188671,887,2229
3026015611,3448983161,1665354928,1665355272,344,3271
3570344123,3709203492,1645942981,1645943460,479,1788
3348153246,3055645032,1646540446,1646541254,808,609
3032060300,3839998185,1644763652,1644763908,256,462
3612205247,3147895045,1655170493,1655170565,72,2244
3412929126,3644542908,1666489886,1666490729,843,3769
3421554113,3128661369,1668099414,1668100337,923,1745
3183754041,3939413018,1666912294,1666912802,508,2828
3941841916,3735771445,1646577122,1646578105,983,3220
3285378404,3620742109,1648401381,1648401408,27,1889
3526849039,3264207298,1665003862,1665004844,982,1901
3669170514,3423883195,1661570487,1661571436,949,4457
3670609141,3714424709,1659440474,1659440993,519,2886
3546979038,3340341143,1651881381,1651881643,262,4134
3671124610,3086848611,1656489637,1656489856,219,680
3609001633,3256190136,1653147306,1653147578,272,4886
3606761339,3519958306,1648026622,1648027449,827,4459
3882786551,3308696867,1648950126,1648950594,468,2154
3216201224,3587140974,1648245153,1648246036,883,3288
3636941404,3643179371,1644094434,1644095031,597,3228
3006904920,3591571782,1667949631,1667950313,682,3602
3849878307,3255442570,1644187212,1644187939,727,4392
3734521016,3205494832,1660666763,1660667755,992,713
3504476206,3254917642,1642802393,1642803360,967,1713
3482921040,3218985473,1649656629,1649657243,614,1652
3102807082,3390802258,1641453073,1641453675,602,1528
3906269587,3952282560,1647141024,1647141376,352,4974
3213727138,3156574841,1655732754,1655733066,312,3430
3639165124,3543971995,1644855501,1644855677,176,2555
3295998576,3190686803,1652363278,1652363278,0,3997
3345767832,3983965772,1642778029,1642778354,325,2748
3057682738,3826933863,1655979051,1655979850,799,988
3610236345,3796031379,1647781032,1647781068,36,4971
3572305906,3208122127,1667573328,1667574299,971,359
3679544289,3777160037,1643116135,1643116445,310,2056
3494458347,3078947005,1652612159,1652612727,568,1840
3568099979,3888948841,1641840325,1641841116,791,3846
3273275145,3792224149,1662606371,1662606531,160,2278
3077498159,3069295158,1645635457,1645635826,369,4671
3200064771,3865562765,1642678235,1642678694,459,3883
3088603786,3806881202,1643732406,1643732412,6,1259
3616783521,3640148940,1658589379,1658589516,137,4825
3360517228,3379172639,1653831042,1653831418,376,786
3487180498,3912515945,1647413088,1647413737,649,1378
3507424111,3638912216,1665703490,1665704080,590,2317
3546928251,3380968931,1651188239,1651188671,432,3831
3072061712,3488548545,1657262182,1657263056,874,99
3393370392,3779022938,1643264186,1643265039,853,2043
3649354881,3381853182,1653584695,1653585655,960,2658
3028645686,3155396907,1654846972,1654847614,642,3822
3361824852,3048715481,1647191724,1647191981,257,1291
3626077886,3121247391,1649749492,1649750248,756,4486
3883969324,3816112873,1650319989,1650320470,481,2073
3388838434,3100880647,1649195469,1649195820,351,1287
3924415196,3921509327,1648931193,1648931372,179,1440
3736002821,3253795260,1645569621,1645570205,584,1924
3265776339,3243516395,1664510098,1664510362,264,3746
3246609183,3759173970,1641977589,1641978490,901,1312
3888681235,3186512142,1649827695,1649827907,212,2600
3331279895,3045199387,1646741326,1646742075,749,3046
3084445096,3238452551,1665521294,1665521765,471,3135
3899356160,3234107050,1653341492,1653341778,286,4965
3938903971,3320966208,1652259399,1652260379,980,3204
3966882930,3717817512,1647925202,1647925712,510,3410
3479557501,3706727071,1653093277,1653093350,73,3441
3044563826,3614286032,1659249162,1659249768,606,1025
3819049296,3113837542,1669219217,1669219392,175,754
3363282756,3300861909,1644699431,1644699486,55,638
3942012685,3715492781,1652704388,1652705262,874,1485
3202945397,3489217472,1642431551,1642432207,656,938
3354200826,3812160267,1669136857,1669137242,385,1106
3637416842,3983917178,1654993357,1654993432,75,1249
3913589943,3582260608,1662679786,1662680090,304,2238
3726122847,3165541733,1649921994,1649922480,486,4795
3826313170,3562454592,1669211644,1669211698,54,2907
3346389906,3520892759,1652791198,1652791210,12,4845
3938267443,3400810428,1660427291,1660427780,489,4304
3817251878,3784474088,1656746472,1656747141,669,2050
3382677341,3397254198,1648182498,1648183150,652,1526
3908964312,3571928139,1644294870,1644295213,343,3126
3055852003,3143442113,1643421519,1643421969,450,3364
3107245744,3484344895,1660809318,1660809783,465,461
3712980777,3582290566,1661631642,1661632024,382,303
3061263632,3783556819,1662929268,1662929819,551,2115
3323653639,3885496226,1649574425,1649575205,780,2690
3174815013,3719418989,1663076497,1663077118,621,1390
3521345294,3677488914,1646028677,1646029068,391,4212
3137399084,3279085864,1659214476,1659214552,76,4461
3007754463,3711128525,1665540903,1665541896,993,3709
3518476009,3532370607,1668185216,1668185781,565,4533
3574333372,3257691167,1664197790,1664197903,113,361
3770863240,3459309183,1653918213,1653918305,92,46
3377678343,3926977887,1657031341,1657031446,105,3600
3123838719,3522721822,1661287120,1661287723,603,661
3093746350,3571387466,1667640861,1667640959,98,864
3366876799,3685909920,1659307194,1659307228,34,4126
3207071946,3971993273,1661864357,1661865092,735,4912
3239838270,3474148965,1644373676,1644373821,145,2328
3216765514,3110518090,1654095791,1654096250,459,3547
3407313696,3190920801,1663095975,1663096346,371,1907
3106558477,3321863007,1662673370,1662674342,972,2478
3869330394,3467696983,1665252223,1665252601,378,2990
3451900239,3495310174,1657715621,1657715889,268,4935
3580996942,3591062408,1668529462,1668529666,204,2773
3872623191,3650645131,1657304902,1657305372,470,1055
3916518668,3333092023,1652598673,1652599121,448,103
3090734729,3538281221,1668743313,1668743602,289,3711
3034152503,3958958225,1654592677,1654592876,199,1851
3074429546,3683458547,1657918068,1657918655,587,4629
3064839915,3826151380,1646851503,1646851882,379,2379
3457832240,3680504202,1662034548,1662035045,497,3493
3638050489,3119787542,1646738811,1646739569,758,1097
3730297248,3153248602,1662898213,1662899095,882,4136
3426503041,3941967938,1655969838,1655970022,184,3440
3605058369,3803571210,1646572074,1646572675,601,2989
3826422443,3120275270,1646133106,1646133764,658,1736
3674229381,3611748946,1669646369,1669647321,952,4710
3908752906,3015549459,1668724648,1668724772,124,1330
3481615800,3676665827,1669093367,1669093457,90,3617
3064881333,3819610114,1657622949,1657623523,574,1330
3560169417,3659262995,1661899009,1661899495,486,1137
3022665074,3095451107,1668888662,1668888690,28,3462
3451394840,3115848905,1669584026,1669584148,122,1370
3638108102,3600510047,1641941989,1641942630,641,709
3396279675,3509548697,1667710977,1667711388,411,1150
3659120926,3979924823,1644878358,1644879123,765,94
3826929067,3443104757,1668929694,1668930682,988,4943
3145213208,3720588514,1641831201,1641831789,588,4352
3404418582,3899137232,1664496601,1664497344,743,2081
3781924076,3110796614,1641459152,1641459276,124,4478
3360383020,3293794329,1646995251,1646996148,897,3133
3024621782,3479143505,1659600115,1659600432,317,1585
3841555144,3097884064,1646161647,1646162167,520,2909
3907730333,3239721902,1645367993,1645368164,171,746
3289012185,3736315321,1657311219,1657311349,130,4677
3543468342,3513797205,1644740284,1644741020,736,3331
3946443920,3075510120,1656889377,1656889902,525,1079
3185186471,3802195833,1661511135,1661511982,847,1003
3114824872,3557425592,1649217034,1649217435,401,2491
3510757426,3150988225,1661132430,1661132588,158,4284
3326582925,3317323619,1665392135,1665392922,787,2975
3536813619,3197834518,1646946798,1646947017,219,4307
3443098305,3434017276,1655253114,1655253915,801,2367
3528111538,3175305380,1660008904,1660009237,333,2556
3038382080,3206855091,1669033961,1669034186,225,855
3600615157,3514826263,1654546497,1654546979,482,3650
3420644008,3782739292,1648786215,1648786505,290,125
3493924341,3868898593,1660217665,1660217785,120,2602
3887763183,3204370077,1646654317,1646654452,135,3179
3331060866,3764264903,1667533833,1667534609,776,2943
3677492070,3711926562,1667446691,1667447324,633,2337
3680760442,3470393724,1649869868,1649870761,893,4850
3984663569,3349726772,1663451865,1663451935,70,2332
3240558756,3148259260,1653156636,1653156699,63,4635
3540074508,3414818209,1641400507,1641400613,106,3068
3062200676,3666035317,1651462925,1651463093,168,2341
3392058531,3011510623,1661119025,1661119546,521,3007
3663564006,3922696949,1654910347,1654910964,617,4228
3837431461,3705953019,1642459871,1642460259,388,3120
3395606843,3945231515,1661766474,1661767094,620,757
3213271043,3173753950,1643775239,1643775479,240,1628
3092202878,3747278462,1658943366,1658943774,408,921
3840724608,3269584595,1657187347,1657187698,351,2198
3125726750,3384124531,1661467367,1661467621,254,3456
3498732092,3290837549,1657064227,1657064511,284,1107
3441407661,3041995014,1663384925,1663384926,1,3237
3191634314,3588095168,1653712518,1653713040,522,3198
3949595450,3738263524,1667548453,1667548806,353,2628
3253334709,3222351085,1651052252,1651052641,389,3333
3901759267,3355019234,1660251523,1660251647,124,321
3732545782,3341970959,1663882882,1663883775,893,4972
3014132100,3799920505,1645432934,1645433146,212,251
3442818312,3222626027,1642348261,1642349005,744,3041
3223068240,3586830834,1650503386,1650504355,969,2779
3870749230,3127054373,1645512079,1645512662,583,2837
3284881928,3005608712,1667507784,1667508384,600,2732
3482434079,3633096356,1643276097,1643276424,327,3680
3276752261,3709091526,1669334021,1669334954,933,752
3199976851,3694693872,1669656168,1669657147,979,1099
3885937087,3314902774,1651859939,1651860341,402,2944
3851182642,3071082008,1649139961,1649140447,486,2232
3920050226,3464626193,1663427387,1663428035,648,860
3652694465,3218738728,1667825001,1667825042,41,2507
3032786518,3331495882,1657739259,1657739326,67,2943
3327740764,3621959740,1645854872,1645855825,953,1146
3750055766,3139582334,1664004712,1664004816,104,608
3085345821,3097547294,1664458623,1664459078,455,4252
3098918633,3614642426,1657386320,1657386602,282,2960
3096985204,3410338885,1644476033,1644476394,361,3018
3584976419,3121110623,1659430478,1659431461,983,2973
3190287138,3418602564,1650499929,1650500233,304,1485
3111698461,3518783365,1645806265,1645806653,388,487
3531487041,3792108887,1644333783,1644334731,948,1193
3624015816,3064681350,1666055847,1666056583,736,3522
3909761840,3543206543,1646906146,1646906406,260,3976
3904209378,3638278315,1646294511,1646294798,287,2779
3966570082,3356257109,1660533053,1660533884,831,3268
3000850654,3325283052,1660217412,1660218312,900,538
3117146116,3818307369,1668135704,1668136631,927,1093
3690271223,3076774896,1649645346,1649645464,118,3831
3938230129,3381540963,1666008651,1666008764,113,4213
3806607716,3640857701,1664185974,1664186807,833,1836
3266566393,3588430844,1651643333,1651643347,14,2665
3462460091,3518355518,1662010361,1662011120,759,3367
3645080496,3941144567,1642462205,1642462737,532,2058
3225563856,3228404994,1668752818,1668753521,703,333
3456716978,3343111013,1664420601,1664421536,935,2932
3685579859,3839316678,1641578796,1641579762,966,2260
3098589803,3571401798,1658302228,1658302809,581,1941
3291620039,3874150044,1663853941,1663853997,56,578
3295884617,3833199402,1657075144,1657075661,517,17
3719724251,3981657964,1660832517,1660833165,648,2054
3624428724,3585472962,1661201653,1661202454,801,427
3014534484,3688052340,1658093676,1658094230,554,2275
3970016067,3021439555,1644225328,1644225502,174,4111
3389020373,3142367041,1644600793,1644601250,457,3028
3459150066,3387269802,1648879630,1648880239,609,3975
3044137533,3585992263,1661188832,1661189647,815,4646
3140136174,3734846909,1653853909,1653854072,163,2065
3462253758,3473634739,1658732709,1658733277,568,3638
3759234937,3115446388,1650556769,1650556879,110,1993
3632596446,3020888814,1641300538,1641300809,271,847
3342805644,3972236942,1651905107,1651906058,951,4638
3913602663,3996735232,1643290465,1643290873,408,3367
3432830412,3939315535,1642164017,1642164255,238,1174
3619309445,3707384273,1667669930,1667670862,932,3324
3791245326,3237482028,1664046652,1664046899,247,3892
3862731590,3615165763,1663232199,1663232209,10,3787
3793641512,3578772305,1662508598,1662509514,916,4653
3189002539,3795651768,1667248871,1667249303,432,4557
3371606619,3428380284,1663459869,1663460421,552,946
3168200860,3472071280,1642722417,1642722851,434,3085
3315259952,3685827292,1660505892,1660505971,79,4684
3642450958,3284213350,1659280917,1659280937,20,3993
3528346011,3754039281,1647555271,1647555941,670,1562
3361421760,3880523153,1649751665,1649752447,782,4398
3815993646,3768117336,1644822786,1644823645,859,650
3735939833,3983851979,1641118053,1641118188,135,618
3163662638,3988580623,1641471829,1641472269,440,2562
3661755335,3584171562,1657392685,1657393303,618,3301
3673173165,3904919215,1659770148,1659771022,874,1511
3204312071,3904574271,1654135606,1654136090,484,1881
3849879279,3691505743,1645765763,1645766435,672,1456
3554172418,3192382331,1661740419,1661741039,620,1024
3245779002,3077391650,1641166580,1641166885,305,3881
3726999771,3660215052,1656698928,1656699319,391,4078
3255614863,3345163473,1661932600,1661932698,98,4746
3367963279,3792241371,1656937476,1656937542,66,1210
3171977255,3333900622,1646569495,1646569535,40,4440
3184934932,3241539858,1652303056,1652303816,760,3223
3163430073,3394284150,1651411189,1651411383,194,3721
3134763381,3229296177,1650531548,1650532538,990,1208
3848762981,3037854944,1669290457,1669290514,57,229
3184997138,3130200528,1665923609,1665924120,511,3966
3492598144,3100748377,1665068588,1665069165,577,1089
3514070248,3696970806,1656754519,1656755480,961,2431
3144464316,3972014541,1653891857,1653892221,364,3003
3352912558,3322132812,1643559995,1643560508,513,235
3735848191,3861130456,1648917896,1648918068,172,4829
3009678862,3704707776,1646069915,1646070554,639,1291
3099400458,3563391738,1669170303,1669170703,400,1297
3126093611,3339291555,1654374494,1654375246,752,2351
3972035107,3377386415,1659011628,1659012160,532,3405
3347748625,3818585876,1668722845,1668723526,681,2022
3682958346,3639861279,1661433537,1661433970,433,2256
3287323756,3597289164,1649919801,1649920112,311,2917
3890418208,3030069419,1664694020,1664694188,168,282
3466887035,3320280748,1660766034,1660766266,232,2395
3227876317,3798109294,1641322512,1641322624,112,2453
3184685433,3077698050,1655726756,1655727003,247,1505
3810424359,3413017563,1654167236,1654167249,13,2740
3101334577,3220581618,1667625348,1667625892,544,4321
3316348553,3812538387,1667979172,1667979885,713,3793
3742947322,3718067081,1660403751,1660404180,429,2702
3858346365,3859060796,1661607717,1661608241,524,819
3921709997,3825032933,1642824364,1642825326,962,1314
3237205713,3362192898,1666342907,1666343603,696,810
3386268563,3113194639,1657579259,1657579758,499,3540
3177940786,3257195975,1657682543,1657682795,252,2526
3600698320,3781721933,1648467732,1648468313,581,1032
3308823791,3185479033,1660426543,1660426618,75,28
3603067875,3364873754,1645477867,1645478604,737,3194
3092809675,3186122352,1658307089,1658307291,202,4549
3494213432,3063538301,1648927073,1648927558,485,4892
3838193656,3389925613,1641587736,1641588430,694,2051
3700516476,3139643237,1657149026,1657149550,524,2033
3668455513,3180945574,1642159548,1642159623,75,2400
3220279084,3423235855,1666705506,1666706069,563,1192
3365988570,3022915872,1652057157,1652057476,319,4618
3255147459,3045758916,1669374359,1669374923,564,3627
3800992688,3188343511,1659011396,1659012150,754,3329
3436132131,3333256749,1646459048,1646459392,344,2891
3755365005,3743406467,1650384749,1650384923,174,4323
3748062692,3349698621,1647976488,1647977115,627,4782
3922061663,3367483222,1649657321,1649657969,648,4875
3173234941,3453906025,1644687104,1644687160,56,1083
3080920766,3198282119,1650966412,1650967175,763,3811
3442884017,3460249477,1641845836,1641846738,902,2176
3539723274,3200724874,1665074361,1665075245,884,825
3861356720,3628368313,1659590907,1659591360,453,3083
3270221194,3148632861,1641060497,1641061129,632,966
3733547525,3752993846,1664140222,1664140825,603,2094
3963483478,3047532980,1643242024,1643242852,828,3719
3498507558,3538214486,1657143673,1657144072,399,3315
3995586979,3458239978,1645064632,1645065110,478,2909
3470771422,3166821240,1656223981,1656224789,808,3859
3089492607,3286200339,1661680289,1661680712,423,755
3205290700,3608569559,1650607358,1650608178,820,4720
3701530801,3040725373,1657462861,1657463380,519,922
3387514963,3805664979,1655799139,1655799156,17,49
3615268471,3224302818,1667122429,1667122567,138,4693
3987078501,3668088235,1663187489,1663188273,784,2299
3179298594,3111896461,1650990813,1650991048,235,1930
3647919717,3358611723,1659782252,1659783219,967,741
3665081713,3806904168,1647156274,1647156938,664,2192
3010827136,3998032634,1662347165,1662347423,258,2606
3702397803,3505795020,1653205455,1653205683,228,752
3196704109,3124789746,1656615129,1656615287,158,2583
3173836384,3251609055,1654904611,1654905446,835,4318
3906259679,3449909440,1666195489,1666196410,921,3365
3604795911,3850105789,1668526496,1668527485,989,2884
3728299512,3431972307,1658072567,1658072840,273,353
3602863241,3828980422,1642188699,1642189281,582,2156
3740187717,3373459875,1660444067,1660444666,599,4059
3276365725,3433065299,1661686148,1661686591,443,963
3993624536,3321401620,1667979459,1667979656,197,3732
3279372298,3047522581,1652028937,1652029662,725,955
3991384223,3664749438,1646926220,1646926912,692,1465
3070889254,3872265674,1661555997,1661556100,103,3356
3317369770,3511390671,1665468085,1665468389,304,993
3861447028,3908765673,1652117264,1652117304,40,4464
3559494813,3019871116,1659956198,1659956612,414,3013
3841350643,3175093876,1643978288,1643978566,278,1236
3811267030,3301065023,1667802053,1667802932,879,2213
3087260916,3782250331,1655646982,1655647417,435,2675
3041137588,3120267331,1648399180,1648399550,370,2687
3282921954,3294868481,1645625951,1645626270,319,1219
3983818040,3747278462,1653405577,1653405613,36,2463
3345153469,3811984854,1658346988,1658347621,633,4031
3196348219,3541679409,1646874462,1646875319,857,4089
3915569668,3241619856,1665752315,1665753124,809,4201
3946053282,3027502729,1668521931,1668522887,956,1190
3189327553,3240214534,1654117341,1654117617,276,2016
3136969295,3311791919,1647105454,1647105768,314,3961
3262111302,3727749190,1646255374,1646256215,841,62
3480693732,3885137139,1654234723,1654235177,454,81
3476267965,3459692630,1657234470,1657234822,352,1579
3800820426,3410878773,1665067225,1665068030,805,4437
3000951978,3370349400,1655275395,1655275652,257,1725
3105541587,3039833612,1656736148,1656736792,644,71
3645708895,3506594574,1657464618,1657465340,722,544
3325812361,3859536430,1658673426,1658673447,21,4128
3605122335,3571444200,1650443076,1650443116,40,1293
3320297626,3203207483,1651350639,1651350731,92,2554
3006038199,3393191968,1644178116,1644178585,469,3008
3582841717,3138930456,1654807999,1654808656,657,555
3555043612,3182527166,1664843549,1664844062,513,3405
3865305265,3470795652,1651192534,1651193126,592,4428
3759845765,3303562492,1654687753,1654687779,26,1631
3736855586,3840877792,1653635752,1653636703,951,3924
3675439075,3658649243,1653689905,1653690361,456,1684
3114589287,3695461334,1657990196,1657990412,216,1708
3381729018,3335676685,1665199872,1665200118,246,1222
3454095287,3387137615,1668641125,1668641771,646,3234
3422999115,3770297725,1663478566,1663478915,349,926
3656779379,3972377749,1646425037,1646425463,426,2178
3958910954,3214702189,1653580084,1653580767,683,4612
3203167041,3886057418,1655241895,1655242695,800,2231
3429676583,3890408266,1648683121,1648683416,295,4288
3690531252,3109301127,1657354461,1657355025,564,1063
3572305906,3047623360,1658453198,1658454093,895,150
3580481580,3656321466,1660401025,1660401916,891,127
3842648355,3830342336,1663877678,1663878342,664,2564
3451764941,3243074596,1654148981,1654149542,561,4396
3347825186,3273420599,1668496882,1668497256,374,4715
3355754689,3639439900,1644664433,1644664726,293,1135
3548219746,3897890287,1644672183,1644672594,411,1684
3778292035,3041824644,1651187574,1651188334,760,1569
3934380165,3691759874,1641655732,1641656118,386,1683
3345068747,3518363595,1663706172,1663706888,716,1327
3658073379,3952669539,1657698811,1657699807,996,586
3264796095,3367418182,1648478912,1648479296,384,251
3863120751,3339731379,1653448065,1653448216,151,808
3584846422,3535840824,1654628522,1654629088,566,3153
3750508555,3190783502,1658941176,1658941288,112,3821
3559153183,3731771202,1653233113,1653233579,466,1969
3440224784,3938821415,1666554114,1666554669,555,1612
3289806050,3463290754,1658515535,1658516123,588,916
3973742848,3030455049,1643257352,1643257637,285,4794
3227457237,3966447249,1668188708,1668189492,784,385
3811484701,3636350731,1666082379,1666082864,485,2876
3906997298,3518733049,1666059603,1666060517,914,4681
3435525809,3223317692,1658760944,1658761770,826,524
3129828193,3083808542,1660997674,1660998496,822,3103
3401618364,3864560336,1645669046,1645669721,675,969
3979997799,3865333227,1666569397,1666570235,838,3003
3641900197,3377828570,1642198433,1642199315,882,4353
3485041379,3265076958,1641308190,1641309053,863,1549
3034165495,3831941001,1660447314,1660447840,526,4561
3880129680,3573393750,1663525296,1663525868,572,3182
3919897683,3218818078,1653463448,1653463921,473,764
3264886208,3610239675,1649770778,1649771660,882,2608
3669537816,3394583254,1644816555,1644817228,673,1081
3754799306,3449157918,1653629713,1653630367,654,2983
3528230813,3506226453,1648591852,1648592777,925,3327
3295520857,3913824109,1666816478,1666817193,715,560
3535501426,3499224992,1662622644,1662623226,582,746
3213874874,3940732451,1663161560,1663162426,866,2014
3507010673,3269008523,1643596521,1643597415,894,2631
3038403419,3593898451,1655979721,1655980372,651,1058
3519676180,3163700254,1659010014,1659010302,288,2169
3296865939,3849349988,1664992796,1664993158,362,2722
3606153244,3601480211,1655264499,1655264768,269,942
3742128738,3768440525,1661148854,1661149357,503,3896
3335221297,3710694767,1647794490,1647794538,48,4382
3877491020,3076843242,1663744569,1663745400,831,1715
3922346447,3249879510,1649786045,1649786312,267,408
3737713865,3750183812,1656315302,1656316120,818,1742
3489363911,3642181084,1650672262,1650672417,155,426
3342369845,3801489049,1666727012,1666727897,885,1437
3370524875,3383406113,1667379715,1667380567,852,4233
3121132735,3124030733,1661240888,1661241400,512,3241
3397515812,3266427786,1659065937,1659066155,218,2252
3702422434,3007701751,1665766093,1665766108,15,4364
3854262568,3549023830,1653294046,1653294143,97,1289
3289687328,3632448134,1659196126,1659196838,712,3478
3897979142,3070710283,1648582803,1648583775,972,775
3819245922,3855638705,1660954281,1660954475,194,2636
3786206001,3790444892,1642057774,1642058446,672,424
3118408003,3515144894,1644296328,1644297304,976,3621
3640726084,3365013743,1656327511,1656328380,869,950
3908021084,3626191470,1659979006,1659979649,643,3601
3471231648,3468357041,1667926976,1667927460,484,2839
3075674312,3429737874,1651748953,1651749363,410,215
3093335565,3386736262,1660437231,1660437989,758,769
3112950139,3602143097,1656345063,1656345365,302,292
3007804170,3508833415,1662188710,1662188944,234,1624
3774524090,3788443673,1660235170,1660236040,870,1005
3830361709,3784313204,1650978204,1650978585,381,2485
3679342113,3716571258,1649287908,1649288188,280,2098
3463479708,3543776760,1647422255,1647422707,452,4201
3128568652,3642652657,1652591035,1652591841,806,4206
3948275902,3806615546,1657827505,1657828231,726,2631
3470242361,3750166334,1663377968,1663378079,111,3703
3286612894,3290949672,1650140409,1650141397,988,564
3198643090,3603069851,1660727252,1660727310,58,218
3630793925,3405836184,1661564595,1661565495,900,3001
3864338639,3227093689,1653097065,1653097773,708,1382
3545865554,3887274673,1641127338,1641128027,689,2557
3992324553,3076198521,1645101592,1645102377,785,1263
3957662533,3783643217,1641619791,1641620534,743,3061
3741354792,3797149308,1668762621,1668763602,981,957
3196761318,3105249617,1660032279,1660032341,62,202
3978802060,3292434567,1653492633,1653492666,33,2586
3855420161,3666589518,1657757965,1657758552,587,2044
3564484483,3289976761,1664006810,1664007176,366,457
3686459492,3672258772,1646735565,1646736075,510,343
3308566284,3642941713,1665658857,1665659641,784,722
3409942946,3565765506,1650932482,1650932520,38,4004
3308986246,3530222939,1653325322,1653325917,595,441
3217712087,3408515824,1669117469,1669117768,299,662
3902047645,3435259828,1650308057,1650308207,150,4803
3827943115,3067066401,1643307048,1643307350,302,1003
3830681549,3280461685,1648025483,1648026361,878,4283
3202130376,3468162380,1668478380,1668479147,767,4501
3788231492,3122191999,1642540018,1642540433,415,3907
3645307801,3387306894,1649614975,1649615546,571,4069
3495952486,3418258405,1663212109,1663212867,758,3937
3190986925,3688327636,1648239457,1648239690,233,1947
3037665961,3769204022,1658880727,1658881430,703,2643
3921113677,3426950211,1667396711,1667397629,918,970
3291379732,3607821319,1644508286,1644508544,258,3556
3202419502,3581324952,1654783596,1654784449,853,3360
3094108357,3845709345,1661957883,1661958761,878,2020
3511907473,3723353155,1648117365,1648117769,404,2916
3985598274,3684667820,1643468523,1643469136,613,3470
3560376899,3015933971,1648148955,1648149878,923,4672
3987068317,3172161099,1648818173,1648818620,447,4282
3882848420,3138554285,1652028514,1652028673,159,258
3695353176,3338896774,1645240134,1645241059,925,513
3119598072,3085066282,1659074247,1659074917,670,3557
3643754161,3187591427,1657922162,1657923015,853,13
3458736101,3469713333,1658907569,1658907592,23,2351
3490177291,3436404857,1657763161,1657763565,404,4555
3039846747,3951381703,1653825463,1653825616,153,3191
3242983197,3818546344,1657677670,1657678227,557,2833
3552079738,3759234937,1668710543,1668710794,251,438
3828732309,3880474441,1649845925,1649846535,610,4091
3919266631,3808624419,1656298745,1656298870,125,951
3983003781,3916968322,1657110330,1657110796,466,4096
3863051034,3701354626,1649536686,1649536711,25,853
3177920324,3533499707,1657312168,1657312329,161,3551
3818443515,3564791710,1642646729,1642646938,209,3431
3551421042,3656148329,1656480092,1656480347,255,66
3198367899,3923792525,1660489572,1660489926,354,4910
3032363267,3429262126,1657936852,1657936991,139,960
3856072039,3232848619,1645171689,1645172292,603,84
3363214328,3790493332,1654319853,1654320428,575,4453
3033078399,3232743326,1662532585,1662533425,840,717
3299902451,3534276506,1651225492,1651226105,613,1037
3775592104,3943469756,1667914516,1667914687,171,3081
3707285412,3064562981,1664853615,1664854439,824,2289
3777250660,3195127571,1649437555,1649438515,960,4082
3259452222,3032766546,1669427234,1669428153,919,3377
3446151754,3810968577,1668037028,1668037215,187,1804
3908273021,3167192065,1649448320,1649448780,460,3714
3308333530,3497571715,1654738002,1654738931,929,986
3550460303,3625347781,1642015393,1642015442,49,4879
3851484766,3447877238,1643281812,1643282674,862,4984
3000491430,3000404769,1655243936,1655244431,495,813
3044552044,3947400758,1644842962,1644843036,74,3912
3179990303,3576230722,1646386515,1646386992,477,985
3231116738,3006904550,1655633412,1655633581,169,2475
3130562785,3693110899,1647567480,1647567974,494,927
3549677358,3430200724,1664946813,1664947540,727,2591
3631749787,3552826458,1662174024,1662174410,386,3466
3532987019,3208972017,1652674893,1652675816,923,3177
3669159453,3101258835,1642108705,1642109375,670,3035
3592442086,3934996746,1646162284,1646162445,161,4664
3338818050,3954547737,1651839859,1651840630,771,2164
3155597271,3013161448,1657506302,1657506615,313,3450
3181465393,3797680235,1663044451,1663045208,757,3432
3139196658,3771148267,1667098121,1667098219,98,1343
3286152492,3175869669,1661194799,1661195010,211,4330
3415596227,3463040424,1661539627,1661539912,285,2813
3253745151,3263469358,1647021186,1647021540,354,44
3917514219,3731155482,1648165647,1648165750,103,2761
3341259283,3648884070,1657367133,1657368019,886,2067
3129245905,3779131295,1654353477,1654354126,649,4554
3829948138,3787237154,1654441991,1654442175,184,4612
3766649105,3297831599,1664653943,1664654487,544,2971
3354632860,3262822612,1641032319,1641032980,661,241
3116686240,3867554073,1654050272,1654050810,538,4977
3015115756,3554759753,1656733850,1656734072,222,1679
3365926306,3920131063,1648894778,1648895274,496,3537
3816886083,3595571817,1648983114,1648983987,873,4877
3631037507,3003278901,1643459396,1643460124,728,1350
3389313661,3512004863,1664457344,1664457962,618,42
3863744178,3040794099,1661663850,1661664087,237,1673
3216747712,3104710387,1641043731,1641043946,215,3112
3785650708,3302277551,1666560785,1666560881,96,908
3103858282,3103257010,1663760988,1663761003,15,3838
3262127302,3421413862,1663301705,1663301706,1,4498
3681144336,3173345422,1669232018,1669232599,581,1128
3014158490,3680211283,1642342898,1642343324,426,3392
3655323995,3311625491,1641678623,1641678912,289,3131
3627514368,3229388337,1656889268,1656890160,892,861
3623938506,3764440215,1649433175,1649433895,720,3134
3479941251,3737904199,1655727792,1655728286,494,4690
3966959266,3543664579,1666794156,1666795126,970,3427
3963426885,3848412218,1667645316,1667645421,105,2267
3743570783,3062062648,1649621548,1649622322,774,1323
3084328689,3422478375,1642901165,1642901779,614,4186
3123838719,3854026176,1657980296,1657980987,691,2431
3366454291,3378259608,1647604699,1647605089,390,2092
3514443308,3246362463,1651613878,1651614640,762,2834
3954317188,3601799283,1655065029,1655065836,807,2512
3614348647,3629462196,1646471181,1646471784,603,4443
3320246384,3491234468,1666866409,1666866430,21,1386
3930771294,3904443881,1644121567,1644122481,914,2054
3245767678,3399715093,1662875603,1662876011,408,2638
3245280966,3718619314,1666888966,1666889502,536,2687
3596217912,3141903145,1666988509,1666988639,130,3426
3804668537,3353160458,1645100667,1645101307,640,3129
3550441012,3578820170,1649302930,1649303569,639,230
3168468366,3070542348,1653396668,1653397512,844,2823
3112074695,3953959585,1659222039,1659222099,60,508
3453209274,3827984659,1660900307,1660901136,829,1553
3350970191,3576866501,1662213280,1662213966,686,846
3418937207,3261452052,1647794620,1647795313,693,2707
3633673154,3479626087,1667770222,1667770276,54,3269
3951289208,3835353833,1661239678,1661239908,230,58
3617584940,3972266399,1656485571,1656486036,465,3540
3165026713,3276901013,1648075783,1648076623,840,1336
3416128875,3367338765,1666779421,1666779918,497,4035
3944263393,3231497409,1662792910,1662793272,362,588
3848881029,3774146004,1666358410,1666358752,342,145
3324575868,3284390769,1647355300,1647355528,228,3825
3935050862,3762505988,1647727611,1647728402,791,2876
3536207056,3917665332,1645432375,1645433177,802,212
3090419535,3059528600,1644861294,1644861539,245,2618
3151099767,3485784072,1665649240,1665649988,748,3487
3050236943,3201318851,1664018936,1664019841,905,3775
3113838615,3029449531,1656134731,1656135535,804,11
3956610796,3777536506,1664254535,1664254918,383,391
3160774676,3113217458,1664534542,1664535017,475,4087
3976219059,3046674011,1668947743,1668948308,565,4323
3507756800,3472180350,1659090165,1659090959,794,461
3695006595,3998378602,1654696959,1654697167,208,627
3954247188,3226859478,1653647527,1653647770,243,4942
3596186994,3284969246,1661556121,1661556544,423,662
3844553723,3701438403,1659639061,1659639093,32,4716
3709799297,3129342432,1648133537,1648134152,615,1274
3388215512,3591519606,1659352458,1659353222,764,4229
3090340714,3175718553,1650635613,1650635635,22,1043
3455635388,3835171103,1660677912,1660678186,274,2511
3862610792,3229364979,1664550404,1664551103,699,533
3871644658,3837507060,1643009370,1643010300,930,462
3604038280,3217193841,1652493862,1652494755,893,3512
3755197347,3996992062,1663974599,1663975108,509,2265
3298423987,3118272305,1661091706,1661092226,520,1787
3721447966,3908586910,1667803975,1667804029,54,3990
3664548282,3725172419,1664508628,1664508952,324,3380
3975417855,3950493829,1653724570,1653725254,684,4402
3900752901,3104423725,1667647327,1667648098,771,249
3239501796,3522376831,1646106593,1646107563,970,770
3115773994,3181423480,1665286153,1665286717,564,3300
3765882623,3510806848,1644433874,1644434269,395,4911
3380238708,3873296432,1645282569,1645282984,415,3330
3463768374,3942922503,1662845053,1662845064,11,4769
3386812913,3019681828,1644284789,1644285346,557,1617
3342576891,3011568912,1661048752,1661049638,886,2050
3749570638,3756137594,1664823800,1664823959,159,4458
3073970328,3252001420,1644496523,1644497218,695,2702
3984735996,3634258939,1649936217,1649937017,800,2017
3950652856,3307446731,1649773301,1649773306,5,3134
3024645793,3522666391,1642159646,1642160586,940,3821
3396274697,3313035858,1641165601,1641165727,126,894
3645221776,3051290679,1659298978,1659299750,772,928
3782160300,3123944988,1645121138,1645121369,231,3867
3966237259,3106019442,1659492840,1659493602,762,2144
3600168207,3588609345,1645163938,1645164370,432,2753
3123496925,3412854664,1646146421,1646146899,478,686
3612573355,3178103774,1652088751,1652089034,283,4336
3192646112,3255154952,1657767608,1657768139,531,2208
3029733488,3603818483,1661864245,1661864277,32,1592
3457477439,3265727268,1646270342,1646270931,589,4997
3349035289,3740370174,1666592555,1666592726,171,298
3690775142,3915669768,1645587183,1645587880,697,1778
3699199929,3956812697,1666747613,1666748256,643,833
3239064835,3408894282,1664873239,1664873830,591,4117
3334408386,3460048378,1660372600,1660372787,187,2587
3894073063,3665326424,1658702797,1658703216,419,4636
3332324540,3955373072,1642718387,1642718680,293,3653
3536445129,3568144820,1652111827,1652112282,455,769
3156305073,3116047077,1655939733,1655940295,562,4008
3821887104,3052346390,1649595448,1649595467,19,4016
3601643942,3426166893,1659657358,1659658313,955,1278
3455428499,3332623398,1654912841,1654912969,128,4571
3386763822,3692187561,1655646485,1655646937,452,3384
3584506700,3853303683,1654017187,1654017970,783,4722
3050160198,3318968924,1666476570,1666477196,626,2024
3334673596,3091070732,1648150294,1648151036,742,2002
3812564018,3469735976,1641853342,1641854027,685,2510
3988651887,3705003689,1654272096,1654272943,847,4589
3792990979,3300444007,1645961711,1645962707,996,567
3192904608,3443716398,1643407178,1643407800,622,3358
3598747892,3282078510,1656623488,1656624477,989,1952
3139649365,3848933895,1665191643,1665192456,813,1807
3634590277,3429257774,1661682108,1661682157,49,61
3216392709,3178024991,1665986597,1665987421,824,404
3407106603,3138314122,1641452786,1641453020,234,482
3379001682,3490110946,1656484927,1656485550,623,205
3212804676,3296399137,1651699997,1651700545,548,4138
3051264713,3324811335,1662202892,1662202971,79,4034
3029919540,3972430278,1659350300,1659351017,717,1983
3009162261,3690563134,1654607898,1654608647,749,912
3156257444,3739480229,1647153713,1647154510,797,2499
3934789530,3039284033,1647247582,1647247640,58,2837
3600795688,3184116134,1666308223,1666309182,959,3633
3499492668,3855966342,1664302257,1664302673,416,1370
3825690086,3552215090,1657185413,1657186031,618,1729
3229124250,3491414868,1648119208,1648119767,559,3455
3453658077,3899194214,1648241092,1648241610,518,2701
3699337429,3186268858,1658512448,1658512626,178,751
3026223483,3066040218,1655222589,1655222869,280,4805
3131035271,3461292482,1650654723,1650654875,152,90
3081731735,3334345493,1644400403,1644400983,580,3050
3691273121,3301405749,1641973232,1641973743,511,3239
3708580846,3420652063,1649965127,1649965172,45,369
3092057696,3834512672,1651757305,1651757477,172,3168
3189200685,3038309399,1641673042,1641673804,762,328
3917775939,3179090187,1657627857,1657628513,656,2101
3562747242,3626971994,1646295550,1646295817,267,2352
3700356372,3239680874,1642934930,1642935533,603,1683
3981532827,3915045705,1669648560,1669648744,184,2918
3292634561,3283353170,1660842075,1660843021,946,4575
3909194627,3721011848,1649944511,1649944996,485,2771
3587105776,3537542979,1645541497,1645541799,302,3611
3796671143,3516051808,1659325267,1659325437,170,3375
3076520458,3847651961,1658663122,1658663536,414,1427
3242602321,3505744465,1651918581,1651919474,893,614
3685516210,3298819096,1659384282,1659384626,344,1251
3257858781,3980531831,1644931823,1644932520,697,2653
3874397558,3349954860,1646040794,1646040948,154,2300
3998219466,3990082006,1658680243,1658680871,628,536
3470170846,3941634475,1647576368,1647577167,799,2654
3988715582,3896065782,1667522335,1667523012,677,2596
3075857494,3372713227,1658285314,1658285685,371,3892
3935950505,3309364169,1660449130,1660449354,224,535
3268109345,3273604163,1662565661,1662566060,399,2762
3475794661,3532159278,1667147308,1667148285,977,476
3856668464,3545453517,1649977813,1649977954,141,310
3868236794,3163844853,1650661591,1650661735,144,2049
3810749006,3460149905,1649048056,1649048580,524,720
3825863254,3776318629,1665587947,1665588818,871,4523
3696879922,3357050503,1643500422,1643501303,881,3537
3708552011,3052838322,1644322300,1644322360,60,1660
3882303568,3810582095,1666953004,1666953010,6,534
3846535743,3178745947,1644484817,1644484890,73,1765
3694228624,3742820233,1658651899,1658652509,610,239
3621648103,3001085596,1647968532,1647969139,607,144
3774570428,3903072857,1657289369,1657290297,928,2993
3151883848,3543682550,1650125391,1650126287,896,1728
3286585890,3912369164,1666436991,1666437647,656,1251
3308888076,3561078602,1654239613,1654239621,8,1156
3619870914,3726204700,1643087307,1643087478,171,1825
3574438693,3525916653,1651761620,1651762405,785,3870
3331932618,3188269626,1664248965,1664249140,175,4109
3777319869,3191305277,1659706103,1659706475,372,1715
3873867846,3517634638,1645176331,1645176765,434,3513
3108829048,3407511919,1668147673,1668147782,109,4665
3550377558,3061836568,1647952756,1647953550,794,4763
3566347863,3050356150,1667223438,1667223539,101,514
3318823671,3215223799,1647707817,1647708276,459,4270
3502105330,3229455656,1650989661,1650989758,97,2480
3088474577,3020999884,1644027148,1644027952,804,3116
3660219621,3385119431,1662903784,1662904116,332,1971
3451993687,3170252189,1655882679,1655883476,797,3587
3598605513,3027743532,1666308842,1666309471,629,100
3895078061,3333946793,1668000646,1668001409,763,3664
3039405794,3706734598,1645935184,1645936107,923,348
3230246449,3544990840,1669108310,1669108516,206,4670
3132748259,3064878006,1654498807,1654499041,234,3367
3950386227,3713403897,1657262903,1657263674,771,368
3081404363,3083478360,1666425683,1666425699,16,3865
3652897222,3871853963,1667575953,1667575974,21,2778
3445282020,3042659152,1643913023,1643913784,761,3629
3958354905,3775279307,1654915648,1654916332,684,2631
3063181840,3460410603,1661016126,1661016936,810,1086
3206887703,3848497698,1663187931,1663188022,91,3742
3508833415,3733378474,1651791590,1651792506,916,1225
3008460932,3444045492,1665970874,1665971795,921,3473
3772598144,3972035107,1650511635,1650512238,603,1757
3982971086,3415951886,1645572962,1645573746,784,2195
3346589925,3893328028,1652980162,1652980313,151,796
3656773787,3858299654,1664077683,1664078259,576,512
3122101055,3235693269,1665233374,1665233883,509,4066
3388949489,3226794082,1647857729,1647857998,269,1714
3816940023,3894907712,1657845150,1657845252,102,4596
3916466927,3115773994,1667201296,1667201782,486,1168
3568552839,3433916790,1666765245,1666765650,405,4794
3819743373,3901230705,1660076759,1660077421,662,2322
3561716136,3981532827,1667831409,1667832103,694,1917
3439246789,3707892690,1669149201,1669149884,683,272
3672023674,3162795665,1664597274,1664597800,526,2004
3226714052,3291777128,1659006251,1659006997,746,22
3719744703,3874904974,1662312591,1662312741,150,2883
3038112042,3238547661,1659292146,1659292148,2,555
3847486730,3803283084,1654611387,1654611787,400,2098
3473640542,3643194684,1666116824,1666117271,447,1473
3700853756,3075167890,1661059549,1661059629,80,3061
3698651666,3856712110,1656795051,1656795642,591,1100
3982279685,3712268706,1660261893,1660262149,256,3149
3964527707,3761677873,1646658681,1646659180,499,1596
3690519998,3807459597,1654874978,1654874990,12,1136
3672594078,3891941225,1654096820,1654096955,135,671
3363535982,3549740529,1649751307,1649751589,282,2220
3076106026,3628618606,1665645209,1665645650,441,3982
3474740872,3334083262,1650490726,1650490866,140,2638
3908550663,3741365642,1662391607,1662391673,66,995
3375594300,3171799255,1653121736,1653121852,116,3994
3287018465,3510255330,1665053376,1665053762,386,1355
3481841923,3919968816,1668435523,1668436327,804,3933
3708131511,3159770609,1642264932,1642265476,544,1564
3812160267,3535657799,1659153673,1659153891,218,969
3812756206,3463492382,1644649747,1644650617,870,1293
3666998580,3320661078,1663594361,1663594552,191,2754
3390634183,3902230106,1643879721,1643880066,345,1974
3032000672,3899906515,1641014206,1641014889,683,3440
3913449064,3861525624,1654345828,1654345882,54,4230
3531686574,3150319745,1645093840,1645094543,703,4599
3254478931,3654093421,1644986574,1644986852,278,4541
3741798198,3862344402,1643374683,1643375145,462,563
3937610547,3744463985,1669043607,1669044449,842,4776
3004457077,3265306517,1649685469,1649686104,635,1419
3884612775,3463676016,1662599896,1662600414,518,2036
3093032596,3547443390,1659080245,1659080413,168,1890
3131736423,3454758422,1661763243,1661763582,339,269
3095451107,3663226476,1645518772,1645519403,631,2168
3422936999,3880081874,1662896111,1662896579,468,3081
3591000902,3754976062,1651143229,1651143742,513,687
3569882153,3182442452,1665791684,1665792461,777,509
3125021256,3428313579,1646667184,1646667779,595,2319
3566917043,3958130699,1666657352,1666657850,498,190
3815260612,3813495717,1642542151,1642542349,198,3081
3401765089,3225113719,1646799270,1646799848,578,465
3849161886,3010977126,1659137805,1659138781,976,1419
3675722000,3542590777,1660562041,1660562756,715,4972
3948269802,3639554470,1662891789,1662892333,544,813
3355513557,3537548178,1657833812,1657834332,520,4335
3284907750,3244425037,1666137378,1666137623,245,4458
3011568912,3536148568,1647559689,1647560532,843,959
3730671580,3546130755,1642866651,1642867103,452,2155
3793022674,3640417757,1643701820,1643702615,795,1627
3366294510,3554419239,1659390741,1659390837,96,4891
3024722909,3308293770,1645533152,1645533278,126,752
3190781035,3943422037,1653756116,1653756183,67,4715
3887680478,3745872074,1658228321,1658228888,567,604
3684053978,3786012641,1642514085,1642514357,272,1905
3018355863,3323936277,1667310057,1667310690,633,4311
3768840160,3737466604,1655501020,1655501262,242,871
3145148947,3109251705,1652771780,1652772707,927,3470
3561716136,3193831045,1668808289,1668808560,271,4932
3224087943,3287180752,1641991309,1641991691,382,4207
3883981711,3284601199,1652897553,1652897926,373,2643
3982844590,3766085811,1666696827,1666697570,743,39
3717832148,3819071045,1657481356,1657481853,497,4278
3984429336,3093770014,1659359663,1659359746,83,4107
3750955741,3140360609,1643007644,1643007704,60,3670
3064649461,3167463673,1649560342,1649561033,691,3949
3896995734,3957360752,1641886492,1641887031,539,70
3148011697,3857944106,1665614812,1665615689,877,1466
3195537236,3346871016,1660377164,1660377269,105,4768
3150686272,3198764144,1659692925,1659693303,378,876
3649095941,3479142341,1659826793,1659826980,187,3520
3816159422,3932672220,1648362802,1648363384,582,3778
3786280541,3906062054,1645827462,1645827958,496,3935
3646207293,3667449499,1659343941,1659344145,204,2801
3205400013,3125262253,1659471903,1659472586,683,393
3782384656,3383461696,1645046883,1645046911,28,255
3378367540,3031185596,1645159628,1645160232,604,1767
3851931522,3590742950,1664407814,1664407906,92,617
3248709811,3613568895,1643974178,1643974627,449,2795
3424293617,3606806679,1663590863,1663590905,42,4539
3548108518,3488203693,1645593233,1645594125,892,3517
3143440799,3468791678,1655123195,1655123615,420,1317
3396035944,3197992573,1658554993,1658555350,357,2971
3949352991,3001157498,1667551080,1667551202,122,793
3145681221,3820371145,1669423913,1669424705,792,934
3702018501,3457014355,1668881521,1668882505,984,1968
3822016626,3057869538,1667163747,1667164409,662,458
3583347542,3138082936,1656300857,1656301390,533,2917
3005263192,3537311035,1643811369,1643811675,306,1578
3331932618,3207786773,1645515738,1645516464,726,3487
3184962964,3750449501,1648986123,1648986731,608,1665
3812437280,3046808325,1662211505,1662212331,826,3919
3216602476,3192093708,1658706580,1658707533,953,4875
3870360044,3739894940,1661503074,1661503642,568,676
3995846338,3965063643,1664714874,1664715184,310,4309
3702474722,3229142748,1641867059,1641867887,828,255
3467069934,3593581900,1667543624,1667543930,306,1680
3832823214,3277775141,1658388692,1658389130,438,3661
3882366544,3737483897,1644469878,1644470225,347,1271
3263421221,3990592495,1658429798,1658430301,503,4878
3092960475,3192686276,1668638602,1668639321,719,3724
3647887369,3378649936,1665480032,1665480910,878,2018
3665168223,3191060129,1643711455,1643711582,127,4373
3273068751,3981625126,1649927101,1649928098,997,2843
3485991524,3363196600,1663649160,1663649680,520,4498
3067430730,3067347321,1661785602,1661786290,688,108
3530372377,3932431859,1643209907,1643210863,956,4540
3566325124,3647051242,1647373682,1647373747,65,3963
3530679730,3050505990,1659245292,1659245928,636,2670
3947307232,3884178429,1660490649,1660491494,845,2838
3336476110,3939973541,1666173919,1666174047,128,471
3096627383,3712591581,1646391775,1646392219,444,2156
3483209738,3153745256,1658283790,1658284683,893,3614
3505232667,3479896194,1668987407,1668987808,401,3241
3794065130,3882190615,1662345271,1662346182,911,1326
3936126822,3793486857,1665500844,1665501024,180,4308
3444465558,3767801908,1659589560,1659589715,155,3859
3150497094,3919390212,1656277998,1656278605,607,1331
3956240928,3188116127,1642611329,1642611481,152,1053
3262875263,3845502495,1649662218,1649662706,488,1289
3864720349,3486556281,1654140132,1654141089,957,1333
3399625376,3112074695,1645379276,1645379571,295,1052
3210595182,3547754244,1653811078,1653812007,929,1199
3803498677,3297684419,1665209574,1665209715,141,4645
3247814954,3100118769,1648820684,1648820859,175,90
3295389556,3525734223,1661100582,1661101033,451,1851
3804202781,3049160548,1649259972,1649260340,368,3661
3923471509,3864710463,1660820195,1660821004,809,2221
3354039736,3414939886,1654076614,1654077023,409,1674
3051433636,3951517489,1667458205,1667458982,777,2977
3630608744,3252669232,1644838031,1644838680,649,2159
3280274983,3454119461,1647605022,1647605876,854,1429
3141595719,3851955847,1650912885,1650913299,414,801
3352150761,3205824335,1656020505,1656021427,922,2052
3326684216,3594259569,1666132680,1666133410,730,3886
3168316708,3355922883,1669625963,1669626114,151,4063
3747056610,3186469300,1646088531,1646089181,650,1421
3401691660,3475208643,1660970806,1660971005,199,3607
3648807536,3122553243,1659609045,1659610017,972,4183
3684099253,3704912494,1661669621,1661669634,13,10
3937773833,3792459970,1648540611,1648541256,645,2171
3710872212,3898701110,1660805948,1660806159,211,4055
3816615376,3051594212,1669497062,1669497473,411,4426
3305363873,3258052882,1663837922,1663838553,631,4473
3931811559,3927876134,1664302729,1664303117,388,4538
3459259804,3385404787,1658009543,1658009568,25,1705
3966625435,3663707951,1648651521,1648651714,193,2346
3452323681,3459782322,1642300599,1642301453,854,308
3182036897,3846757826,1641328785,1641329444,659,1021
3777604903,3513573127,1642030220,1642031002,782,851
3292122940,3353036293,1665093909,1665094595,686,1882
3388361348,3862935471,1648047656,1648047907,251,118
3940207508,3821001377,1664884273,1664884673,400,756
3241939295,3402745477,1642496930,1642497567,637,95
3039935326,3931498520,1663120669,1663120730,61,1164
3065535387,3823383883,1662811791,1662812307,516,2416
3014560293,3519907404,1652989877,1652990732,855,2176
3915408897,3129560799,1660147113,1660147179,66,4138
3253111859,3359406565,1642807344,1642808265,921,152
3642760527,3542775772,1664304230,1664304907,677,4041
3239215393,3210887436,1666144079,1666145021,942,2866
3969886898,3211668251,1663399489,1663399729,240,2607
3220196774,3503234779,1644050366,1644050437,71,1939
3054902934,3018057988,1668305338,1668305874,536,3353
3623855855,3822079026,1646692663,1646692864,201,772
3164231336,3954398382,1664954647,1664955257,610,3059
3315396791,3046304613,1659133934,1659134684,750,1301
3009429918,3712260848,1651611109,1651611837,728,4199
3765287897,3782350004,1665214889,1665215238,349,1050
3804109755,3389788801,1658018866,1658019771,905,525
3005116911,3253460222,1654948326,1654949235,909,1119
3828391675,3944806528,1648401545,1648402120,575,1682
3168866789,3342221270,1649435274,1649435656,382,2752
3642846053,3352241493,1665438617,1665438871,254,2747
3731754759,3061725222,1658277605,1658277998,393,258
3830820259,3033700545,1663969660,1663969825,165,541
3025396159,3605233671,1648724748,1648725681,933,3502
3982932130,3405614615,1657519801,1657520473,672,2646
3772410857,3639381647,1657995821,1657996570,749,3863
3489915737,3536753196,1653414599,1653415053,454,4926
3644454490,3952368713,1658865905,1658866778,873,655
3842631472,3799920505,1650268676,1650269430,754,2789
3543477470,3691354699,1666867538,1666868421,883,2553
3545969472,3813139457,1664503270,1664503548,278,1780
3511553519,3498523334,1650920468,1650921174,706,500
3555805918,3797753257,1655258999,1655259056,57,2854
3515286404,3464350775,1668814137,1668814389,252,4799
3525168702,3008147857,1656125238,1656125416,178,1098
3368440857,3214392484,1661309258,1661310199,941,2234
3513052388,3663885277,1644933004,1644933980,976,2402
3150714059,3076529508,1664020573,1664021072,499,1046
3715853939,3972260714,1666392841,1666392994,153,43
3036007273,3116497019,1661062921,1661063316,395,2108
3454615825,3875858558,1654224253,1654224520,267,3690
3458797243,3129505329,1647830951,1647831872,921,278
3139062875,3522923318,1652750464,1652750835,371,4371
3290715564,3954608232,1647545340,1647545803,463,2350
3724020595,3243501600,1665887287,1665887514,227,4459
3396626055,3754548494,1661475759,1661475943,184,1748
3619952832,3981792358,1646773674,1646774383,709,4876
3104352044,3909203826,1656863729,1656863801,72,1518
3911478597,3328683206,1644699536,1644700192,656,2745
3581621077,3270442624,1650823012,1650823456,444,2821
3708005969,3198274515,1662011369,1662011663,294,4893
3888730016,3929107243,1650936021,1650936221,200,4105
3238210575,3048309177,1656228243,1656229097,854,4998
3197921186,3490728980,1657985040,1657985487,447,1429
3467728419,3656020880,1661744487,1661745475,988,4250
3607377463,3469476929,1647850365,1647851350,985,1924
3059126552,3448917737,1659013549,1659014156,607,2561
3261814077,3466355480,1653194795,1653195773,978,1913
3840053058,3675087856,1665588709,1665589590,881,971
3543560177,3102427707,1666326703,1666326828,125,1806
3543418105,3493078632,1661943044,1661943977,933,1519
3769946319,3670619107,1650665580,1650665990,410,3359
3040601224,3073930327,1657864306,1657864755,449,1377
3173826061,3098492157,1657474860,1657475485,625,3665
3923947949,3720118896,1653417581,1653418030,449,2634
3438289889,3499833103,1661378593,1661379339,746,2721
3277422426,3040007859,1653122673,1653122851,178,4588
3987789767,3078178694,1644200283,1644200338,55,85
3537693096,3262865692,1661004405,1661004763,358,2363
3933013459,3742035558,1650977892,1650978781,889,3622
3382395472,3813229744,1649757107,1649757685,578,2582
3081232961,3282511104,1663445925,1663445940,15,2904
3868222660,3334494114,1652807842,1652808453,611,758
3015824464,3295323467,1649811730,1649811846,116,4880
3208612066,3121227933,1662019558,1662019813,255,644
3643754161,3927060411,1646728034,1646728679,645,1172
3104700409,3159026525,1661962983,1661963812,829,2768
3753907045,3522342751,1660322010,1660322722,712,3113
3814604714,3978391150,1651767962,1651768850,888,1310
3596934063,3772986397,1663976933,1663977584,651,2660
3456443244,3712362156,1643662082,1643662915,833,1121
3143917462,3861426342,1642465956,1642466707,751,4461
3018025528,3606660110,1647672830,1647672929,99,1546
3742467754,3305226431,1663634842,1663635368,526,4489
3739163015,3473401175,1642963946,1642964061,115,1117
3606185665,3330116312,1648259428,1648260003,575,363
3375720285,3460894804,1658169426,1658170169,743,4831
3209267394,3986049601,1646321498,1646321665,167,1677
3230395757,3082972508,1668262244,1668262293,49,817
3046217066,3342082286,1654878209,1654879191,982,44
3427863483,3654396530,1664693099,1664693119,20,1497
3155030748,3987860315,1657565331,1657565608,277,1670
3506792626,3815336609,1656928151,1656928836,685,1980
3924938858,3049152798,1642619029,1642619918,889,4072
3952414565,3859889478,1653134035,1653134937,902,4797
3269931107,3212640581,1665536284,1665536352,68,2301
3824899707,3979684577,1666246493,1666247325,832,310
3008806552,3148671085,1642802258,1642802488,230,2758
3106968034,3968727285,1654813937,1654814679,742,2646
3328338848,3002723533,1663167917,1663168154,237,1644
3751459539,3500530137,1665563974,1665564757,783,1716
3633846676,3073832455,1654570167,1654570949,782,4278
3302424480,3302444221,1667576869,1667577607,738,179
3116959185,3547201432,1664996219,1664997120,901,350
3505283603,3169723020,1646676816,1646676819,3,1227
3633135903,3813801628,1644274838,1644275041,203,3050
3611312347,3266610287,1647019171,1647020082,911,1943
3847919121,3915124657,1650009117,1650009391,274,729
3994254686,3681901996,1660646927,1660647896,969,2423
3232670700,3919433819,1668991561,1668991688,127,1307
3695606718,3765516323,1641069114,1641069121,7,4156
3977129552,3285003643,1658209353,1658210062,709,91
3038412000,3126128943,1654628480,1654629189,709,1609
3638157781,3675496230,1668699446,1668700416,970,3167
3101351397,3305597720,1651016690,1651017624,934,1057
3783938664,3183574339,1663116660,1663116812,152,1210
3458816944,3283308271,1644207261,1644207330,69,3871
3296241959,3038093158,1655336774,1655337509,735,3514
3297511844,3426757055,1652448528,1652448971,443,434
3671524070,3133702113,1656637423,1656637954,531,390
3079322291,3615196057,1644180841,1644181607,766,2982
3577148840,3089383168,1664926610,1664926983,373,2269
3191117315,3983877600,1667574121,1667574189,68,1952
3836121272,3501047961,1648459416,1648460173,757,1240
3289348068,3725521461,1653397561,1653398350,789,906
3917758350,3325940942,1650363687,1650363692,5,4570
3843005792,3997490683,1644200169,1644200492,323,3998
3782817054,3287705289,1648765701,1648766165,464,2619
3960664023,3867224569,1664660877,1664661497,620,3399
3983856989,3699180488,1654206214,1654206916,702,1424
3029836125,3517665442,1648716187,1648716742,555,4965
3933858594,3173216625,1653717668,1653718261,593,473
3993790765,3002420882,1646374657,1646375314,657,1258
3594558058,3648767464,1660613002,1660613437,435,2001
3404465674,3126006491,1649668050,1649668054,4,12
3314907278,3241416580,1650819097,1650819730,633,3738
3192953931,3720605483,1668939109,1668940103,994,3302
3150641954,3954223941,1666445864,1666446014,150,3038
3449871468,3657018367,1664459901,1664460075,174,3518
3620851600,3113340835,1652562542,1652563197,655,4901
3565169571,3503637879,1643180098,1643180340,242,3093
3017217226,3765082686,1651349181,1651349321,140,4518
3894475722,3182872240,1667333264,1667333283,19,582
3352929534,3471661113,1642342735,1642342831,96,947
3948117478,3058409923,1656956666,1656956697,31,2079
3782504089,3562431640,1658089033,1658089364,331,3613
3977685354,3940132984,1645001576,1645001814,238,781
3217494849,3400937895,1661497087,1661497356,269,126
3116757252,3001075073,1653143449,1653144244,795,569
3161008194,3086811693,1666304268,1666304753,485,1828
3096051337,3084345307,1642935804,1642936161,357,1599
3914168869,3312509021,1647765773,1647766333,560,3281
3232246411,3414397946,1642585496,1642586136,640,1711
3694204286,3178722816,1647871102,1647872027,925,4429
3039811023,3829464392,1664546853,1664547458,605,3624
3386314080,3921203892,1645123990,1645124568,578,3152
3042229072,3736513867,1644771849,1644772144,295,427
3744584880,3711945656,1657318639,1657319295,656,1807
3169600796,3790580970,1641137449,1641137491,42,3491
3244211976,3633580292,1667631055,1667631996,941,2519
3372411165,3937930456,1649846016,1649846420,404,2195
3391326737,3471828474,1661712585,1661712685,100,2474
3143275968,3611825017,1645488885,1645489591,706,998
3510805966,3455599305,1646184751,1646185332,581,2014
3767099948,3512377934,1658100549,1658100632,83,69
3992884378,3518694165,1641344874,1641345004,130,1533
3532668082,3818645956,1642217704,1642218600,896,3193
3908949773,3910495397,1653885456,1653885809,353,112
3470050507,3967919322,1652091327,1652091850,523,1703
3962872358,3450844912,1641434352,1641434645,293,4472
3313552634,3922894090,1663078370,1663078984,614,4351
3929634861,3183559932,1660968565,1660969421,856,4815
3538411696,3691829579,1663818586,1663819057,471,3867
3116449527,3129330020,1650988429,1650988939,510,3676
3427121928,3524213773,1641727398,1641728351,953,1064
3432393134,3370862246,1656636906,1656637226,320,4941
3899097958,3234102452,1656547400,1656547724,324,674
3135991542,3760564434,1656989237,1656989992,755,4905
3778753118,3882724868,1659377606,1659377791,185,789
3775466071,3526058988,1668206117,1668206563,446,2361
3024717832,3850590857,1659172936,1659173348,412,4114
3705712961,3576266252,1667699822,1667700315,493,4291
3136508714,3777918123,1644377957,1644378869,912,677
3757123328,3744198640,1642849672,1642849888,216,719
3675155111,3329452809,1654543449,1654543777,328,1243
3063671378,3025425301,1654112720,1654112993,273,4484
3496234708,3485835674,1642843346,1642844342,996,1962
3951851912,3824414363,1649820529,1649820781,252,2061
3077354623,3210252285,1653848547,1653848847,300,2492
3395819846,3755534319,1669648622,1669649616,994,2362
3249402757,3264088578,1641591187,1641591203,16,4165
3590070871,3192940082,1663593781,1663593797,16,227
3031346280,3511870396,1649796902,1649797818,916,137
3719738538,3794173201,1655172979,1655173255,276,4387
3100361551,3850740919,1659581418,1659582403,985,1080
3234014555,3737679622,1663600613,1663601565,952,4479
3405837869,3495911245,1645385649,1645386065,416,3108
3518052891,3487029921,1656036813,1656036813,0,936
3696804508,3927635493,1655950504,1655950927,423,3157
3319145837,3484584618,1668184432,1668185207,775,3015
3492476776,3278037780,1660035273,1660035731,458,905
3021998875,3837693619,1656678784,1656679054,270,3714
3388719941,3821179894,1660254743,1660255486,743,1337
3964719945,3597762499,1653705607,1653706325,718,100
3265450534,3015791973,1654960886,1654961664,778,3377
3810997849,3881462645,1652136088,1652136611,523,1513
3481569783,3037249427,1667063713,1667064244,531,875
3623291596,3553593733,1663919053,1663919706,653,2377
3860966663,3402844315,1660502344,1660502420,76,248
3368440857,3090926842,1649353472,1649354186,714,137
3162400749,3152991283,1665832355,1665833028,673,4983
3214993216,3925473274,1658602055,1658602724,669,3621
3167040863,3665662562,1662495331,1662495537,206,605
3660101266,3236119477,1645637378,1645638314,936,4559
3489865988,3669869834,1641250316,1641250637,321,2273
3419800403,3048654133,1664947874,1664948034,160,1905
3760653373,3760426318,1644510820,1644511703,883,1008
3825451940,3993245941,1664030839,1664031666,827,3929
3622734881,3925012422,1664195696,1664196380,684,4143
3843405102,3820785452,1658722764,1658722931,167,1182
3135546366,3108897247,1662744055,1662744257,202,4425
3894986717,3740585181,1663347077,1663347715,638,2393
3637931911,3512168745,1665739096,1665739386,290,3376
3749985314,3913882493,1667046560,1667046713,153,2287
3600763791,3467657951,1663114620,1663114693,73,2011
3533172543,3279021672,1666980579,1666981569,990,3080
3706069083,3818299853,1642782530,1642783141,611,2090
3330637808,3110998222,1644771429,1644771490,61,3814
3589605971,3142220298,1658368698,1658369509,811,1008
3816178288,3965538975,1662362637,1662362784,147,2254
3965191121,3256186793,1662246634,1662247174,540,4676
3432238853,3731552788,1648308954,1648309652,698,3165
3029046769,3298478126,1658485531,1658486001,470,4688
3100944277,3445166817,1651013766,1651014757,991,2371
3299899575,3493538644,1669591724,1669591826,102,4644
3821955972,3789931978,1666320585,1666320975,390,1722
3415093636,3942434125,1652641170,1652641727,557,3198
3062224491,3519150960,1664109301,1664109459,158,887
3253394715,3339078680,1644254437,1644254763,326,2183
3412365197,3502451251,1665463355,1665463543,188,3896
3095506888,3335545550,1647202396,1647203269,873,3540
3389170259,3761540585,1653857308,1653857569,261,3020
3590576073,3892400495,1643841469,1643842217,748,2124
3745033484,3018317361,1668857898,1668858729,831,3165
3221306657,3524393322,1662789259,1662790183,924,4615
3852899714,3387416053,1658567355,1658568192,837,2268
3473449139,3909980421,1669451395,1669451421,26,2042
3048288656,3243042691,1644119278,1644119915,637,590
3158827706,3463138016,1658463248,1658463698,450,852
3871537698,3409942946,1653590498,1653591308,810,2806
3013027104,3052051704,1660203129,1660204048,919,3417
3973446192,3456892460,1664850344,1664851272,928,70
3676997371,3555701956,1658738442,1658738886,444,4115
3206200891,3218097439,1641358423,1641359016,593,50
3107746785,3604246149,1644708178,1644708454,276,1285
3456634621,3353390990,1641049933,1641050135,202,3815
3595914220,3456137773,1646343018,1646343701,683,3564
3910020717,3481818231,1643042864,1643043825,961,51
3365121849,3707152329,1654574011,1654574570,559,96
3079885559,3701217340,1659738086,1659738693,607,2585
3735397187,3161208538,1666045009,1666045733,724,3799
3586448694,3280281103,1666410573,1666411014,441,1135
3770043109,3290532442,1666037101,1666038052,951,4429
3825981789,3544974591,1665814466,1665815177,711,3756
3940096418,3943268155,1659600688,1659600858,170,2295
3647675197,3611852237,1665388565,1665389001,436,4817
3621442920,3825338264,1650045995,1650046347,352,4774
3418226645,3868607437,1667339845,1667340436,591,1481
3067879877,3392627398,1647635323,1647635905,582,1881
3580829755,3232972981,1665974805,1665975742,937,740
3711374510,3140345396,1642197456,1642198417,961,1622
3956519171,3802767577,1669343037,1669343371,334,59
3276891362,3352042834,1657224258,1657224455,197,220
3328948660,3841445306,1647207045,1647207739,694,3906
3785062537,3107153278,1667315988,1667316685,697,1064
3131306549,3000925687,1645658502,1645658826,324,63
3013006013,3658960128,1668993090,1668993219,129,1503
3515147629,3306518255,1651876762,1651877475,713,1922
3912052282,3818298270,1657834396,1657835272,876,2585
3363029929,3354847772,1648535393,1648535647,254,4044
3651902251,3080030101,1644600055,1644601048,993,4663
3799514414,3192093708,1653199931,1653200890,959,4127
3131589749,3794152131,1651291535,1651292340,805,1951
3619676084,3716314758,1653442697,1653442771,74,82
3586605391,3867681089,1645046511,1645046954,443,598
3496545354,3175588248,1654114720,1654115504,784,3138
3697484665,3954580082,1668485489,1668486370,881,2127
3163957679,3556933533,1657646122,1657646649,527,1205
3972455974,3281729274,1641826924,1641827114,190,3739
3673047047,3382403228,1648246384,1648246996,612,2341
3976523582,3337267516,1649339736,1649340630,894,1982
3725090032,3268109345,1648727390,1648727616,226,2995
3877063575,3976072626,1653506030,1653506628,598,3356
3975367930,3406501366,1669299236,1669299818,582,2230
3222951083,3070967277,1658035757,1658035931,174,2988
3011049810,3646742954,1654519214,1654519577,363,1878
3359253224,3002805231,1646446745,1646447677,932,4549
3032802420,3610447370,1660957033,1660957928,895,53
3908368394,3908985615,1663452259,1663452871,612,3232
3072926579,3915876422,1661734050,1661734402,352,1309
3792804777,3209760839,1655377668,1655378101,433,249
3326956944,3902289612,1663868095,1663868923,828,360
3920309309,3520440297,1647982218,1647982904,686,1551
3941172694,3020435478,1669041728,1669041838,110,612
3732724214,3699048285,1653640343,1653641052,709,566
3839893383,3716692984,1662900031,1662900762,731,4320
3539340706,3266643576,1645489791,1645490334,543,1287
3602888885,3776124879,1663059459,1663060320,861,168
3210529479,3969687892,1654816662,1654817500,838,2074
3042027114,3908895524,1658912187,1658912686,499,269
3326406813,3298694762,1668867558,1668868013,455,1580
3575570501,3805057575,1641862325,1641863041,716,584
3957329538,3455006869,1649990660,1649991137,477,2852
3509097708,3773489568,1645473206,1645473368,162,1181
3242974213,3942292192,1652463287,1652463912,625,126
3916154318,3006038199,1667422377,1667423191,814,1592
3699527212,3202676928,1656347430,1656348030,600,2587
3963142788,3755944217,1652987727,1652987914,187,4721
3989684052,3681634487,1649082007,1649082224,217,2003
3842467008,3012788238,1652447755,1652448655,900,2517
3743184089,3158893741,1644106855,1644107222,367,1004
3977710794,3303087411,1665810480,1665810816,336,3264
3873762820,3290428693,1665757920,1665758204,284,1340
3483557037,3740876027,1646643128,1646643477,349,2303
3739494651,3924467261,1669112771,1669113567,796,3183
3349668153,3997294727,1668673784,1668674400,616,3065
3054147970,3844448627,1658948132,1658949109,977,4889
3364312276,3698200596,1650276553,1650276962,409,2182
3833138475,3927097898,1664326123,1664326614,491,2940
3924187233,3491609352,1653011123,1653011882,759,528
3860053200,3042478717,1650398465,1650398559,94,2453
3174815013,3149586040,1642271844,1642271954,110,3882
3815159462,3210074791,1652616978,1652617178,200,3586
3113530535,3374470608,1654608455,1654609394,939,2702
3326787987,3970564254,1660460190,1660460743,553,3863
3228017397,3834044089,1646340333,1646341329,996,797
3812282075,3902981010,1643901135,1643901145,10,1094
3401961082,3309682303,1641807507,1641808414,907,2601
3014462229,3295413206,1668637126,1668637509,383,3575
3107802207,3850908860,1646018654,1646019314,660,1236
3083745988,3780800250,1668631247,1668631587,340,3621
3929591839,3453737054,1654126090,1654126612,522,1776
3169622730,3209853461,1649612860,1649613143,283,3268
3233823514,3000102465,1645872395,1645872402,7,998
3134418289,3259499601,1652131152,1652132086,934,4310
3229596131,3646720656,1668896493,1668896946,453,325
3979937136,3066689392,1651470315,1651470548,233,4018
3647051242,3255291487,1655804391,1655805290,899,3712
3745325962,3501172852,1647302656,1647303317,661,3893
3226794082,3054202055,1664664572,1664665245,673,1485
3415360508,3398991700,1662387326,1662388064,738,2750
3946934488,3377619743,1652035547,1652035694,147,899
3298949166,3575421258,1648214680,1648214753,73,898
3239747205,3569613825,1657341393,1657341986,593,388
3702333432,3219076921,1646296481,1646297290,809,3183
3658602347,3757826873,1645728436,1645728893,457,3697
3083729930,3053152879,1650135421,1650135880,459,4252
3775087692,3446679239,1643992041,1643992588,547,1201
3619091527,3100739835,1663938315,1663939115,800,719
3616666797,3160635060,1643309524,1643310244,720,850
3216368367,3025082174,1658336669,1658337555,886,411
3544120463,3790506191,1659494999,1659495345,346,13
3178841143,3950486990,1657046881,1657047830,949,4009
3583798742,3250949456,1652162824,1652163391,567,3978
3127892919,3840596443,1667778474,1667779463,989,2091
3186158860,3625990996,1651023771,1651023947,176,900
3107803116,3418645821,1661391324,1661391662,338,2403
3559459027,3905896509,1648574423,1648575067,644,3665
3450761842,3093269643,1652379994,1652380447,453,2497
3556393500,3741108931,1641257071,1641257637,566,3613
3116475980,3758149388,1663810053,1663810239,186,735
3535422966,3764805154,1655472271,1655472788,517,4983
3003419032,3873282728,1661000524,1661001163,639,3848
3482209872,3210418313,1648461489,1648462090,601,3876
3230101345,3367116731,1643706513,1643707185,672,2244
3228326528,3483659830,1656725047,1656725550,503,4535
3323959263,3573920915,1665570371,1665570763,392,3997
3545865232,3971510742,1644906120,1644906446,326,4094
3160459213,3567767488,1665345792,1665346364,572,4332
3948275902,3927578314,1665273224,1665273370,146,4685
3442638507,3220861766,1668932184,1668932810,626,253
3595846893,3761942678,1661515268,1661516094,826,3058
3923792525,3870890024,1659867973,1659868525,552,2392
3860308393,3799193231,1667721104,1667721804,700,3904
3861687751,3616855034,1646133735,1646133958,223,1925
3549889756,3592225172,1665870794,1665871564,770,1012
3254782349,3795372299,1667897792,1667898222,430,2467
3092083161,3833690085,1650088176,1650088202,26,1212
3847738086,3974919378,1660316277,1660316661,384,2647
3268398070,3962127810,1661315680,1661316058,378,3798
3909548432,3607313116,1665672037,1665672414,377,210
3876485130,3365368359,1647786905,1647787605,700,2320
3931857286,3920021634,1666718729,1666719330,601,849
3139510419,3848228030,1652133507,1652134165,658,3120
3226535948,3009049638,1665147473,1665147511,38,4140
3078482207,3305746465,1665309327,1665310259,932,3351
3012767474,3046411910,1661783295,1661783790,495,795
3916473004,3809998825,1659679256,1659679401,145,282
3502786578,3148064291,1665188402,1665188653,251,1441
3676665827,3827510898,1644178666,1644178966,300,1016
3097703049,3189014586,1645006385,1645006527,142,3932
3662353729,3263218216,1652818328,1652818565,237,2105
3245923467,3848353945,1644282847,1644283613,766,2322
3412017760,3634257381,1655443626,1655444257,631,3712
3262242535,3171392976,1662897344,1662897476,132,1590
3983004596,3166527652,1645078219,1645078620,401,1012
3612253649,3227775736,1652837864,1652837997,133,1058
3295985552,3682433910,1664539845,1664540598,753,1155
3004161027,3467952218,1646704220,1646704431,211,1361
3851653050,3328903014,1665612337,1665612784,447,3420
3826531028,3378118734,1644735127,1644735970,843,4404
3552529547,3126640674,1665116303,1665117239,936,3602
3086932269,3603311729,1662757082,1662757771,689,1588
3489907788,3407777138,1641682997,1641683081,84,3981
3166924488,3648121828,1661211779,1661211900,121,4399
3650228111,3885430338,1643095862,1643096765,903,4348
3560053298,3500385932,1649347816,1649347945,129,4229
3834975555,3288745618,1650807953,1650808170,217,1467
3775918729,3682555022,1663703017,1663703622,605,4796
3801911078,3405489919,1653830795,1653831406,611,3706
3013718466,3931094868,1659211715,1659211992,277,2343
3674493357,3966363165,1647652062,1647652481,419,3880
3927735001,3262446212,1668420821,1668421290,469,2516
3988464363,3485981189,1660119381,1660120014,633,2062
3448666743,3398927661,1668904111,1668905109,998,1999
3656020880,3604903336,1648030486,1648030706,220,1878
3611120750,3922061663,1659404016,1659404938,922,2593
3991755067,3913523927,1654935123,1654935638,515,3412
3985928619,3633294625,1665932324,1665933316,992,4829
3975359449,3115961891,1649200637,1649201091,454,4612
3517546674,3529324741,1669365740,1669366127,387,4083
3335773381,3930256140,1648460159,1648460368,209,871
3081681657,3869029900,1654089771,1654090478,707,3170
3288795848,3480420704,1654632348,1654632847,499,3212
3418576227,3599756363,1649631312,1649632063,751,3146
3022860933,3757774602,1667949588,1667950349,761,1638
3572010500,3699798917,1662611605,1662612172,567,78
3347256765,3575020310,1660743525,1660743683,158,961
3938439427,3538231010,1664459194,1664459226,32,3324
3601742693,3109356561,1645167091,1645167824,733,3102
3431082675,3139283601,1664193185,1664193706,521,1200
3659177703,3502371910,1664828481,1664828989,508,4703
3803964033,3224958361,1643916614,1643917570,956,2260
3834797844,3456214568,1644710700,1644710767,67,3963
3252481275,3036232702,1643698316,1643699111,795,346
3442257567,3305537199,1657077092,1657078092,1000,2994
3249647537,3306347988,1641181072,1641181359,287,2038
3083248586,3045949359,1668174789,1668175493,704,4801
3881318465,3788251401,1654899270,1654899495,225,370
3016087301,3535144822,1661991073,1661991506,433,3958
3495271594,3483830775,1661909472,1661910195,723,4278
3184132862,3610873697,1669231291,1669231819,528,4749
3523822220,3966273642,1663121893,1663122269,376,2202
3391948742,3375115109,1667084894,1667085367,473,1968
3551360008,3302230972,1656441175,1656441453,278,4212
3666980695,3720773089,1657442191,1657442611,420,1627
3987826829,3946360718,1662324157,1662325013,856,2862
3869317983,3587477732,1652311171,1652311965,794,3821
3060580707,3095330916,1661432767,1661433692,925,1438
3974533714,3649832615,1647211659,1647212425,766,748
3227657037,3371995273,1662731452,1662731900,448,2959
3015435710,3143539977,1655368557,1655369277,720,4775
3450872715,3590466989,1660025751,1660026515,764,2903
3717860376,3290045995,1645504822,1645504903,81,3852
3240891874,3016017028,1661061222,1661061483,261,4562
3375606115,3621725866,1660544686,1660545167,481,2831
3366789421,3229430457,1656260542,1656261521,979,1030
3550978062,3989118177,1659743359,1659743624,265,3313
3146738480,3201007612,1641620897,1641621885,988,1772
3311412976,3696320241,1657558780,1657559388,608,2350
3082012385,3086160273,1661533829,1661534220,391,3696
3141025704,3239066667,1642126324,1642127134,810,609
3231829906,3396142431,1655289873,1655290446,573,1658
3527957989,3774364120,1654443491,1654443880,389,1428
3726204700,3727703451,1666404426,1666404567,141,4023
3596436822,3247240796,1660411235,1660411697,462,158
3276575967,3981532827,1667664306,1667665047,741,267
3429663906,3022503989,1647583023,1647583862,839,859
3499099173,3388025437,1652597813,1652598538,725,1261
3941499193,3913122687,1657989993,1657990318,325,1188
3929358431,3245991824,1642901166,1642901666,500,116
3136241156,3034545528,1651934443,1651935284,841,4605
3426699603,3865658114,1660117918,1660118158,240,1652
3044627779,3246908597,1644344227,1644344622,395,1167
3745442239,3710564988,1646445081,1646445527,446,543
3573926067,3457314189,1666092179,1666093109,930,1185
3576133666,3090275913,1656924306,1656925183,877,4944
3324482730,3253597716,1664691338,1664691878,540,1061
3491235215,3211851139,1669260772,1669261444,672,1515
3664236758,3556812007,1656781760,1656782725,965,4919
3976121640,3451745498,1640998769,1640999334,565,4360
3374556086,3175960289,1660546196,1660546786,590,1771
3272861105,3207407456,1666053356,1666054110,754,106
3997969302,3452470627,1652546931,1652547439,508,4251
3717318581,3365592488,1648903488,1648904184,696,4357
3159248836,3838097046,1663903367,1663904233,866,2338
3702034599,3051496685,1642947968,1642948851,883,4367
3252562518,3867954657,1645869067,1645869665,598,988
3003232305,3261716009,1659648820,1659649106,286,1728
3654628740,3427245484,1661882591,1661882751,160,3589
3327679743,3760237881,1648999454,1648999744,290,751
3063132100,3393585417,1654238695,1654238887,192,4000
3242224074,3505383110,1646476928,1646476931,3,1380
3868295160,3681716912,1660762860,1660763417,557,4782
3494436413,3274942807,1651702645,1651702654,9,1337
3203039624,3209426213,1664202104,1664202887,783,3301
3372682102,3892031390,1648804597,1648805230,633,4369
3642743346,3186698482,1661307733,1661307836,103,1427
3435311775,3133896811,1648975936,1648976294,358,1803
3566248080,3875282971,1667520716,1667521593,877,4741
3950369089,3856040759,1654347403,1654348179,776,1039
3635975140,3791517436,1644384693,1644384837,144,2212
3513560608,3787310538,1650275522,1650276039,517,4988
3522227067,3216559645,1644260863,1644261203,340,3705
3354847772,3872004169,1663026729,1663027545,816,4332
3283118509,3352863463,1659877641,1659878027,386,412
3154971929,3375539352,1666649632,1666650202,570,2109
3655253023,3914359359,1668291888,1668292254,366,3245
3983115440,3498932553,1641768754,1641768875,121,4224
3453175125,3328013928,1655046210,1655046542,332,4780
3401853535,3041916133,1665031496,1665031729,233,263
3044737088,3180820900,1651685605,1651685991,386,2042
3073601284,3596022284,1650691303,1650691726,423,3834
3484735079,3060736594,1660608704,1660609191,487,1048
3707914646,3714711187,1661092544,1661093018,474,200
3976242306,3397696507,1652351753,1652352007,254,1445
3880976226,3310604828,1654622759,1654623551,792,4531
3038269258,3840782718,1658826671,1658827252,581,909
3510111813,3826933863,1668518574,1668519191,617,2552
3288605716,3807112510,1646567629,1646568088,459,1991
3428559272,3115032059,1668987581,1668988157,576,2649
3323912761,3298949166,1645321654,1645322213,559,996
3237112108,3987076996,1643323580,1643324420,840,3597
3298803674,3304817049,1654744143,1654744874,731,3279
3481506427,3493746102,1657426582,1657427087,505,1938
3008726193,3586402106,1651427913,1651428038,125,1797
3508960129,3869518810,1648723935,1648724893,958,3858
3916916989,3916398306,1644739427,1644740078,651,996
3338323573,3488447152,1654816914,1654816924,10,2117
3331689492,3380200821,1646954669,1646955444,775,497
3920050226,3369599484,1654022684,1654022811,127,2605
3224862129,3641934666,1643595448,1643595653,205,1050
3015211734,3844357792,1669445075,1669445216,141,3221
3749443033,3580489205,1663465600,1663466313,713,4327
3284051454,3513612396,1659193054,1659193860,806,2954
3639861279,3535644174,1654767331,1654767670,339,558
3873128142,3720102388,1654951595,1654951979,384,2348
3215022028,3824258532,1655824825,1655825644,819,3074
3042478717,3526976222,1663768022,1663768098,76,4460
3159491932,3977956049,1664986684,1664987115,431,1491
3251627617,3567601107,1652298130,1652298484,354,1355
3814444418,3262211531,1668276853,1668277610,757,1701
3735164696,3526992807,1655979314,1655979708,394,4283
3457075278,3841710196,1656376478,1656376673,195,2066
3404716614,3399526903,1648974144,1648975095,951,68
3142220298,3134117884,1656196811,1656197081,270,3680
3283583297,3826738410,1661577304,1661577899,595,2085
3577921646,3890605394,1658565078,1658565221,143,3902
3236851371,3118240482,1644452003,1644452106,103,3961
3838794054,3508777247,1647236144,1647236740,596,665
3897810436,3809852017,1666987891,1666988209,318,2586
3469457996,3356987907,1649999348,1649999762,414,3238
3683363254,3276927185,1656179458,1656179945,487,513
3770987683,3730623189,1659401681,1659402187,506,4447
3299465069,3672259370,1664654556,1664655411,855,1906
3654173215,3035321443,1646822569,1646822648,79,1899
3103569177,3614102415,1665669362,1665669451,89,510
3158305444,3206066459,1644477977,1644478195,218,4910
3453702104,3013550814,1643628621,1643629345,724,4362
3997045457,3003853057,1653986125,1653987107,982,4820
3956259369,3665006130,1667023829,1667024778,949,4994
3892279920,3670284324,1648418912,1648419900,988,1625
3650424881,3114291532,1668061601,1668062307,706,2252
3978013915,3547340231,1669156568,1669157356,788,3080
3263192446,3126322810,1647995275,1647996187,912,4010
3664032860,3144619802,1660820721,1660820784,63,774
3632925691,3589042741,1660861700,1660861937,237,3598
3395386253,3659177703,1645234456,1645234670,214,2340
3558043174,3458508329,1654185025,1654185107,82,1771
3236094329,3393271165,1645207748,1645208343,595,3106
3304593109,3633347872,1664663050,1664663189,139,4248
3664063011,3956628387,1641667734,1641668070,336,2532
3629253050,3151014941,1653911932,1653912551,619,1862
3816901988,3436030950,1661255625,1661255747,122,526
3660342336,3096924923,1660172217,1660173197,980,1713
3865305265,3110449509,1667491341,1667491796,455,963
3819979042,3833712936,1658758077,1658758235,158,2434
3966069408,3847592710,1653766616,1653767034,418,4999
3128490872,3838460046,1663672599,1663673547,948,4020
3847325289,3590057826,1667679035,1667679464,429,4225
3085555882,3307347405,1667494744,1667495188,444,3932
3917154611,3791827174,1666223151,1666223414,263,2870
3097714374,3530456755,1647256167,1647256406,239,2831
3843382501,3011417311,1656205919,1656206528,609,3583
3664935160,3346223902,1668652419,1668652897,478,1681
3041044568,3980237957,1646200806,1646201228,422,4066
3801281858,3859294959,1641289490,1641289677,187,1686
3812655084,3464308676,1649390756,1649391192,436,1609
3115063700,3493129870,1651285375,1651285962,587,171
3626572049,3596102449,1643467418,1643467571,153,3590
3915025105,3460590716,1664718290,1664719062,772,1177
3485412072,3152512199,1641453414,1641453632,218,3682
3465116884,3867063758,1644527027,1644527741,714,1577
3650203392,3349445535,1662105695,1662105848,153,1918
3074160219,3694653249,1641360297,1641360386,89,3970
3696607703,3187540904,1646001162,1646002060,898,4373
3352213139,3107109814,1666392843,1666393612,769,3821
3329100905,3410731237,1642248979,1642249778,799,734
3765997611,3319594263,1668788155,1668788432,277,1806
3039865830,3805439776,1646512350,1646513216,866,1763
3637891254,3076328172,1642180168,1642180906,738,3898
3661962172,3210393970,1664769650,1664770564,914,1110
3765012932,3728657052,1642005888,1642006435,547,1484
3885184211,3736734629,1667003872,1667004803,931,1768
3787094801,3262852335,1648963136,1648963158,22,2920
3499834585,3803012970,1645837113,1645837310,197,2880
3315594017,3548585665,1649590695,1649591603,908,3383
3498564286,3939230779,1662894691,1662894815,124,4843
3246871614,3077747785,1650648293,1650648790,497,1675
3517191987,3155886814,1642505553,1642506382,829,899
3305171195,3909810189,1668382062,1668382419,357,1091
3046942895,3994740725,1653887510,1653888021,511,2442
3088775121,3828315089,1659423944,1659424330,386,2292
3653725635,3603602724,1642341107,1642341948,841,2333
3595093174,3854871937,1648883145,1648883195,50,1662
3960827729,3181993766,1650201815,1650202350,535,467
3037033947,3189923807,1657027476,1657027952,476,1853
3442932136,3862512829,1653678071,1653678208,137,4511
3749956314,3214785753,1642374283,1642374832,549,3968
3196952600,3189155664,1642569390,1642569586,196,4972
3951274797,3667250435,1669110104,1669110377,273,2469
3122112936,3585964946,1647769818,1647770093,275,3826
3511565609,3386343150,1660059003,1660059023,20,147
3330356908,3767257443,1651539771,1651540263,492,569
3830094065,3411344753,1644481516,1644482175,659,1041
3643084011,3573465049,1655991645,1655991828,183,786
3469309491,3628403283,1656892080,1656892572,492,637
3523338586,3212862420,1661524844,1661524929,85,2104
3150197800,3003658910,1660418996,1660419563,567,447
3286654026,3093043774,1644425199,1644425678,479,3009
3556532355,3177606597,1669458746,1669459266,520,930
3722282138,3440017580,1653359279,1653359486,207,3444
3250047843,3343564370,1654501044,1654501216,172,506
3051843291,3518204475,1650166175,1650166382,207,2228
3526196294,3174455400,1657232827,1657232943,116,611
3042752178,3378642380,1655766362,1655766817,455,590
3836602999,3513252712,1656179408,1656179695,287,3745
3198362200,3007975780,1656919176,1656919350,174,466
3120430232,3759404275,1654214426,1654214603,177,380
3344413352,3711777375,1658133003,1658133417,414,3417
3414583942,3488572322,1663806631,1663807099,468,4651
3529163833,3830746181,1661791490,1661791996,506,3891
3909675918,3407296246,1649408640,1649408920,280,1510
3143623263,3743117885,1647210688,1647211007,319,3886
3284514944,3326818460,1655558701,1655559487,786,3276
3289884968,3740720488,1662142116,1662142319,203,844
3616956775,3274725300,1661295333,1661295572,239,3108
3488275090,3485303427,1660884161,1660884918,757,4213
3069947051,3140026586,1658538676,1658538987,311,3500
3676313462,3826455983,1650340804,1650341648,844,890
3170640738,3662608273,1643614914,1643615828,914,91
3137768967,3324588921,1652821035,1652821380,345,4788
3355224540,3125167318,1664754647,1664755644,997,1040
3229067953,3919633260,1668860016,1668860245,229,4143
3672484387,3136370358,1658891400,1658891609,209,2481
3441382702,3735340596,1646414624,1646415622,998,2026
3063657814,3866845982,1641395102,1641396025,923,3795
3793883543,3433102857,1643325013,1643325169,156,4489
3965217033,3030032975,1649176149,1649176976,827,4634
3136020953,3453377840,1649252741,1649253465,724,4867
3468982754,3529895878,1648935600,1648935680,80,2460
3589648747,3275274781,1665540727,1665541300,573,2548
3462431155,3331060866,1666768604,1666769357,753,2713
3516052281,3972745481,1667277096,1667277681,585,4638
3881572788,3238244410,1662362279,1662362917,638,1019
3806760239,3996013835,1669248593,1669248738,145,1632
3885538365,3234316661,1648456110,1648456865,755,126
3002862387,3582964352,1658020734,1658021231,497,4439
3524160297,3713403897,1654618641,1654619156,515,78
3716897812,3370853759,1646324492,1646324732,240,3776
3216059009,3331415994,1654174621,1654174918,297,4634
3579416113,3492242927,1647001370,1647001855,485,896
3560971202,3830134955,1643430270,1643430896,626,1226
3229756286,3438453139,1641010670,1641011532,862,4420
3437612203,3821426642,1660121644,1660121815,171,3361
3179193980,3864237936,1665779988,1665780076,88,1147
3019749515,3025021411,1666963415,1666963516,101,2881
3128186198,3965611013,1645750800,1645751204,404,1614
3802903206,3177547285,1654932524,1654932811,287,3732
3229364979,3197481268,1649838852,1649839043,191,2142
3180339550,3188141177,1660030618,1660030800,182,2895
3837788684,3368826152,1655418542,1655418603,61,4949
3912806464,3079325992,1648773167,1648773370,203,2239
3069252539,3962323250,1668224341,1668225076,735,4195
3993277582,3409807976,1664533796,1664533976,180,3721
3969121357,3276449250,1648851914,1648852852,938,3482
3480948439,3209296702,1646511260,1646511314,54,4411
3037104344,3045213352,1660063495,1660064321,826,2773
3188970714,3024949982,1649563571,1649563751,180,2437
3774555685,3197397294,1653155093,1653155742,649,4872
3974157233,3056555207,1644893506,1644893682,176,2823
3320957902,3955189980,1652815636,1652816312,676,1514
3920782047,3478797452,1658586519,1658587286,767,3395
3897980201,3592311442,1664118049,1664118736,687,1861
3909741748,3880070541,1653673108,1653674095,987,4880
3983649544,3227217993,1653252377,1653253063,686,3888
3838849141,3169080417,1661496374,1661497273,899,2829
3337240952,3321073779,1642901766,1642902120,354,2900
3806942021,3675408809,1660837507,1660837667,160,2991
3319617947,3052797328,1649593011,1649593231,220,1635
3211037992,3602809678,1660343270,1660343990,720,3854
3562472461,3056859634,1651154797,1651155119,322,1536
3355130092,3737679622,1657630922,1657631502,580,2307
3097273143,3100517542,1644873040,1644873180,140,3202
3977186146,3178184514,1657162262,1657162837,575,3294
3256759947,3598700168,1645845124,1645845221,97,3672
3893223973,3079007172,1667945621,1667945781,160,3250
3422820405,3973429240,1658976022,1658976605,583,3209
3316655437,3042414332,1665274294,1665274730,436,1111
3831772210,3647061212,1648114733,1648115540,807,3886
3278896829,3068247893,1664682459,1664682695,236,4148
3995506991,3744338954,1650286952,1650287139,187,4291
3877545434,3931368985,1651269277,1651270089,812,815
3861260392,3924998236,1665022207,1665022304,97,4635
3314682595,3245105159,1652956529,1652957120,591,2893
3780833795,3243328196,1657019558,1657020026,468,535
3137209094,3339180649,1650650135,1650650369,234,2541
3942615548,3176038104,1664804437,1664805063,626,4224
3393883540,3463464777,1649731943,1649732592,649,1328
3650916265,3744291640,1654108815,1654109619,804,1137
3412217251,3850418205,1653887878,1653888133,255,3710
3704179402,3040612176,1644389591,1644389610,19,33
3455759857,3528834046,1657379365,1657379921,556,2853
3448924838,3300806899,1664859418,1664859748,330,3315
3874460014,3402208654,1653555248,1653555293,45,1000
3958235055,3854948737,1648079941,1648080303,362,1769
3854931023,3621839560,1643709721,1643710675,954,806
3087133874,3550638414,1660836603,1660837211,608,2654
3876749440,3160551319,1668665623,1668665689,66,4331
3331073841,3045864022,1641074391,1641074794,403,1728
3316139038,3123963536,1644302664,1644302949,285,2273
3780723389,3263300881,1653733393,1653734151,758,1053
3209395646,3938323174,1661146623,1661146630,7,192
3390878359,3540327709,1652332004,1652332825,821,3658
3089603921,3662156305,1647355192,1647355982,790,1075
3191661981,3341829631,1645254115,1645254245,130,4081
3680530283,3991009919,1641059203,1641059530,327,198
3670720370,3138464444,1655711282,1655711984,702,3436
3961827451,3271672036,1655060413,1655061093,680,3755
3238613484,3740870870,1656915948,1656916428,480,90
3163007220,3201256220,1651679636,1651680050,414,853
3079363745,3850454852,1647988268,1647989189,921,4096
3622146009,3957648139,1668776291,1668776622,331,1706
3009718244,3538651527,1662555384,1662555606,222,2082
3817300038,3916975217,1666732596,1666733493,897,2243
3005539348,3432794287,1657701092,1657701697,605,3837
3913352000,3545426065,1651230281,1651230430,149,2464
3157894477,3079277099,1643197855,1643198530,675,3561
3796679889,3598035325,1652678137,1652678880,743,388
3304137286,3159725992,1665777226,1665777597,371,3938
3426846138,3088452852,1659470337,1659470473,136,1931
3273092540,3371110397,1668601662,1668601736,74,1318
3164682884,3384394447,1652833689,1652834007,318,4311
3532165586,3670513415,1651782111,1651783024,913,135
3035008597,3515923017,1660465414,1660465592,178,3113
3436652775,3248999525,1650890196,1650891154,958,418
3115056713,3443204407,1664246810,1664247755,945,1734
3161689756,3132679349,1641182462,1641183154,692,3370
3218047844,3920813221,1659696561,1659697174,613,4410
3893390038,3818298270,1664569944,1664570834,890,2101
3540527941,3552688686,1659071910,1659072689,779,338
3595507532,3550684200,1650296545,1650296815,270,1003
3209956253,3535537980,1654355868,1654356533,665,4158
3581179208,3670540118,1644498692,1644498961,269,4182
3671505076,3850522735,1652247858,1652248620,762,1684
3784211106,3079947948,1654684773,1654685644,871,1513
3635593334,3346650281,1655367205,1655367683,478,2162
3425737518,3178570861,1669003145,1669003495,350,440
3625530640,3130084610,1642935070,1642935516,446,2879
3655337664,3395141161,1647133785,1647134528,743,2739
3836741786,3301647042,1665257922,1665258847,925,2217
3642883980,3834872370,1644473868,1644474498,630,504
3487366263,3636477922,1641314688,1641315340,652,3442
3091983099,3209407721,1643963043,1643963219,176,240
3168468366,3664704079,1654150737,1654150786,49,2530
3434438732,3554239752,1644045025,1644045384,359,1758
3241539858,3979880557,1641320991,1641321091,100,4577
3237702739,3180339550,1650078103,1650078400,297,1541
3397084028,3864412165,1645244888,1645245319,431,4664
3048149031,3620244487,1648740688,1648741230,542,2968
3066688531,3602066299,1647417929,1647417998,69,3934
3026530601,3980789479,1641247115,1641248021,906,2154
3973435118,3057207798,1665861630,1665861881,251,196
3695641337,3295399783,1646702959,1646703121,162,3942
3374302749,3358110136,1646876795,1646877298,503,1003
3743003698,3162075731,1668488750,1668489142,392,4988
3995566619,3151144094,1657209946,1657210907,961,771
3631796881,3970120619,1650250977,1650251123,146,3872
3530372377,3821531005,1652964545,1652964565,20,2695
3864896138,3759173970,1668260697,1668261391,694,4665
3422695934,3838793275,1669200120,1669200415,295,2911
3025333496,3781283816,1650602193,1650603059,866,2531
3334411777,3448213369,1646765026,1646765834,808,2336
3389105882,3167344856,1647011018,1647011594,576,1316
3097915830,3290882153,1660667086,1660667181,95,2202
3480189239,3139717461,1646494941,1646495772,831,4448
3857417594,3407680303,1664661505,1664661762,257,1729
3307340238,3345701830,1642067267,1642068132,865,4693
3581908753,3794323587,1663280970,1663281776,806,4475
3319159522,3249103434,1655599496,1655599694,198,655
3903518498,3985430745,1658177911,1658178417,506,2071
3417210451,3092439784,1667639935,1667640533,598,2391
3950828686,3629771113,1660639115,1660639481,366,3438
3298656092,3900249703,1663155180,1663155516,336,3721
3718874447,3210359794,1647269681,1647269718,37,2773
3750637560,3857804129,1653150361,1653150952,591,4553
3363038446,3005689679,1655589776,1655590049,273,4241
3278785861,3738638270,1660946634,1660946781,147,3012
3342734561,3603113107,1652980427,1652981168,741,4996
3709005538,3640857701,1656201223,1656202033,810,595
3652127038,3900368367,1652948989,1652949341,352,1099
3375948369,3401462630,1642871259,1642871655,396,1355
3818844549,3576987570,1661984667,1661985312,645,4210
3765038739,3260482271,1658785204,1658786019,815,1099
3461742984,3262240086,1665936299,1665936566,267,2460
3931498520,3947314224,1666342102,1666343000,898,4840
3909301253,3382073250,1641879074,1641879778,704,412
3103738301,3215578953,1663713351,1663713860,509,1976
3132786987,3874091171,1646443760,1646443795,35,4716
3247263302,3344190937,1642769888,1642770412,524,2078
3994186543,3747612205,1658932979,1658933543,564,587
3831385438,3553902524,1668449983,1668450367,384,2593
3444118812,3247024495,1646882834,1646883461,627,1523
3090451436,3079681642,1642218492,1642219209,717,2520
3195802070,3129741464,1669330166,1669330969,803,4090
3029663307,3985172792,1656158133,1656158434,301,2637
3935480285,3531261604,1648549781,1648549931,150,2014
3299566950,3529617506,1657265761,1657266174,413,3981
3467276571,3604932275,1663940492,1663941291,799,1698
3163991020,3502469288,1659856565,1659857409,844,2897
3596533364,3708373701,1659934553,1659935368,815,4900
3552655285,3763571247,1666733024,1666733719,695,3196
3476589918,3245080050,1642691210,1642692160,950,3280
3826738410,3744584756,1669087163,1669087168,5,3133
3900396320,3200418783,1651803035,1651803951,916,1545
3803015165,3562207478,1659268033,1659268055,22,318
3649278044,3239853086,1652349108,1652349912,804,3214
3253096231,3705524109,1653224019,1653224703,684,2905
3146143215,3558671183,1643243823,1643244669,846,4128
3848834484,3751776429,1644356463,1644357247,784,159
3970079722,3229543768,1661703327,1661703549,222,2734
3747789642,3912515945,1651401388,1651401817,429,3461
3471458749,3002339022,1658721912,1658722332,420,4056
3448562627,3856302824,1644555678,1644556213,535,3560
3730309140,3183539842,1654375111,1654375960,849,2706
3625214699,3365170992,1667386298,1667386861,563,794
3245809384,3978553524,1664215658,1664215680,22,992
3628633629,3523084466,1668459616,1668459721,105,1687
3069638576,3601462192,1664322336,1664323129,793,4118
3026641763,3306643496,1649843398,1649843443,45,2625
3430939314,3154193263,1654731991,1654732443,452,4405
3976724026,3940200790,1641393476,1641393840,364,4128
3359303604,3748290784,1669058671,1669058781,110,1139
3151147742,3130347110,1649947910,1649948024,114,4260
3475805441,3084260670,1662024453,1662024996,543,13
3290606056,3156046932,1666542345,1666542987,642,1667
3510397994,3436604941,1651571574,1651571978,404,4172
3161866929,3440115516,1645290284,1645291267,983,1461
3726959683,3969229597,1668315451,1668316311,860,2538
3629915831,3155390455,1645492977,1645493415,438,3916
3476728993,3198835826,1659813698,1659813786,88,2008
3372959476,3890801290,1654952577,1654953360,783,785
3605233671,3457554120,1646607569,1646607570,1,3824
3859350987,3101462736,1669622278,1669622859,581,1372
3887601169,3154359769,1667638705,1667639038,333,2090
3976706197,3977835360,1665366786,1665367596,810,1329
3697784923,3136410259,1650362770,1650363769,999,2374
3873449158,3702215504,1642832210,1642832520,310,2476
3895884602,3610840996,1649045748,1649046720,972,1793
3907999283,3703691386,1647378266,1647378729,463,1082
3030952496,3194205349,1664521824,1664522303,479,2282
3235143195,3241313242,1641919655,1641919899,244,2798
3175782283,3470078192,1654516968,1654517336,368,762
3056795894,3633561659,1658744054,1658744323,269,4214
3035182644,3883565419,1658856350,1658856783,433,3649
3761326828,3531512954,1669083058,1669083091,33,1463
3062080717,3726959683,1660403728,1660404380,652,4901
3725940599,3420235320,1668688883,1668689103,220,2681
3431030894,3023832487,1668338513,1668339010,497,4504
3880253543,3553604214,1652219009,1652219804,795,3456
3970746839,3148994058,1664678527,1664679194,667,4031
3947032784,3950464508,1667877137,1667877910,773,1847
3646984766,3244767956,1662501469,1662502288,819,2931
3704976491,3475859975,1643571129,1643571447,318,897
3861299254,3212697128,1641864631,1641865457,826,2737
3392466395,3233489494,1658131642,1658132620,978,794
3446688519,3899163280,1659685917,1659686808,891,1289
3203014470,3667615856,1666137973,1666138353,380,405
3688713287,3856057993,1659612805,1659613026,221,133
3322599174,3001168777,1667585179,1667585406,227,3141
3932168064,3577259981,1647861257,1647861985,728,4586
3056004036,3806650333,1646134654,1646135489,835,2132
3068552328,3252151291,1665831492,1665831803,311,4666
3227042336,3669203629,1646052349,1646053080,731,2059
3809341577,3792356291,1659476465,1659476576,111,743
3510736275,3866231129,1663518188,1663518188,0,212
3204674136,3126768918,1666507648,1666508511,863,3255
3480958495,3124499735,1654264250,1654264619,369,1445
3265041065,3282947799,1656417587,1656418181,594,4760
3104398240,3938966889,1648989556,1648990484,928,835
3662713598,3667250435,1666687731,1666688688,957,221
3557502685,3867453325,1667467080,1667467807,727,3318
3279475834,3771162998,1666648340,1666649174,834,4046
3246908597,3966732336,1641613767,1641614737,970,96
3993120434,3278865502,1665433476,1665434453,977,3040
3857386978,3974708789,1649626302,1649626495,193,2118
3362771387,3383454774,1655700124,1655700977,853,1598
3102998713,3607860424,1642606545,1642607244,699,3843
3085697384,3870022354,1648705312,1648706261,949,2275
3206610324,3074671818,1642205682,1642206499,817,1402
3686067086,3644944805,1652669630,1652670416,786,4951
3750759678,3766952006,1663366515,1663367093,578,3443
3554477123,3898442961,1666880564,1666880644,80,3534
3391987734,3205842097,1648406212,1648406338,126,156
3729951080,3597381625,1660771975,1660772810,835,2960
3538511745,3535661845,1654444675,1654445472,797,2419
3267379891,3622143386,1655303770,1655304508,738,1757
3161532225,3383278067,1655131654,1655131924,270,3259
3926262112,3808396574,1655071938,1655072844,906,3358
3807635993,3034996074,1653139794,1653139810,16,3159
3756355948,3938368943,1660333166,1660334149,983,4567
3523651249,3191350990,1654673737,1654673766,29,2579
3346830134,3747921425,1645678235,1645679063,828,763
3481710826,3553109709,1663805810,1663806625,815,1649
3175498099,3865109784,1661400058,1661400143,85,3816
3710212944,3484166696,1643708584,1643709074,490,2268
3643650753,3407841307,1646487665,1646487672,7,2760
3432628140,3648729885,1667254304,1667254650,346,2845
3488340387,3940776606,1643161512,1643161986,474,913
3182595646,3260920169,1669156121,1669156255,134,3278
3917972110,3959776013,1641374886,1641375855,969,4912
3959548971,3953629936,1656065552,1656065938,386,3101
3267293641,3531292815,1665967618,1665967618,0,4732
3839363844,3202119402,1647298046,1647298231,185,3688
3680441177,3622120506,1644954869,1644955708,839,4715
3039201166,3230753646,1659967462,1659968154,692,140
3220925171,3443891210,1662493266,1662494025,759,331
3624526520,3992735153,1659129277,1659129313,36,1947
3297528969,3365986973,1648753572,1648753893,321,3214
3875948750,3494458347,1655399517,1655400085,568,4409
3167344856,3513941359,1656216143,1656216205,62,1144
3959535697,3200632090,1646704485,1646705234,749,1251
3759917538,3657290726,1665831671,1665831882,211,2743
3911321345,3495334987,1645987069,1645987917,848,1571
3492787091,3799490715,1668005327,1668006222,895,2058
3856441901,3411152161,1653069625,1653070554,929,1225
3865943751,3604575652,1642948747,1642948752,5,1312
3243490960,3040132593,1646720808,1646721512,704,1615
3862754669,3192568410,1668124421,1668124982,561,222
3980866211,3621739245,1651466940,1651467525,585,115
3441873205,3083130493,1654556575,1654556689,114,4514
3987414801,3186814028,1646509191,1646509567,376,953
3944460364,3043899882,1651423353,1651423844,491,707
3368835721,3175162225,1668220504,1668220913,409,2553
3954409685,3580703317,1665789300,1665790026,726,1071
3115307843,3823645797,1648091992,1648092765,773,3805
3355066408,3503519703,1659454025,1659454429,404,3321
3641835803,3995112614,1648387162,1648387505,343,2060
3032206641,3979452113,1650394791,1650395032,241,2436
3785547789,3008069758,1660631322,1660631509,187,2146
3198837254,3731091668,1667279618,1667280187,569,1926
3381321357,3740720488,1665622604,1665623030,426,2735
3929401332,3352930571,1652275970,1652276591,621,2216
3027601743,3034992357,1668895301,1668895429,128,4926
3372643929,3527608364,1650892727,1650893716,989,1901
3560308443,3291868269,1658977729,1658978317,588,4234
3775951771,3449597941,1646734215,1646735180,965,2140
3793548678,3450126909,1655242406,1655243287,881,2278
3867806954,3730333181,1667329224,1667330130,906,2953
3434377570,3661661916,1668045796,1668046020,224,3856
3941328123,3498256277,1660248014,1660248999,985,3371
3507141084,3870267332,1651925014,1651925084,70,4975
3990476746,3019679718,1661037839,1661038519,680,531
3013605774,3873205999,1654191613,1654191953,340,1824
3129245905,3446505103,1644112382,1644113326,944,3575
3077698050,3092988421,1665060297,1665060849,552,1969
3185775834,3603890232,1641143051,1641143477,426,4633
3611502190,3718864971,1652969432,1652970385,953,1883
3553796932,3903205787,1661418884,1661419853,969,1507
3539859701,3804047987,1645316190,1645317114,924,4399
3575001317,3676494548,1644298652,1644298690,38,4109
3910495397,3735680047,1649347711,1649347912,201,530
3311650960,3587306879,1651856675,1651857167,492,3177
3082566906,3727225308,1662463335,1662464227,892,4849
3862550603,3761409227,1647029093,1647029496,403,3935
3390938936,3885394491,1663678084,1663678712,628,564
3222555302,3707188145,1642226004,1642226835,831,3186
3581184918,3903550192,1665663023,1665663070,47,1579
3854764486,3415194041,1645235100,1645235583,483,2427
3833199402,3903135390,1669080786,1669081741,955,779
3057567646,3312611936,1653448298,1653448736,438,118
3062188724,3772926094,1646486536,1646486651,115,3947
3434609554,3929393577,1650241944,1650242499,555,4122
3678305947,3068646939,1643742739,1643743599,860,4969
3702623043,3578376900,1668063911,1668064700,789,3293
3933788548,3227388351,1653026183,1653026831,648,2514
3888991810,3542394655,1647435112,1647435652,540,2085
3794332185,3614664856,1641456838,1641457462,624,237
3538501863,3349019179,1656662336,1656662575,239,877
3556384880,3210461134,1667507881,1667508701,820,3880
3157094647,3525876128,1647602084,1647603077,993,1627
3826506248,3300475857,1643534002,1643534013,11,2323
3164686281,3222971938,1649645862,1649646827,965,1306
3633917313,3257327386,1649595889,1649596344,455,1580
3599391004,3920936649,1668636672,1668636797,125,1219
3142457780,3003569514,1644596500,1644597030,530,1790
3281385219,3524286286,1648334073,1648334246,173,2017
3662112154,3320383137,1651108164,1651109045,881,3315
3845724911,3230823105,1663275994,1663276037,43,1072
3337672067,3408515824,1648904759,1648904934,175,1607
3712937634,3954396121,1662374508,1662374514,6,2559
3682902129,3856780036,1667751384,1667751730,346,1685
3671192201,3037252924,1666226699,1666227452,753,3973
3708611768,3510028715,1647810357,1647811277,920,4259
3783200188,3234012542,1647475625,1647476294,669,4364
3644291441,3371034713,1654054814,1654055240,426,4638
3235835693,3239100504,1663636217,1663637195,978,2573
3444187007,3348346515,1646383837,1646384685,848,1458
3956531583,3204167035,1669676083,1669676385,302,2591
3119793699,3453175125,1654791812,1654792616,804,2951
3193802162,3010498683,1659293710,1659294071,361,4245
3533785631,3746375134,1643778151,1643779000,849,1968
3724466115,3714254299,1652404135,1652404835,700,804
3939831739,3155640525,1646085472,1646085688,216,1911
3615165763,3665590421,1650522801,1650522817,16,509
3374198761,3753127764,1664303251,1664303669,418,2721
3261659814,3823251414,1669110679,1669111376,697,3501
3982748288,3184655561,1642359144,1642360131,987,3699
3048264258,3172747474,1645613838,1645614655,817,631
3111788633,3421907199,1644410905,1644411631,726,866
3671542998,3890104477,1663641419,1663641697,278,2633
3885509773,3706495220,1648704262,1648704962,700,1870
3027528258,3492640258,1663251276,1663251955,679,748
3301065023,3917817410,1668596237,1668596806,569,1019
3089740032,3486031111,1642637024,1642637825,801,287
3081307566,3052891469,1661313320,1661313370,50,2230
3572469356,3781502217,1646466304,1646466452,148,902
3629031493,3518760401,1652552564,1652553464,900,4424
3792384769,3705829288,1644849663,1644850494,831,1685
3493494253,3498243940,1658363677,1658363754,77,3475
3970409898,3174698478,1642604668,1642605095,427,2940
3630338722,3172763284,1659599270,1659599512,242,1450
3659158185,3141479711,1652463008,1652463337,329,3020
3142816720,3989073508,1662294680,1662294991,311,4892
3276389341,3774464063,1659740193,1659740491,298,13
3585561818,3110209716,1648125302,1648125904,602,681
3532159278,3037700159,1641515132,1641515811,679,4208
3054608601,3305872695,1664844035,1664844541,506,110
3622326056,3731337698,1648578214,1648578860,646,134
3035799201,3985172792,1667013932,1667014252,320,629
3422876316,3364059930,1654225574,1654225947,373,950
3317966371,3158394790,1668369223,1668369378,155,1312
3504377968,3607573294,1646351338,1646351989,651,4598
3488859877,3195778005,1665067225,1665067876,651,573
3872300455,3456389216,1643742489,1643742948,459,4245
3105489652,3152421665,1647967727,1647968652,925,4243
3030673242,3000620968,1666602361,1666602916,555,2221
3345078914,3651816275,1666336646,1666337036,390,1172
3311856812,3725855375,1660061175,1660061421,246,2375
3395779598,3811988603,1659033412,1659034405,993,344
3612860468,3416662430,1664044060,1664044232,172,2225
3521963503,3165306183,1663557072,1663557368,296,2431
3277156943,3390251086,1647129954,1647130099,145,182
3910325527,3563460447,1669026673,1669027165,492,3110
3300609699,3824607386,1655101002,1655101021,19,225
3760426318,3278147861,1661068677,1661069495,818,2056
3272820161,3338112924,1652862201,1652862678,477,3508
3519664821,3196322247,1651328306,1651329125,819,1223
3885555793,3959548971,1666333110,1666333185,75,4169
3060415095,3499524415,1654454840,1654455484,644,826
3564121347,3145473059,1651759989,1651760620,631,1186
3716327716,3683912485,1641025920,1641026544,624,1315
3727944948,3467277788,1667581628,1667582082,454,5
3512180181,3133969277,1643943338,1643944269,931,863
3035661291,3145762184,1654597340,1654597389,49,4496
3739781856,3682922662,1650956627,1650956803,176,4468
3829078996,3062462151,1643134285,1643134680,395,2877
3081872897,3200387008,1645576331,1645576604,273,661
3754126293,3704026755,1669220111,1669220554,443,3561
3390848211,3930833932,1645242091,1645242830,739,1369
3315024210,3973852285,1664822789,1664823717,928,3680
3736839763,3574919674,1650275761,1650276645,884,2026
3602091017,3097886964,1642299766,1642300546,780,4405
3688215799,3582055685,1649652327,1649653001,674,511
3022988379,3502091403,1661619310,1661619501,191,3410
3698167640,3235738310,1667950798,1667951274,476,1978
3038950204,3132392165,1641973341,1641973644,303,738
3450864380,3949723088,1659023782,1659024536,754,2277
3017565270,3951244569,1661115652,1661116399,747,4391
3108113809,3243140828,1666361285,1666361536,251,80
3986103938,3661692161,1659785279,1659785962,683,3611
3210686849,3791602089,1642163998,1642164581,583,2918
3596942439,3043100765,1664620604,1664620836,232,3429
3467056943,3757687252,1648908727,1648909046,319,1484
3478381953,3327727015,1650664464,1650664839,375,1449
3564848543,3977384767,1648483372,1648483553,181,1844
3729414917,3268260980,1647637663,1647638144,481,997
3325650350,3666660767,1646253633,1646253836,203,3549
3144546258,3174949398,1669036161,1669036527,366,1624
3514652538,3143310680,1668915383,1668915604,221,2955
3335552070,3369581104,1644143833,1644143868,35,589
3786176392,3232974911,1644888893,1644888947,54,2534
3492623662,3335991197,1647757568,1647758051,483,643
3295336995,3698763049,1652491483,1652492077,594,1810
3617811032,3625534234,1659718410,1659718824,414,3367
3303049822,3076163990,1669478181,1669478295,114,4505
3172044392,3942888923,1660213804,1660213993,189,1959
3468187619,3370149285,1664309664,1664310620,956,2699
3565133661,3028720745,1658779053,1658779333,280,774
3608981770,3122476005,1642176522,1642176576,54,2001
3025765428,3426329001,1658928373,1658928436,63,2316
3644673833,3091776320,1651690511,1651690568,57,3164
3566627713,3112551931,1645554198,1645554622,424,2912
3395730273,3327869415,1658150962,1658151333,371,4209
3891640629,3023323456,1646165071,1646165900,829,4761
3211268708,3158985232,1658340584,1658341581,997,4245
3755091859,3507727771,1664024346,1664024751,405,3800
3578131910,3288910820,1658835967,1658836577,610,4383
3490606628,3109526470,1651302027,1651302629,602,3195
3074961731,3707649209,1654081467,1654082057,590,4671
3059323737,3321783073,1658752989,1658753657,668,4841
3852394875,3301113349,1662724350,1662724645,295,2153
3984426226,3854632672,1644596618,1644597160,542,2029
3122750860,3239209270,1657858075,1657858560,485,2877
3867082245,3968755871,1641221731,1641222467,736,724
3883564824,3514801468,1653569554,1653569588,34,2836
3025425301,3781139304,1649661365,1649662346,981,627
3582484199,3886123031,1650117127,1650117930,803,137
3009630916,3154767647,1662421466,1662422215,749,3465
3935769530,3942233460,1652375951,1652376146,195,2692
3586106951,3761972345,1652908741,1652909003,262,4746
3201269385,3369847004,1645549679,1645550138,459,2265
3911317447,3997874674,1651130567,1651130671,104,3461
3127100749,3852247509,1645619193,1645619330,137,3227
3595817515,3157185999,1664674028,1664674916,888,4695
3417470006,3929186507,1663148669,1663149662,993,1438
3239721902,3136326655,1643347229,1643347987,758,74
3642482911,3168408856,1645255629,1645255964,335,2243
3870412424,3588689927,1665177835,1665178247,412,2618
3722603860,3161688528,1648493626,1648494271,645,4191
3735648462,3893865024,1641010230,1641010878,648,1092
3642447813,3319206179,1649995830,1649996452,622,3757
3009678862,3851511383,1645111291,1645112260,969,4778
3152391621,3070940052,1650712428,1650712876,448,4939
3919633260,3973527097,1667324317,1667325020,703,269
3003853057,3821506349,1662547879,1662548508,629,3974
3674764890,3371110397,1654482620,1654482972,352,2936
3901900193,3218275047,1660033170,1660033853,683,4158
3921920279,3117074592,1666761089,1666762041,952,505
3433214707,3217889057,1657924541,1657924824,283,2870
3865534454,3117576860,1652754212,1652754629,417,381
3037871348,3549401649,1662518671,1662518933,262,1242
3015346480,3923264743,1650354770,1650354877,107,635
3216612290,3225762893,1667728728,1667729152,424,822
3197262219,3814869521,1650061726,1650062218,492,4194
3476104665,3147942873,1664932317,1664932945,628,4340
3521561123,3880081874,1643884424,1643884587,163,1095
3199672641,3096428592,1641168043,1641168494,451,933
3802990506,3408137661,1661518607,1661518796,189,258
3455065041,3744145245,1656378839,1656379692,853,900
3176239090,3872931684,1663040653,1663041359,706,2352
3500776619,3233788305,1653979378,1653980240,862,3018
3640207306,3768847983,1666358681,1666359075,394,4860
3239837182,3429737874,1654093217,1654093886,669,4999
3888254763,3985074018,1657856725,1657856972,247,3833
3382937901,3879348122,1645339382,1645339621,239,4499
3408437726,3370992991,1657395662,1657396041,379,4210
3469795746,3090184356,1649376177,1649376330,153,4945
3619046053,3209388343,1658019596,1658019976,380,2709
3258422486,3530009430,1657235690,1657235777,87,1174
3431711923,3163344674,1648608104,1648609044,940,3258
3636088553,3488548545,1664933025,1664933651,626,4005
3591877355,3587900063,1667402007,1667402081,74,504
3442689701,3155032101,1646039273,1646039456,183,4347
3815719008,3782384656,1646150919,1646151313,394,2958
3612989403,3825335743,1655285833,1655286154,321,2461
3843210787,3744145245,1662943624,1662944112,488,4790
3269831582,3912145770,1652798759,1652799752,993,2995
3200739091,3198319661,1658537597,1658537725,128,1457
3958378809,3970985127,1660186260,1660186621,361,737
3002984730,3773273335,1662367458,1662367934,476,244
3240020536,3621534318,1649220305,1649220837,532,3917
3511063813,3176981895,1656989378,1656989970,592,2557
3146972085,3938841055,1668599898,1668600457,559,583
3845783053,3886238825,1653082869,1653083530,661,1636
3212086875,3636032043,1660615951,1660616197,246,4672
3466869677,3669954524,1641548823,1641549572,749,0
3515449022,3443385355,1649948129,1649948415,286,3380
3128309221,3765707753,1668488443,1668488474,31,1551
3666957887,3007457526,1661426116,1661427051,935,1456
3633201119,3310544186,1649244341,1649245191,850,2502
3172857407,3302525668,1641344273,1641345109,836,1033
3124935897,3423242922,1655616806,1655617380,574,2407
3741150749,3679441161,1659112726,1659113629,903,1676
3544398332,3318403247,1646009463,1646010260,797,485
3003759602,3127755703,1652556746,1652557073,327,4306
3219729232,3485722574,1648595299,1648595700,401,424
3198172634,3567311484,1657891258,1657892012,754,2053
3868486175,3773142091,1664316395,1664317026,631,4739
3976410908,3015435710,1658147327,1658148063,736,759
3244786415,3217188518,1646821196,1646821923,727,40
3703071464,3690209889,1654320837,1654321440,603,3830
3311908597,3366281500,1664420441,1664420933,492,3090
3653028918,3321325364,1650750126,1650751032,906,2710
3508234963,3137380547,1643134826,1643134942,116,4550
3709535435,3258989403,1656169154,1656169395,241,3847
3354478061,3764607050,1660193825,1660194073,248,1185
3143391255,3034539017,1653146366,1653146522,156,3271
3438890200,3670194328,1668446854,1668447114,260,597
3862512829,3107015481,1663321373,1663322280,907,1442
3435225128,3351014572,1655644133,1655644587,454,484
3515818354,3713693257,1661077712,1661077929,217,2814
3170516514,3476617757,1667213958,1667214668,710,2290
3887913318,3857762352,1645163103,1645163744,641,3813
3396013016,3876547416,1656011885,1656012778,893,4270
3702495987,3965870863,1663753358,1663753639,281,1368
3625394714,3754071228,1651919817,1651920425,608,3957
3732961005,3595203289,1661235185,1661236023,838,588
3615949276,3384842688,1666856884,1666857440,556,2487
3650860321,3156102899,1666781310,1666781490,180,3316
3559890485,3586533941,1667541729,1667542349,620,2027
3214038297,3574638297,1652288039,1652288879,840,2877
3468689432,3318923716,1649374225,1649374378,153,4906
3921726818,3861343983,1643408525,1643409313,788,1534
3805219312,3626227636,1653223827,1653223943,116,453
3299837298,3167463673,1657468470,1657469128,658,2170
3934630756,3935322164,1662588780,1662588970,190,2690
3883981711,3592526627,1667996901,1667997239,338,2050
3002163763,3935382770,1667302428,1667302690,262,752
3352213139,3878329371,1656062362,1656062651,289,3043
3122635818,3352253584,1645258563,1645259173,610,2182
3609557194,3775709082,1659877848,1659878760,912,1428
3933930669,3403889019,1657596888,1657597500,612,3533
3658107775,3879039908,1652213019,1652213693,674,3996
3180025402,3977736611,1649072479,1649072739,260,3631
3647346906,3626601017,1668369753,1668370358,605,767
3238925364,3395802916,1651242478,1651242976,498,643
3994311629,3349460523,1657506781,1657506994,213,1433
3603267983,3732790760,1641288719,1641289060,341,4924
3432749468,3037727864,1667896356,1667897166,810,1644
3470312351,3585429602,1644494869,1644495514,645,444
3892437307,3943843139,1653674810,1653674952,142,3389
3976517269,3409388792,1654732991,1654733021,30,2227
3535533678,3650228111,1648554247,1648554459,212,2693
3897827804,3051357442,1650734195,1650734998,803,2902
3943352530,3654695044,1657025070,1657025976,906,2720
3728105217,3810268115,1649045252,1649046017,765,3784
3690775142,3645391455,1651588012,1651588221,209,4198
3556638918,3486051685,1668326854,1668326868,14,2941
3956320516,3434422298,1664482666,1664483386,720,1549
3470303198,3252645637,1653539384,1653539714,330,4550
3226151734,3943268155,1650562859,1650562988,129,1137
3276939401,3573070649,1663715404,1663716355,951,4464
3678150491,3244459030,1655132817,1655133563,746,3005
3937852921,3418424682,1658872261,1658872380,119,4914
3398235328,3852873909,1644236521,1644236672,151,3973
3631616821,3073758901,1659091224,1659091670,446,3698
3884328512,3628809540,1650917724,1650918657,933,3894
3424716332,3805236533,1645655310,1645655651,341,2250
3883796861,3969334261,1666780770,1666781732,962,1476
3452966917,3562547525,1655870701,1655871039,338,4607
3355306116,3167533405,1651538312,1651539137,825,2768
3213834314,3210689509,1658031709,1658032080,371,2044
3826272165,3996777620,1651423966,1651424429,463,3199
3270728763,3756534758,1666871525,1666871988,463,3186
3070576565,3348950672,1656201576,1656201871,295,512
3803571210,3557883795,1667138719,1667139180,461,2754
3733651114,3650202692,1645060932,1645060974,42,4001
3426392368,3624295666,1647473058,1647474055,997,4085
3361553220,3376250934,1654136319,1654136720,401,2604
3520132269,3274049641,1659506176,1659506435,259,920
3104371466,3153654893,1654844472,1654845158,686,3390
3169690970,3653476987,1659102688,1659103143,455,1868
3917052131,3051723471,1665921902,1665922113,211,1986
3480202150,3789123077,1650442205,1650443084,879,2457
3264041236,3040767680,1646290899,1646291697,798,4069
3049215650,3181544625,1655522804,1655523329,525,4243
3296776746,3107746785,1641041097,1641041652,555,3179
3565343931,3143339700,1650061679,1650062172,493,3575
3090430330,3979523283,1650016439,1650016845,406,4099
3368294659,3514505245,1654905961,1654906834,873,3004
3554677452,3941214170,1647140790,1647141773,983,1636
3689126527,3656530587,1657337548,1657338352,804,406
3182680296,3107680323,1648026229,1648026646,417,2857
3682729901,3138061885,1652303498,1652304229,731,3974
3058890347,3550546656,1642299387,1642300094,707,3586
3236318170,3880629692,1659038855,1659039089,234,1875
3841034288,3583468224,1663940277,1663940646,369,4014
3529559657,3849745757,1653623647,1653623650,3,1898
3384368615,3166409046,1666764813,1666765264,451,106
3085239970,3977061014,1652087249,1652087942,693,3373
3888465834,3228056872,1662727464,1662727664,200,3628
3570034326,3871743244,1661588674,1661589131,457,2199
3400391748,3749882298,1667131667,1667132427,760,903
3739163015,3969702154,1665996079,1665996425,346,4532
3664061904,3622444593,1659918093,1659919061,968,3081
3318293476,3834161185,1662663460,1662664076,616,2919
3215759935,3843318944,1641462537,1641463476,939,2853
3677210844,3959125563,1657781748,1657781756,8,3610
3310535604,3178891742,1652352558,1652353454,896,460
3007078234,3662194945,1666255099,1666255569,470,4314
3471644425,3269124542,1659260859,1659260930,71,2417
3721195889,3967317483,1663289430,1663290310,880,387
3531221788,3169976571,1644942704,1644943386,682,4235
3823786866,3424570934,1656381525,1656381800,275,578
3129784050,3981152004,1655515969,1655516958,989,1475
3561906699,3713674282,1649167859,1649168434,575,3635
3355173419,3303350878,1661415778,1661416597,819,4218
3477692655,3950172176,1645605426,1645605545,119,3847
3748551293,3502495699,1662037548,1662038060,512,1621
3947015330,3677781917,1664285690,1664285700,10,4371
3737889944,3000198187,1657047085,1657047979,894,3027
3803773117,3722571629,1665771217,1665772158,941,4330
3855147487,3532170348,1644347502,1644348036,534,345
3004035881,3497175523,1641989863,1641990145,282,782
3099063147,3605380480,1650340959,1650341341,382,1675
3079248357,3778558388,1660881236,1660881555,319,1505
3402971882,3588118854,1669414313,1669415263,950,4281
3604433681,3493538644,1648049180,1648049330,150,4031
3460410603,3626566515,1666392317,1666393155,838,4628
3151751386,3572340793,1645030186,1645030714,528,4448
3260966318,3493996653,1644128411,1644129099,688,4335
3869691194,3849585054,1665291117,1665291976,859,3685
3831783774,3533948641,1643376691,1643377421,730,3230
3395386253,3416883922,1646838751,1646839369,618,3701
3131189118,3156551309,1669264039,1669264530,491,1754
3763286791,3344599200,1647447794,1647448497,703,3596
3416989361,3961836303,1659650754,1659650885,131,1100
3505185491,3241000219,1663111216,1663111441,225,380
3311655067,3121447930,1668838796,1668839223,427,1770
3373658305,3026006319,1668518045,1668518443,398,935
3017606504,3878365032,1660335162,1660335211,49,2813
3544974591,3654855335,1643426866,1643427454,588,3130
3669226349,3306674424,1657974257,1657975184,927,518
3629819271,3924241726,1642707813,1642708453,640,2410
3292897177,3286435892,1655037209,1655037804,595,3908
3594292934,3304435236,1664329736,1664330283,547,2056
3390074639,3298454807,1659327235,1659327292,57,1850
3569013642,3918978612,1653199030,1653199553,523,1746
3865386677,3292248649,1659456800,1659456967,167,352
3312601330,3612049823,1645937799,1645938051,252,4049
3649195459,3086631860,1659231072,1659231490,418,2733
3295389556,3335794672,1652854207,1652854783,576,1398
3589122382,3552740188,1668791872,1668792618,746,2463
3978640579,3657508012,1645199144,1645199384,240,4222
3891702502,3564341555,1659684146,1659684252,106,4874
3428165244,3686592612,1659166951,1659167408,457,2095
3432596019,3722735747,1650533291,1650534029,738,4980
3380866607,3356396782,1641678859,1641679667,808,3544
3139752883,3401114735,1665368103,1665368295,192,4180
3561235176,3113950428,1665460086,1665461024,938,3770
3356163822,3379507342,1658545572,1658546550,978,4979
3331147696,3190837165,1668375006,1668375202,196,3956
3762714677,3172375931,1647617244,1647618121,877,4140
3845407473,3970013417,1657306269,1657306501,232,3552
3179980894,3210041436,1652171939,1652172095,156,1684
3622109505,3990249195,1656514142,1656514954,812,435
3523332401,3543015105,1667304744,1667305157,413,1311
3951467007,3400209850,1663637183,1663637632,449,2411
3446770951,3378838487,1655543036,1655543739,703,4440
3587934510,3713299975,1652706833,1652707170,337,3590
3380182634,3894828647,1655601223,1655602210,987,3111
3121633485,3259553487,1654985567,1654986180,613,623
3187682107,3803724204,1659394065,1659395047,982,2054
3811267030,3387137615,1643661187,1643661435,248,2902
3734251663,3241070339,1666015701,1666016481,780,2674
3357874485,3576577064,1653288509,1653288724,215,4927
3525856169,3968978550,1653317841,1653317943,102,2320
3919342589,3779712479,1646646032,1646646480,448,3923
3009232245,3684431873,1667279327,1667279385,58,4951
3426614357,3588751092,1641641164,1641641590,426,2632
3102710909,3412648071,1649150678,1649150886,208,4937
3988739626,3483271313,1647309762,1647310064,302,348
3892748369,3424999540,1654066451,1654066703,252,1325
3170526544,3022503989,1659075488,1659075637,149,3882
3542413395,3394591004,1665877292,1665878089,797,4554
3145534718,3802664884,1651193085,1651193770,685,4434
3803483380,3941230622,1655701754,1655701875,121,111
3949142919,3642473511,1659838129,1659838617,488,1798
3299467702,3427471149,1657452805,1657453495,690,4326
3996304076,3602123108,1668763221,1668763433,212,1407
3311856403,3780414345,1669675547,1669675576,29,3530
3633652367,3248252041,1653574458,1653574630,172,2089
3887742364,3656350321,1654669933,1654670408,475,562
3509395127,3275346838,1643869999,1643870038,39,4418
3017583174,3334487489,1644306408,1644306644,236,4685
3896634881,3219013910,1661313150,1661313750,600,4531
3129361484,3726318236,1661097242,1661097536,294,4483
3764923652,3274387842,1665281261,1665281991,730,4093
3509313203,3421097991,1659101712,1659102420,708,21
3080324267,3879985975,1652658808,1652659666,858,3433
3667644284,3716428118,1646656242,1646656990,748,4281
3025986077,3538214486,1653099452,1653099740,288,1882
3773496440,3176469716,1646381961,1646382484,523,2404
3756960285,3965638051,1645508421,1645509051,630,2849
3671192130,3444737936,1650544814,1650545686,872,3493
3220877428,3030523593,1656101888,1656102640,752,3628
3540382486,3116651745,1648274268,1648274990,722,712
3629019073,3296865939,1667882714,1667883072,358,325
3521712313,3646652020,1653110263,1653111217,954,3763
3671988333,3150051126,1666346236,1666346595,359,2735
3266763921,3626971994,1663826562,1663826590,28,4460
3984408992,3327088625,1663384240,1663385147,907,4039
3177950168,3025191040,1657783553,1657783668,115,643
3154864340,3489217472,1655077114,1655077938,824,1217
3556420413,3777809769,1653046580,1653047242,662,4731
3718561305,3570842152,1657769232,1657769289,57,2045
3987843327,3095047372,1662932719,1662933425,706,398
3096170284,3731012745,1666657734,1666658073,339,41
3816584157,3806920507,1647504178,1647504319,141,4550
3982538269,3423685958,1662059031,1662059824,793,1934
3414374280,3912240368,1644823982,1644824449,467,860
3106971552,3216068989,1654550630,1654551518,888,3131
3938450333,3273164924,1667027762,1667028036,274,507
3501618594,3305597720,1641351945,1641352527,582,2579
3374733835,3016376391,1648854920,1648854958,38,1379
3264790703,3913998442,1661104297,1661104473,176,4132
3522105968,3260662201,1645454034,1645454896,862,1037
3839560979,3751303990,1644009020,1644009973,953,1223
3603439670,3169636630,1659035726,1659036298,572,4612
3584406164,3789123077,1665703869,1665704056,187,3307
3232434060,3383691044,1657581392,1657582225,833,2118
3294168271,3467380234,1652205456,1652206320,864,4156
3149668747,3693932637,1663714632,1663715211,579,1060
3203895928,3806607716,1665191448,1665192090,642,2302
3824794373,3147121902,1653318509,1653319345,836,2456
3786123695,3432979709,1663634200,1663634961,761,4851
3435312441,3610533969,1648447828,1648448177,349,4332
3549699805,3753798521,1643012325,1643012333,8,1678
3929448076,3796153761,1642842817,1642842882,65,4800
3937288406,3102522220,1652208716,1652208879,163,1725
3703937904,3400846746,1653621232,1653622136,904,158
3145875823,3890868055,1659411814,1659412641,827,397
3828835278,3542752085,1643705401,1643705925,524,1256
3195584989,3630553639,1649789006,1649789990,984,374
3711644325,3557397088,1655573494,1655574392,898,110
3317513793,3817723938,1668310316,1668310936,620,1981
3034452600,3991666669,1667600263,1667601123,860,4690
3276120229,3705096752,1647349346,1647349724,378,292
3196464525,3300872564,1665103916,1665104394,478,2665
3355317227,3423382623,1649280172,1649280480,308,4486
3427293728,3538010169,1650824955,1650825597,642,4370
3699353456,3538884093,1650389841,1650390047,206,3754
3277807466,3714697031,1665233856,1665234003,147,1678
3647801340,3293501044,1650468330,1650468340,10,1175
3941605267,3311608435,1641518008,1641518567,559,2062
3317243488,3305014350,1665414339,1665414494,155,2672
3018392961,3770896500,1646987565,1646988549,984,3139
3932593025,3970498740,1657143898,1657144112,214,4596
3365986973,3271783202,1653952401,1653952464,63,4126
3244909566,3965120862,1649879138,1649879183,45,3304
3085403038,3888797511,1665523367,1665523872,505,4594
3521999622,3345738703,1658106084,1658106651,567,603
3499253084,3514323850,1642221709,1642221746,37,1604
3268096323,3748345380,1651875599,1651876469,870,2919
3774146004,3812232170,1663547150,1663547404,254,129
3328610802,3453523653,1650492448,1650492658,210,3029
3894073063,3300872564,1643111080,1643111101,21,1544
3851652994,3596918589,1650935014,1650935558,544,4172
3052346390,3428559272,1664923777,1664924312,535,3967
3663668095,3353477195,1650937286,1650937389,103,4867
3938024749,3000701978,1655635343,1655636335,992,856
3560465097,3727389008,1653012542,1653013020,478,2072
3764261000,3898439830,1668416319,1668417040,721,177
3327886105,3337945771,1667779769,1667780171,402,3068
3333441073,3507985353,1657170994,1657171887,893,817
3673814206,3893876555,1643673352,1643674053,701,763
3275705436,3972266399,1660899585,1660900179,594,2132
3053220557,3283191576,1658100721,1658100990,269,3436
3808470907,3232938586,1641179783,1641180306,523,784
3779366653,3533241497,1646338530,1646339070,540,2731
3513958415,3137808909,1660967089,1660967495,406,3926
3969338063,3647437795,1652198013,1652198436,423,658
3653463236,3487580194,1656063838,1656064025,187,4966
3233761270,3456647396,1643357623,1643358057,434,2226
3545116472,3637985911,1649501953,1649502425,472,461
3295285640,3211679936,1655851560,1655851996,436,280
3497861620,3915308534,1658259471,1658260231,760,3635
3921938615,3236949804,1645752066,1645752838,772,1480
3228183995,3927557954,1664672286,1664672750,464,2168
3168364673,3174831012,1647689353,1647690154,801,4103
3673676846,3577371539,1663767763,1663768224,461,2961
3614416592,3740960337,1664626971,1664627685,714,3242
3621232060,3719956315,1647771634,1647772456,822,3513
3308912828,3507975818,1658828449,1658828678,229,2670
3899567738,3993775940,1649220812,1649220832,20,2266
3170303894,3981613134,1641584511,1641585228,717,1895
3602044385,3603515150,1659241751,1659242316,565,3886
3608760206,3678150491,1663528263,1663528494,231,265
3643107346,3010713760,1664933198,1664933785,587,3612
3890466747,3816195330,1645943057,1645943971,914,1539
3693982008,3653721550,1644254633,1644254994,361,4763
3315319642,3871881956,1661424230,1661424692,462,2040
3485880955,3828983459,1645266328,1645266615,287,707
3112477852,3846428736,1656475304,1656475716,412,2614
3005953129,3868413847,1667967664,1667967863,199,1846
3609105678,3289219781,1654430112,1654430934,822,4036
3374451311,3579416113,1656672053,1656672857,804,3692
3915513341,3235449718,1665459781,1665459915,134,663
3511156753,3710483699,1661199470,1661199950,480,1452
3199173661,3740878944,1648888808,1648889114,306,526
3238132390,3229496443,1644666480,1644667184,704,3547
3314790474,3854307191,1666017432,1666018179,747,2670
3849140708,3142733146,1667447118,1667447972,854,2937
3621232060,3671571593,1641268602,1641268929,327,1352
3440597487,3351961998,1662827534,1662828378,844,882
3404078640,3346389906,1669490145,1669490900,755,4593
3658980640,3602223231,1668615692,1668616662,970,4511
3022508441,3552734555,1656018346,1656018896,550,4852
3961430769,3029034522,1663371782,1663372478,696,1630
3439986682,3520314592,1644149189,1644149512,323,2498
3349079845,3744699727,1666388556,1666389443,887,1619
3360865637,3518293564,1647441638,1647442201,563,3809
3963126465,3769023061,1666689207,1666690201,994,1296
3509959480,3517766046,1667010987,1667011828,841,139
3319024052,3918192832,1655207992,1655208411,419,4238
3054824098,3244786415,1660957457,1660957828,371,4567
3302218881,3680971963,1657707780,1657707809,29,4492
3369187519,3894339288,1644856913,1644857579,666,3167
3350762252,3974377277,1668358261,1668358435,174,4443
3004120739,3833937560,1657103245,1657104205,960,2539
3886144780,3798013764,1663348340,1663348845,505,3372
3812271350,3488521576,1657459645,1657459843,198,4116
3561437770,3119362894,1662922907,1662922973,66,3444
3942257621,3427773510,1656477664,1656477843,179,745
3718382298,3293369380,1644844486,1644845114,628,2214
3396962203,3961417157,1646745643,1646745756,113,2918
3390351197,3695828367,1660792926,1660793300,374,2933
3903892746,3369808394,1643129134,1643129319,185,3050
3821185992,3312050281,1665659295,1665659950,655,1924
3563188970,3999757853,1667625595,1667625799,204,332
3965570577,3107050630,1647300106,1647301004,898,235
3955714678,3910202952,1665046064,1665046451,387,3862
3407241059,3211805613,1644790435,1644790442,7,2536
3620513820,3380475621,1656736851,1656737333,482,3694
3370444991,3020696206,1662821840,1662821866,26,3817
3507265559,3739339878,1645107070,1645107513,443,1433
3598761948,3994182311,1644441340,1644441738,398,1621
3601374590,3368779020,1643864494,1643865155,661,4637
3083004597,3110069598,1649581812,1649582146,334,2723
3174571214,3182057770,1667602419,1667603115,696,468
3799429643,3125868222,1643165699,1643166502,803,1717
3819755143,3317435960,1653100037,1653100866,829,2447
3645707937,3461619716,1662713353,1662713986,633,2413
3150826904,3031086708,1668297677,1668298123,446,3486
3082781229,3444311526,1652807214,1652807349,135,441
3333842075,3362435522,1668761255,1668761420,165,3478
3346399285,3484133376,1647319094,1647320088,994,987
3488340387,3870207519,1647975556,1647976453,897,4831
3031924178,3143309242,1659427992,1659428283,291,255
3505859358,3270655299,1645701647,1645702236,589,2649
3736227635,3393523607,1658396200,1658397010,810,1612
3149242785,3005148582,1651047296,1651048086,790,4468
3573061185,3843210787,1657900770,1657901546,776,3098
3397360523,3270222216,1649672850,1649673419,569,2154
3287793517,3743268859,1656893630,1656894373,743,1851
3663402910,3652111318,1659375030,1659375739,709,4265
3002418615,3490581891,1669121739,1669122494,755,2382
3681473834,3222851019,1648765555,1648765935,380,630
3509776498,3913428226,1665800788,1665800866,78,4651
3924716423,3394962825,1656275034,1656275199,165,687
3482854332,3099847274,1651896823,1651897432,609,1837
3207145389,3256255072,1660465113,1660465636,523,3722
3902752329,3705736514,1645445808,1645446189,381,1489
3769484150,3515072651,1651517677,1651517915,238,3347
3157212981,3173281096,1666265247,1666265716,469,767
3082741953,3238339053,1650920357,1650920403,46,819
3269194577,3300244312,1654662394,1654663127,733,4559
3580382605,3557597687,1669223084,1669223290,206,2101
3100714009,3566515870,1654886171,1654886506,335,633
3080031285,3273751720,1654831355,1654831856,501,2821
3800287955,3932156652,1648347605,1648348334,729,1815
3803667811,3996979680,1669556949,1669557574,625,2571
3850289021,3659953541,1665847340,1665847645,305,3011
3492110184,3995566619,1648749097,1648749270,173,3377
3431308827,3354245728,1668814173,1668814915,742,4886
3207087109,3804395395,1662314970,1662315382,412,2457
3872081436,3760275384,1659989581,1659989876,295,831
3148279551,3048707031,1647509141,1647509476,335,764
3872732002,3783544555,1652775813,1652776147,334,4745
3291669561,3661540931,1648518609,1648519428,819,1068
3216551264,3194680856,1645375484,1645376238,754,2685
3653126892,3857482792,1653627544,1653627904,360,1017
3473260938,3054964230,1668441519,1668442415,896,4535
3806615546,3654402256,1642577203,1642577686,483,16
3263711365,3567246055,1657211013,1657211419,406,4971
3803279969,3621255685,1666288513,1666289222,709,2404
3781137541,3805535586,1650639725,1650640066,341,4170
3925036457,3844600652,1666254636,1666255627,991,4137
3568603049,3109238451,1652043799,1652044294,495,3756
3919558002,3243930811,1644034659,1644035586,927,4548
3228242606,3764811604,1652157904,1652158073,169,4241
3668365718,3274362437,1658643434,1658643584,150,3018
3035412905,3486645535,1662757561,1662757766,205,2521
3989060969,3220279084,1660104365,1660104543,178,3433
3268790554,3205480289,1653302810,1653303574,764,2790
3476207849,3182376204,1653463651,1653464418,767,3032
3671064670,3943623153,1660917193,1660917685,492,4960
3360790098,3514916026,1649249404,1649249468,64,2912
3461715693,3836600679,1649427280,1649428038,758,2419
3034575504,3928272616,1660188141,1660188222,81,1439
3775202598,3477012844,1649381177,1649381379,202,3722
3750055766,3106469046,1666691793,1666691881,88,4651
3044294844,3520395745,1661862690,1661863318,628,2900
3756226590,3338898637,1653445717,1653445825,108,955
3308032258,3550036296,1657076571,1657077194,623,2097
3188636761,3820550768,1648038271,1648038727,456,4625
3459118075,3758149663,1647210999,1647211613,614,2494
3814965168,3029556483,1643614420,1643615278,858,24
3377562690,3091689856,1659319655,1659320082,427,1507
3860053200,3041428012,1644541348,1644541402,54,3277
3219192322,3696573977,1642735289,1642735938,649,1333
3597057925,3346246102,1642226183,1642226751,568,2946
3220283439,3917974109,1665497766,1665497930,164,630
3207407456,3703258419,1654811088,1654811860,772,599
3485717030,3698129694,1667188441,1667188903,462,1360
3583190483,3836153324,1656820293,1656820374,81,3400
3890100338,3124411025,1648726445,1648726900,455,4937
3867233124,3348368673,1667789360,1667789693,333,1882
3143397100,3106792841,1662732429,1662732692,263,3732
3468740463,3585066130,1669668209,1669668961,752,1757
3106180712,3664591537,1652592103,1652592991,888,1164
3426699603,3243901516,1644086138,1644086887,749,1106
3370467698,3890901648,1645215839,1645215890,51,2069
3142917709,3637483915,1649373254,1649373657,403,4158
3664810807,3216264785,1649193759,1649194481,722,567
3371452985,3087999818,1654333166,1654334098,932,4941
3051163847,3713411650,1642391001,1642391278,277,1146
3783511377,3229305904,1647453942,1647454433,491,2385
3273759900,3044133418,1645263507,1645264018,511,3223
3851660113,3719215170,1643976585,1643976991,406,136
3575439264,3817228640,1644803638,1644804410,772,3993
3287672110,3486810548,1661240408,1661241161,753,3527
3491597513,3586080458,1651302306,1651302585,279,776
3132520096,3894410608,1643572313,1643573002,689,669
3666272527,3271827792,1645920788,1645921131,343,4793
3633295632,3009223930,1646445204,1646445514,310,1299
3089313385,3886355308,1647056955,1647056983,28,2595
3634462595,3156155190,1656494248,1656494925,677,3956
3707929471,3729077195,1668190719,1668191383,664,3394
3064875095,3388838434,1645670222,1645670873,651,3633
3739752313,3402205389,1659901506,1659901521,15,765
3517441575,3844442629,1642228630,1642229448,818,679
3904327572,3504711245,1648542217,1648542561,344,3183
3270920556,3527155156,1641393143,1641393844,701,3015
3659191092,3095339430,1643084874,1643085018,144,4917
3341946025,3856356133,1655544145,1655544589,444,485
3482234857,3770722415,1649545184,1649546016,832,791
3785789519,3127855483,1658529709,1658530223,514,3797
3100326996,3364345159,1662782785,1662783022,237,1032
3427538547,3583024393,1660512665,1660512789,124,1063
3320578732,3610498206,1655781544,1655781909,365,3074
3129203902,3208749198,1663619974,1663620427,453,4325
3570367617,3852456307,1661964168,1661965023,855,4421
3360878603,3403281083,1649218300,1649218331,31,1941
3046808325,3299595872,1662546836,1662546949,113,1491
3806108587,3028756400,1655611164,1655611358,194,1997
3111793685,3680451282,1656920477,1656920579,102,3568
3296348139,3987546608,1665220234,1665220395,161,271
3800901442,3841596953,1652387446,1652388176,730,1251
3687287495,3333009065,1653511185,1653511544,359,1077
3040449197,3158419865,1648140867,1648141781,914,734
3106226329,3749265259,1645267197,1645267528,331,2516
3790259264,3459893214,1661369544,1661370140,596,272
3742613189,3274202211,1648364397,1648364610,213,3100
3964712037,3339157739,1667261065,1667261333,268,2644
3682987630,3860652594,1660203923,1660203974,51,14
3162696822,3679807729,1666565022,1666565635,613,148
3930914795,3782014254,1662431272,1662431664,392,3163
3708881756,3084045589,1647926382,1647926926,544,3339
3343088156,3550420962,1648390285,1648390590,305,2096
3665160873,3396206666,1669147753,1669147976,223,4966
3157223314,3730361477,1664592830,1664593814,984,1911
3538648278,3473267186,1656246440,1656247164,724,4178
3046729918,3956816160,1654517828,1654518768,940,164
3412826930,3481541190,1643546033,1643546409,376,4058
3467885351,3018652228,1652269013,1652269112,99,2180
3553238091,3153719338,1657138754,1657138815,61,3969
3326719533,3847203189,1654610099,1654610769,670,2709
3239914081,3179383459,1658090210,1658090914,704,4903
3980760103,3422685650,1645438794,1645439039,245,189
3797638971,3295811429,1646363639,1646364149,510,4130
3274032495,3473414778,1657301508,1657302405,897,4752
3816674156,3178891742,1663766452,1663766768,316,2086
3608576389,3205660251,1652016952,1652017280,328,4074
3488340387,3071094711,1658169252,1658170246,994,555
3794040110,3045471517,1660680910,1660681052,142,723
3876852558,3981711775,1669035737,1669036057,320,4869
3241594561,3003730461,1663983396,1663983989,593,2374
3672907710,3430636342,1648240307,1648240416,109,976
3156744668,3741404844,1661303916,1661304175,259,802
3454512866,3660950218,1662202663,1662203413,750,4214
3613679040,3267023803,1647303861,1647303933,72,909
3350524507,3274361685,1656018082,1656018235,153,3422
3793274718,3109029631,1664398289,1664399181,892,315
3171630485,3963974244,1645400655,1645400673,18,137
3663011454,3621386133,1652843799,1652844065,266,3783
3729860861,3612452820,1665475881,1665476246,365,4178
3048454188,3490731960,1656924357,1656924882,525,400
3236991345,3905991184,1659775013,1659775557,544,3027
3098150784,3596099890,1662321994,1662322048,54,4588
3831589758,3311625491,1647806421,1647806648,227,706
3641070194,3532140949,1657733188,1657733791,603,3350
3774572196,3047722468,1667774418,1667774632,214,2135
3186967774,3986962547,1669504438,1669504661,223,1986
3660884942,3888270412,1650065009,1650065247,238,52
3545471039,3820268832,1651302499,1651302548,49,4530
3890556912,3132820185,1647693431,1647694158,727,3544
3561800579,3441598246,1663673217,1663673440,223,592
3792759597,3428566231,1655481400,1655481879,479,301
3691655351,3704101484,1659059878,1659060023,145,1605
3175660586,3475584545,1649890008,1649890593,585,4455
3778051857,3472921686,1643650079,1643650168,89,4289
3408377648,3851858540,1668365126,1668365257,131,432
3316030195,3587401915,1651629116,1651629990,874,559
3689946213,3719082801,1669469204,1669469231,27,1040
3971029176,3449771398,1649890447,1649890538,91,4643
3587977218,3575502194,1658000098,1658000376,278,77
3090414050,3164536372,1641332331,1641333215,884,1915
3664095585,3498378849,1662555686,1662556684,998,3826
3299595291,3638118647,1646978392,1646979047,655,2710
3975508761,3266025561,1649486354,1649486372,18,115
3423437033,3347837567,1641767074,1641767179,105,3524
3420826737,3980946239,1658509384,1658510303,919,2074
3998858332,3476967872,1658355269,1658356211,942,2869
3804030185,3862841132,1650416179,1650416781,602,2694
3233250021,3730789202,1647682179,1647682179,0,326
3664738062,3561159767,1651031839,1651032487,648,4434
3437285661,3269577608,1650549285,1650549745,460,119
3074835049,3568177893,1641812751,1641813697,946,1920
3487971428,3215710129,1643226624,1643227091,467,4141
3270348311,3241890979,1649490237,1649491003,766,3949
3885906102,3897020374,1650820591,1650821392,801,4590
3609341315,3484383189,1648515237,1648515539,302,4021
3316683539,3129083987,1664088634,1664089328,694,3829
3076149612,3319279448,1667319674,1667320498,824,927
3624245488,3431337811,1648640299,1648640673,374,1395
3869189780,3904088511,1645069721,1645070607,886,2671
3581020801,3978204820,1644273129,1644273468,339,4992
3107976186,3134130632,1665097859,1665098633,774,594
3216576306,3202287040,1662474431,1662475113,682,4424
3813062614,3937650919,1666055560,1666056346,786,150
3972909524,3578258582,1641194301,1641195180,879,581
3147738261,3413070640,1643889097,1643889380,283,4430
3844610901,3626501099,1646675369,1646676075,706,1182
3644528394,3975862951,1653930623,1653931591,968,1797
3157896152,3079595475,1660543444,1660544158,714,452
3168939618,3106314392,1665016544,1665016967,423,2475
3125307706,3699102664,1659104834,1659105074,240,2248
3448816793,3201277457,1655130860,1655130906,46,4260
3945523211,3590687946,1653275374,1653275523,149,4231
3464155481,3047715979,1656694921,1656695271,350,320
3567100647,3817119551,1653011403,1653011569,166,3184
3302075061,3715977283,1641467662,1641467765,103,3774
3867480038,3970808875,1663968840,1663969526,686,3618
3410296649,3340109597,1650654564,1650654639,75,4151
3927418343,3211881874,1654922100,1654922174,74,2637
3253238128,3675459407,1653094432,1653094600,168,3170
3404455025,3813714957,1646174638,1646174735,97,1401
3786988989,3106953325,1662664861,1662665723,862,3665
3149950727,3286947668,1643321708,1643322660,952,3099
3365013743,3804317416,1669264593,1669265399,806,1024
3493040137,3439824553,1660525634,1660526382,748,3433
3870891841,3255802263,1641799239,1641799402,163,2487
3124489900,3573609516,1643709963,1643710899,936,3365
3751427855,3263772561,1653173406,1653173948,542,1680
3958604689,3820267404,1641224254,1641224715,461,4513
3522547669,3110998222,1669306349,1669306842,493,930
3483059961,3480054446,1641319036,1641319895,859,3872
3459082487,3906766774,1644482603,1644482819,216,2328
3488548545,3261322013,1656629854,1656630143,289,1436
3383406113,3551996539,1648984820,1648985451,631,4075
3429391289,3349539399,1641579445,1641579757,312,16
3813999940,3163394047,1647652010,1647652916,906,2529
3833674390,3604279595,1645661166,1645662059,893,1966
3062032471,3030587827,1665414627,1665415367,740,4158
3455177907,3902289612,1653612400,1653612735,335,1319
3154631537,3859869735,1666025725,1666025736,11,1153
3215448510,3978521503,1645626774,1645626870,96,130
3353340103,3136425299,1662262116,1662262627,511,532
3862671795,3829110553,1660223154,1660223221,67,4827
3529171441,3712866599,1659035836,1659036388,552,818
3306033432,3121932661,1668256220,1668256330,110,834
3075373323,3688279543,1667687416,1667687819,403,822
3528467672,3945060698,1646085357,1646085487,130,2185
3380749106,3818604138,1646141275,1646141612,337,4267
3839737138,3210041436,1655857964,1655858785,821,1391
3654606032,3598729974,1646329491,1646330430,939,3412
3098277319,3254323047,1666076546,1666076782,236,862
3054363612,3620099468,1655570822,1655571471,649,610
3889575875,3615238608,1641313070,1641313509,439,3204
3689197449,3492778920,1665664176,1665664924,748,2439
3520911637,3787440200,1647240892,1647240906,14,3256
3615358050,3264742478,1644690952,1644691605,653,2958
3151014941,3628743824,1667489885,1667490338,453,4441
3378942802,3416281125,1664438559,1664439326,767,2863
3470283099,3530709506,1648244182,1648245083,901,2474
3186663153,3875596561,1652634991,1652635652,661,1676
3251723029,3603582737,1669374242,1669374540,298,4477
3094169704,3459144154,1652698913,1652699887,974,2595
3978204820,3928563088,1649423108,1649423707,599,4068
3197876508,3835471462,1666284944,1666285372,428,3465
3046348656,3463491336,1653187142,1653187279,137,4946
3510096731,3214230540,1656920084,1656920221,137,3844
3811460097,3849274587,1654371571,1654371789,218,2425
3252300222,3945298593,1658443236,1658443520,284,4349
3737088907,3771391766,1655129296,1655129306,10,945
3639220957,3539073188,1648775019,1648775367,348,1369
3159509340,3567967253,1655739070,1655739096,26,2599
3637112080,3490179443,1663373244,1663373413,169,402
3570462088,3755751669,1658683351,1658684268,917,3345
3721836433,3777996196,1646307371,1646308012,641,1816
3391246444,3305721544,1644381701,1644382329,628,1353
3592837340,3983998846,1664080466,1664081128,662,2375
3381148907,3162115728,1653510450,1653510484,34,979
3299899575,3602705568,1664361026,1664361915,889,2496
3297230139,3091400464,1651073717,1651074666,949,443
3760750358,3810825212,1647363984,1647364169,185,1727
3105799690,3618379459,1648502081,1648502805,724,852
3695910039,3744427697,1657167948,1657168754,806,1749
3145461329,3372799963,1652747335,1652747432,97,4982
3603573198,3392712847,1667827913,1667828760,847,3518
3826455983,3291434075,1659154434,1659155314,880,2270
3060156209,3333337378,1644025814,1644025907,93,3651
3062575242,3138035556,1664864898,1664865701,803,1549
3998527343,3548709081,1661741674,1661742202,528,229
3580709965,3191982118,1643860992,1643861008,16,3835
3784427172,3890143096,1653096875,1653097838,963,4231
3677538042,3604646007,1649124047,1649124387,340,4026
3993942678,3624959769,1659549980,1659550638,658,548
3742739075,3723163083,1664371664,1664372434,770,3299
3832461966,3127347872,1652964319,1652965212,893,4628
3865628503,3595316272,1648310042,1648310561,519,1094
3147286299,3774593799,1656475722,1656476602,880,127
3171538721,3541170429,1662092522,1662092594,72,2887
3864561560,3642740990,1655458242,1655458655,413,4425
3346959605,3830343046,1664474422,1664475085,663,2204
3523733420,3736424303,1647524506,1647524848,342,1903
3750545094,3664307350,1655444328,1655444728,400,3543
3888270412,3031886435,1645581583,1645582347,764,4662
3399754480,3826366559,1661447987,1661448481,494,4508
3543289152,3483292281,1660538566,1660538583,17,1597
3468891594,3819824806,1662101690,1662101744,54,3895
3902007145,3202901980,1652187374,1652187503,129,795
3743996328,3336431032,1669402576,1669402673,97,1231
3302842351,3291063242,1665193681,1665194159,478,1505
3052316153,3787641632,1642916449,1642916941,492,4609
3672385468,3396716219,1650963782,1650964013,231,2781
3683634781,3655040241,1651537373,1651538111,738,3515
3782577214,3075655628,1656178393,1656179288,895,3571
3336502079,3699029119,1653001111,1653001981,870,4732
3315592770,3218774316,1653111203,1653111280,77,2101
3550487892,3543310906,1651455642,1651456192,550,1642
3351555681,3706583834,1655412781,1655413226,445,3536
3531700811,3755788732,1669059209,1669059617,408,2843
3226714052,3671656055,1644461026,1644461994,968,820
3273828350,3900013732,1654973954,1654974868,914,3265
3112637847,3802949857,1654285279,1654285373,94,3141
3026478378,3792642651,1646449799,1646449963,164,889
3159154051,3550978062,1664251854,1664252419,565,1345
3550247564,3171725301,1658421214,1658422090,876,1
3875750919,3372224763,1654138600,1654139092,492,2844
3250943971,3492132581,1658595963,1658596089,126,3906
3583564954,3871167853,1666859866,1666860030,164,2363
3802885954,3140734715,1667249501,1667250016,515,406
3630020717,3435648503,1645441350,1645441629,279,240
3088519949,3999946301,1665395104,1665395731,627,366
3222401690,3073537628,1669291550,1669291721,171,2771
3985724889,3763845997,1666902980,1666903315,335,1477
3084190701,3890119159,1664166441,1664167216,775,1747
3824287014,3730819532,1665190323,1665190457,134,848
3729659206,3722252285,1667797501,1667798287,786,3562
3450844912,3188630843,1648332388,1648332865,477,2638
3890143096,3801609444,1649214536,1649214543,7,4344
3871466571,3560173142,1669536717,1669536719,2,414
3188349982,3974590845,1650519829,1650520481,652,3082
3129640561,3122549788,1660790926,1660791249,323,4065
3461911766,3182780927,1642748516,1642749320,804,1100
3659906918,3169676668,1665562358,1665562373,15,360
3138013652,3450034466,1663236855,1663237010,155,2121
3405160047,3215279922,1650875731,1650875872,141,656
3030984055,3248004056,1664794899,1664794986,87,1453
3904166650,3414818209,1641919857,1641920227,370,4627
3328472671,3761394980,1657244934,1657245044,110,3832
3047291248,3447689971,1655641800,1655642307,507,2932
3324604205,3163872728,1645172348,1645172777,429,3552
3102987122,3609886568,1655054952,1655055620,668,4392
3138182867,3371571578,1642190200,1642190524,324,4702
3567085166,3377851291,1644134398,1644134710,312,1506
3482761505,3958532879,1661791681,1661792276,595,4337
3601076423,3915598092,1661123098,1661123600,502,3186
3821327575,3427598132,1666016680,1666017025,345,4752
3245671059,3710159363,1656152498,1656152640,142,3335
3982425213,3677881418,1658145066,1658145097,31,3534
3571596349,3292932050,1653854539,1653855448,909,3466
3104518323,3939030777,1667250948,1667251491,543,1378
3033195058,3770386955,1644396249,1644396586,337,640
3581298178,3818437463,1667401683,1667402173,490,3878
3378604587,3628575260,1654400128,1654400559,431,3710
3804202781,3329714914,1661485012,1661485451,439,1385
3810434592,3671987136,1644508069,1644508665,596,4736
3841350643,3958354905,1664097449,1664098273,824,2458
3569604140,3637171342,1652692828,1652693420,592,4823
3368089943,3246110988,1644822803,1644823507,704,1558
3100267825,3814921306,1668402357,1668403308,951,4083
3836379009,3762063812,1645876460,1645876868,408,385
3339717550,3932226624,1660533537,1660534413,876,4522
3312072527,3789950154,1649476834,1649477563,729,2829
3282326983,3428408085,1661519835,1661520129,294,2203
3090940539,3753121951,1668712798,1668713272,474,93
3150345168,3357364345,1665381098,1665381880,782,3559
3166804055,3586355017,1660295217,1660296153,936,1352
3675439075,3420664796,1651256683,1651257129,446,740
3546715923,3478853138,1643825067,1643825465,398,4477
3537389967,3362081453,1657588785,1657588925,140,3896
3772346285,3539515291,1652614966,1652614983,17,4260
3812537668,3825405054,1669399641,1669400115,474,4848
3266311665,3302358976,1663939360,1663939533,173,3857
3173787242,3331532429,1650103975,1650104652,677,3987
3296128827,3835119846,1654179717,1654180343,626,889
3656739208,3951811943,1651604332,1651604813,481,4742
3413294173,3244283871,1656656208,1656656653,445,1112
3093440501,3230906845,1657896487,1657897355,868,1086
3226372844,3435300131,1655486551,1655486572,21,4920
3824953035,3208626891,1649662721,1649663385,664,3212
3523151922,3897578042,1666799665,1666799722,57,2054
3348530607,3698266932,1662375002,1662375738,736,2101
3221277973,3945598699,1662789184,1662789705,521,4275
3552791995,3038506055,1646546358,1646546967,609,1406
3751090394,3417206733,1643790959,1643791600,641,1650
3938694264,3578155570,1653655467,1653656367,900,2185
3820175445,3722459488,1658953643,1658954494,851,3157
3908540269,3185804510,1656603685,1656604075,390,1910
3202814590,3585377392,1654234828,1654234862,34,2894
3308995083,3591847136,1653710993,1653711760,767,2167
3319553078,3143199583,1660102583,1660102699,116,2376
3209709407,3075925684,1650686446,1650687183,737,4342
3806209580,3542587993,1665282542,1665283045,503,2348
3917571245,3977901639,1645692636,1645693340,704,942
3557860955,3408770914,1644657056,1644657184,128,1553
3355194209,3722761304,1641048464,1641048668,204,2633
3330311670,3527109946,1647050717,1647051088,371,1874
3999675454,3548345162,1662724335,1662725085,750,1306
3440090165,3986801877,1656644365,1656644852,487,2009
3984664863,3540709908,1648215736,1648215827,91,1559
3106938186,3716612963,1668968867,1668969254,387,508
3073701739,3088689670,1642418000,1642418688,688,286
3770357332,3244038083,1669053336,1669054179,843,3886
3269290190,3385499361,1669205142,1669205477,335,4614
3170282906,3471108590,1663652428,1663652504,76,1399
3521206789,3511619778,1662160473,1662161451,978,3185
3596346736,3614299688,1658196859,1658197008,149,1943
3090174365,3061271543,1665153811,1665154728,917,508
3260087940,3416497485,1649185278,1649185643,365,3664
3404575964,3687526259,1662440548,1662441327,779,864
3326690298,3556516202,1651121675,1651122644,969,3637
3403636226,3424703597,1652255081,1652255373,292,2776
3011481822,3780909534,1658350483,1658351148,665,2927
3866497340,3808572580,1662860827,1662861415,588,2358
3257163819,3218457279,1663684684,1663684789,105,1855
3026302626,3067979078,1652415966,1652416518,552,2567
3202676928,3001100999,1665141887,1665142434,547,4856
3596998905,3188374962,1644730582,1644731161,579,4168
3403924298,3425927893,1650301563,1650302015,452,907
3617474566,3169093499,1641319984,1641320852,868,1081
3023564878,3494000260,1659884176,1659884279,103,1963
3739054854,3557949222,1647121666,1647122580,914,3434
3639734967,3631387891,1641721045,1641721187,142,4911
3767113112,3047971083,1641060116,1641060739,623,1141
3545771205,3039561822,1655391110,1655391899,789,3554
3451341334,3995762624,1649121332,1649121928,596,3913
3749129961,3402345379,1652452223,1652452604,381,4710
3405384223,3423083428,1657763569,1657764349,780,675
3683269757,3008374032,1658673869,1658674535,666,1141
3695686095,3579689008,1663290108,1663290658,550,3206
3216146301,3529709498,1656276742,1656277476,734,1633
3474670707,3478099341,1666349589,1666350555,966,2669
3099830903,3657014318,1669456263,1669456345,82,2585
3466762920,3097529093,1654436383,1654436862,479,511
3651996394,3194182925,1649981306,1649981390,84,2084
3888777347,3401739951,1662144708,1662145596,888,3329
3082636241,3644197617,1656703292,1656703753,461,731
3919010639,3098089582,1661764024,1661764820,796,647
3236090873,3565508658,1644109146,1644109262,116,3791
3143810223,3620280552,1648696483,1648696809,326,4836
3542884067,3770610488,1642829518,1642829713,195,2205
3377768905,3577981738,1643505537,1643506044,507,3087
3961937521,3360555373,1659679656,1659680620,964,1375
3932478642,3448314398,1651137458,1651137687,229,1816
3740101368,3349039777,1651381345,1651381624,279,4628
3330217564,3396867763,1658184463,1658185049,586,4811
3963364551,3805206184,1659818157,1659819129,972,4041
3341027780,3167963222,1665023269,1665023392,123,223
3974211459,3219503082,1668174759,1668175344,585,1889
3835571911,3310582923,1650630768,1650630870,102,4376
3188478798,3117251714,1654879215,1654879223,8,58
3985676652,3440874098,1649035191,1649035369,178,4353
3267322883,3911256928,1658779525,1658780449,924,2364
3381013188,3203016040,1662145839,1662146704,865,2547
3465479209,3979068120,1651180317,1651181116,799,2553
3472959004,3975443976,1658249054,1658249615,561,631
3254276631,3447661239,1651062465,1651062925,460,457
3120903339,3628451803,1652181326,1652181568,242,1653
3825058006,3331241632,1650440831,1650441552,721,3569
3428076212,3102682819,1643450359,1643451109,750,4340
3740870870,3930244269,1656140200,1656140573,373,640
3583689703,3516229890,1646474700,1646474785,85,4060
3406000969,3247646892,1669261425,1669261656,231,1113
3685874971,3409107628,1652209430,1652210184,754,1378
3858480724,3872795541,1643627497,1643627658,161,3773
3800273975,3139277759,1656637866,1656638732,866,3027
3957943369,3390093327,1660426433,1660426785,352,1343
3854454730,3392664309,1663878212,1663878390,178,2473
3114750376,3116559755,1668186168,1668186226,58,3703
3179993730,3335214941,1655773445,1655773719,274,1284
3249731449,3644878085,1655797246,1655797933,687,2251
3481840286,3059751436,1648817432,1648818405,973,709
3437142550,3677761458,1642090095,1642090638,543,656
3228483742,3351109940,1668764635,1668765107,472,942
3689771088,3098212460,1667996908,1667996933,25,4296
3933642303,3886504409,1655877061,1655877146,85,2987
3948915650,3757845227,1666049013,1666049734,721,385
3180121886,3792296583,1641796637,1641796656,19,475
3441126507,3853143751,1660247178,1660248068,890,4877
3552287240,3478530526,1641061943,1641062403,460,2512
3554171318,3494721240,1658320944,1658321056,112,4284
3605291632,3878364670,1652428428,1652429020,592,3036
3831547968,3599679982,1642612254,1642612940,686,4389
3514765572,3972745481,1668931788,1668932426,638,4276
3915768408,3993603439,1654695969,1654696691,722,858
3761528719,3179470430,1655164735,1655165424,689,3646
3256186793,3104363404,1652727881,1652728428,547,889
3379001682,3817502847,1655317993,1655317996,3,2875
3122738314,3597632549,1659712213,1659713013,800,740
3464584976,3302521132,1661744400,1661744498,98,1300
3485241669,3717054406,1655374449,1655375141,692,1409
3445538764,3293091412,1647941562,1647942021,459,3556
3486111423,3092132615,1645126850,1645127423,573,3014
3921023874,3960500195,1665608287,1665608966,679,68
3437356409,3348746817,1646407527,1646408064,537,4160
3455464749,3403353454,1661726621,1661727211,590,1301
3471230514,3757108494,1648132453,1648132492,39,1856
3195801778,3386253702,1662883559,1662883876,317,2911
3466937366,3694174214,1644229785,1644229797,12,2299
3699951476,3960472813,1669020677,1669021350,673,1923
3646019345,3554937871,1659103754,1659103958,204,2601
3204403688,3588181050,1644007892,1644007941,49,1799
3574241445,3234229602,1643493674,1643493885,211,3515
3908594533,3348530115,1668553040,1668553147,107,151
3398445572,3343643337,1656459608,1656459796,188,3992
3038341088,3405302420,1651222956,1651223006,50,3804
3469493418,3093087021,1642751288,1642751953,665,2008
3833432021,3943346495,1645417368,1645418073,705,1844
3270516134,3455260054,1648778090,1648778498,408,990
3427175524,3987311166,1647038402,1647038500,98,1125
3088332872,3839164659,1647142595,1647143263,668,2013
3263155251,3340341143,1646627912,1646628836,924,486
3344529439,3022915099,1657313358,1657313438,80,1295
3754700642,3764772846,1652358788,1652359728,940,3588
3352824494,3127543409,1653722389,1653723135,746,4408
3246125128,3307876792,1669338494,1669339487,993,1057
3258792236,3371931353,1667089681,1667090211,530,1956
3960384146,3201084450,1642848199,1642848541,342,4808
3913906985,3646801155,1651723709,1651724138,429,4688
3016342132,3848550298,1647690472,1647690966,494,4760
3560753651,3232568291,1662838852,1662839742,890,3437
3855440794,3841555144,1663935533,1663936468,935,3978
3298672241,3629706514,1658708675,1658708904,229,3310
3253556462,3233013983,1667892175,1667892955,780,2085
3538527931,3963446461,1667899366,1667899809,443,3692
3923975146,3428806029,1654675573,1654675695,122,1770
3250894173,3746453024,1644111006,1644111410,404,2190
3754984650,3041644555,1664002095,1664002831,736,3431
3392516972,3097296127,1643247561,1643248354,793,835
3342080180,3215294687,1653675796,1653676158,362,963
3484299307,3420170776,1651613330,1651614290,960,3433
3763507059,3866076723,1658259909,1658260404,495,4386
3576089098,3544221289,1654324890,1654324977,87,703
3238812036,3721190156,1665179415,1665180207,792,4343
3480131178,3671749131,1651176842,1651176946,104,2065
3712817281,3464771600,1643593175,1643593237,62,788
3885745602,3392685425,1657189154,1657189964,810,4574
3588372604,3893909478,1644898420,1644898708,288,3429
3883028073,3871968003,1665009206,1665009970,764,3463
3746283563,3630787519,1658128539,1658128887,348,3494
3978746843,3262907833,1647001613,1647002421,808,3690
3044815413,3564481890,1662286985,1662287788,803,2248
3971756049,3882303568,1642720708,1642721273,565,2047
3254739679,3262067406,1655598243,1655598382,139,4632
3368985927,3562540731,1661585928,1661585994,66,2432
3860103565,3559297824,1649407600,1649407837,237,1752
3495421511,3523427088,1654018059,1654018278,219,1293
3711675297,3265029216,1663405847,1663406101,254,1222
3674518206,3789665160,1651771064,1651771091,27,4273
3961827451,3205616340,1652607534,1652608217,683,2625
3219168583,3013482061,1668110804,1668111144,340,4545
3234505915,3199024050,1643193267,1643193661,394,1830
3693888503,3823693447,1648530266,1648530319,53,600
3757692867,3694363265,1642077825,1642078785,960,1399
3196894221,3300981886,1661400403,1661400904,501,1321
3975520580,3521712313,1669346895,1669347595,700,2234
3757526551,3955548358,1664959628,1664960593,965,1909
3421865841,3698541332,1666617159,1666617758,599,793
3753403821,3633428273,1651264648,1651264685,37,1614
3630119090,3630638680,1652171736,1652172145,409,2859
3718181680,3713863755,1657703442,1657704360,918,1765
3386093666,3338603013,1650666143,1650666426,283,1381
3072685680,3268840815,1650471242,1650472030,788,3202
3974733980,3774165064,1641768516,1641769099,583,3796
3762066654,3755124388,1644239826,1644240816,990,4877
3037588671,3563564944,1650006777,1650007204,427,1818
3336116499,3822394029,1655176021,1655176523,502,1181
3936340071,3130051512,1647932823,1647933067,244,4091
3224434359,3359491188,1654845804,1654845860,56,1699
3165313251,3564889132,1662095492,1662095892,400,3360
3826185313,3914587618,1646660725,1646661063,338,1782
3059912537,3450935587,1649798839,1649798890,51,4098
3310849486,3920644264,1643504141,1643504524,383,923
3680336662,3794868313,1668593262,1668593304,42,1366
3035008597,3602652344,1660317664,1660318344,680,2359
3272117397,3741381858,1662537429,1662538357,928,599
3560642493,3575160739,1657878190,1657878332,142,1594
3295744839,3306278125,1662549584,1662550243,659,2617
3572154724,3536128220,1669291449,1669292270,821,3959
3296234359,3716679968,1665667716,1665668580,864,36
3264633899,3242602202,1641845027,1641845336,309,173
3932317531,3222160468,1653215560,1653215766,206,3693
3751549455,3886434676,1652159772,1652160000,228,4138
3741578482,3443539877,1654417801,1654418406,605,770
3405901784,3498256277,1665177918,1665178688,770,3737
3048692547,3481710826,1662279272,1662279338,66,3517
3327178856,3365264986,1666867281,1666868246,965,4096
3502786578,3199180897,1668245748,1668246637,889,4217
3274149354,3302251865,1648993568,1648994417,849,4640
3870573246,3564605624,1645730954,1645731199,245,2476
3704804253,3378049518,1648356036,1648356803,767,4570
3189562891,3510952195,1644842353,1644842839,486,2122
3460185818,3757478759,1654713389,1654714302,913,1747
3591748100,3245100019,1648203024,1648203250,226,3681
3170802374,3636841288,1665129743,1665130282,539,1145
3444912644,3873004804,1661238911,1661239772,861,1754
3374374607,3688052340,1658594070,1658595057,987,1450
3696655850,3322272098,1653396107,1653396942,835,340
3815151211,3248724364,1664143194,1664143699,505,3279
3586307750,3523401608,1650048369,1650048388,19,4085
3301629759,3049940626,1654309804,1654310200,396,3313
3310260614,3266933627,1665942546,1665943537,991,2641
3803964033,3924890597,1655171891,1655172591,700,4457
3637483915,3239009986,1666107487,1666108097,610,1233
3691315260,3215133026,1641660712,1641660871,159,4133
3630785542,3571401798,1644778609,1644779271,662,1332
3642219477,3766727007,1641940997,1641941814,817,2075
3426256478,3904416353,1649729641,1649730459,818,3323
3163792852,3050526279,1660489981,1660490941,960,3382
3351808374,3708170062,1666771324,1666772068,744,3969
3323024450,3953472226,1663361976,1663362001,25,886
3749537061,3871470708,1667662072,1667662832,760,4686
3635489265,3159155067,1660568579,1660568997,418,1427
3024080340,3628464345,1659711688,1659712592,904,1746
3132125558,3581400124,1656465819,1656466533,714,1169
3644966072,3047326551,1651716649,1651716780,131,3670
3140820958,3581498358,1659702638,1659703164,526,1953
3534941269,3388887968,1644823692,1644824427,735,2374
3300421434,3177547285,1656102481,1656103313,832,3607
3923352503,3082463976,1650413001,1650413759,758,1255
3101462736,3097033437,1665649743,1665650239,496,3209
3077794870,3577707384,1667776484,1667777056,572,3491
3977999074,3267954918,1658814408,1658815105,697,170
3163988876,3253801826,1663379628,1663380017,389,44
3921478417,3766911543,1658942900,1658943158,258,1427
3451469556,3429899673,1663031578,1663032009,431,778
3090460772,3351899861,1647225442,1647225853,411,1611
3767123625,3907367592,1649160011,1649160271,260,4785
3495021433,3966676628,1660274184,1660274452,268,857
3918074888,3550265683,1645732045,1645732275,230,1722
3416446744,3537606287,1668430617,1668430768,151,1799
3578729092,3271463836,1668019688,1668020338,650,1839
3004000770,3411949925,1667733812,1667734472,660,2872
3551843966,3460318163,1669280943,1669281640,697,1554
3250610354,3599980068,1646840665,1646840699,34,2421
3778738872,3682602748,1645856862,1645857552,690,3099
3751322103,3707729215,1659898479,1659899073,594,3062
3110596659,3373518779,1666047907,1666048834,927,779
3316285069,3548568847,1648534495,1648534894,399,4823
3676740753,3347455197,1657729323,1657729492,169,1092
3054024187,3964641389,1665241722,1665241844,122,4547
3910375857,3187498134,1647116864,1647117590,726,955
3871278184,3906460699,1663026918,1663027089,171,3107
3494257076,3194926606,1645149970,1645150663,693,1291
3681057615,3499954423,1662649850,1662650113,263,437
3609201533,3137475041,1652425497,1652425992,495,1690
3815848024,3525220847,1661297363,1661298183,820,2286
3675319138,3986347379,1649594510,1649595193,683,2940
3785205523,3502173819,1653846619,1653847456,837,978
3403410173,3651716202,1644184866,1644185543,677,4333
3727601262,3889052940,1664541597,1664542521,924,2748
3766691799,3390107075,1662740644,1662741373,729,1803
3542173845,3493283452,1651698569,1651699425,856,2498
3626337599,3488878846,1641126769,1641127758,989,3173
3900117908,3135289079,1642679533,1642679900,367,619
3121015503,3218238364,1664992049,1664992056,7,1419
3357703785,3899792141,1667220013,1667220775,762,3570
3453756173,3915141290,1658927832,1658928813,981,3710
3809418349,3826494905,1659304470,1659304704,234,4142
3077650927,3501812131,1660159287,1660159299,12,1875
3985079278,3640384059,1668675967,1668676667,700,643
3517665442,3077161737,1659692601,1659693483,882,3643
3241539858,3962311147,1665576384,1665577330,946,231
3808797170,3400725995,1667183640,1667184054,414,300
3664417228,3741380687,1661649522,1661650202,680,653
3408911316,3707410906,1658518577,1658519260,683,4641
3044123087,3246468967,1641513505,1641514130,625,833
3475979227,3901524785,1664717077,1664717308,231,3559
3087153936,3935027940,1641305819,1641306537,718,48
3592740297,3623918942,1663728302,1663728646,344,2291
3744043286,3807117586,1653501122,1653501187,65,2896
3729732241,3210732822,1664431220,1664431259,39,1342
3914803262,3167148971,1647649724,1647649914,190,2481
3706581145,3039865830,1666217935,1666218592,657,3201
3442980597,3839145437,1648840773,1648840891,118,2440
3731567775,3525089768,1653981589,1653982427,838,3173
3571368547,3705298318,1646628948,1646629710,762,1623
3909326097,3992737476,1650848039,1650848097,58,312
3784289524,3847806013,1649328056,1649328885,829,4204
3843226507,3286500475,1646441047,1646441417,370,3009
3044130455,3680652879,1644205062,1644205257,195,4092
3591688852,3425605275,1665818661,1665819241,580,4053
3588810056,3548345162,1665375867,1665376490,623,682
3926206853,3630617290,1653831259,1653832184,925,4899
3542708265,3925384672,1669114754,1669115630,876,1024
3501141385,3178993826,1641271463,1641272201,738,544
3239722014,3565263334,1661710260,1661710487,227,1712
3242561359,3925355678,1650550936,1650551382,446,685
3868486175,3124770107,1657867716,1657868689,973,4488
3999334180,3933858594,1654602761,1654602883,122,4403
3218748459,3652260203,1666373308,1666374271,963,1239
3565909531,3190157752,1645795709,1645796264,555,3278
3780622305,3461242167,1647171400,1647171672,272,569
3953645994,3682678588,1653562138,1653562793,655,3739
3779452562,3012453886,1648722338,1648723219,881,4838
3350815149,3313723420,1669309294,1669309904,610,691
3545410939,3970111684,1645429821,1645430314,493,3243
3114619644,3284521403,1648410289,1648410699,410,2437
3406979664,3772896888,1648131868,1648131999,131,3376
3703394220,3912103944,1655473196,1655473309,113,3130
3358110136,3626517500,1650877296,1650877736,440,864
3691336128,3125234814,1651879266,1651879681,415,4922
3001099329,3156782812,1648355457,1648355849,392,3676
3767165641,3771071775,1644292792,1644293644,852,66
3353546765,3312823125,1657912455,1657913413,958,1550
3983076274,3853643550,1665684918,1665685685,767,2067
3188273784,3342296552,1659434195,1659434436,241,2895
3689968634,3340197579,1647892277,1647892713,436,1553
3361264429,3338929243,1653341848,1653342213,365,2511
3308307785,3568621227,1653866960,1653867100,140,2806
3663847185,3758822955,1648572047,1648572677,630,1923
3204527056,3203828802,1643012952,1643013359,407,2675
3557279889,3477930959,1652893398,1652894342,944,2253
3648282210,3853972385,1649673525,1649673772,247,3846
3613568895,3953340613,1641501090,1641501754,664,4410
3129722690,3643099500,1644210191,1644210808,617,1480
3733847547,3147259329,1668875973,1668876254,281,2270
3025749847,3700346465,1652171203,1652171286,83,3835
3392896372,3740152926,1657054731,1657055224,493,2725
3201637456,3052887785,1658226604,1658226958,354,3534
3135717121,3068904356,1665181448,1665181541,93,3127
3628029374,3556961462,1658355239,1658355634,395,4803
3118296222,3365557193,1657554584,1657555291,707,2623
3817875675,3989065367,1653735175,1653735599,424,4106
3380529722,3806420155,1657893192,1657893484,292,2184
3265341166,3180574466,1653926568,1653927028,460,1062
3922448839,3424660142,1662465661,1662466621,960,4629
3088708140,3941841916,1650944161,1650944788,627,3460
3051934165,3357947898,1656159703,1656159837,134,4878
3106953325,3604038280,1644363112,1644364037,925,4118
3356396782,3792642651,1659672451,1659673038,587,1532
3192115542,3687844620,1665646685,1665647561,876,3338
3051252208,3561312616,1659627698,1659628603,905,1127
3803498677,3860708543,1661838301,1661839003,702,1799
3450438360,3842266483,1644828137,1644828577,440,685
3525178730,3133972580,1656827847,1656827971,124,3581
3761959252,3201280383,1653895165,1653895302,137,2669
3364465926,3274664746,1651668726,1651668819,93,3831
3167415517,3097347426,1645276182,1645276523,341,190
3148918456,3289436886,1662820400,1662821317,917,4183
3926440139,3989906149,1664480630,1664480814,184,758
3849860490,3301754004,1658961422,1658961697,275,647
3139458870,3805944469,1668363380,1668363703,323,2236
3015777969,3792549456,1648987421,1648988213,792,1418
3480265340,3554104266,1669554448,1669554752,304,2181
3541525319,3628947165,1643511999,1643512346,347,2728
3763838198,3045293045,1666828875,1666828980,105,1633
3794665153,3285911205,1658173174,1658173520,346,2256
3193039385,3304232018,1667039031,1667039264,233,683
3202353215,3323951937,1658111515,1658112328,813,2660
3436976067,3148076889,1662326868,1662327760,892,1231
3898569984,3579759385,1662307202,1662308182,980,3182
3922896995,3499209084,1657366449,1657366728,279,246
3788432573,3120775834,1648762723,1648763288,565,3686
3054139858,3962706229,1653735153,1653735830,677,56
3091871728,3300937071,1646614901,1646615495,594,4412
3440818662,3887326641,1651148312,1651148709,397,4356
3515473403,3898071683,1647384756,1647384810,54,626
3062224491,3261615281,1652674193,1652674815,622,3231
3277777472,3908200307,1656393928,1656394375,447,3505
3139377155,3201226354,1645443918,1645444620,702,2925
3111435024,3162703743,1664574474,1664575457,983,1755
3948915650,3067652476,1649117969,1649118742,773,1425
3479584194,3482949060,1651203927,1651204170,243,3118
3300503997,3145901939,1645965189,1645965325,136,289
3952698379,3361372787,1661633770,1661634394,624,541
3745264546,3146779123,1656122334,1656123329,995,4794
3536046492,3507953967,1641893292,1641894097,805,4437
3149469828,3446288655,1643377138,1643377933,795,4221
3526288388,3786712450,1656182134,1656183079,945,2615
3352630964,3328211193,1644594765,1644595729,964,3185
3752625301,3042584481,1653032459,1653032763,304,3573
3722903283,3241920582,1646305467,1646306193,726,1123
3514438436,3645329717,1646549354,1646549500,146,759
3570712387,3987843285,1647071840,1647072726,886,2921
3798522127,3728105217,1643081437,1643081872,435,4377
3084743406,3089478157,1651649981,1651650430,449,1880
3141554481,3993857163,1643154999,1643155668,669,1374
3001758030,3758149388,1657532475,1657533324,849,1000
3299735839,3622301019,1667099132,1667099713,581,4824
3180574466,3708839927,1645134248,1645134791,543,4279
3836955585,3919097299,1660797406,1660797434,28,2407
3080990637,3184962964,1654541318,1654541502,184,4106
3237274432,3297456838,1663838512,1663838862,350,4585
3292116412,3936246082,1648131124,1648131543,419,912
3144911534,3826812334,1660384252,1660384577,325,3125
3859680832,3351960673,1647741791,1647742172,381,710
3749702788,3156155190,1641014846,1641015702,856,4215
3576356701,3768307398,1657396895,1657397761,866,778
3525853209,3308032258,1651264168,1651264345,177,1282
3173945958,3817098387,1650980340,1650980922,582,2575
3508392031,3275562169,1664114015,1664114927,912,2241
3458622839,3699215956,1660545816,1660546557,741,4338
3409636054,3936496046,1667951632,1667952121,489,2792
3432325278,3403261513,1652220288,1652221262,974,1896
3519422962,3291079963,1653401878,1653402390,512,2700
3962407099,3535747182,1662061423,1662061860,437,1203
3307310604,3579678913,1654425820,1654426226,406,1667
3837245457,3403261513,1663383029,1663383541,512,280
3501292025,3832001337,1662773099,1662773378,279,1969
3494815650,3446209385,1659199341,1659199785,444,3557
3537166563,3957045547,1655980942,1655980964,22,3422
3089917139,3777026542,1657087199,1657087583,384,764
3951024009,3122191999,1652751037,1652751104,67,3515
3831270311,3303288727,1648419284,1648419751,467,2083
3985813977,3772053686,1646323341,1646323414,73,2634
3818380375,3847263076,1661675493,1661676365,872,108
3375502502,3526679239,1655512071,1655512327,256,2969
3972378699,3283078131,1656901979,1656902355,376,4658
3030037566,3298853560,1645558935,1645558973,38,2086
3966530798,3698949568,1658403187,1658404054,867,4589
3815916132,3572487872,1657034154,1657034611,457,3440
3804317416,3333164976,1650909385,1650909440,55,569
3063788647,3946086472,1653180601,1653181512,911,463
3068904032,3837942338,1666143974,1666144908,934,2146
3559037110,3946344222,1665320827,1665321226,399,2103
3665862213,3708580846,1646321204,1646321714,510,4426
3834512672,3630899785,1651252916,1651253141,225,1927
3724192620,3207786773,1643751473,1643751520,47,936
3862886376,3758900784,1653014590,1653015406,816,4229
3636960418,3192753922,1665273652,1665274157,505,1259
3730119543,3514664536,1645477333,1645477999,666,2455
3127100291,3485864792,1646314233,1646314331,98,1137
3398699140,3642691546,1656799123,1656799958,835,1103
3778876769,3723505887,1658751708,1658752080,372,1162
3752980168,3226300360,1664226578,1664226681,103,2067
3297938817,3384393637,1656008376,1656009075,699,1151
3302156937,3043477364,1651487629,1651487886,257,3724
3287672110,3430939314,1664280249,1664280385,136,1482
3272096141,3306031895,1665819207,1665819465,258,1017
3971645469,3774335279,1656871515,1656872490,975,3889
3062317302,3325885842,1656205790,1656206302,512,1798
3230964050,3293301331,1654574317,1654574409,92,3947
3112486497,3090407649,1642884324,1642885105,781,1391
3594548782,3738260889,1646433516,1646434340,824,4420
3323708845,3265136047,1652749809,1652750028,219,2422
3096306609,3993624536,1669386993,1669387164,171,890
3251438610,3570385891,1661396152,1661396739,587,2697
3043083509,3231508151,1642671030,1642671405,375,1042
3553500462,3265576339,1651177872,1651178845,973,1749
3546634955,3730612717,1647983319,1647983664,345,1754
3835552462,3527346945,1667903399,1667904009,610,4972
3662110939,3774936479,1655388989,1655389846,857,193
3900142687,3127054704,1641101894,1641102459,565,2106
3161077110,3037343455,1667816294,1667816484,190,849
3973024285,3619832319,1657509542,1657510455,913,355
3208014354,3731811281,1648070348,1648070965,617,379
3307795298,3935499567,1669662285,1669663042,757,1508
3490486086,3037011539,1668226403,1668227396,993,2389
3646358727,3888833783,1653021372,1653022056,684,3605
3068850924,3292073129,1661364609,1661364856,247,2083
3368173677,3783805829,1658655265,1658655626,361,1160
3276763747,3622859080,1646902544,1646903086,542,1385
3565472705,3484444883,1641452918,1641453349,431,3233
3131107786,3918649320,1657105624,1657106029,405,4895
3550265683,3938083212,1644655891,1644656426,535,1072
3965223618,3472436734,1652571893,1652572205,312,2300
3493294063,3489405310,1650511485,1650512187,702,4003
3309166464,3889793395,1656888916,1656888992,76,1283
3552737749,3223755304,1645069202,1645069949,747,4036
3374537966,3174455400,1664695943,1664696251,308,1267
3405169545,3931707090,1644466173,1644466380,207,2705
3018765562,3074466727,1667601703,1667602097,394,3041
3599370503,3245042651,1660435287,1660435690,403,2935
3878044865,3327236994,1643414885,1643415188,303,1124
3940864555,3024620065,1661399447,1661399566,119,211
3757087656,3364733152,1658440092,1658440919,827,2619
3808783604,3773512145,1655936463,1655937376,913,1585
3919506304,3704718768,1648648800,1648649136,336,240
3356384604,3767165641,1667362375,1667362818,443,2003
3635087718,3960487190,1646808359,1646809139,780,1936
3988302054,3579508389,1662061959,1662062473,514,946
3124729047,3236100558,1668195372,1668195924,552,4432
3703290964,3560535530,1661120202,1661121126,924,362
3141046099,3339029426,1665314174,1665314800,626,4703
3495131345,3473577249,1652058228,1652059020,792,2685
3070849157,3249129100,1651042204,1651043095,891,518
3252649920,3413778287,1656572042,1656572141,99,2106
3243182336,3574998696,1665688439,1665689037,598,3882
3604433681,3931869113,1662572339,1662572648,309,3177
3505809392,3028597701,1659316886,1659317382,496,511
3477683227,3703008794,1667935549,1667936299,750,1513
3048093798,3535747182,1655017294,1655017464,170,3376
3368949951,3540568708,1664203106,1664203642,536,1735
3203875843,3146741535,1669547204,1669547549,345,1821
3705522123,3924064557,1645988457,1645989019,562,493
3376453034,3392896372,1658380630,1658381235,605,161
3970415174,3991900912,1655886620,1655887256,636,4768
3336928352,3514543772,1658807733,1658808065,332,548
3687491889,3211605348,1664757419,1664757623,204,1147
3339827582,3093196535,1662744366,1662744455,89,304
3844874735,3486406925,1653682069,1653682675,606,3691
3683875286,3355109679,1667254244,1667255172,928,2152
3629157343,3623783697,1649077860,1649078675,815,1614
3682098110,3182263263,1643616957,1643617220,263,4426
3017333665,3332667472,1665101177,1665101269,92,2568
3203322937,3631842883,1656282739,1656283219,480,3434
3907845718,3245266382,1659965931,1659966929,998,4584
3239198677,3068844957,1646017137,1646018035,898,3763
3342933842,3618413624,1661801044,1661801742,698,4476
3715540652,3272141099,1657345629,1657345679,50,3791
3610078862,3683190297,1646610752,1646611263,511,483
3008850494,3474188174,1643908687,1643908999,312,2509
3201257739,3895360147,1647884239,1647884423,184,2343
3274265198,3013297825,1647523496,1647523903,407,2372
3259531425,3328044847,1655075359,1655075576,217,1673
3267347155,3191387654,1667464980,1667465491,511,3579
3665978765,3144810573,1661533404,1661534171,767,607
3893837188,3402345379,1647487402,1647487808,406,2344
3324252807,3251154279,1652322009,1652322504,495,4565
3548151258,3482882129,1649720464,1649720983,519,2150
3494351640,3361668983,1664856374,1664857164,790,589
3784003540,3575869326,1668625851,1668626018,167,994
3300244312,3117547914,1643008377,1643008871,494,65
3286101576,3279867105,1658337806,1658338652,846,1026
3881146500,3741696983,1645309439,1645309642,203,1796
3306906172,3199831180,1656617403,1656617841,438,4886
3917524565,3763686486,1646856459,1646856683,224,3823
3759273820,3773476248,1654144294,1654144863,569,852
3715844211,3994511673,1653305161,1653305916,755,4963
3753907045,3909595253,1663462745,1663462973,228,4638
3332953033,3993838597,1669223872,1669224587,715,2123
3437992845,3714882747,1669312706,1669313590,884,3522
3041619696,3399199221,1658784621,1658784810,189,4321
3083658616,3368130392,1645854101,1645854273,172,282
3707576320,3330490223,1657274463,1657275245,782,3183
3412481737,3171895707,1654515053,1654515578,525,1984
3760551567,3972777485,1661909230,1661910177,947,3741
3227173673,3826096769,1650077764,1650077855,91,580
3673688489,3370689260,1656847414,1656847499,85,2824
3676397584,3732233361,1646307467,1646308251,784,2231
3095373147,3473649583,1655664477,1655664931,454,1281
3935185752,3338493911,1667696245,1667696735,490,772
3034452600,3235248675,1660687993,1660688904,911,3774
3171912269,3925053951,1665737237,1665737986,749,4956
3747921425,3583468224,1663646668,1663647141,473,3228
3321193364,3641561507,1641832707,1641833223,516,3339
3302021985,3464131567,1642175858,1642176782,924,4557
3702899556,3116251100,1651228112,1651228724,612,2463
3804299472,3160446976,1656108737,1656109633,896,293
3129273872,3201468879,1668973745,1668974450,705,4841
3766511522,3464240830,1646508871,1646509405,534,3116
3397948941,3738027813,1643807649,1643807868,219,615
3287662177,3921918920,1653189865,1653190787,922,604
3313601365,3042510067,1653527947,1653528334,387,2059
3945060698,3010683479,1652975590,1652975678,88,2562
3910253198,3180996884,1649825705,1649825863,158,4161
3690519998,3320360653,1650884658,1650884900,242,4306
3192522421,3399850044,1653734330,1653734400,70,1462
3119362894,3492640258,1647212745,1647212828,83,4609
3462035239,3558330280,1651655775,1651655990,215,216
3158865765,3640426977,1661615604,1661615812,208,1066
3400661273,3803087281,1668516032,1668516594,562,7
3134967525,3198914070,1655010989,1655011710,721,4517
3843996524,3219500147,1666189206,1666190074,868,2482
3236196443,3378489042,1657848277,1657849027,750,1326
3220553840,3014703718,1645105217,1645106104,887,4809
3937636916,3225361896,1654563807,1654563935,128,191
3230646140,3439802378,1667737848,1667738728,880,965
3270744720,3110449909,1647054733,1647055544,811,403
3144957525,3442730455,1649565114,1649565860,746,4237
3471628796,3782190717,1652278990,1652279193,203,3910
3410390070,3492471935,1660181740,1660181791,51,346
3735807924,3005022782,1652714935,1652715730,795,2272
3493313921,3735721228,1665638610,1665638690,80,1748
3117074592,3650611394,1660302441,1660302944,503,334
3508097014,3031266520,1662773730,1662773858,128,4532
3726450257,3874549392,1669174226,1669174295,69,166
3561079655,3194826702,1666203850,1666204626,776,4104
3818148787,3862441428,1668720898,1668721071,173,539
3237909233,3984190380,1642840197,1642840558,361,414
3197371712,3479274089,1641673219,1641673917,698,3597
3690563134,3816915806,1643399613,1643400198,585,3316
3758420719,3516352354,1651596501,1651597193,692,1897
3302615601,3927834604,1662643165,1662644120,955,107
3284336508,3344868559,1644447995,1644448292,297,4448
3244499574,3349300699,1647951351,1647951572,221,1118
3513182514,3070940052,1655182323,1655182732,409,1800
3346138346,3709847975,1659108084,1659108982,898,123
3561037331,3048809723,1662671379,1662671572,193,3003
3921713955,3911594948,1656801589,1656802411,822,660
3521636607,3792168237,1643889840,1643890183,343,4169
3845018765,3464670639,1653735538,1653736020,482,1638
3086343307,3807457266,1642931845,1642932699,854,3439
3097333366,3754662934,1660925059,1660925565,506,572
3479719806,3109516154,1649209345,1649209975,630,3720
3477966437,3411679908,1657356643,1657357357,714,3670
3923795973,3362117812,1648650954,1648651614,660,2358
3297230803,3036271337,1641693694,1641694660,966,169
3374375509,3016189594,1667310362,1667310661,299,1805
3393191968,3741885439,1643823921,1643823989,68,3652
3806696009,3245097390,1668807454,1668807698,244,1846
3651499505,3648815608,1643950904,1643951569,665,3717
3520511039,3300096973,1656047495,1656047681,186,3638
3775427465,3934933720,1655631104,1655631906,802,3019
3288510209,3826110002,1663569527,1663570292,765,2435
3986446339,3558678575,1653325866,1653326488,622,3025
3783973065,3895746410,1662501858,1662502363,505,382
3554453287,3985576895,1645057433,1645057760,327,1156
3881875397,3698679634,1654871615,1654871975,360,4920
3431267988,3973949550,1669213223,1669213568,345,2985
3260637681,3252151291,1645903302,1645903482,180,463
3766229211,3933172107,1662775081,1662775705,624,97
3061554992,3110288178,1649960773,1649961546,773,3751
3763743466,3861589274,1648382213,1648382540,327,2991
3364236563,3566945338,1641729920,1641729929,9,3583
3068895245,3465052855,1661988849,1661989465,616,2494
3961645511,3589596014,1668948640,1668948957,317,431
3234115284,3419192470,1657352132,1657352329,197,1066
3830107441,3695163316,1644957300,1644958006,706,1997
3816575149,3943407736,1654969700,1654970312,612,4319
3838343795,3358592843,1658276696,1658277612,916,4388
3450180162,3127925822,1655605598,1655605854,256,3311
3342606234,3805182915,1667263634,1667263989,355,2020
3629972407,3399050564,1650490944,1650491328,384,1584
3654550921,3347309950,1643220813,1643221519,706,1923
3617315369,3426287814,1663551695,1663552199,504,2566
3483115957,3133765076,1665302896,1665303465,569,4550
3232848619,3121761720,1655346671,1655347174,503,1589
3224086955,3280427110,1662407910,1662408810,900,81
3406638601,3215167744,1649980819,1649981590,771,1317
3015951125,3952909164,1657740200,1657740383,183,3460
3694220990,3789515500,1647926441,1647926646,205,3983
3466451363,3590687946,1666724082,1666724101,19,3709
3088395453,3637698493,1663229212,1663229546,334,626
3070452881,3074913463,1664186344,1664187335,991,1724
3329506696,3666362295,1659307745,1659308092,347,3579
3050534773,3088650934,1668757117,1668757419,302,3626
3922357339,3785718090,1645024584,1645025206,622,4298
3281146155,3587618267,1656255706,1656255717,11,2259
3264796095,3811479478,1668230118,1668230890,772,2903
3722444853,3846933206,1659387796,1659388395,599,4226
3933196337,3020628781,1641866025,1641866626,601,629
3812050274,3248887385,1646728921,1646729009,88,3011
3983526892,3131820603,1663021053,1663021790,737,2601
3408958202,3999719582,1666286167,1666286776,609,80
3531946153,3228138039,1647275113,1647275905,792,2810
3023602671,3927233345,1646250121,1646250988,867,1277
3183816555,3158336695,1649047470,1649048436,966,2852
3236236644,3756189269,1646557995,1646558921,926,1336
3569053013,3483012916,1660802465,1660802506,41,1092
3076127789,3454507766,1658129676,1658130210,534,2166
3077424839,3671294951,1660133056,1660133312,256,4869
3977921545,3920025579,1654230791,1654231506,715,2562
3886405656,3623678006,1668228724,1668229371,647,1632
3170647005,3658673321,1646392906,1646392925,19,2538
3770610488,3907973519,1643782757,1643783705,948,451
3135621215,3615661913,1641811512,1641811587,75,3665
3323187154,3944574783,1644295459,1644295623,164,104
3100853769,3206173831,1657448223,1657448482,259,3672
3406753266,3492899463,1646276453,1646276908,455,3223
3857059967,3191036638,1665313343,1665314306,963,343
3201584400,3431796434,1645943782,1645944762,980,4658
3464425600,3569667203,1662724484,1662725161,677,1426
3149606208,3394399318,1656760963,1656761619,656,4106
3528662600,3865428317,1656030847,1656031323,476,1092
3458607569,3746544022,1642589374,1642590151,777,2092
3204734254,3943082444,1653239199,1653239999,800,737
3484247503,3180041787,1644249986,1644250188,202,4565
3761982588,3987796869,1644656321,1644657261,940,4459
3904452695,3557327754,1667145613,1667146001,388,3912
3873681875,3266448520,1656810499,1656810599,100,2937
3644522328,3863494179,1650485068,1650485144,76,2737
3613420401,3698384751,1659228561,1659229088,527,3083
3939973541,3737857057,1657170286,1657170885,599,1703
3719956315,3703486070,1662952206,1662952358,152,4406
3981834777,3586488590,1657764225,1657765119,894,944
3862622933,3242698327,1662101452,1662101507,55,1428
3996304076,3491256596,1669210709,1669211129,420,2545
3389314327,3326611565,1646123087,1646123624,537,3548
3635489265,3065633895,1651773861,1651773933,72,309
3456226271,3245775687,1647225950,1647226750,800,1131
3298593043,3227731226,1668234929,1668235882,953,4225
3716808940,3445869713,1647362718,1647363675,957,1192
3762162463,3858031213,1646527459,1646528368,909,609
3448447006,3981301057,1646160789,1646161320,531,4820
3761146310,3744209737,1642182338,1642182567,229,296
3063356750,3060265658,1650734257,1650734766,509,2809
3482215098,3362130816,1667507369,1667507681,312,1584
3573068329,3491065341,1649186121,1649186440,319,2274
3498316888,3614542341,1657843384,1657843691,307,2889
3527626312,3189267830,1651357737,1651358059,322,2275
3776830012,3247689184,1663389098,1663389179,81,3802
3625897085,3318478057,1650808537,1650808946,409,4581
3576248964,3077986400,1658508185,1658508721,536,4535
3148545060,3170303894,1662561704,1662562465,761,4000
3184685433,3745484426,1663587404,1663588179,775,2387
3637214867,3686258982,1641334431,1641335305,874,4659
3765102471,3838965072,1665699279,1665699283,4,3409
3651934517,3933446627,1655727155,1655727480,325,4637
3953200815,3429079624,1649614508,1649614598,90,1198
3572473990,3861555640,1643285689,1643286630,941,4401
3600451169,3921804333,1658635473,1658635900,427,3726
3434624470,3863899747,1644425665,1644425701,36,717
3065378612,3376826184,1652022223,1652022674,451,697
3989921503,3096109045,1648306055,1648306246,191,2769
3759481832,3668939376,1643146150,1643146550,400,1253
3152305812,3423525296,1661783816,1661784108,292,662
3583347542,3952109923,1656858212,1656858815,603,1372
3716035817,3691926348,1648562699,1648563478,779,1287
3066748970,3495829994,1659972279,1659973187,908,2105
3010353083,3149393422,1659242489,1659242942,453,1637
3993906069,3998126443,1642455944,1642456682,738,4044
3247105684,3132826694,1661845974,1661846043,69,384
3429018245,3373892309,1666460536,1666460744,208,1098
3654960184,3862935471,1646754902,1646755741,839,4897
3729414917,3019649688,1666759786,1666760505,719,1992
3373814203,3600421930,1666221638,1666222273,635,1558
3553706746,3872896870,1659138740,1659139510,770,940
3472787583,3790434739,1669117893,1669118775,882,4589
3573502082,3793309815,1646639907,1646640552,645,2721
3590232634,3042977542,1651230404,1651230603,199,3599
3789433565,3647097496,1662228368,1662228925,557,1186
3498152359,3809535414,1644410080,1644410094,14,2337
3943440345,3237036186,1667527115,1667527946,831,4545
3895268314,3084558246,1657493039,1657493265,226,32
3146487113,3093963550,1656781094,1656781224,130,4791
3911267196,3556347284,1663080377,1663080687,310,1613
3311035825,3590242153,1662609642,1662610253,611,4698
3341027780,3061201450,1669359889,1669360408,519,1434
3857831530,3138148218,1644404979,1644405680,701,4981
3904382779,3417131373,1660485458,1660485656,198,1819
3810154127,3457548760,1659663215,1659663433,218,3422
3800189101,3175132637,1657530773,1657531265,492,1830
3526288388,3865525149,1649403974,1649404445,471,4452
3773035869,3786178028,1661960927,1661961330,403,643
3641217554,3462421357,1661636376,1661636884,508,2780
3877961141,3605512680,1668114281,1668114299,18,2172
3256685246,3043696232,1661320378,1661321289,911,2774
3782439789,3204674136,1651494044,1651494736,692,3095
3515818354,3206976249,1659313085,1659313650,565,1170
3220526520,3045779936,1649827506,1649828116,610,667
3900946910,3444518677,1653163616,1653164589,973,1587
3261695759,3224046294,1647232595,1647233034,439,90
3570799572,3102336046,1647149135,1647149740,605,55
3678591560,3853252779,1642102763,1642103324,561,4397
3121536925,3564380975,1648067741,1648068111,370,2343
3955066655,3136240374,1644043892,1644044042,150,1200
3789515500,3264440104,1652061793,1652062697,904,2280
3965926135,3612811980,1665380295,1665380556,261,3461
3634790390,3900344812,1643028172,1643028719,547,644
3030102081,3864891118,1663463351,1663463522,171,2147
3162158185,3520528046,1642929394,1642930229,835,3173
3939893270,3110201705,1663747111,1663747299,188,2299
3352428708,3238252679,1658981373,1658981512,139,4280
3550420962,3464152483,1663940409,1663941368,959,644
3362717778,3882354292,1662103990,1662104502,512,2886
3926351393,3746954029,1648152925,1648152961,36,739
3639745816,3086699978,1657981869,1657982545,676,749
3224743727,3151833139,1641325430,1641326430,1000,2154
3343068724,3752704047,1664784797,1664785730,933,3964
3624524770,3071371917,1661667499,1661667820,321,951
3451398371,3045916489,1647144132,1647144893,761,3852
3031959086,3904708545,1648458024,1648458136,112,2673
3698907320,3011361017,1657951691,1657951757,66,1059
3383663544,3175184138,1653655832,1653655978,146,1854
3428632388,3850119676,1643987989,1643988432,443,3402
3376453034,3841122111,1649847718,1649848295,577,4116
3632165906,3529848063,1656885728,1656885863,135,60
3226581664,3988387540,1662577206,1662577373,167,761
3482882129,3600447523,1647143107,1647143743,636,3942
3326572386,3650454863,1661422601,1661422935,334,639
3508220821,3890977880,1656516500,1656516544,44,4477
3587577650,3512917492,1666358170,1666359010,840,1191
3170367609,3863778000,1658664902,1658665273,371,2377
3608773837,3306738678,1648752149,1648752874,725,4506
3075126207,3256019476,1655250937,1655251282,345,443
3731206854,3914061769,1642630737,1642630906,169,3437
3875042371,3017150685,1653000110,1653001057,947,3754
3020475836,3219258803,1660899844,1660900091,247,4684
3362461708,3635670919,1658722770,1658722937,167,989
3097000762,3894981080,1665185724,1665186452,728,284
3014796709,3857241854,1666428820,1666428900,80,541
3314438404,3453871332,1657151975,1657152345,370,4804
3061716258,3946644247,1651312982,1651313746,764,233
3733233648,3405664615,1651774462,1651775111,649,2352
3459082120,3024351190,1650473185,1650474067,882,4264
3505492543,3218280041,1669641835,1669642260,425,4489
3279085864,3828023417,1654731983,1654732945,962,343
3956894051,3832551443,1652434359,1652434796,437,2755
3434369625,3054137539,1649713875,1649714534,659,2389
3646434636,3102166082,1662290074,1662290322,248,2235
3352496177,3445714993,1642270679,1642270893,214,585
3529209508,3921269605,1648230472,1648230741,269,891
3074622432,3037836281,1669591582,1669591743,161,336
3288326879,3794358892,1656283203,1656283458,255,687
3602336834,3849883869,1662420885,1662421125,240,3169
3695808929,3699434872,1655317056,1655317413,357,2854
3355553085,3848329478,1645700704,1645701024,320,3134
3732261659,3679993739,1650402116,1650402759,643,4390
3306154647,3452198401,1645257803,1645258420,617,2638
3366592546,3309697149,1658544153,1658544583,430,3473
3551452544,3751870670,1651269460,1651269757,297,1316
3755600495,3232972981,1649436577,1649437099,522,2344
3067591410,3596255016,1659939426,1659939660,234,2262
3928731602,3613367629,1643427044,1643427310,266,3671
3874230521,3982814438,1667673980,1667674861,881,3754
3664442427,3221100632,1653453831,1653454497,666,765
3105763440,3746917102,1660329263,1660329707,444,3330
3670832900,3728573683,1649579649,1649580589,940,4759
3621628773,3702053626,1655825591,1655826090,499,1173
3935517776,3518607736,1668794669,1668795560,891,662
3836153324,3886664409,1663301008,1663301065,57,4367
3509080203,3520934960,1658811903,1658812810,907,155
3144999124,3398996914,1656930180,1656930335,155,3067
3967570220,3058484178,1665025367,1665025577,210,1363
3629227782,3649899740,1655817244,1655818096,852,4645
3429149500,3154182146,1656080054,1656080369,315,4455
3158719120,3963396674,1660844784,1660845474,690,2533
3588514030,3275103912,1651551183,1651551259,76,262
3037104344,3997305004,1648955351,1648955891,540,3524
3268026612,3361919423,1662740407,1662741351,944,79
3882234068,3458067867,1651690139,1651690243,104,28
3818611738,3025033517,1644323511,1644324508,997,2482
3944992691,3616532771,1652864915,1652865091,176,4936
3302219778,3750382271,1642029021,1642029023,2,4011
3439934852,3462253758,1648098486,1648099048,562,595
3892913923,3046948032,1664727103,1664727395,292,1341
3379420195,3862874931,1662739273,1662739598,325,3507
3040477935,3403482854,1647666491,1647666647,156,2382
3547690069,3820542453,1668706823,1668707700,877,3149
3567624325,3115374209,1650507938,1650508264,326,734
3500816542,3651747169,1644111475,1644111634,159,1982
3266311665,3356702441,1660220359,1660221189,830,757
3720245933,3577501000,1641174095,1641174757,662,3002
3534342349,3082808566,1641466108,1641466155,47,3890
3332059596,3151339800,1649314376,1649315214,838,3533
3829246731,3639029138,1642268184,1642269111,927,2135
3389330504,3938197696,1648549235,1648549673,438,2488
3381294803,3592186788,1652697477,1652698238,761,3876
3212701588,3909125333,1666276759,1666277743,984,1632
3603384854,3199679010,1643308964,1643309054,90,3364
3695002539,3713935606,1650793973,1650794622,649,4306
3455483620,3133539408,1665303265,1665303899,634,4181
3756722062,3321469678,1647471884,1647472613,729,1399
3886341692,3029083897,1663040952,1663041245,293,3198
3584932264,3835069493,1660527307,1660527310,3,3709
3241717082,3023807282,1649878686,1649879250,564,2885
3418258405,3232485556,1662721310,1662721930,620,3423
3248446740,3578216368,1654974015,1654974788,773,3647
3200418783,3780376258,1651971686,1651972543,857,587
3621290656,3328683749,1664052287,1664052288,1,1552
3779844963,3217910313,1669516904,1669517591,687,3775
3357826552,3727462255,1648908727,1648908998,271,223
3553830807,3637784770,1655966842,1655966913,71,2196
3158174799,3825125091,1647413192,1647413266,74,3585
3216085015,3195846430,1646881442,1646882381,939,530
3027536382,3304156433,1667662987,1667663093,106,3568
3129449957,3485541055,1642478323,1642478906,583,2119
3672354672,3192632223,1650507316,1650507323,7,1280
3858106972,3167510756,1660421727,1660422167,440,2764
3909100807,3190189810,1642631576,1642632448,872,3592
3242944089,3285020248,1648065015,1648065564,549,2577
3292213124,3902736622,1650060677,1650061003,326,4536
3568020138,3259191612,1658706920,1658707689,769,1089
3415241311,3483083173,1648592529,1648593143,614,478
3441850800,3721284253,1668757362,1668757462,100,2174
3389553058,3433410703,1650990781,1650990944,163,2117
3815781808,3183572154,1656797489,1656798380,891,3084
3081605012,3377386194,1661905710,1661906380,670,4234
3054767809,3130157095,1655920544,1655920570,26,3702
3970061379,3061313831,1664716676,1664717048,372,3534
3775444432,3908964312,1652855764,1652855804,40,1297
3110912469,3627314785,1649187269,1649187453,184,3180
3202448787,3701103788,1643544899,1643545856,957,3533
3628698365,3152107607,1652526024,1652526809,785,1394
3221819576,3682844258,1644749105,1644749854,749,2086
3865027819,3975823720,1655227864,1655228563,699,4788
3112477707,3416162717,1654600125,1654600767,642,1171
3351668588,3482579170,1647474542,1647474717,175,1605
3163615926,3486150667,1661740730,1661740738,8,3170
3635200466,3571919061,1666681310,1666681776,466,1750
3904668818,3553409077,1655344598,1655344839,241,254
3530277569,3267886383,1644390240,1644390335,95,1333
3108418971,3671712674,1642779038,1642779448,410,8
3007026179,3840094433,1652977027,1652977982,955,1792
3516870994,3941695505,1641135579,1641136384,805,1416
3230358355,3746225121,1665482361,1665482808,447,2870
3440321816,3967118245,1664156403,1664156732,329,2606
3237267587,3901961286,1648521366,1648521452,86,2329
3794825473,3968493869,1645557749,1645557839,90,372
3184348425,3895389298,1654033479,1654034171,692,165
3808001092,3723449061,1654610140,1654610662,522,1664
3775181459,3870506073,1641834063,1641834312,249,2378
3401395511,3999686993,1642029057,1642029363,306,202
3659717659,3814668010,1662187283,1662187540,257,4409
3437166707,3669148364,1645170318,1645170815,497,665
3321211682,3269372755,1661059226,1661059625,399,145
3255442570,3178949153,1643666254,1643666290,36,1680
3279081924,3364105875,1667442005,1667442138,133,2773
3063241220,3631319600,1645489820,1645490279,459,693
3843750600,3465285769,1656311698,1656312606,908,3925
3999789186,3591442640,1648666616,1648667544,928,938
3348464047,3501673751,1658207538,1658207819,281,2644
3292231379,3629771113,1664357170,1664358085,915,770
3381329053,3294267816,1659384176,1659384775,599,3306
3394467106,3595683158,1644884051,1644884499,448,132
3406696233,3981041367,1645856512,1645857302,790,3316
3416975226,3688886323,1664782479,1664782959,480,3077
3070968897,3668895875,1646187177,1646187256,79,472
3585732301,3370689260,1657880358,1657880779,421,4991
3216149525,3983835705,1648360758,1648361187,429,2271
3612848020,3488739640,1648639881,1648640796,915,3234
3939777968,3761915357,1661997791,1661997971,180,1374
3977829125,3241226228,1651083118,1651083722,604,2254
3264426609,3375377600,1663340619,1663340695,76,4942
3033441771,3616599279,1666128977,1666129718,741,4555
3170252189,3189852992,1668567288,1668567947,659,287
3343363103,3604121989,1653852012,1653852212,200,4640
3767079722,3347193074,1660797746,1660798671,925,2567
3618732253,3497343942,1660269558,1660270552,994,4315
3094192326,3322645494,1655161574,1655162249,675,3737
3120394246,3801830043,1663634478,1663635439,961,4315
3585144374,3536991382,1660082239,1660083044,805,1707
3992548567,3968115812,1651281808,1651282240,432,2972
3999700718,3132313453,1647337479,1647337542,63,4798
3141087938,3817355675,1668308344,1668308560,216,4003
3769946319,3140916534,1665141261,1665141271,10,4030
3016365798,3993041334,1659705733,1659705937,204,4786
3459782881,3481471908,1669122409,1669122648,239,2922
3367620647,3921741984,1652128215,1652128367,152,4410
3774460986,3847301044,1658099182,1658100108,926,2141
3541878597,3043174450,1653691091,1653691682,591,3031
3927984989,3661844356,1648308996,1648309684,688,40
3016704645,3063380321,1644874993,1644875346,353,4595
3787111903,3392211362,1666718119,1666718764,645,1391
3552039768,3808350561,1660668851,1660669455,604,9
3483163581,3563974675,1652142931,1652143248,317,4910
3687672991,3743341439,1649235811,1649236303,492,1405
3180625101,3977667742,1644208222,1644208563,341,1220
3708552011,3168465189,1657100526,1657100731,205,2737
3351309714,3237853745,1641624272,1641624325,53,546
3590660222,3896415327,1649244767,1649244771,4,3805
3899163280,3563581285,1642671889,1642672463,574,3201
3832733345,3397572665,1641753046,1641753761,715,965
3188317284,3966900141,1648114072,1648114366,294,46
3166116626,3753372904,1656427309,1656427938,629,1122
3766686118,3625694569,1657992816,1657993475,659,3521
3646223465,3854209431,1660713954,1660714153,199,614
3135739412,3820836584,1654160982,1654161218,236,363
3627017054,3752720215,1645526678,1645527290,612,3564
3701416771,3721364024,1659987376,1659987596,220,4832
3365670834,3212148644,1645979985,1645980791,806,4744
3556187316,3659963151,1642551741,1642551791,50,1952
3597780570,3721833326,1656256733,1656257567,834,4831
3647658542,3890349994,1641512438,1641512872,434,1051
3404319345,3802903206,1641230249,1641231190,941,1929
3445232886,3056831582,1651906157,1651906234,77,88
3914230565,3160947991,1665711887,1665711971,84,2338
3477393113,3909639783,1654983958,1654984217,259,3237
3782356721,3565030206,1644944866,1644945804,938,616
3600062831,3610752891,1650424929,1650425289,360,43
3804841028,3359376440,1654035958,1654036508,550,4821
3705774592,3683914468,1659883893,1659884143,250,3886
3341030469,3205601781,1645776596,1645777187,591,2613
3601742693,3439885054,1641657184,1641657849,665,963
3161695046,3784680236,1669324266,1669324467,201,1358
3768401237,3799483775,1660557855,1660558821,966,3995
3347139620,3085697770,1644934916,1644935527,611,1875
3010442236,3158705532,1656783570,1656784533,963,4034
3244563630,3071125117,1664392752,1664392797,45,4251
3312072527,3191806546,1662809555,1662809638,83,4207
3954463192,3104941185,1667500599,1667501071,472,1020
3277897913,3436117552,1663010413,1663010896,483,472
3509074031,3228134745,1652711344,1652711456,112,3779
3684124695,3744718536,1651217833,1651218168,335,2539
3699528421,3547934854,1663099909,1663100137,228,2906
3596896105,3318301464,1657945412,1657945963,551,1552
3301783679,3613679040,1647436031,1647436033,2,1607
3013313541,3626851852,1647145269,1647146068,799,3297
3759158152,3374537966,1655950128,1655950303,175,4447
3912021975,3377508610,1668667786,1668667856,70,2510
3911316010,3570719291,1656207577,1656208571,994,4574
3829641884,3738298675,1658170490,1658170651,161,3161
3522095910,3945045199,1655962295,1655962812,517,1098
3725142994,3397851223,1669554892,1669555717,825,1252
3916829978,3828283309,1655379742,1655380185,443,69
3816072519,3405942229,1668670910,1668671541,631,2823
3504350753,3554635701,1644080678,1644081153,475,1948
3521636607,3805225315,1651440260,1651440535,275,4757
3038810863,3621255685,1655927231,1655928105,874,4406
3289429735,3115737467,1661688953,1661688981,28,520
3165226341,3250913499,1648782664,1648783581,917,2156
3766846103,3762227345,1669627142,1669627603,461,2881
3729702674,3486151108,1648846892,1648846893,1,2424
3926160698,3579416113,1642219951,1642220468,517,2300
3764871176,3596528935,1645524400,1645525111,711,3974
3100536624,3542336164,1660302652,1660303603,951,3027
3877215791,3633669658,1644019883,1644020657,774,4400
3774032302,3815528362,1657679884,1657680317,433,547
3284222510,3770756697,1661822641,1661823407,766,4571
3493402584,3818611738,1651177926,1651178555,629,1456
3229109699,3352304022,1649119955,1649120492,537,502
3803594010,3236912085,1664734943,1664735224,281,3122
3672286596,3613140989,1645330044,1645330984,940,2955
3474734356,3287335447,1648370085,1648370406,321,2015
3147983246,3263814161,1657487887,1657488382,495,850
3197690747,3056087656,1641277783,1641278426,643,1124
3324850817,3463937654,1646702761,1646703581,820,512
3420755547,3773476248,1652992619,1652993522,903,3230
3510886308,3991706563,1666795584,1666796078,494,3956
3295816546,3496713905,1663648567,1663648860,293,244
3282546681,3931750533,1668533555,1668534547,992,349
3679735881,3513941359,1665583078,1665583226,148,1706
3339601617,3842561104,1666136916,1666137835,919,3449
3013860475,3813062068,1646042109,1646042722,613,2501
3007819894,3776439925,1645434096,1645434650,554,3693
3250242106,3627153004,1659935500,1659935999,499,3193
3985745225,3373850936,1668249856,1668250502,646,3566
3370554782,3795490162,1655888269,1655888726,457,2625
3928449136,3093612898,1661143413,1661143549,136,3062
3093853858,3534103558,1666260323,1666260685,362,2351
3606088473,3539199668,1666540363,1666540952,589,1345
3962978645,3577443300,1655429024,1655429429,405,3519
3267379891,3807244776,1665874217,1665874684,467,4344
3627239334,3529865961,1643889860,1643890485,625,4312
3874874412,3425459242,1663627513,1663628504,991,4223
3679212300,3785150754,1645521640,1645522579,939,1669
3175529702,3557495639,1655665279,1655666116,837,1051
3378938724,3637177665,1643170694,1643171592,898,4242
3001098111,3676539559,1652478317,1652479202,885,946
3743888891,3583664506,1652896380,1652896734,354,3025
3603020047,3901288530,1656917203,1656917868,665,3647
3806787212,3742427711,1664019612,1664020114,502,3170
3824472310,3788190944,1662313612,1662314363,751,2239
3842494406,3715148944,1665556557,1665556936,379,74
3960448253,3823091310,1647246768,1647246831,63,4528
3018589788,3084649620,1653976038,1653976064,26,3522
3184962964,3754086292,1652434891,1652435018,127,4532
3523689381,3655888527,1650001870,1650002158,288,3235
3688897968,3988373897,1667006385,1667006687,302,3515
3751471974,3707956309,1661436995,1661437950,955,1713
3441562486,3669521125,1665481673,1665482657,984,2638
3396838906,3427359727,1668680560,1668681220,660,3927
3527608364,3697880339,1660144820,1660145115,295,3826
3442114744,3818847104,1667361411,1667361682,271,1807
3248363364,3698801781,1656029540,1656030532,992,2673
3910404738,3809205651,1651176025,1651176719,694,2625
3259761029,3616024268,1663318215,1663318454,239,1743
3969569857,3299874686,1665844636,1665845097,461,230
3816671012,3037800513,1655796794,1655797735,941,3832
3258412743,3580153114,1662163101,1662163394,293,1812
3320654641,3950927566,1655733179,1655733609,430,3589
3543868250,3724191304,1659245080,1659245964,884,1097
3575846263,3287065095,1647051522,1647051877,355,2494
3508823569,3919709762,1653440046,1653440636,590,56
3850066558,3106798007,1666996892,1666997189,297,675
3609914369,3227429251,1643940758,1643941436,678,4609
3498216935,3117299889,1668445862,1668446707,845,3464
3528902984,3100371069,1659422866,1659423545,679,2764
3146368380,3867635426,1647884809,1647885294,485,3928
3811172946,3782606578,1661944418,1661944873,455,1397
3828507175,3870121609,1648693505,1648693524,19,731
3501553833,3135033664,1654105882,1654105897,15,473
3612201785,3601639253,1659239138,1659239586,448,3196
3090791182,3291636525,1658959261,1658960221,960,1555
3460261266,3278104734,1659968768,1659969684,916,2639
3039875199,3879330157,1645038862,1645039467,605,3428
3694340723,3484237054,1643496817,1643497647,830,1334
3416381432,3711039905,1665526283,1665526903,620,487
3273014456,3674744856,1643950150,1643950805,655,4452
3433852689,3377310226,1656572774,1656573226,452,2459
3908147191,3615358535,1641800771,1641800883,112,2455
3806584100,3730733819,1667944182,1667944928,746,2581
3495768467,3635182215,1653813470,1653814327,857,4958
3403761534,3424527659,1661203501,1661203792,291,4343
3155211610,3161957845,1646055808,1646056486,678,3718
3338439908,3650803247,1667056074,1667056270,196,4724
3261784193,3804540102,1643079625,1643079905,280,4635
3921530188,3973740922,1643286450,1643287050,600,2780
3930082539,3807796968,1668355540,1668356414,874,2005
3175386678,3974245762,1660158934,1660159738,804,3622
3713128618,3512536127,1658302471,1658303384,913,1152
3909248832,3857993945,1647475282,1647475398,116,4839
3900964469,3131590481,1658027370,1658028164,794,495
3037497417,3780531587,1665597957,1665598022,65,2644
3217714371,3971595436,1659392305,1659392519,214,3424
3554821807,3685537623,1648708769,1648709031,262,4306
3191501835,3087346595,1647398100,1647398782,682,2895
3725797140,3438804447,1648958374,1648959250,876,2369
3233393387,3122201865,1667894938,1667895438,500,1731
3602839320,3491559689,1654856100,1654856746,646,1107
3041920196,3463535375,1646164678,1646165439,761,1921
3417435181,3018461390,1668546573,1668546599,26,4792
3856068380,3198783946,1653438263,1653439242,979,31
3878649323,3312939953,1647421448,1647422264,816,4166
3984496283,3005717468,1644626661,1644627565,904,936
3457075278,3398623266,1650147534,1650148043,509,3825
3361646028,3628602750,1645507432,1645507587,155,3384
3721855573,3854438335,1662542715,1662542829,114,3054
3813431392,3677704923,1645919597,1645919738,141,2216
3989609822,3878284088,1664436327,1664437019,692,2384
3486790299,3284819256,1649528763,1649528843,80,953
3557756432,3616231495,1666045013,1666045311,298,4851
3291850021,3771596029,1660664089,1660664923,834,4229
3753159651,3437264974,1641347789,1641348307,518,667
3235223287,3691529052,1664145559,1664146346,787,2815
3117613190,3888710659,1655033718,1655033822,104,1718
3841911422,3434639263,1649418651,1649418713,62,4034
3499059844,3988592172,1661720850,1661721053,203,1934
3390076838,3418529485,1657268527,1657268709,182,2599
3549813952,3514844818,1659806207,1659807101,894,1522
3027941325,3919175627,1652055483,1652055726,243,1293
3440857726,3544631557,1661161002,1661161683,681,2302
3687233184,3552600008,1664484901,1664485389,488,4700
3736032324,3202359971,1644335982,1644336969,987,3829
3217188435,3948472606,1660680350,1660680497,147,26
3048047633,3018924837,1645780026,1645781019,993,92
3299566950,3177403462,1648169112,1648170109,997,1786
3441998778,3219811159,1651230780,1651231737,957,3218
3713157353,3030657658,1652710979,1652711657,678,4710
3476465615,3207017020,1656619080,1656619248,168,4816
3956455577,3092326926,1661685261,1661685288,27,4808
3814815465,3052524141,1660296908,1660297890,982,2778
3442795683,3185116831,1664444664,1664445587,923,1689
3145530842,3902618977,1662640665,1662640905,240,1188
3458546366,3477780033,1641289916,1641290736,820,2986
3374069929,3851484766,1642969010,1642969183,173,3981
3397825502,3948756811,1663843697,1663844201,504,1378
3120160760,3595722018,1665923427,1665924277,850,4499
3684379328,3022640228,1658172350,1658173337,987,4936
3090090900,3331758962,1654752742,1654753342,600,3949
3258085199,3627953066,1644135604,1644136381,777,637
3365121849,3421097991,1646344753,1646345242,489,1740
3223698813,3502943422,1661245269,1661246066,797,3930
3333192588,3668000175,1667974047,1667974555,508,3520
3161357551,3905689792,1668627924,1668628652,728,4724
3477966890,3578211797,1668135499,1668135669,170,2877
3986370592,3321211145,1663621249,1663621753,504,142
3774530659,3277351660,1665430410,1665431308,898,263
3556372190,3735414277,1656033331,1656034248,917,961
3043601007,3060103036,1662981683,1662982388,705,4188
3024099780,3174614804,1663145611,1663146101,490,1801
3394134947,3857069957,1642956640,1642957331,691,4559
3170535095,3002167186,1658519510,1658519706,196,2763
3030642202,3232589782,1668946074,1668946227,153,1041
3849949275,3491785253,1655344525,1655345205,680,3602
3615792031,3207513670,1654725555,1654726261,706,3528
3489798022,3168742673,1642253149,1642253516,367,3128
3571327212,3787310538,1667700228,1667700847,619,2461
3214479265,3853942607,1664861681,1664862382,701,3790
3605448948,3811816960,1667140464,1667141161,697,423
3020636032,3713745528,1653297905,1653298646,741,2977
3713269653,3557341901,1652167291,1652167821,530,693
3144464316,3522163412,1641954550,1641955308,758,3810
3549276761,3779087157,1647474722,1647475547,825,3687
3842059015,3192522421,1651176089,1651176157,68,4301
3575222718,3638501741,1649788105,1649789091,986,3348
3206555421,3028539895,1656139491,1656140304,813,3282
3363433759,3655443639,1668580211,1668580982,771,274
3666589518,3122908321,1665482165,1665482187,22,2566
3234045230,3618274280,1650731177,1650731225,48,4817
3582304911,3494031475,1667268897,1667269202,305,3665
3834607316,3737727140,1642444417,1642444483,66,840
3318114088,3272188790,1649740879,1649741600,721,3930
3585483442,3101966579,1646977588,1646978243,655,1351
3414828424,3652520634,1655721286,1655722208,922,1578
3609200149,3018213304,1643700183,1643701119,936,2849
3603545653,3167860684,1667493151,1667493568,417,3334
3013823638,3215554481,1658464129,1658464693,564,36
3867573074,3360055423,1652763253,1652764109,856,1784
3424534860,3420375885,1646003906,1646004379,473,3458
3614173809,3112249417,1654920471,1654920750,279,1162
3004665287,3039660737,1665373503,1665373825,322,1647
3076816861,3893725093,1663490179,1663490371,192,4518
3112359633,3177167180,1648846891,1648847730,839,3543
3679830978,3752287137,1651954978,1651955101,123,3859
3764581569,3036472094,1655925668,1655926229,561,424
3900752962,3801904728,1666617413,1666617764,351,1448
3801256514,3519958306,1653992872,1653993565,693,809
3501682642,3960399917,1664446890,1664447200,310,3534
3125016085,3538636384,1642434015,1642434566,551,4563
3838611564,3609068693,1660547279,1660547545,266,2934
3805140691,3492061271,1663867241,1663867905,664,262
3213131691,3365529376,1668561446,1668562349,903,83
3639328303,3364606155,1653984483,1653985060,577,4753
3375113590,3212913483,1645666355,1645666596,241,624
3348750303,3387608536,1642462088,1642462538,450,4166
3750655133,3813262112,1654499306,1654500272,966,2905
3140198636,3213528740,1659946061,1659946177,116,1699
3236912085,3603686273,1645536834,1645537172,338,892
3346321784,3762906817,1655494840,1655494988,148,1542
3549270155,3118123654,1655662238,1655662467,229,291
3933216390,3269748168,1660194404,1660195311,907,3252
3022799365,3965611013,1656581084,1656581406,322,2114
3814308150,3156746938,1655096559,1655097250,691,211
3844253280,3664680710,1649151600,1649151805,205,3363
3460353546,3460937211,1648272798,1648272869,71,4806
3151549282,3473401175,1666905877,1666906209,332,3155
3722903283,3206839033,1662971469,1662972253,784,2675
3375481256,3019447391,1644116493,1644117437,944,345
3046408917,3005102130,1653112424,1653112886,462,1033
3206222173,3493223436,1653760862,1653761017,155,1590
3486505530,3122290782,1652344299,1652344584,285,4739
3064278328,3945589191,1667864319,1667864345,26,4334
3897929673,3893411218,1654726280,1654726620,340,1007
3469457996,3607213550,1667254877,1667255805,928,780
3297839164,3554453287,1664853840,1664854481,641,1695
3927800940,3679841193,1667261262,1667261587,325,412
3493091570,3856882265,1650526644,1650526888,244,363
3397128217,3814432949,1658473886,1658474252,366,1925
3100096036,3215724482,1642679881,1642680003,122,996
3914350525,3661408646,1641336385,1641337063,678,3455
3560596622,3764294963,1656704666,1656704879,213,3355
3511346361,3803812620,1643631717,1643631720,3,4841
3597433107,3077702858,1643218154,1643218903,749,3031
3413802212,3468600661,1658834837,1658835794,957,68
3753326049,3805944469,1652624105,1652624808,703,1941
3941381570,3555580031,1656344156,1656344267,111,4036
3392331464,3063716478,1644162276,1644162718,442,3228
3010817011,3358908099,1651928745,1651928941,196,4229
3782599314,3988692119,1646587489,1646588325,836,4056
3492798833,3023922642,1650405107,1650405498,391,1161
3205289088,3606677171,1655977181,1655977688,507,4967
3691978209,3089904995,1666888892,1666889724,832,3568
3150686272,3441550550,1648343781,1648344104,323,2929
3383274677,3611530468,1668191983,1668192834,851,4280
3644777988,3564322827,1647872863,1647872892,29,1586
3972693456,3338866424,1647763075,1647763770,695,3537
3214795831,3731993257,1646365950,1646366539,589,4207
3452663190,3596541606,1655284559,1655284672,113,2579
3343972199,3145102145,1660864492,1660864653,161,4050
3637481361,3291221425,1667244667,1667244988,321,1292
3046331109,3870884044,1653663487,1653664379,892,2420
3640224607,3822161853,1642483974,1642484789,815,4715
3229713095,3203730956,1643609215,1643609282,67,2236
3620361369,3458871589,1664991878,1664991957,79,1279
3186663153,3038074473,1652684184,1652684730,546,3225
3274387842,3758491507,1641762990,1641763663,673,2696
3852526668,3905260211,1669052588,1669053214,626,1846
3426253606,3947089511,1648825077,1648825973,896,1880
3514493703,3162493544,1652092402,1652092908,506,22
3928798092,3466114675,1651847608,1651848238,630,4732
3608773837,3716355209,1669042684,1669043655,971,4260
3722271017,3349363889,1645359468,1645359909,441,534
3871597709,3292500706,1659275575,1659276460,885,905
3545865554,3548072343,1649963005,1649963385,380,3089
3059917418,3311621454,1657789036,1657789728,692,4814
3862356874,3305950706,1658840429,1658841350,921,2385
3486406925,3260702674,1645866978,1645867303,325,3701
3836486405,3089091428,1657549733,1657550679,946,127
3736851536,3044299087,1643917920,1643918152,232,225
3263452238,3328284781,1642254253,1642255109,856,2593
3295706603,3654951317,1655893522,1655894405,883,3726
3522302709,3730119543,1653540107,1653540221,114,3270
3305491510,3802249293,1661863246,1661863735,489,4736
3923129978,3436021803,1661291192,1661291338,146,2282
3023785129,3718919371,1666848153,1666849092,939,3026
3957022012,3359283591,1641811998,1641812915,917,241
3990347426,3877929989,1660361412,1660361486,74,4171
3759508272,3784497748,1648540160,1648540922,762,4979
3367081863,3121348875,1666042166,1666042366,200,2972
3327883969,3573654288,1665871834,1665872320,486,2245
3932672220,3607980637,1659184608,1659185036,428,2896
3162566865,3736033971,1654369752,1654369872,120,1201
3015162197,3341614126,1644010319,1644010950,631,1568
3003973039,3761297717,1666618813,1666619591,778,2146
3462966732,3672911950,1642906196,1642906437,241,3990
3097057815,3984958154,1655107306,1655107689,383,4453
3560003622,3048321504,1650996804,1650997653,849,874
3973740922,3879259125,1643481875,1643482453,578,1974
3825411657,3514797923,1656765289,1656766131,842,2094
3240322926,3754165348,1648211910,1648212900,990,2821
3717413665,3577393633,1656648319,1656649243,924,720
3332627352,3007607349,1661686117,1661686915,798,3028
3903379554,3806241550,1647166822,1647167702,880,4593
3174149689,3564861044,1665834295,1665834672,377,1808
3847868709,3331600091,1646111835,1646112817,982,4798
3107590366,3443781583,1662207155,1662208133,978,2558
3075399796,3255144805,1646626652,1646627038,386,648
3470121798,3101801077,1651000923,1651001822,899,4976
3374402830,3312650724,1669199624,1669200295,671,280
3425802563,3306776325,1643919504,1643919860,356,247
3306834613,3076052154,1666617851,1666617958,107,2501
3083042838,3550509079,1661855312,1661855645,333,3836
3974563301,3527008949,1660348426,1660348939,513,4274
3951922206,3176579322,1641970164,1641970644,480,1808
3296521456,3587618267,1661221122,1661221679,557,2744
3898601926,3402533742,1650142469,1650142624,155,3720
3945735163,3468982754,1657043433,1657044210,777,4517
3284390769,3804870279,1642328078,1642328442,364,3814
3519562589,3622914265,1661220892,1661221434,542,1139
3851182642,3231037857,1658992492,1658992557,65,1716
3310511453,3957914210,1662850090,1662850628,538,1494
3897962415,3052583435,1650995361,1650995718,357,2856
3431843721,3473767230,1657908896,1657909197,301,3067
3153397953,3183068209,1644090114,1644090262,148,883
3954295515,3221054651,1641206860,1641207641,781,3355
3493996653,3279481234,1648090331,1648090877,546,1045
3080466429,3529591851,1665146660,1665147120,460,2924
3512128849,3276789451,1658117179,1658117954,775,4754
3227457237,3538337371,1652213828,1652214463,635,1038
3547843062,3320939825,1641157812,1641158736,924,2733
3485057428,3756663228,1642937264,1642938254,990,844
3531759868,3307652923,1661191556,1661192096,540,2221
3821234754,3014718997,1653036452,1653036748,296,1595
3026402749,3018568273,1659490563,1659491115,552,191
3570232006,3433829307,1658434956,1658435691,735,1552
3175073738,3991164893,1641146505,1641146898,393,3750
3794828526,3652549780,1641529461,1641530029,568,1812
3163166040,3075299536,1659084220,1659085025,805,32
3681463143,3218116636,1668883227,1668883291,64,1064
3556393500,3540048863,1667627401,1667627707,306,3919
3616978973,3211344406,1642250245,1642250362,117,2307
3825521964,3958370657,1647736473,1647736750,277,2527
3583224680,3435796090,1641881966,1641882916,950,4806
3480693732,3161504163,1659799124,1659799683,559,2994
3096029124,3602627525,1662661882,1662662566,684,560
3872259828,3671421214,1659679487,1659679689,202,4150
3290397443,3142013222,1657128081,1657128513,432,712
3828473770,3876634957,1647099103,1647099664,561,2922
3310849486,3489970613,1664854467,1664854859,392,2938
3703989991,3338987504,1665038530,1665039072,542,4668
3864563584,3796546216,1659313829,1659313950,121,3205
3119908061,3299980029,1654172290,1654172628,338,1726
3348707644,3756979051,1657270280,1657271201,921,3818
3908101785,3154812811,1645849343,1645850101,758,2843
3715576151,3135095604,1643531292,1643532125,833,857
3210261645,3183465526,1661282594,1661283458,864,4876
3289151637,3998831334,1642707330,1642707673,343,2051
3099865336,3821018088,1655244031,1655244856,825,4770
3647736248,3859807026,1661085861,1661086359,498,1072
3092366477,3431713438,1667326718,1667327554,836,4001
3327063516,3663092562,1644802543,1644803298,755,3181
3709266649,3565585722,1649342197,1649342784,587,2879
3862754669,3087952571,1642477535,1642477605,70,3255
3070155926,3905759111,1652423817,1652424317,500,2682
3599386750,3403961686,1644345137,1644345596,459,4818
3218240107,3941572663,1644064677,1644065577,900,1759
3702910814,3937815022,1666410060,1666411000,940,2528
3198935015,3931799589,1660074806,1660075450,644,901
3937178898,3268256538,1657996429,1657997064,635,3370
3804540102,3819111681,1662050753,1662051630,877,472
3949770200,3120137131,1660862192,1660862354,162,233
3317739310,3121247391,1665409072,1665409539,467,1017
3180763341,3512466963,1664758691,1664759142,451,1692
3597628296,3462659948,1656646953,1656647380,427,3607
3987516041,3954540686,1666813495,1666814117,622,4098
3976959970,3428092419,1658030037,1658030228,191,2467
3714293900,3185028443,1665578840,1665579064,224,1667
3297290723,3171769042,1645460598,1645461074,476,872
3465678417,3089737915,1658508281,1658508885,604,2771
3959332431,3295394558,1667306379,1667306435,56,3796
3049255743,3644793124,1642740779,1642741708,929,4564
3514760357,3642083636,1641360003,1641360939,936,2756
3554761808,3460785572,1650369076,1650369419,343,4328
3650155845,3399207306,1655747907,1655748131,224,2769
3801830043,3164430472,1649430399,1649431377,978,4948
3573555553,3453699710,1646242136,1646242606,470,2528
3626870441,3373732894,1664743087,1664743814,727,2928
3695963175,3930480302,1642806923,1642807818,895,4506
3136410259,3811921559,1650069210,1650069547,337,3244
3826635382,3447923911,1655744501,1655744615,114,2527
3107956061,3449586221,1645221748,1645222040,292,3624
3483562157,3317568923,1669449493,1669449833,340,1648
3232947580,3899642924,1651382928,1651383812,884,727
3214383192,3579170896,1663694360,1663695296,936,487
3438890200,3640914630,1653050421,1653050491,70,2780
3783171379,3074961731,1665448231,1665448772,541,119
3145762184,3468884464,1661236436,1661237286,850,2166
3918448266,3569162395,1648970297,1648971108,811,4460
3063219225,3038287541,1669574107,1669574613,506,3951
3770837565,3636626107,1655572371,1655572954,583,2243
3126247799,3432370306,1654973463,1654974325,862,334
3726016574,3732506552,1661877893,1661878571,678,3879
3476514630,3075179573,1642279031,1642279624,593,2330
3155988847,3398715838,1661506195,1661507166,971,4818
3570324066,3735268052,1655749497,1655750111,614,554
3378882943,3534012855,1653985979,1653986583,604,3003
3142733146,3015260958,1666880721,1666880725,4,3710
3277784263,3215452975,1654298711,1654299442,731,3804
3387321048,3653073448,1641880771,1641881256,485,339
3380603483,3811464710,1642261170,1642261312,142,2117
3707372243,3774272800,1647740895,1647741279,384,1661
3606806679,3237821766,1641696131,1641696517,386,1536
3339626710,3950465358,1652555297,1652555575,278,4859
3464542698,3237993822,1663423189,1663423787,598,1875
3523352735,3190508220,1668454680,1668455182,502,3697
3127029877,3213312331,1642155985,1642156707,722,1363
3975794540,3335552070,1652904597,1652904666,69,2474
3720740064,3828879446,1658236630,1658236970,340,4924
3492780038,3565222853,1651080262,1651080348,86,337
3571798014,3343789147,1648545600,1648546057,457,1002
3585998083,3793672047,1655703488,1655704310,822,2900
3327231461,3306776325,1668870270,1668871229,959,2527
3383005086,3954518291,1662695866,1662696746,880,1071
3913309039,3960982442,1652725709,1652726586,877,1862
3280532986,3265624033,1646808670,1646809291,621,1534
3101768262,3131602383,1661058476,1661059266,790,4087
3890915580,3915498752,1663590220,1663590554,334,761
3457866680,3522022946,1660840660,1660840893,233,11
3676647000,3553500462,1661475357,1661475972,615,3346
3276869800,3601475599,1666696149,1666696474,325,3013
3274375036,3510905335,1663193321,1663194276,955,4641
3321172504,3582936973,1643503944,1643504373,429,2424
3082827024,3768985009,1655182656,1655182941,285,3950
3839398811,3290307555,1659122650,1659122676,26,2939
3857589649,3976005508,1659444152,1659445115,963,622
3116274949,3802626950,1663023919,1663024752,833,4325
3278637204,3504460450,1657297042,1657297180,138,1823
3665672100,3605772683,1657228710,1657229243,533,3235
3668147929,3047646133,1661208959,1661209313,354,469
3807284673,3585486568,1641511307,1641512004,697,2819
3481658551,3627675289,1668845603,1668845722,119,2587
3544020778,3466355480,1658104117,1658104286,169,4240
3001987632,3317430190,1642936030,1642936573,543,3438
3493581981,3863085547,1661551374,1661551683,309,1856
3578295072,3694363265,1655600254,1655600302,48,4708
3152317253,3372316640,1644769873,1644770556,683,561
3398689103,3924439159,1656721847,1656722665,818,180
3589072578,3216282333,1664696361,1664697299,938,1602
3416952397,3567632919,1665584115,1665584955,840,373
3250622411,3716885400,1651861167,1651861776,609,4211
3945155883,3623146344,1661506476,1661506481,5,2695
3895548153,3769123934,1645996046,1645996304,258,555
3553907329,3861207343,1648882793,1648883361,568,125
3244992628,3358020385,1649192595,1649193502,907,4138
3332953033,3533559884,1667639824,1667640581,757,2212
3044129033,3342513221,1649021817,1649022496,679,140
3739820108,3551631771,1665377597,1665378255,658,4910
3812109133,3516608979,1654235887,1654236326,439,4198
3447366453,3749182278,1649680366,1649680713,347,1198
3403788784,3524648430,1666986877,1666987845,968,4293
3237821766,3796765732,1658037488,1658038053,565,661
3295998576,3153469387,1657871255,1657871788,533,3962
3467934142,3870547725,1656342297,1656343000,703,3393
3642298852,3162370144,1643283553,1643283887,334,4079
3226802726,3526359241,1653790211,1653790235,24,3297
3060219453,3467007341,1652759976,1652760503,527,3716
3097033437,3115022698,1650988829,1650989562,733,1255
3142812960,3359581940,1644876443,1644876504,61,2847
3378109688,3171940326,1664904991,1664905679,688,4906
3178411090,3587625288,1654846236,1654846931,695,2290
3625604317,3958216322,1663817229,1663817624,395,297
3954376359,3644168112,1650667370,1650667774,404,4551
3716733438,3141988434,1667721682,1667722307,625,1895
3623932086,3091608897,1664919583,1664920100,517,3809
3672484387,3443764960,1641616038,1641616978,940,4008
3814466973,3777241469,1666080387,1666080968,581,997
3693548662,3441939151,1661910150,1661910578,428,3650
3003460716,3746643161,1663276808,1663277458,650,3366
3789364872,3553213047,1667853570,1667853620,50,3900
3800172207,3228306217,1647807234,1647807772,538,955
3364992076,3822599863,1650377787,1650377966,179,4662
3868043587,3470266763,1658239997,1658240462,465,3110
3843525237,3307609847,1652351333,1652351971,638,4907
3714694417,3100010134,1652748504,1652749349,845,2245
3368732747,3107680323,1653303523,1653304038,515,2126
3413408111,3210529479,1651851857,1651852571,714,2922
3305330102,3787876779,1667926780,1667927203,423,3732
3721190988,3130747261,1659498145,1659498382,237,2892
3508035715,3133572001,1659633532,1659633995,463,4786
3332204485,3197043947,1646938545,1646939118,573,3914
3403059623,3155080917,1658567492,1658568416,924,3046
3005964331,3107822536,1641118354,1641118887,533,623
3311544704,3766073634,1650046421,1650047036,615,3030
3871537698,3355072933,1663667840,1663667949,109,4609
3503973607,3046448783,1649609791,1649610429,638,4807
3513927025,3456722856,1664422710,1664423587,877,3853
3565326166,3277173193,1666543093,1666543821,728,4840
3661301010,3103785567,1655951086,1655951724,638,1207
3539918491,3615038242,1641563066,1641563837,771,3238
3519778490,3125555840,1645840512,1645841419,907,1018
3450530320,3789826919,1650990382,1650991189,807,2028
3664810807,3950873908,1649573221,1649573664,443,220
3499697168,3764473068,1659310119,1659310400,281,2364
3854340001,3957780147,1647384811,1647385667,856,13
3132584139,3840293769,1648472100,1648472367,267,3503
3007176392,3081898805,1668525346,1668525472,126,2208
3050488431,3740127934,1656457605,1656457853,248,1374
3660342336,3487733419,1656645634,1656646181,547,2264
3139614278,3629098663,1667129699,1667130006,307,3321
3149240347,3537537557,1667996062,1667996962,900,4697
3976291135,3823442965,1657301012,1657301080,68,2245
3412396838,3797756553,1665583292,1665583380,88,2976
3999819737,3161539431,1657768360,1657768466,106,1996
3324099846,3192329424,1668569307,1668569581,274,3117
3865866543,3921062397,1648572932,1648573886,954,925
3838431067,3386126998,1659773870,1659773933,63,641
3222798609,3570962078,1658616392,1658616615,223,3759
3759426276,3377136707,1666198783,1666198876,93,325
3245708877,3072454260,1655565959,1655566796,837,4187
3098492157,3565585722,1656836438,1656837295,857,1999
3940720396,3775709285,1663514880,1663515100,220,2199
3700076483,3049049781,1655222058,1655222201,143,3826
3000106517,3098851806,1649648785,1649649644,859,2679
3322296817,3848382789,1666350005,1666350358,353,460
3152813275,3822914120,1645990523,1645990864,341,2628
3166142720,3052354627,1659260945,1659260955,10,2523
3579976465,3977000290,1643715782,1643716000,218,921
3790114531,3867298580,1660487788,1660487991,203,3326
3829683425,3926040698,1653732672,1653733273,601,4009
3824741418,3332959729,1648172042,1648172688,646,863
3097912743,3051918915,1642660023,1642660814,791,4871
3830071431,3995732316,1656491648,1656491956,308,4841
3933074657,3023870413,1652770501,1652770794,293,3911
3465678417,3417965641,1656265703,1656266221,518,2531
3273004874,3847529837,1644051011,1644051378,367,3397
3966570082,3213485934,1652851286,1652852206,920,2767
3517360142,3534285371,1666660391,1666660788,397,2202
3152153227,3139196658,1661703838,1661704180,342,2454
3739440985,3574256299,1667395515,1667396272,757,2447
3359617276,3578262583,1650824229,1650825153,924,1800
3721986277,3476112078,1644795436,1644796015,579,3839
3204331713,3921713955,1664453278,1664453966,688,3760
3345430019,3528086503,1648500505,1648500948,443,4153
3993663366,3283986921,1663642201,1663642455,254,4667
3160585799,3497631575,1662708567,1662708655,88,3232
3003651520,3737476318,1654615315,1654615447,132,2325
3206848583,3793245508,1642270616,1642271161,545,2675
3125931192,3395874120,1668592568,1668593131,563,3866
3378066807,3507389821,1662572778,1662573667,889,127
3068321847,3699908111,1662126985,1662127650,665,198
3667880337,3652313686,1656855176,1656856022,846,981
3539649192,3573227938,1657033136,1657033681,545,4278
3986148651,3544841657,1644372261,1644372674,413,1285
3684826187,3826164279,1650930946,1650931401,455,766
3533027325,3303114855,1645303225,1645304199,974,3198
3544981896,3954661179,1667458287,1667459171,884,3562
3282945051,3438725911,1649203514,1649204008,494,3578
3331777351,3221686514,1644157008,1644157219,211,860
3366033151,3217331441,1668682271,1668682553,282,3283
3761540585,3369593360,1648725017,1648725950,933,3879
3215535865,3045540995,1665428042,1665428849,807,2344
3813177336,3984787783,1666106436,1666106728,292,2770
3645564532,3126093611,1668330396,1668331042,646,94
3048211119,3265920114,1641183794,1641183961,167,4855
3292176203,3259370815,1649518860,1649519148,288,1042
3661070688,3904901968,1643289581,1643289799,218,2756
3243901516,3668161206,1662851904,1662852638,734,1575
3264904009,3483728986,1648976271,1648976545,274,3512
3692367180,3891188996,1642257090,1642257527,437,2565
3644143282,3929448076,1654364376,1654364764,388,2169
3240621563,3989403718,1643535189,1643535326,137,3816
3052583435,3875901590,1650119283,1650119848,565,924
3396738738,3038506055,1667408608,1667409317,709,2606
3000716802,3429255445,1651614700,1651615156,456,913
3520958168,3768765094,1658917792,1658918683,891,764
3048732098,3544700557,1642308914,1642309340,426,1419
3036287872,3654539466,1642825721,1642826538,817,2315
3199695355,3677727354,1657588751,1657588833,82,2283
3768117336,3716351233,1666952489,1666953440,951,1727
3839916201,3152131663,1643063400,1643064327,927,1913
3569662789,3458552070,1643893804,1643894798,994,4671
3538065996,3880097760,1658459672,1658460667,995,2319
3483732265,3518356809,1654348052,1654348519,467,1625
3551477850,3712756170,1668345288,1668346003,715,1004
3490620916,3106590733,1663332892,1663333315,423,793
3081260354,3313621936,1663580349,1663581210,861,1763
3982425939,3432648894,1655342168,1655342242,74,3008
3990996447,3569984685,1649932517,1649932653,136,4032
3241619856,3827457094,1654688108,1654688234,126,1681
3167248289,3482028993,1655157114,1655157505,391,4561
3314696794,3849029203,1646796404,1646796810,406,4690
3696474270,3481101124,1651395514,1651395821,307,2858
3350855198,3806655028,1646087470,1646088271,801,2553
3819877393,3003627736,1652392902,1652393503,601,1619
3979512981,3594449619,1650054860,1650055434,574,2372
3227853940,3979935001,1661404046,1661404694,648,2609
3294176958,3207575358,1668947977,1668948849,872,2040
3887377284,3502040073,1657040763,1657040807,44,2148
3636299754,3545216822,1644844656,1644845494,838,1351
3216032730,3938843750,1661127173,1661127291,118,1909
3237326033,3878288306,1646704561,1646705111,550,2664
3248415858,3040810714,1645551879,1645551879,0,608
3900087129,3506105076,1655658961,1655659011,50,1054
3542587993,3298694762,1649304035,1649304416,381,4068
3772950579,3857512093,1656766004,1656766644,640,2818
3482794371,3898446787,1663512936,1663513880,944,3933
3147030260,3477106844,1656811432,1656812415,983,4069
3095706382,3718457169,1650666668,1650667126,458,4879
3906543600,3257147916,1661452726,1661453284,558,4403
3674476976,3628487373,1661455385,1661455828,443,115
3459584735,3741327110,1655408765,1655409654,889,4214
3626191470,3941310302,1658993784,1658994765,981,2226
3811357834,3916766513,1654790406,1654790575,169,3970
3195648231,3957297608,1669449991,1669450797,806,4741
3259539829,3212290570,1644513599,1644514422,823,191
3443909371,3848329478,1664785518,1664785773,255,4076
3370232057,3423869560,1650308219,1650309190,971,4444
3636412334,3508938233,1664777754,1664778100,346,1553
3892631572,3752552481,1647979980,1647980137,157,2636
3967225270,3146635330,1661601111,1661601346,235,1924
3351982273,3078023149,1652189220,1652190074,854,4174
3345955008,3307514048,1664127987,1664128189,202,2255
3081125855,3102456757,1649515154,1649515547,393,2187
3835131554,3699285901,1669380918,1669381437,519,3148
3779499761,3397254198,1654046513,1654047004,491,3735
3269263289,3412331988,1667401368,1667401717,349,2863
3938972958,3547070638,1648883832,1648884785,953,3063
3273590399,3466584947,1668635091,1668636047,956,1356
3555966326,3832183117,1652115545,1652116093,548,3106
3989496539,3222555302,1658293746,1658293757,11,2817
3393101179,3337568509,1666034406,1666035079,673,3825
3471149476,3454753727,1645763635,1645764533,898,4922
3555490664,3632165906,1647334141,1647334966,825,571
3858792568,3806964460,1663630745,1663630865,120,2318
3738169037,3277346167,1664164753,1664164765,12,648
3995192914,3972205448,1666969279,1666970083,804,4491
3145762184,3119050322,1650462063,1650462968,905,674
3062054119,3938638614,1642874772,1642875159,387,4440
3820533617,3991661222,1642801830,1642802713,883,357
3128290755,3351417920,1641382839,1641383515,676,461
3737882761,3315097810,1661569282,1661569318,36,704
3079468759,3617289003,1657574686,1657575619,933,1566
3004083971,3106892702,1650693338,1650693900,562,1176
3136785389,3772464667,1666103983,1666104780,797,3884
3702673840,3695684283,1647568697,1647569395,698,1421
3889230424,3841735181,1646328757,1646329337,580,1084
3353605744,3358714963,1665080364,1665081040,676,2888
3119062423,3854832977,1657049540,1657050000,460,42
3944087325,3545738689,1641112834,1641113215,381,1250
3400531291,3365229323,1659913956,1659914056,100,2486
3162456805,3890862353,1669637068,1669637315,247,2086
3439115662,3323040513,1655400602,1655401386,784,1604
3147302643,3414083044,1645751438,1645751606,168,2406
3435662457,3823458968,1667744957,1667745770,813,1637
3554578305,3416312948,1641957796,1641958246,450,868
3329736910,3702176017,1650329160,1650329964,804,3597
3424012430,3922503520,1655274791,1655275457,666,2690
3466606104,3024918879,1662105201,1662106163,962,3348
3409524270,3722144329,1652526121,1652526821,700,2697
3730715710,3267143161,1659713651,1659714040,389,4263
3614047471,3311466683,1660578289,1660579091,802,4904
3456706788,3729562452,1667459178,1667459747,569,943
3281316958,3414583942,1657805123,1657805764,641,2632
3431055122,3753033363,1666898022,1666898825,803,3693
3323309932,3557408563,1662565191,1662565950,759,4348
3570799572,3737770479,1651701056,1651701725,669,3350
3956359354,3728334013,1652377848,1652378001,153,872
3751760495,3535644174,1663700974,1663701814,840,2825
3718635060,3007159939,1662334588,1662335115,527,2936
3979512981,3188685309,1650323823,1650324729,906,1792
3490349793,3189104238,1642296155,1642297071,916,1029
3605098388,3204865160,1664861770,1664862684,914,2569
3370774025,3410777237,1647056447,1647057317,870,2005
3740360592,3555861380,1654486281,1654487223,942,921
3210448452,3391728412,1647908095,1647908096,1,4029
3978902749,3986952379,1654011021,1654011521,500,391
3108829048,3119612433,1669601667,1669602437,770,4243
3883227425,3859113340,1658555634,1658556355,721,3920
3331942343,3139565862,1652780698,1652781625,927,4581
3422128299,3837554222,1650741063,1650741901,838,3837
3243226430,3831164378,1657440581,1657441339,758,90
3270161711,3577154756,1653243867,1653244861,994,4456
3369576065,3151845868,1646003723,1646003870,147,2649
3438690496,3204434544,1642300418,1642300976,558,2477
3809627043,3231464839,1662331298,1662332233,935,1672
3837224236,3624393022,1668367562,1668367921,359,4378
3588943199,3049888019,1668634194,1668635166,972,4472
3285591476,3511052053,1651866840,1651866867,27,4566
3955803094,3579078857,1661838275,1661838928,653,199
3465529289,3299630787,1644994439,1644995375,936,2847
3782585751,3532165586,1659542663,1659543066,403,2945
3088539200,3425654937,1665461042,1665461177,135,2512
3805248541,3320718649,1660466772,1660467280,508,3832
3245659793,3702770665,1669246874,1669247000,126,3640
3428843089,3005571729,1666169114,1666169740,626,1635
3937054707,3501515854,1660458536,1660459060,524,2637
3853055077,3198219022,1641892043,1641892612,569,2006
3072201287,3060673853,1642379041,1642379733,692,4472
3583108274,3920025579,1648735536,1648736456,920,135
3966892258,3923170849,1661413148,1661414049,901,1502
3132151346,3212684094,1643277373,1643277797,424,1010
3286483416,3157094647,1646056561,1646056836,275,156
3908901833,3711436459,1646281810,1646281929,119,1243
3377944308,3356428876,1661254581,1661254754,173,4993
3646342062,3835974061,1644429087,1644429358,271,2165
3045697745,3759453664,1664130920,1664131380,460,4314
3732506552,3927164305,1647023292,1647024101,809,1229
3193831045,3495519638,1662430446,1662430587,141,1888
3735323009,3467635184,1667575914,1667575918,4,2927
3345738703,3804540102,1649239888,1649239947,59,4248
3294064693,3951850013,1641108403,1641108983,580,4841
3986400616,3273558099,1659796429,1659796786,357,2260
3903562582,3151310722,1663367602,1663368417,815,2700
3551967773,3816524967,1656270609,1656270673,64,3921
3894983870,3960674512,1643675189,1643675518,329,3181
3853972385,3254378854,1649693785,1649694036,251,34
3273082291,3442087363,1641330294,1641330719,425,4685
3751123198,3437531125,1659773147,1659773340,193,2198
3939544697,3867701859,1642233034,1642233553,519,4289
3104213008,3609341315,1669001335,1669002083,748,1920
3938953599,3645221776,1643425965,1643426185,220,2309
3213128454,3327190125,1669511677,1669512340,663,1574
3822426285,3183373378,1656527182,1656527424,242,1352
3446364273,3931000360,1643587096,1643587810,714,4033
3663369684,3081813647,1654522606,1654523242,636,2375
3218796129,3893361434,1659131766,1659132429,663,1580
3979809406,3672385468,1650684896,1650685637,741,3570
3788501922,3645720205,1666249665,1666250105,440,2404
3531397256,3689302027,1647898152,1647898297,145,1186
3120854899,3903789797,1647214921,1647215116,195,3687
3101729064,3756189269,1646759843,1646760586,743,4004
3184919651,3536046492,1641203628,1641203737,109,302
3251622689,3323744835,1660742881,1660743318,437,2009
3400647191,3177027030,1659134380,1659135039,659,1426
3080920766,3916744484,1649171301,1649171800,499,3805
3002910809,3133026545,1661794243,1661794845,602,662
3973842672,3737617598,1667579583,1667579954,371,2870
3885001437,3208396390,1665044911,1665045875,964,141
3249217141,3712664670,1650967015,1650967241,226,3192
3043244114,3166338743,1649359134,1649359460,326,1936
3691926348,3552445732,1655008352,1655008377,25,3537
3626664792,3458607569,1666337029,1666337092,63,295
3426368083,3751612582,1657861776,1657862378,602,3184
3988081681,3100933045,1654790284,1654790496,212,1057
3156659048,3910380118,1665445070,1665445988,918,4494
3894022788,3346914553,1652551462,1652552386,924,2591
3570299335,3424297545,1667399274,1667400192,918,4427
3303038650,3476597236,1657550780,1657550979,199,3485
3612848020,3060141365,1656774911,1656775225,314,3224
3312577053,3481201308,1655869563,1655869758,195,844
3765632512,3791914255,1643531007,1643531835,828,350
3519582695,3923330233,1666508944,1666509533,589,1756
3136483196,3640207306,1656855596,1656856353,757,2495
3599343803,3727022030,1655020188,1655020941,753,4156
3796623414,3143291969,1667659096,1667660051,955,2550
3076733958,3437554992,1657025822,1657026158,336,4856
3113509077,3399068655,1654786406,1654787068,662,4059
3343719253,3970079722,1645254079,1645254115,36,3531
3077539530,3474684289,1663251961,1663252310,349,3126
3764166906,3771577657,1664060632,1664061559,927,621
3494149524,3371941228,1660679875,1660679876,1,4225
3084605062,3163910956,1652109811,1652109831,20,267
3549122858,3095698828,1653158019,1653158396,377,3517
3910632103,3003781741,1656608309,1656608948,639,2943
3799945332,3734343483,1642583833,1642584396,563,1337
3466887035,3912588481,1646301615,1646301759,144,2748
3796671143,3730321603,1649841609,1649842001,392,4308
3782216115,3733329174,1668820072,1668820871,799,1032
3841445306,3484091927,1642489747,1642490575,828,4312
3328626698,3168054398,1662294360,1662295157,797,2262
3964180428,3881382333,1661099209,1661099416,207,2849
3804167883,3869048996,1648383036,1648383252,216,706
3249525662,3860225876,1667863965,1667864357,392,4950
3716376007,3041485168,1667508052,1667508589,537,4516
3769166910,3110612505,1667403953,1667404548,595,1612
3729631485,3648495102,1668842201,1668842979,778,4009
3695808929,3597829521,1646488999,1646489126,127,1589
3427001210,3767554802,1649040322,1649041111,789,1194
3097370349,3686617681,1654427685,1654428260,575,3593
3463840281,3630407842,1645708244,1645708845,601,1859
3057166192,3731465811,1651494296,1651495009,713,1241
3407726012,3277753683,1660850956,1660851876,920,3098
3466840352,3787868371,1646569336,1646569526,190,2218
3130153094,3452027853,1658082648,1658083356,708,3866
3469528026,3845160186,1647425403,1647425727,324,734
3702176017,3048921999,1663778766,1663779009,243,1720
3134549910,3884801619,1651911386,1651911406,20,430
3979935909,3768294532,1657944888,1657945390,502,4592
3669189250,3559826321,1665220234,1665220791,557,2127
3181818097,3339563623,1664742708,1664743416,708,3619
3649615524,3017349193,1649675816,1649675991,175,705
3718966293,3719733712,1663687158,1663687247,89,1538
3028597701,3353287311,1663585981,1663586045,64,285
3746015637,3580148445,1664656400,1664656457,57,1892
3239307412,3844064860,1666822302,1666822485,183,1613
3320608201,3757592127,1652602352,1652602431,79,1991
3660822409,3409757698,1649439664,1649440527,863,3837
3075927499,3591697760,1668040160,1668040938,778,4719
3978292530,3525243327,1661527466,1661527875,409,3144
3826812334,3917319917,1664200362,1664201021,659,183
3559740720,3087038418,1647868035,1647868582,547,4005
3272308454,3131999212,1662889781,1662890275,494,86
3472590131,3431325218,1664036353,1664036403,50,3998
3033116130,3955066655,1646927482,1646927533,51,1806
3891828502,3215246749,1657140789,1657141320,531,229
3474791125,3939361047,1668115263,1668115401,138,2605
3930874089,3468162380,1666749749,1666750039,290,3473
3961617171,3597151456,1652927734,1652927918,184,2532
3810075692,3842632839,1660575324,1660575590,266,2567
3811066214,3720469516,1642269359,1642269771,412,1475
3217565381,3657792071,1667460517,1667461030,513,963
3231018379,3769412420,1643180149,1643180243,94,4959
3794279760,3931670865,1652041266,1652041369,103,1272
3835355060,3391681521,1664101114,1664101310,196,274
3373068678,3955987962,1649966167,1649966632,465,1222
3148375346,3334098088,1642090974,1642091083,109,4068
3283969285,3452799582,1654101135,1654101142,7,3885
3296254433,3910404738,1644651844,1644652026,182,1353
3415564926,3076264689,1664008573,1664009570,997,209
3231637013,3765984446,1660987974,1660988798,824,848
3723712299,3798668341,1651730819,1651731479,660,3366
3572336905,3021036760,1668912375,1668913371,996,1199
3726255331,3825732885,1664782829,1664783716,887,3800
3576421293,3207568957,1668875848,1668876329,481,4453
3600198157,3033897573,1642382615,1642383029,414,3461
3439824553,3051638042,1644501470,1644501825,355,770
3509959480,3168100259,1665430831,1665431779,948,2026
3508322673,3972021352,1651927366,1651928082,716,79
3948889725,3560922211,1662550489,1662551452,963,369
3266631909,3104775157,1643502324,1643502473,149,1421
3056995350,3823694642,1646628175,1646628520,345,3231
3960902598,3992923058,1656533003,1656533116,113,2728
3685314247,3472767976,1662470454,1662470906,452,2991
3141002616,3384502897,1644655158,1644655529,371,3218
3333143295,3064562981,1646035611,1646036320,709,2568
3086168491,3192093744,1647293641,1647294587,946,0
3105007057,3739361590,1660374872,1660375132,260,1307
3539982055,3702673840,1643307278,1643307278,0,347
3746314179,3498146637,1641158408,1641158503,95,657
3070331909,3235616077,1641696296,1641696592,296,1925
3804647655,3171516489,1653819705,1653820399,694,1404
3698432521,3013449946,1642096715,1642097370,655,898
3361739322,3382922091,1654499951,1654500794,843,1698
3759565618,3346157237,1645427394,1645427539,145,3058
3066186033,3849968747,1662070392,1662070782,390,2238
3484918035,3750885417,1649891210,1649891423,213,2536
3680304387,3243131975,1641591385,1641591434,49,975
3240086795,3858031213,1652470779,1652471314,535,1806
3055781973,3174909359,1668374056,1668374351,295,411
3295417768,3468037260,1654633409,1654634308,899,1097
3000282131,3687542030,1647832255,1647833225,970,2419
3083336873,3868893537,1668210331,1668210950,619,361
3564787311,3710818773,1662393560,1662393644,84,3800
3311840797,3693819795,1650219072,1650219199,127,4630
3307131181,3738413879,1658204021,1658204175,154,4226
3812537668,3577067563,1655106559,1655107326,767,858
3245809384,3510735299,1650168518,1650168683,165,1702
3054363612,3523690944,1665272383,1665272531,148,62
3163477089,3885992511,1652795902,1652796061,159,322
3936284125,3785718915,1642273299,1642273985,686,4755
3564574520,3582873447,1660667575,1660667817,242,3520
3267847728,3913986031,1649675405,1649675589,184,2848
3564229546,3978456345,1657497853,1657498653,800,2324
3019232734,3070806574,1654649669,1654650026,357,1998
3646019345,3949066017,1654186322,1654187039,717,2542
3593200999,3092275438,1647197107,1647197626,519,1250
3182680296,3758085969,1649703353,1649704254,901,2602
3395949860,3482000800,1649924398,1649924818,420,4815
3049060928,3364471416,1667252767,1667253034,267,2428
3422295176,3702592510,1651392871,1651393830,959,1088
3536123014,3599386750,1645808598,1645809572,974,2930
3505849457,3049700719,1647653133,1647654119,986,2994
3344147385,3060576884,1646205503,1646205752,249,4793
3517001242,3288829625,1649817025,1649817325,300,2439
3668718561,3292586553,1652994506,1652994728,222,2971
3515822618,3393547537,1642680590,1642680618,28,1164
3650385205,3778164916,1664388361,1664388644,283,3849
3367125360,3557403611,1669620225,1669620617,392,37
3921295206,3351666034,1661477318,1661478209,891,2246
3748131266,3679865500,1666173054,1666173148,94,4912
3026350689,3679441161,1667274905,1667275202,297,4495
3242154783,3393724373,1658373428,1658374290,862,4455
3904797329,3975901136,1642332121,1642332686,565,967
3178679148,3916744484,1648952859,1648953307,448,767
3997350612,3371606619,1668915865,1668916772,907,2251
3431238678,3976665590,1653948462,1653948845,383,2542
3238491579,3344217278,1647139691,1647140240,549,4770
3674839577,3754126293,1651586998,1651587245,247,4364
3268060778,3376681738,1641372603,1641372679,76,3837
3453647253,3649658063,1657071875,1657072140,265,1236
3908296379,3078609608,1657966020,1657966587,567,2869
3988217140,3716742294,1654581625,1654581778,153,4221
3556044730,3745665721,1650447385,1650447743,358,795
3345623091,3631969278,1649586666,1649586782,116,4581
3035924918,3556622638,1641306907,1641307838,931,4654
3269225482,3606977137,1659434009,1659434981,972,3081
3300763429,3535485062,1649409866,1649410586,720,4394
3597451824,3708100440,1644547159,1644547600,441,2071
3499016422,3602220958,1663277604,1663277851,247,2943
3393176062,3716690143,1656185218,1656186057,839,795
3261982792,3772896888,1662488354,1662488882,528,576
3892849554,3311800813,1641205318,1641206181,863,2299
3050727934,3145580202,1646025471,1646025479,8,4174
3336913143,3347499679,1644953730,1644954193,463,3482
3666105565,3183817381,1665494116,1665494208,92,45
3358566344,3378928978,1652308438,1652308944,506,125
3651878551,3107653562,1663550393,1663551092,699,439
3852247509,3220116105,1650528751,1650529218,467,2410
3011538401,3508916395,1649031546,1649032000,454,2635
3175997509,3603959832,1656891535,1656891639,104,2071
3314436423,3575984192,1663199478,1663200035,557,2676
3862841132,3402123364,1656391614,1656391648,34,2948
3048891694,3950025968,1653915903,1653916229,326,2482
3175059865,3646234504,1659421137,1659421426,289,1741
3707644305,3552786792,1650144797,1650145492,695,4787
3477852843,3487910973,1645730597,1645730736,139,3741
3097324508,3459074149,1643927255,1643928162,907,1434
3558048011,3249440467,1643643962,1643644757,795,3881
3825644399,3831476438,1656301501,1656302491,990,1790
3329295032,3574030890,1652898018,1652898131,113,223
3154187996,3523730272,1643913459,1643914021,562,2051
3771971678,3373557405,1668099665,1668099688,23,2877
3365580675,3059048991,1649616132,1649616552,420,2241
3037727864,3835099014,1668746494,1668747224,730,3457
3785328580,3144395022,1644466119,1644467102,983,2351
3490486086,3322149774,1642076457,1642076628,171,4464
3213059617,3677835983,1653899119,1653900017,898,1088
3133350744,3734844545,1645638420,1645639187,767,2993
3848857196,3982742048,1643900738,1643900981,243,1210
3077509609,3000419153,1656820964,1656821842,878,1239
3799381085,3738563015,1647914289,1647914670,381,4937
3700967967,3768977588,1653777035,1653777836,801,1810
3531417658,3079322291,1647418180,1647418481,301,2496
3358802553,3136763617,1661807161,1661807565,404,4956
3586692316,3155032101,1659355766,1659356539,773,4633
3026633509,3992125603,1654817329,1654817991,662,3178
3099251700,3680659603,1646588343,1646588585,242,3611
3894184038,3084684270,1660612899,1660613364,465,74
3851459062,3338685665,1658470651,1658471164,513,4694
3320727452,3897503532,1642085175,1642085307,132,4679
3884755439,3359202475,1653562551,1653563458,907,1465
3761431085,3664288299,1648958048,1648958947,899,3364
3371186791,3106590733,1651352588,1651352751,163,2845
3159841448,3681573581,1643657307,1643657554,247,3991
3911361714,3194264736,1648657695,1648658575,880,3129
3929138656,3935264023,1652004806,1652005211,405,4395
3152145941,3199528124,1641868761,1641868816,55,3821
3885555793,3639825407,1645144825,1645144966,141,4834
3972626915,3645116092,1653177813,1653177956,143,725
3264073837,3447374512,1663090838,1663091523,685,4003
3248438047,3926260159,1662287431,1662288107,676,1352
3550725632,3302990672,1648303531,1648303863,332,4965
3477393113,3036812924,1663747982,1663748168,186,686
3097619158,3139664135,1659169827,1659170598,771,3372
3264942706,3613581272,1648135974,1648136769,795,576
3197086357,3521590641,1652476576,1652476784,208,4902
3352155314,3423083428,1647778681,1647778980,299,1597
3193682841,3459933434,1645062041,1645062349,308,1656
3024949982,3629431756,1652123057,1652123627,570,4702
3311322207,3563853078,1649372732,1649373140,408,1555
3602451282,3443128611,1654083767,1654083787,20,1571
3174646413,3185903771,1668632597,1668633064,467,4235
3212199137,3997817655,1661309677,1661310163,486,378
3138875199,3390057512,1656575864,1656576661,797,1774
3695603799,3440187163,1645717379,1645718156,777,838
3516624196,3589225867,1659054571,1659054614,43,3279
3854438335,3369808394,1658763243,1658763668,425,4667
3726441611,3347842851,1662602498,1662602926,428,3780
3640561736,3518869767,1657210728,1657210796,68,1347
3597316497,3162214476,1665324908,1665325402,494,3076
3815848024,3561533540,1659857654,1659858145,491,4566
3576878079,3288362139,1642245088,1642245446,358,935
3006353171,3956816160,1662404575,1662405136,561,3101
3898312867,3738092802,1665567307,1665568151,844,4149
3086220354,3924772711,1656413783,1656414179,396,3564
3494436413,3532370607,1642042371,1642042914,543,3518
3511054968,3372924095,1650049347,1650049976,629,4422
3423352344,3150373043,1646664243,1646664560,317,3478
3950267973,3662332588,1642655013,1642655513,500,4675
3893684443,3344578094,1666731434,1666731613,179,1382
3314116283,3709614767,1663977113,1663977305,192,1199
3482208499,3706518804,1656299142,1656299705,563,3712
3647705891,3452959956,1655816773,1655817505,732,2333
3559323209,3146010343,1645247821,1645248311,490,193
3592034195,3389353024,1668146717,1668146924,207,250
3347186850,3572872138,1647703582,1647704052,470,2768
3873610351,3068177895,1663146640,1663147146,506,3397
3601774964,3039405794,1647356552,1647357029,477,4413
3708032699,3552337426,1645622961,1645623468,507,420
3695684283,3373705042,1666397244,1666398225,981,4312
3265629816,3365789125,1661950504,1661951484,980,2078
3600051510,3369576065,1655343799,1655344647,848,3856
3063294479,3226300360,1646596466,1646597029,563,104
3818396514,3150270288,1665492383,1665492776,393,663
3078883093,3156257444,1662634456,1662634695,239,1165
3358598095,3631842765,1654414710,1654414934,224,3953
3100859760,3683815672,1666390330,1666390554,224,3102
3429304500,3781518452,1647117350,1647117504,154,2851
3731337698,3315486720,1663107773,1663108151,378,856
3038515002,3688283034,1660314569,1660314826,257,2301
3677738917,3591008261,1664427377,1664428299,922,1609
3965130650,3445851208,1658555151,1658555513,362,4192
3637889568,3204663733,1645939629,1645939767,138,2599
3275279830,3748825503,1653569046,1653569519,473,3448
3421523885,3266744708,1667908255,1667908548,293,3075
3333348696,3694080571,1665447553,1665448159,606,4408
3405821659,3397009815,1659977130,1659977445,315,589
3555319139,3374174183,1649201105,1649201546,441,2166
3967123090,3317163549,1651180241,1651180668,427,2705
3054461380,3453432045,1642730530,1642730868,338,2361
3573278364,3601637171,1663845140,1663845571,431,186
3549270155,3292309752,1644177535,1644178500,965,587
3646353753,3301597421,1659018838,1659019531,693,4785
3805115159,3484401614,1669093560,1669093843,283,4951
3435757620,3162901820,1643947249,1643947800,551,1747
3058827089,3440941042,1666148186,1666148772,586,1060
3122030285,3548185723,1668641948,1668642815,867,4947
3512536127,3632812269,1665821435,1665821467,32,474
3132538993,3563090998,1667918236,1667918983,747,1978
3908429332,3739585444,1658132435,1658133225,790,2131
3566050668,3291627038,1667702359,1667702741,382,4051
3018015322,3261861586,1664457535,1664458348,813,858
3752732664,3240753516,1642021576,1642022268,692,1308
3768197864,3757774602,1663050784,1663051338,554,3591
3581824307,3087505494,1642998909,1642999135,226,84
3676747645,3853021210,1668861933,1668862468,535,286
3834502391,3726396169,1642082585,1642083293,708,4440
3074980851,3832604849,1653451648,1653452073,425,745
3163319660,3714737726,1669256478,1669256974,496,1208
3242436788,3248330628,1643093671,1643093687,16,263
3556759067,3397703992,1651341855,1651341863,8,1554
3364050691,3675839632,1664351029,1664351728,699,1341
3168928941,3223974728,1656648572,1656648608,36,1174
3554467353,3530894474,1644514946,1644515846,900,1708
3478853138,3537071419,1655099153,1655099639,486,2028
3808648109,3119884985,1662865286,1662865971,685,2398
3916140242,3342464839,1650049333,1650049901,568,4110
3558273812,3069105472,1643899545,1643899993,448,4321
3167910586,3702746543,1646493569,1646494335,766,235
3517963674,3838609695,1657864983,1657865228,245,2230
3431073978,3418298779,1662056012,1662056570,558,984
3136123883,3731708837,1667498846,1667499441,595,2577
3941891849,3647901249,1645676480,1645676646,166,255
3577301217,3797373842,1666975029,1666975920,891,1458
3556576890,3208263974,1643033969,1643034809,840,2013
3610848828,3564976199,1657787592,1657787839,247,957
3032333967,3491184633,1669038071,1669038958,887,4410
3967461117,3223810578,1664579982,1664580030,48,2015
3017820894,3775587869,1666367807,1666368209,402,3476
3552275616,3013407948,1643531197,1643531517,320,4883
3939919613,3678538815,1643882515,1643882836,321,4159
3715727958,3495908584,1645368053,1645368730,677,235
3063653423,3500910984,1649153500,1649154401,901,2546
3292309752,3930725790,1654333537,1654334409,872,4028
3171448594,3681533812,1661685501,1661685731,230,1053
3718997482,3769077239,1653400168,1653400332,164,3848
3381647781,3388475229,1642271982,1642272371,389,3256
3775948077,3268872538,1641586546,1641587376,830,4830
3516712361,3703924259,1649642848,1649643778,930,1004
3354169760,3014328258,1647137790,1647138457,667,4070
3062169447,3105290173,1664953501,1664954196,695,3579
3567632919,3024028812,1663808107,1663808802,695,204
3407262538,3127925822,1668805581,1668805932,351,3434
3744988493,3135094975,1654735030,1654735276,246,2276
3845132567,3383773758,1658046680,1658047284,604,286
3511673768,3472416579,1641171929,1641172648,719,3882
3925779984,3492413996,1649705927,1649706052,125,3806
3853441573,3163481788,1647478950,1647479723,773,2326
3513863789,3782092451,1641124811,1641125660,849,4353
3940504573,3189120195,1660171298,1660172150,852,1316
3729198501,3806760945,1652032365,1652033057,692,1821
3430252829,3101258835,1661954365,1661954819,454,2661
3811924611,3122302437,1662579533,1662579585,52,3934
3746585101,3465183079,1658640436,1658641134,698,3300
3538175537,3850956608,1661810539,1661811270,731,4844
3336425434,3570007174,1652972280,1652973243,963,3127
3106997438,3866049112,1649670110,1649670495,385,2916
3795557140,3217732918,1648352060,1648352245,185,3193
3622301019,3142780463,1661327761,1661327914,153,1801
3600183902,3598333145,1657809269,1657809428,159,166
3944956525,3056094935,1645131903,1645132652,749,1554
3248828328,3603439670,1664821472,1664822056,584,84
3879610924,3179763172,1668994731,1668995030,299,1975
3022354822,3332458207,1649279862,1649280664,802,4091
3526943721,3804074860,1650071663,1650072143,480,2400
3418513250,3218825798,1648116742,1648117243,501,2989
3529857638,3725578705,1647410816,1647411766,950,3837
3467450689,3319884065,1650208295,1650208593,298,977
3443572923,3150432498,1664667820,1664668452,632,4070
3395302686,3482523990,1651858368,1651859103,735,4988
3872795541,3346246102,1647256784,1647257528,744,3922
3399199221,3208972017,1658054372,1658054657,285,301
3323176739,3150568196,1657433748,1657433839,91,2419
3756514144,3069723891,1648517849,1648518414,565,457
3429304500,3152101202,1646121882,1646122495,613,1442
3376505502,3363975987,1659282676,1659282921,245,2952
3373892309,3947089511,1661960765,1661961620,855,814
3704476261,3294488677,1658020497,1658021470,973,4639
3368287477,3854636485,1650397822,1650398356,534,3702
3701867309,3408231144,1641764729,1641765555,826,3822
3203747995,3697169337,1658904926,1658905259,333,4259
3204201429,3043145206,1644577455,1644578405,950,1055
3611616482,3263521770,1662824416,1662824963,547,408
3029433226,3231716700,1669356898,1669357257,359,4341
3747291973,3817477864,1660541149,1660541274,125,1695
3868719518,3527404713,1669037596,1669037870,274,4222
3281399606,3991039644,1658901325,1658902142,817,2333
3065390761,3984337349,1663544334,1663545119,785,3608
3404066242,3011568912,1644195247,1644195786,539,197
3959382146,3854260390,1658845819,1658846708,889,1298
3279085864,3138520909,1665028516,1665028525,9,2892
3869468461,3866848895,1660243183,1660243554,371,994
3106271056,3076738962,1657260499,1657261485,986,4223
3340721907,3812234916,1660518176,1660518554,378,2016
3320917010,3345612898,1665147585,1665148307,722,3672
3090148836,3622835781,1649641331,1649642289,958,1131
3602694809,3886477997,1660101522,1660102137,615,716
3288572887,3675978003,1649110798,1649111070,272,3227
3952768246,3698200596,1659640887,1659641275,388,1827
3750449501,3909141647,1647067182,1647067516,334,3802
3391641278,3162671290,1662217802,1662218446,644,1980
3322126403,3915863796,1663245959,1663246066,107,4642
3631087796,3587982570,1668848404,1668849243,839,3316
3119383138,3056355283,1662190810,1662190959,149,4588
3574283532,3703498518,1644852853,1644853770,917,4659
3162410505,3933930669,1640998015,1640998794,779,4257
3381205426,3958478681,1656927218,1656927688,470,2544
3672533588,3911137309,1661454996,1661455078,82,696
3032629223,3254828505,1649166630,1649167301,671,532
3763855343,3033668539,1660727912,1660728300,388,4036
3150685995,3594322640,1668782918,1668783690,772,2226
3042027114,3751322103,1648251206,1648251250,44,2425
3397510237,3054986469,1643132167,1643132345,178,2350
3653093904,3570226708,1662949595,1662949854,259,2273
3307585606,3878594412,1645275350,1645276287,937,1800
3288044068,3274594896,1647446187,1647446985,798,3069
3425540385,3208654421,1650324075,1650324679,604,4439
3171822750,3497707319,1668204026,1668204904,878,2119
3147039602,3950768440,1647295769,1647296499,730,4661
3046616918,3948715773,1642231104,1642232069,965,2031
3510493739,3297912191,1669598970,1669599539,569,2704
3438453139,3407921211,1667677362,1667677966,604,3927
3051086968,3800189101,1665297752,1665298700,948,3284
3703498518,3777216951,1656606477,1656607186,709,2106
3591478750,3454458549,1647935425,1647936106,681,266
3573856005,3310740001,1657253822,1657254567,745,758
3815806921,3787884274,1649518313,1649518907,594,3019
3374191663,3612953849,1646757869,1646758358,489,4101
3678822978,3947435328,1655092339,1655092981,642,3227
3269389153,3657841625,1646619929,1646619957,28,4266
3311567482,3432666506,1657311288,1657311701,413,2404
3441818876,3861661555,1651231440,1651232349,909,464
3698684338,3098396709,1642072690,1642073519,829,3868
3442227512,3825573703,1646407465,1646408242,777,4680
3344990048,3262138988,1650720909,1650720975,66,3851
3469365554,3462110884,1657471285,1657471721,436,1323
3945363789,3405223708,1657373209,1657373767,558,2143
3538514588,3549677358,1662410269,1662411131,862,2662
3817572268,3515750378,1651548657,1651549560,903,506
3374870493,3063568677,1661371427,1661371695,268,2452
3994974721,3350054357,1645216142,1645216256,114,4084
3687331544,3115699001,1654376056,1654376872,816,4006
3388862229,3004906408,1651973983,1651974697,714,1571
3030817432,3807929501,1649118655,1649118928,273,643
3809694244,3530463739,1667685747,1667686133,386,4731
3530834031,3548056229,1651031474,1651032183,709,1307
3695323618,3771567416,1653656692,1653657132,440,2882
3287598686,3993661047,1664165493,1664166367,874,3194
3205240490,3199563000,1645870790,1645871620,830,3370
3322038638,3215067054,1641213246,1641213560,314,4537
3213146349,3707215229,1666647483,1666648079,596,114
3114050384,3406000969,1656520929,1656521236,307,2988
3875480555,3895407596,1645159993,1645160090,97,3093
3159304663,3446555296,1644190552,1644190927,375,4050
3543660296,3829113799,1646670030,1646670249,219,813
3326386884,3874073217,1647380412,1647381279,867,39
3220087284,3630241700,1659232659,1659233525,866,3472
3299601898,3478279444,1666285598,1666286220,622,1703
3567190200,3485919638,1658525746,1658526641,895,2844
3114489882,3553256628,1649552781,1649552819,38,3018
3986575592,3857872755,1657383584,1657383852,268,1985
3022366152,3605223000,1669612570,1669612830,260,1963
3776026245,3269016229,1643531108,1643531689,581,3379
3302326271,3076013752,1665632520,1665633049,529,449
3142631839,3533453714,1666697965,1666698745,780,2879
3250837495,3816199218,1666048524,1666048889,365,3233
3514763577,3862170700,1649717525,1649718312,787,23
3934703309,3197172383,1659164526,1659164692,166,2035
3212804676,3479032856,1660319211,1660319227,16,1695
3536587408,3382398489,1648093732,1648094144,412,362
3989043360,3278867545,1651981056,1651981850,794,3437
3779976379,3927374120,1666573206,1666573868,662,1218
3647134266,3967898602,1648531180,1648531988,808,3000
3772631884,3028696508,1660498619,1660499043,424,1576
3512040560,3556899046,1665680342,1665680748,406,126
3227275103,3570730165,1664927333,1664927630,297,3714
3072385110,3434789041,1649311593,1649312133,540,2811
3511922800,3285509534,1661323554,1661324432,878,2065
3633698929,3318095420,1643421379,1643421820,441,1387
3618360613,3920021634,1668919839,1668920243,404,3589
3011532151,3567241504,1656868299,1656868456,157,2638
3053480902,3034545528,1654908913,1654908990,77,4953
3929891013,3257548558,1667681862,1667681982,120,678
3775986853,3942747612,1647584965,1647585698,733,3937
3922541245,3529138590,1646365622,1646366302,680,533
3764294963,3659138020,1655960967,1655961446,479,1050
3502268099,3898418108,1668458232,1668458555,323,3401
3846598273,3696166386,1651229915,1651229935,20,2206
3641757170,3648524293,1641437238,1641437900,662,315
3574407069,3510751834,1652820067,1652820161,94,190
3526278218,3271069080,1651438949,1651439636,687,4441
3876816508,3439099399,1649708185,1649708194,9,4936
3670929700,3070629479,1654029584,1654029909,325,3048
3574899314,3623391649,1653618998,1653619374,376,1679
3854636485,3623938506,1665782135,1665782247,112,3541
3470345997,3755324697,1660795066,1660795330,264,849
3719334806,3376850873,1658120646,1658121026,380,64
3322519167,3793514464,1649128187,1649128224,37,2927
3232606735,3731550876,1643069194,1643069728,534,1019
3864787204,3537089473,1661765013,1661765485,472,3416
3933670104,3173244438,1647746750,1647747403,653,1802
3568544980,3642583189,1646783221,1646783936,715,2950
3560102218,3490250056,1653966610,1653967437,827,474
3407438146,3406458921,1666299546,1666300074,528,143
3701881328,3887347638,1663972421,1663972942,521,730
3823953396,3809020062,1647528665,1647529231,566,3239
3393291709,3905160223,1658352953,1658353578,625,1890
3119462567,3403889019,1644922706,1644923332,626,1137
3498840898,3744180199,1667519888,1667520692,804,521
3251095803,3835537596,1644340673,1644340922,249,308
3615331883,3050356150,1642553434,1642553806,372,2625
3388912190,3866117460,1665931268,1665931360,92,3174
3409042435,3138290507,1648836204,1648836448,244,4599
3325242361,3737466604,1660886976,1660887170,194,1262
3802597481,3976959970,1664818907,1664818988,81,4625
3488150664,3001151269,1641201427,1641202339,912,2871
3008575368,3753440115,1661021688,1661022251,563,1702
3570046493,3568320981,1662888612,1662889213,601,452
3059948586,3065916163,1650231385,1650231598,213,2961
3548794025,3081301738,1656657945,1656658752,807,2195
3270066898,3308933191,1663588063,1663588532,469,474
3726591900,3044165240,1666853293,1666853973,680,2368
3024939604,3938638614,1642329654,1642330430,776,3816
3897023494,3111698461,1641166209,1641166506,297,2139
3837079343,3597519343,1649705937,1649706171,234,2566
3841068934,3125556151,1659196821,1659196994,173,4847
3125267028,3278303417,1663943540,1663943797,257,738
3038281663,3699977408,1650310279,1650310769,490,2673
3595208276,3811792093,1644968706,1644969435,729,1600
3979654359,3290949672,1659666929,1659667815,886,2151
3603033465,3017606504,1654727933,1654728313,380,3396
3525857847,3353334864,1668733648,1668734091,443,2959
3338357286,3802200093,1664167302,1664167400,98,4329
3666911358,3946199242,1666619251,1666619626,375,992
3048362710,3115623444,1649260358,1649260642,284,586
3767113112,3075760322,1665414479,1665415473,994,224
3012015863,3309377422,1664941054,1664941348,294,829
3196683588,3548228086,1643163718,1643164340,622,1164
3743855298,3671307509,1665622879,1665623859,980,3498
3365070596,3120122219,1646120117,1646120439,322,1865
3079665373,3781116910,1665225198,1665225373,175,3664
3313759450,3407769962,1651557675,1651557876,201,2780
3762499535,3540223652,1664882412,1664883374,962,3876
3778898148,3169352310,1662132466,1662132713,247,995
3673853435,3022216233,1665437109,1665437981,872,3844
3796505288,3406342260,1651288899,1651289013,114,2482
3577324879,3126197243,1669334045,1669334930,885,1268
3400181506,3245878868,1659896380,1659896794,414,133
3904325757,3300952349,1646969198,1646969502,304,2259
3830082929,3512255799,1644457688,1644457911,223,4986
3021824510,3466489751,1646489355,1646489993,638,2912
3274857707,3822762555,1644831249,1644831290,41,3928
3092632142,3654809146,1646690219,1646691025,806,644
3048963758,3097882070,1662689471,1662689673,202,662
3083486756,3150658010,1642420153,1642420478,325,2475
3432784264,3762925910,1642167116,1642167167,51,3927
3219061484,3310219160,1644246427,1644246765,338,4072
3141554481,3955406529,1659194889,1659195663,774,207
3710054374,3475968456,1642614261,1642615015,754,1596
3871713615,3176854871,1649843033,1649843218,185,2158
3451174702,3203143124,1658684960,1658685614,654,3059
3049247250,3792123502,1667893564,1667893599,35,2461
3814815465,3777910379,1647951146,1647952131,985,3638
3676539559,3490369362,1660158514,1660158718,204,2291
3965929525,3109420286,1662866328,1662867184,856,168
3642308164,3300872564,1666651871,1666652046,175,2914
3269551723,3038946560,1644830941,1644830945,4,4637
3266950123,3595214869,1645253927,1645254196,269,3081
3724133619,3424178720,1656068213,1656068399,186,501
3861510874,3560008004,1642788126,1642788901,775,2579
3330700820,3826959285,1657403329,1657404222,893,3038
3551421042,3303049822,1646086762,1646086870,108,4070
3712456613,3654855335,1651405521,1651405744,223,347
3674861469,3087230275,1665802123,1665802411,288,3137
3765543995,3229324983,1650321614,1650321998,384,3698
3621442920,3461022652,1646436249,1646437035,786,583
3142633666,3019436398,1641276905,1641277529,624,3300
3976387307,3962274931,1653253306,1653253653,347,4205
3980506726,3553174654,1653302635,1653302798,163,3834
3865667894,3932988011,1664627275,1664628180,905,864
3652092553,3865066990,1653931344,1653931754,410,1525
3174646127,3497302155,1659783955,1659784736,781,4255
3122316043,3274173287,1658037798,1658038320,522,1106
3776934944,3161094389,1655363782,1655364064,282,4329
3067879877,3245039654,1662174534,1662174848,314,387
3413177703,3215247615,1668716570,1668717522,952,2139
3089858584,3030485249,1668689783,1668689800,17,1812
3437612203,3132520096,1667405997,1667406087,90,4972
3649550215,3722823993,1659615344,1659616290,946,4249
3876649177,3832534259,1648851544,1648851639,95,3125
3038353485,3898131860,1643425632,1643426167,535,785
3425350335,3382004630,1668736005,1668736526,521,2710
3940935158,3438373107,1669152818,1669153020,202,2679
3812440176,3758209809,1667614247,1667614458,211,3734
3559575425,3955464356,1666275352,1666275544,192,3880
3484918035,3559826321,1653298234,1653298783,549,3698
3311840797,3009264920,1666961347,1666961739,392,1978
3595751849,3905491595,1647499266,1647500225,959,4575
3912688535,3781466522,1646816625,1646817220,595,4995
3179010360,3413970422,1653356157,1653356860,703,4114
3710688671,3791739888,1643333770,1643334155,385,1247
3009804108,3098872707,1655768419,1655768974,555,2620
3075080546,3629455046,1661262639,1661263236,597,1253
3488505272,3214854107,1657909669,1657910121,452,289
3343820267,3270502753,1655010831,1655011556,725,4122
3483495750,3826212927,1666305790,1666306242,452,1512
3028002354,3370104438,1663143869,1663144457,588,2895
3676671094,3051638042,1664290168,1664290230,62,2774
3126612603,3144300512,1650733090,1650733430,340,2436
3114555057,3728110509,1664395913,1664396429,516,2603
3814063820,3793442830,1666441933,1666442366,433,2487
3251148639,3817755200,1659378919,1659379625,706,2798
3753326211,3930478562,1665147465,1665148030,565,1368
3562248543,3817985109,1641352130,1641352866,736,430
3702465059,3939496467,1641554887,1641555868,981,1451
3208508767,3677068305,1641632403,1641633134,731,2295
3339757799,3680093918,1665545792,1665546090,298,4531
3797999300,3870890024,1658810798,1658811760,962,4259
3824741418,3383536144,1662678947,1662679920,973,751
3036165152,3359141588,1659516493,1659516955,462,2328
3545425892,3507785782,1648279749,1648280585,836,628
3603359440,3677943959,1668334305,1668334838,533,3911
3407570232,3980273068,1662527803,1662528474,671,184
3206530146,3066775847,1652674696,1652674756,60,4597
3871262789,3691898465,1659873058,1659873455,397,1655
3296786216,3517119108,1646377925,1646378248,323,121
3361098383,3246871614,1659136672,1659137515,843,3824
3593973386,3802664884,1650328490,1650329465,975,844
3576681411,3184224166,1666154008,1666154738,730,537
3288605716,3645640893,1666713155,1666713488,333,3309
3311544704,3600648830,1654164845,1654165739,894,2309
3305158859,3010847998,1652893909,1652894067,158,4513
3436108965,3933946766,1651666888,1651666922,34,4097
3048781653,3853346806,1658783236,1658783421,185,4926
3455285279,3148264406,1669450647,1669451182,535,308
3570416045,3906854329,1653872581,1653872820,239,383
3661360916,3097572511,1644500460,1644501285,825,1748
3641383519,3661603690,1664480676,1664480922,246,1325
3244665895,3731060109,1654581932,1654582873,941,1459
3845355726,3713280666,1661968626,1661969383,757,83
3785640310,3507152848,1667220720,1667221417,697,2587
3729663284,3021771186,1668612999,1668613827,828,3371
3888541272,3354004509,1663813996,1663814267,271,3911
3672567963,3389516910,1651285799,1651286639,840,4643
3258643811,3355831878,1647603026,1647603075,49,4315
3984066975,3128721551,1661137722,1661138634,912,244
3520005319,3437790762,1647680401,1647680721,320,3640
3219971651,3353577206,1663474643,1663475524,881,2262
3012056504,3803991712,1647706454,1647707452,998,3160
3095850201,3172095366,1645382114,1645383053,939,98
3742153570,3757636744,1646429390,1646429461,71,4608
3612945861,3677789439,1658611212,1658612002,790,4617
3698331145,3174234820,1653756429,1653757224,795,2459
3496184023,3109301127,1660438937,1660439783,846,1679
3695055776,3316774322,1666236654,1666236793,139,4681
3820175445,3536521355,1656286975,1656287040,65,817
3351506363,3832861537,1646241854,1646242104,250,2699
3601842431,3459800346,1656413809,1656414287,478,4633
3155996453,3323374303,1647212325,1647212412,87,1206
3437708022,3882376895,1666701290,1666701871,581,4921
3364795087,3976121640,1651250027,1651250809,782,2556
3431610913,3668939376,1661337304,1661337579,275,695
3067544828,3945299362,1659303457,1659303841,384,3619
3804864870,3962221914,1645250108,1645250669,561,3594
3128012086,3270920556,1668330121,1668330677,556,2046
3021015404,3967104302,1655611414,1655612370,956,4144
3590807222,3321765777,1654532228,1654532814,586,2817
3735906341,3110813046,1659061077,1659061906,829,4138
3433564383,3352610471,1644805717,1644805889,172,3226
3424937895,3302277551,1663400694,1663401328,634,1709
3219847918,3722469154,1666115307,1666115569,262,3925
3522191588,3160098869,1655785227,1655785272,45,1991
3859906503,3766073634,1645063342,1645063588,246,3971
3859476946,3277974558,1657162905,1657163294,389,266
3698746562,3187968189,1656285485,1656285681,196,2467
3507975818,3998598437,1642468724,1642468901,177,2915
3385447528,3568576466,1653734749,1653735438,689,4132
3257634428,3532162090,1663807217,1663808165,948,3792
3338401664,3160981738,1660738309,1660738449,140,3650
3025084000,3324077565,1667189023,1667189934,911,989
3456868558,3308202033,1657098703,1657098917,214,3108
3019182738,3935039806,1655876486,1655877168,682,3805
3679888864,3451687607,1652877721,1652877830,109,3790
3968960831,3599756363,1648754172,1648754400,228,4808
3313139863,3964237395,1660927798,1660928788,990,398
3746413577,3292198009,1649971420,1649971519,99,1376
3789992869,3595238479,1654865961,1654866464,503,1696
3513414843,3897890287,1651664888,1651665217,329,3552
3341471470,3830775748,1660514660,1660515417,757,2294
3426557868,3292876404,1646399399,1646399558,159,4639
3506914499,3016257285,1651760374,1651761009,635,1766
3996272105,3200522060,1653087821,1653088764,943,2425
3149166601,3534701826,1649242545,1649243165,620,3386
3976535004,3358611723,1655559374,1655560201,827,1279
3810400002,3712268706,1655102781,1655103340,559,469
3752838059,3369599484,1665463714,1665464177,463,3545
3845637488,3805975771,1648115857,1648116790,933,3913
3757153646,3592171568,1645609657,1645610318,661,4118
3846216741,3952426342,1649720322,1649720683,361,4057
3045540995,3919109316,1645893379,1645893531,152,2096
3436090125,3820938407,1658754177,1658754207,30,1928
3505989094,3134039862,1651385336,1651386134,798,1873
3432004429,3459863285,1648428689,1648429464,775,629
3606988788,3130185988,1663997910,1663998502,592,3064
3416218604,3013788155,1641779221,1641779339,118,1768
3265958330,3771370201,1649188873,1649189714,841,1687
3121550193,3365988570,1642652373,1642652532,159,3566
3039648795,3316389418,1648228861,1648229531,670,2233
3053199735,3739140570,1666637877,1666638761,884,1447
3806392219,3428103775,1644063779,1644064703,924,444
3580076136,3343492046,1666639800,1666640065,265,2260
3037794329,3411398918,1656244378,1656244931,553,2674
3062725929,3958397268,1657279306,1657279369,63,4892
3239515525,3667075384,1654495355,1654495843,488,4329
3629476757,3134342794,1650009922,1650010327,405,2609
3230243557,3537674364,1663861577,1663862567,990,1794
3272163002,3646747668,1656800180,1656800235,55,3646
3587242360,3751405869,1660737699,1660737932,233,2857
3997068839,3855140856,1660267908,1660268546,638,3820
3305098554,3018167019,1665840903,1665841312,409,4779
3674568780,3029793208,1662749053,1662749716,663,4488
3609270396,3587631849,1642642055,1642642581,526,2673
3086958441,3651827228,1645505717,1645506280,563,3835
3370128188,3915909292,1644472659,1644473091,432,4757
3102424103,3958995868,1642872208,1642872691,483,3308
3631842765,3081569500,1658426139,1658427094,955,3148
3021562646,3157818399,1657606299,1657606542,243,4367
3561698557,3497838632,1658447264,1658447530,266,4978
3168103487,3485019435,1641709245,1641710066,821,2493
3694102533,3866381741,1662481517,1662482078,561,2262
3019339632,3561792862,1653560966,1653561918,952,4977
3633846676,3327506867,1645525651,1645526428,777,2246
3919893864,3160882783,1649684828,1649685328,500,2215
3672104680,3455868023,1641159183,1641159738,555,4822
3642487632,3217894263,1656821727,1656822188,461,1686
3568708036,3719941194,1656984384,1656985224,840,2033
3749344472,3799391441,1664890355,1664891284,929,696
3032569867,3129387553,1659682557,1659683190,633,4564
3350370672,3152611120,1669477751,1669478747,996,4775
3026403616,3422230160,1649874922,1649875231,309,4616
3874491484,3208973201,1646021221,1646021959,738,1670
3250968144,3534549700,1657392717,1657393394,677,620
3908949773,3893100366,1659255174,1659255984,810,539
3915498752,3339523894,1660412439,1660412844,405,729
3518518282,3404769093,1653015949,1653016794,845,10
3571431998,3719928912,1658795848,1658796560,712,3803
3927094650,3943225855,1646401337,1646401886,549,2134
3996763864,3934844053,1654644464,1654644475,11,3215
3203674900,3350932020,1659836204,1659836892,688,4698
3038500162,3726255331,1643072787,1643073652,865,806
3070645739,3189484837,1641685298,1641685309,11,4483
3319348155,3701117091,1646908375,1646908550,175,2809
3184545199,3122351155,1649150427,1649150668,241,405
3111435024,3279060435,1644988208,1644988277,69,620
3547169454,3113937359,1646128066,1646128767,701,3112
3271086241,3384871296,1647831042,1647831264,222,3965
3072991251,3541606833,1660880984,1660881185,201,1849
3350322682,3691650734,1645500859,1645501200,341,3721
3339803811,3987420490,1661997868,1661998844,976,4421
3207962766,3664706064,1643707041,1643707229,188,3633
3138729811,3900724899,1659956899,1659957814,915,1721
3470283071,3605313145,1667079780,1667080550,770,2352
3267620290,3578622576,1666808850,1666809507,657,4969
3933955785,3530683636,1653702827,1653703020,193,2809
3352639962,3717806168,1646727236,1646727726,490,1416
3687274595,3567711890,1649259667,1649260393,726,3750
3386382825,3705832398,1652228233,1652228997,764,4224
3475351237,3597190446,1661629671,1661630498,827,3111
3896664341,3367272834,1643478282,1643478789,507,1757
3498222829,3026871452,1650134124,1650134489,365,3761
3635215296,3183348114,1657075114,1657075168,54,1411
3851815532,3057113687,1644981857,1644982253,396,1584
3266759680,3441049048,1656263821,1656264579,758,1320
3470463404,3852899714,1662442538,1662443032,494,1452
3960963614,3199636575,1642858250,1642858730,480,1900
3419968811,3050526279,1661038513,1661039179,666,547
3419882255,3868509340,1660169881,1660170541,660,3882
3635926617,3994712515,1649939379,1649940251,872,991
3961175185,3588612021,1651277209,1651277913,704,1771
3458067867,3601843543,1652058311,1652058707,396,2318
3181744604,3506836720,1644257834,1644258434,600,4645
3600981651,3176463119,1649382969,1649383792,823,4335
3195329689,3596931598,1662082318,1662082451,133,445
3290247061,3999366965,1647836861,1647837700,839,1923
3307446731,3743058723,1646905278,1646905971,693,2354
3234192461,3808504690,1653288048,1653288854,806,2817
3134369673,3296483609,1656246248,1656246382,134,688
3727703451,3875542699,1646220983,1646221556,573,2570
3500597917,3891542534,1658979119,1658979529,410,119
3627524357,3566625013,1650503805,1650504387,582,696
3872716214,3869608592,1653031686,1653032485,799,3642
3126130264,3280266638,1659442355,1659442911,556,1622
3160635060,3944101465,1646833773,1646834219,446,4482
3163166040,3607796902,1658613720,1658614304,584,2553
3117528936,3850443540,1646688355,1646688549,194,1057
3018391769,3234015173,1659948001,1659948756,755,3626
3640227872,3505108449,1661220888,1661221616,728,2529
3222036539,3771391766,1659959544,1659960371,827,2312
3452901546,3453702104,1649974358,1649974912,554,2291
3942688111,3263793157,1658810769,1658811371,602,3644
3583068590,3795632696,1657064700,1657065266,566,3229
3513219728,3632448134,1666675166,1666675507,341,2952
3239629106,3731464405,1661418658,1661418980,322,2954
3899293355,3796146265,1669285162,1669285833,671,4655
3515750378,3584932264,1644667594,1644667970,376,3283
3058919668,3120712318,1658179443,1658180134,691,784
3922277642,3539073188,1645980445,1645981275,830,2857
3771268261,3859992585,1641565786,1641565928,142,2776
3461385822,3306519508,1663676817,1663677745,928,3781
3899265189,3562816372,1664396483,1664396542,59,2870
3112603638,3177439001,1655191379,1655192334,955,4839
3713774591,3989256744,1665360349,1665360837,488,2969
3275095992,3631842765,1648433047,1648433465,418,915
3943215041,3834729275,1664987619,1664988577,958,1208
3121558958,3008249589,1654790678,1654791328,650,2735
3303477143,3938267443,1641560514,1641561418,904,4418
3237638847,3758083335,1668132340,1668132920,580,1608
3470626526,3868662578,1657128030,1657128630,600,4227
3376107213,3849357894,1654688870,1654689714,844,2682
3794639477,3596675999,1659946476,1659947052,576,283
3452952503,3650347551,1653757129,1653758115,986,1951
3057319385,3637698493,1662929012,1662929326,314,3992
3082991985,3248799667,1646848263,1646849063,800,4226
3095292696,3867629640,1663578210,1663578867,657,4521
3346896327,3591748100,1662714964,1662715804,840,579
3267161314,3260866710,1653009847,1653010094,247,4091
3538234386,3687521075,1663320524,1663321489,965,2972
3623670833,3454251382,1649165566,1649166017,451,3611
3700218974,3746660203,1650771300,1650771447,147,2284
3651641604,3278286854,1658416775,1658417623,848,2785
3837089971,3739526252,1642006416,1642006712,296,64
3062963126,3138082523,1664082314,1664083278,964,4201
3735721228,3534421194,1658843030,1658843523,493,1462
3214405634,3754105001,1660158475,1660158524,49,4311
3859350987,3642780175,1652116066,1652116479,413,4667
3213905592,3398399802,1655281477,1655281718,241,50
3855814455,3903634551,1645829428,1645829924,496,886
3845950471,3620726325,1648031649,1648032109,460,1474
3047132554,3451893146,1660768355,1660768782,427,3129
3447656188,3858851222,1649711272,1649712147,875,4851
3882392115,3276882018,1648754035,1648754649,614,1230
3775832776,3403276200,1655731430,1655732298,868,2327
3844515098,3464703565,1667377028,1667377690,662,51
3549436189,3514944735,1662705400,1662705579,179,323
3624419822,3297081809,1649116850,1649117370,520,2670
3080907736,3116908065,1650811548,1650812281,733,292
3219639866,3719221980,1668268393,1668269188,795,738
3415691597,3645751744,1652464730,1652465148,418,3353
3181661424,3971564708,1645621785,1645622551,766,4043
3038660257,3909453959,1663545196,1663545536,340,2704
3523991479,3164174838,1659256976,1659257612,636,4892
3503509013,3784193573,1646664550,1646664913,363,1080
3657889339,3658081125,1657405674,1657406390,716,3915
3768162320,3994297211,1648816628,1648817536,908,1465
3766021919,3807023444,1641939028,1641939197,169,3591
3042831162,3451077292,1667567277,1667567344,67,2654
3562448397,3845655278,1648299033,1648299665,632,1745
3698384751,3301018781,1661131672,1661132382,710,2052
3070811410,3189050407,1648256991,1648257243,252,3302
3516479140,3887705035,1643372825,1643373649,824,3188
3179385240,3990591119,1663363088,1663363456,368,2734
3895573497,3346765408,1661360633,1661361294,661,1948
3632628074,3463766731,1654260445,1654260679,234,1003
3395306989,3022426237,1645049606,1645049835,229,4871
3106009707,3510176081,1663918447,1663919330,883,3712
3129294296,3083474098,1656056526,1656056739,213,4912
3020390417,3079007172,1663995476,1663996334,858,1882
3927447653,3405428534,1668098153,1668098701,548,2516
3516681210,3961333582,1646441852,1646442437,585,619
3644406090,3558753362,1642391704,1642392283,579,1138
3176678429,3010285646,1661961248,1661961426,178,3742
3885515913,3995477364,1644069923,1644070472,549,3184
3767663195,3487898559,1646358682,1646359409,727,4751
3491163230,3443143089,1664414666,1664415295,629,87
3581596632,3818266908,1664128617,1664129095,478,3117
3703691386,3152453311,1660134628,1660135619,991,3040
3877276486,3143492678,1647195911,1647196222,311,946
3403546603,3092194950,1666048091,1666048459,368,913
3360996209,3400807355,1649754327,1649755006,679,1956
3106386039,3615268471,1668756093,1668756250,157,3918
3537874083,3501935007,1660710597,1660711088,491,2518
3200805921,3451284315,1663305826,1663306037,211,648
3472589912,3714254299,1653487395,1653487812,417,367
3054854418,3508569024,1664648160,1664648346,186,401
3930082539,3863149527,1662013549,1662013871,322,4544
3719602663,3495693218,1663435844,1663436530,686,4928
3239683839,3670594396,1645349868,1645350333,465,3641
3638732045,3900338726,1662934822,1662934862,40,3516
3064671253,3614542341,1649228046,1649228150,104,4997
3549208039,3269150553,1666952965,1666953804,839,3553
3937996125,3788089025,1644073828,1644074799,971,818
3922208465,3054307671,1664491450,1664491784,334,586
3299783613,3519408761,1655277132,1655277245,113,2930
3504957902,3883617582,1665148264,1665149155,891,3702
3156511404,3951236588,1645768815,1645769476,661,2002
3500443157,3807509257,1664817840,1664818321,481,255
3030453389,3929005867,1641409438,1641410224,786,2734
3551419006,3877757916,1660825734,1660825776,42,4028
3599393206,3310342490,1645786510,1645787448,938,1140
3634462595,3931410833,1651738419,1651739142,723,3983
3702961840,3684450065,1653498403,1653498962,559,223
3616778911,3707215229,1654974679,1654975371,692,2310
3443625365,3751687688,1648534500,1648534700,200,1280
3158889614,3344599200,1643264007,1643264781,774,1168
3341493394,3305597720,1650996587,1650997402,815,923
3279344155,3896506378,1664969974,1664970020,46,3730
3250160353,3951868660,1658108680,1658109550,870,991
3264216255,3774272800,1658900447,1658901359,912,3199
3278966139,3135338868,1644756103,1644756493,390,1491
3265841935,3721508500,1652510602,1652511399,797,4835
3395542709,3094271985,1648044227,1648044675,448,3660
3251520961,3373823571,1645549167,1645549202,35,1518
3755739008,3050943525,1652791736,1652792229,493,2481
3168639921,3239515525,1659842655,1659842669,14,2284
3670991698,3409632414,1665436553,1665436675,122,3500
3479094902,3062368087,1664850323,1664851155,832,3872
3367927550,3139993084,1649598211,1649598742,531,2102
3904914653,3772065574,1649525188,1649525457,269,1404
3133277900,3676108623,1641604204,1641604887,683,4062
3899940504,3258635100,1643309607,1643310213,606,3935
3583825202,3692023302,1644504859,1644505721,862,1504
3968502615,3186452798,1661103207,1661103284,77,2452
3864003290,3726441564,1647141504,1647141742,238,2710
3535962615,3760275384,1658544955,1658545081,126,1425
3639046864,3964810718,1666559389,1666560264,875,1713
3875785225,3976577086,1657696400,1657697110,710,178
3123044415,3451545826,1666756713,1666756863,150,3138
3488275090,3586070044,1644197094,1644197250,156,4178
3181768595,3856588835,1660147937,1660148627,690,4132
3971373230,3569117449,1653846830,1653846947,117,3693
3746817886,3255334218,1659314560,1659314965,405,1392
3408962032,3201213436,1664001956,1664002861,905,1522
3328974848,3364166998,1652475682,1652476512,830,4853
3848972924,3821427102,1654574741,1654575389,648,1510
3452027853,3018032141,1658169994,1658170791,797,213
3408437726,3087673025,1649198223,1649199083,860,3436
3496666821,3444268850,1646553179,1646553536,357,1885
3126212802,3354893428,1645222644,1645223223,579,4908
3017830709,3000490595,1648218761,1648219641,880,510
3686356072,3345059778,1668931416,1668931422,6,3617
3148918456,3046466745,1651702711,1651702941,230,2966
3572336905,3381553031,1646126939,1646127582,643,1228
3764166906,3707898681,1660038577,1660038745,168,2851
3420393195,3761067358,1667143863,1667144192,329,985
3319206179,3244226758,1669388142,1669388855,713,685
3435228947,3939395864,1661891273,1661891450,177,2971
3770900770,3516582172,1664552676,1664553178,502,578
3710692560,3083445485,1661784834,1661785638,804,1209
3393169503,3514292830,1641665082,1641665251,169,760
3166615767,3375594300,1647875845,1647876273,428,4414
3560971202,3699570721,1646619014,1646619844,830,4701
3849232344,3301405749,1644393422,1644393583,161,136
3250243986,3507568135,1669310359,1669311233,874,1882
3279834625,3662246887,1655790928,1655791823,895,4388
3541641097,3422187272,1657382578,1657382832,254,4651
3943462221,3747820867,1652065462,1652065827,365,925
3082105928,3386055181,1644427398,1644428202,804,2380
3997152226,3595327080,1643773516,1643773763,247,440
3657943032,3414583942,1664558484,1664558544,60,4014
3482431049,3498319112,1645483711,1645483898,187,4698
3994350230,3996567506,1657586022,1657586819,797,2643
3610577624,3642309632,1668892240,1668893178,938,3908
3725103282,3482882129,1650738156,1650738966,810,2560
3984822975,3302277551,1641680328,1641680897,569,2284
3072057034,3729388933,1656888360,1656889347,987,4898
3356703127,3852831076,1664514243,1664514670,427,4675
3123162902,3536735889,1646336740,1646337471,731,3962
3578116622,3225637924,1669671389,1669672103,714,1307
3404465674,3589911420,1668496939,1668497142,203,3982
3159455657,3130000796,1668547680,1668547971,291,2367
3166079992,3187891826,1651198248,1651198579,331,3102
3837569040,3543370286,1668464805,1668465230,425,4630
3760564434,3478963742,1669144462,1669144942,480,4903
3235490662,3261521500,1650056963,1650057661,698,1358
3105290173,3112528034,1642866994,1642867716,722,4887
3583800071,3743796895,1661084282,1661084694,412,3390
3503490921,3879140750,1665996836,1665997111,275,3767
3434422298,3690496276,1667544371,1667545033,662,446
3239722014,3293142255,1659833498,1659834004,506,1641
3794533895,3897275618,1650208867,1650209751,884,2493
3650352440,3419574371,1665138196,1665139075,879,731
3873385590,3904988600,1661958455,1661959128,673,532
3241206188,3572872138,1645324278,1645324633,355,3396
3468616239,3060538792,1665237576,1665238173,597,3167
3931301000,3975686482,1663393372,1663393952,580,65
3600989353,3347988023,1649915612,1649916541,929,4495
3075898932,3756663228,1665421758,1665422020,262,81
3039934487,3614756587,1652516252,1652517232,980,486
3571492642,3982999109,1650596086,1650596445,359,514
3572487703,3779529209,1666954388,1666954975,587,1829
3309780700,3184370660,1666463771,1666464499,728,3768
3510551355,3591018175,1666782294,1666783220,926,2265
3688069684,3613035278,1659955671,1659956340,669,3257
3639564737,3187501106,1652978992,1652979053,61,2418
3729320244,3713244229,1665694056,1665694467,411,2917
3218085847,3156022319,1650879698,1650880326,628,3865
3468891585,3150374455,1668237403,1668237913,510,327
3696099964,3422105461,1652051158,1652051798,640,3873
3351685662,3465347117,1656469968,1656470645,677,1663
3786388044,3537568746,1651305912,1651306795,883,4286
3709054095,3189908654,1646587084,1646587226,142,3286
3105895807,3892002730,1666048506,1666048579,73,2783
3009546227,3455178203,1653824349,1653824791,442,3961
3322464007,3222367979,1662055280,1662055791,511,511
3686592612,3999507912,1656480507,1656480510,3,2444
3481425703,3087094718,1648431069,1648431503,434,996
3149957663,3140777542,1662772353,1662772931,578,4302
3139448284,3895847898,1648510766,1648511279,513,4546
3860053200,3757943434,1666754565,1666754948,383,3839
3488548946,3265119040,1649427870,1649427915,45,4188
3633638517,3514797923,1655166376,1655166961,585,3193
3302850006,3093531973,1657070695,1657070938,243,2426
3454219628,3289510504,1654162312,1654162620,308,91
3292803804,3822360438,1659383447,1659384201,754,2376
3328245990,3803937320,1664327694,1664328312,618,3692
3132502667,3964063748,1655348560,1655349181,621,2884
3475584545,3754374290,1659561187,1659561508,321,185
3395178454,3738239524,1657691417,1657691986,569,4083
3463176015,3607480255,1644922987,1644923361,374,4538
3250307379,3829458669,1655673793,1655673815,22,3349
3941059682,3806668233,1646868755,1646869248,493,1986
3050525398,3917607744,1659601745,1659601792,47,2476
3349880499,3370689260,1643512283,1643512416,133,1459
3651743849,3363132532,1649160706,1649161364,658,362
3240621563,3917144748,1663072898,1663073084,186,428
3112333658,3315371591,1643616606,1643616685,79,3712
3563407285,3485483285,1648573526,1648574503,977,3533
3689022765,3679213616,1669111293,1669112094,801,595
3051788814,3283308271,1661545772,1661545886,114,1762
3000508703,3426950211,1661045916,1661046843,927,1119
3705614470,3481322143,1641808316,1641809188,872,2721
3684203901,3417470006,1663210665,1663210937,272,2472
3583350905,3023490718,1665433708,1665434306,598,3198
3108373273,3293366220,1662399208,1662399269,61,4118
3781921987,3605983394,1650987661,1650988433,772,2913
3055148403,3143744183,1644192578,1644193343,765,2564
3544967946,3991900912,1664455948,1664456312,364,2488
3022290861,3896328760,1664029857,1664030218,361,1357
3421545230,3007687601,1641950628,1641951498,870,3091
3068219524,3615338494,1642418276,1642419185,909,1419
3813405168,3949809606,1649889498,1649890281,783,276
3550262447,3474498279,1647489527,1647490034,507,4256
3840861117,3476128432,1644106601,1644107585,984,746
3243132773,3825485549,1649392755,1649393124,369,3389
3591687238,3046479862,1651405383,1651405982,599,3625
3909305974,3857583579,1656220103,1656220210,107,875
3090654106,3645751744,1666780965,1666781952,987,1314
3822069487,3290668440,1651767104,1651767739,635,4585
3390107075,3991593791,1643518228,1643519090,862,3989
3526609729,3920083495,1661764627,1661765476,849,1386
3282600462,3751709520,1669186437,1669187326,889,3355
3729747608,3719402346,1661555636,1661555937,301,1580
3304137286,3980673105,1642586741,1642586988,247,882
3355139529,3739390834,1648139430,1648139436,6,749
3666768050,3910514839,1643428765,1643428884,119,1328
3648841888,3196192162,1655091787,1655092010,223,2723
3102189388,3316807012,1650467801,1650467968,167,401
3511819074,3086057979,1665622705,1665623571,866,3666
3556086918,3381889893,1667520413,1667521327,914,2412
3048139012,3677981092,1649875272,1649875696,424,2367
3423274341,3128054005,1647750968,1647751524,556,2263
3375677117,3341548266,1668180202,1668180823,621,517
3463647042,3613973186,1646324044,1646324238,194,3287
3078756663,3529309105,1657018295,1657018339,44,3097
3735534209,3410190940,1647519239,1647519777,538,2366
3535503264,3800221930,1658014609,1658015059,450,3559
3003575898,3452055657,1652818043,1652818797,754,2268
3726916010,3689996543,1666991195,1666992014,819,958
3387873267,3441403155,1663008095,1663008372,277,330
3351685662,3897827804,1667673310,1667673725,415,3451
3744617062,3430304983,1663903943,1663904887,944,2383
3828094326,3703258677,1656908996,1656909708,712,4387
3211587304,3229479495,1649748050,1649748686,636,4699
3006553976,3063108267,1665616124,1665616541,417,3580
3436527588,3821708855,1648479139,1648479886,747,4078
3842352901,3735621228,1666206114,1666206429,315,567
3734410370,3564574520,1646890661,1646890688,27,347
3550491791,3464131194,1652834074,1652834720,646,99
3863304611,3590881614,1642203501,1642203931,430,2879
3789502113,3862254298,1665721002,1665721418,416,755
3758118194,3164957343,1645095451,1645095851,400,3791
3098785109,3465479209,1652410274,1652410658,384,2154
3983877600,3965646129,1660879131,1660879605,474,4541
3757271069,3823458968,1644607131,1644607950,819,4605
3459910626,3156161352,1653223355,1653224217,862,2448
3531739457,3470447975,1658483524,1658484306,782,3181
3735944608,3472787583,1650400772,1650401543,771,1284
3625330023,3296759235,1647016673,1647017434,761,102
3055205986,3025829154,1669534002,1669534925,923,1363
3243276267,3992895469,1660615887,1660615929,42,4634
3030130764,3645324071,1647660569,1647660952,383,3794
3883324400,3049820512,1665765496,1665765979,483,4247
3525089768,3959780571,1656965950,1656966265,315,1250
3918444668,3549907535,1656080134,1656080957,823,4863
3682349571,3735188959,1657107656,1657108027,371,3735
3942012685,3281603417,1646510687,1646511460,773,1004
3174952053,3614982681,1662148948,1662149919,971,2623
3854764486,3551598300,1662801654,1662802101,447,969
3792561593,3109116807,1666097839,1666098028,189,4471
3706877363,3603515150,1657953166,1657953374,208,4535
3049232477,3363651065,1659085142,1659086021,879,80
3539793055,3209777635,1666268774,1666269113,339,3265
3702046318,3194847548,1642867678,1642867798,120,1991
3394263828,3099514535,1651408746,1651409605,859,31
3335773888,3493091570,1641647176,1641648112,936,2602
3272188261,3661826473,1668776845,1668777698,853,2146
3560567819,3247432426,1668881384,1668881971,587,1105
3046679231,3545572825,1651264351,1651264880,529,4076
3148245616,3564322827,1657327859,1657328565,706,255
3352547826,3245775687,1641993639,1641993679,40,23
3458787486,3746137808,1664919447,1664919723,276,2062
3478044325,3596820403,1662111412,1662112154,742,2311
3343088156,3423767417,1656191311,1656191359,48,4134
3870943882,3259891484,1643529425,1643530002,577,949
3388190317,3023157343,1650110332,1650111312,980,395
3702967397,3762601487,1657143830,1657143954,124,1989
3064172703,3064918304,1650030463,1650031015,552,2632
3783969286,3259125579,1649738451,1649738498,47,3180
3652089444,3621277447,1650214309,1650215111,802,3214
3695077735,3932212731,1665537620,1665538547,927,440
3168424616,3031358954,1646980419,1646981215,796,16
3023859293,3644579188,1646406549,1646407030,481,253
3757153646,3967962635,1647702567,1647702873,306,2581
3748519389,3025004234,1656126812,1656127369,557,2221
3059823368,3130090940,1653418403,1653419254,851,2662
3273567117,3391969479,1666410048,1666410479,431,106
3450188591,3614961757,1643748754,1643749596,842,3258
3402189791,3448907989,1649287393,1649288004,611,1732
3018466830,3436888819,1665371835,1665372172,337,4439
3642650197,3534549700,1647828277,1647828644,367,2908
3716129750,3498129976,1669088887,1669089745,858,2848
3979428661,3518733049,1662007511,1662008134,623,3507
3795995271,3403009020,1647230870,1647231371,501,929
3478504677,3184900883,1659113699,1659114271,572,2213
3700883850,3231071898,1655246256,1655246628,372,2264
3219860087,3328551602,1656794698,1656794939,241,1404
3542818678,3211146215,1668793708,1668793901,193,2048
3792430356,3816882499,1653895106,1653895662,556,2233
3374529900,3935329421,1664840216,1664840269,53,3936
3680180906,3492357273,1646601999,1646602571,572,4757
3066782425,3787551404,1663166939,1663167111,172,3425
3915052734,3530234111,1661029173,1661030106,933,2525
3625456529,3975721041,1647037474,1647037717,243,379
3113716924,3830343046,1660544571,1660544582,11,1530
3729495798,3364396551,1660064348,1660064796,448,1420
3126798901,3963889907,1648716104,1648716403,299,3607
3891088314,3884845578,1642296693,1642297558,865,1299
3349630291,3974959460,1667146164,1667146911,747,3461
3394948649,3218845464,1659683713,1659684491,778,4353
3173454659,3555681652,1666835517,1666836483,966,476
3685168754,3170905700,1641177404,1641177564,160,655
3212095191,3343789147,1663956538,1663957104,566,2337
3494213432,3951949027,1649088529,1649088934,405,910
3908494432,3426570121,1653129215,1653129990,775,4602
3439313772,3583307274,1662193429,1662194140,711,3178
3080321041,3540858852,1663608553,1663609522,969,4945
3882303568,3696768971,1645016298,1645017060,762,4838
3758646054,3549824090,1656184151,1656185030,879,4797
3660401756,3687556109,1653752282,1653753130,848,4674
3174336636,3144328858,1668948970,1668949081,111,4673
3386666661,3285101772,1668002540,1668003513,973,3041
3960933490,3905157968,1651219475,1651219882,407,1801
3981250989,3558581830,1649266077,1649266629,552,92
3323541751,3455796899,1653853097,1653853378,281,3190
3587675889,3298836656,1649454567,1649455224,657,592
3557341901,3783076077,1659720188,1659720750,562,3854
3594810094,3644814107,1651746632,1651746903,271,432
3680120167,3769121790,1650565222,1650566071,849,4774
3221257849,3068350825,1645766123,1645766270,147,1851
3731005764,3967031951,1658610097,1658610397,300,3611
3223404467,3661813334,1664625445,1664625776,331,73
3190064811,3352547826,1655554286,1655554790,504,1509
3839427421,3845054730,1643072988,1643073758,770,3738
3438823224,3208925694,1656727699,1656728094,395,3771
3056687092,3965355962,1641763885,1641764637,752,2314
3108886436,3695192782,1646230982,1646231242,260,4306
3502587721,3755739008,1644322118,1644322640,522,1164
3468818730,3416638191,1662596555,1662596914,359,1177
3058882010,3123221586,1646205262,1646206127,865,2309
3718966293,3877325684,1668613746,1668613808,62,1577
3030551986,3581596632,1666781511,1666781925,414,1216
3852726120,3666239299,1651743888,1651744246,358,965
3631304178,3259233996,1656865762,1656866346,584,4970
3427082024,3466481004,1642049564,1642049812,248,59
3767047185,3228134745,1649799779,1649800606,827,3177
3046918200,3691437053,1661170663,1661171122,459,2932
3907011948,3798017232,1654391353,1654392226,873,4284
3432564581,3956480605,1668176721,1668177208,487,675
3248481789,3016168885,1641164712,1641165180,468,1768
3194816156,3158056470,1647537762,1647538278,516,4648
3885289891,3648577122,1668448221,1668448356,135,642
3828952821,3680019007,1648309663,1648310343,680,1843
3387814310,3475787429,1668300892,1668301440,548,855
3607596878,3430665149,1666468449,1666469159,710,2985
3518701580,3735764706,1668799635,1668800410,775,1958
3600051510,3425801129,1666031898,1666032110,212,3896
3029340399,3785802868,1665332289,1665333070,781,2792
3961262298,3661604718,1648499693,1648500327,634,3076
3939028126,3820275465,1665840790,1665841181,391,65
3270176716,3879250594,1641868310,1641868659,349,3934
3483405299,3270690395,1659990550,1659990643,93,3367
3120252138,3424503233,1664927125,1664927319,194,4200
3866720955,3073855796,1668498019,1668498525,506,117
3516382026,3877042144,1652483846,1652484623,777,323
3462083416,3322482495,1651565730,1651566493,763,4263
3336500102,3462378057,1646746288,1646746930,642,1830
3656773787,3254338357,1655260085,1655260814,729,4088
3366649437,3323770841,1648830107,1648830923,816,4885
3146217062,3725356301,1658766035,1658766857,822,3624
3024914533,3441688874,1663054649,1663055567,918,4676
3772941450,3834390383,1658905453,1658906225,772,3406
3135462840,3489290809,1643648165,1643649092,927,4311
3898559362,3927379691,1661642517,1661643197,680,3487
3144395022,3628718773,1641853350,1641854032,682,1466
3741741904,3664490620,1653787786,1653787955,169,4118
3644871240,3502126162,1664880376,1664881261,885,1884
3688696662,3615545659,1645114160,1645114192,32,1171
3585522183,3905444291,1650884016,1650884266,250,1531
3462847628,3755719860,1645664111,1645664856,745,4134
3547719719,3416913829,1647704260,1647705119,859,2134
3707353732,3867359576,1641980095,1641980596,501,2387
3378023134,3565768511,1643987386,1643987392,6,784
3408839004,3046290148,1643030128,1643030517,389,4009
3824287842,3719402346,1664648176,1664648560,384,9
3622089194,3804094125,1668699767,1668700575,808,2868
3508308351,3965358540,1656218721,1656219656,935,378
3888352225,3193578408,1663614350,1663615297,947,1929
3670991698,3852109172,1664840475,1664841241,766,3227
3573191366,3305375502,1649981689,1649981735,46,1917
3888597944,3410731237,1669414495,1669414519,24,95
3817582227,3737434179,1642526574,1642526749,175,505
3961145886,3113493233,1650899717,1650899910,193,3996
3624959769,3819132343,1665820053,1665820269,216,4623
3385614517,3842392055,1646138478,1646139222,744,2007
3666362295,3802481108,1653102157,1653103118,961,1266
3434852926,3195371177,1647045782,1647046764,982,4993
3406657626,3210530375,1641735199,1641736021,822,799
3474814029,3133665473,1659459301,1659460246,945,2494
3161022966,3705906700,1650161163,1650162067,904,1405
3037836281,3447879670,1655885536,1655886045,509,748
3375921801,3886402238,1666924696,1666925393,697,3130
3237352996,3592129771,1661439045,1661439684,639,4895
3417510866,3599811290,1644479761,1644480189,428,4611
3594146794,3773182000,1653511282,1653511580,298,4469
3190467643,3659624789,1655576820,1655577046,226,2436
3542755764,3846161514,1661515893,1661516836,943,1913
3243784091,3365818432,1648859763,1648859922,159,3679
3988624184,3661553300,1659760300,1659760747,447,257
3631853877,3826277876,1646871462,1646871557,95,3162
3589283370,3515862880,1655880405,1655881103,698,2642
3265003074,3162327165,1667626654,1667626939,285,1801
3670704714,3391681521,1656885724,1656886690,966,3431
3672171681,3484396841,1648837942,1648838702,760,4682
3442017285,3649834919,1664624748,1664624987,239,3232
3974942132,3751669196,1668376459,1668376654,195,2146
3617578640,3095901680,1659874637,1659875476,839,1580
3455837683,3376868511,1669412922,1669413260,338,632
3588124954,3109419439,1664434668,1664435100,432,63
3975166550,3002910809,1657041761,1657042260,499,30
3184444444,3249164574,1645698907,1645699327,420,2664
3597348657,3587444345,1651349965,1651350707,742,4764
3582185317,3370409233,1657957777,1657958326,549,2872
3421547982,3770693382,1645752596,1645753434,838,4171
3597556035,3557067342,1644124730,1644125131,401,1415
3775206778,3781019129,1666747408,1666748342,934,4668
3518694165,3074486639,1652286069,1652286874,805,2258
3480921701,3195649276,1663113586,1663114518,932,4350
3779477642,3407350238,1645086072,1645086423,351,3483
3398235328,3454300933,1650356242,1650356749,507,219
3197172383,3335519480,1653857146,1653857310,164,1701
3986028041,3691537793,1661045065,1661045500,435,4983
3644722907,3726440620,1662403009,1662403613,604,802
3565657476,3777746912,1648640110,1648640499,389,1666
3922614451,3803209575,1647890094,1647890430,336,3792
3665976972,3214912185,1643585001,1643585856,855,795
3068780367,3004612442,1646045082,1646045499,417,4725
3429387798,3135818787,1641064305,1641064889,584,3310
3440911715,3686994677,1660634804,1660635721,917,2421
3273828350,3196988799,1651443932,1651444064,132,1018
3097053219,3522431239,1662542742,1662543462,720,4710
3886105674,3295753432,1647975243,1647976196,953,4644
3859536430,3866906856,1664480710,1664481350,640,2726
3842678579,3717868249,1644587474,1644587704,230,4114
3727059664,3931328480,1653187481,1653187626,145,3438
3045284954,3999986167,1654984417,1654984845,428,1130
3551619942,3803954467,1646091254,1646091939,685,447
3060617149,3572491368,1642151860,1642152289,429,4537
3196268492,3335752210,1666388265,1666389104,839,943
3086858697,3918883298,1661837923,1661838155,232,3388
3018101780,3717128807,1645664247,1645664940,693,4642
3360102106,3371270216,1659310849,1659311498,649,1341
3798935514,3125982731,1650569401,1650570132,731,3369
3146187472,3773806202,1660088660,1660089417,757,2700
3014811102,3504897330,1650927156,1650927622,466,4948
3644291441,3831941001,1644919860,1644920117,257,4569
3596102449,3387416053,1646465611,1646466112,501,3057
3943882392,3530894474,1646027036,1646027734,698,2038
3858028979,3510735299,1668949481,1668949629,148,1550
3997358345,3260285423,1643305505,1643306350,845,882
3429170038,3815494888,1667360235,1667361190,955,4179
3987056396,3938918493,1663242182,1663242784,602,3951
3394306551,3344536847,1643418874,1643419133,259,3229
3017030443,3114643331,1665685631,1665686177,546,4758
3866477683,3262624969,1643722870,1643723076,206,883
3867622456,3668102331,1641740280,1641740457,177,4915
3378230748,3327746720,1662449690,1662450147,457,603
3007607349,3372631053,1658743864,1658743959,95,2652
3830659910,3863803992,1657903453,1657904083,630,4218
3443517533,3939854664,1641667093,1641667906,813,3174
3410658059,3203050734,1647811476,1647811789,313,2656
3953971047,3720324357,1659332504,1659333301,797,2902
3307250144,3671874164,1651036630,1651037060,430,3646
3981283341,3408983542,1653688538,1653689254,716,2413
3313467020,3812209963,1651271849,1651272076,227,3020
3419252207,3528921898,1645824875,1645825033,158,4482
3104819787,3763285700,1653746397,1653747095,698,246
3469544565,3695981877,1641915696,1641916690,994,3247
3040933863,3578942787,1644774305,1644775110,805,4248
3153796062,3456411517,1646036114,1646036336,222,1834
3167148971,3058245012,1656253639,1656253922,283,1715
3458042525,3443072217,1658931331,1658932016,685,4852
3884636297,3334088248,1659989241,1659989558,317,1965
3541202651,3715307537,1668040467,1668040785,318,923
3601810802,3783009838,1650467009,1650467235,226,1568
3044755740,3641809069,1648003418,1648003714,296,4202
3062807420,3257501617,1643510306,1643511249,943,2801
3752419423,3738911167,1648551039,1648551606,567,215
3605430487,3350924657,1648644754,1648645048,294,69
3518270089,3864973949,1656312259,1656312399,140,2450
3000597190,3314280966,1666244116,1666244500,384,3497
3255142377,3030142469,1656867371,1656867439,68,2801
3461976533,3343425566,1647127323,1647127478,155,1356
3161589233,3072216955,1644618468,1644618712,244,4764
3085557760,3905196178,1647755894,1647756045,151,3594
3956272872,3591984658,1642801659,1642802516,857,2773
3584033746,3509751258,1649283983,1649284595,612,526
3502432516,3061271543,1666258446,1666259228,782,3239
3618379459,3497204197,1667178904,1667179344,440,3333
3746643631,3722772770,1652262445,1652262932,487,3742
3012149748,3157133142,1656899939,1656900475,536,591
3008256175,3284184824,1657021057,1657021395,338,2154
3569178275,3960199140,1666662587,1666662755,168,368
3535537980,3258249336,1643688352,1643688869,517,4773
3119344691,3015164995,1645589001,1645589923,922,3360
3091606053,3647353883,1666984218,1666984627,409,736
3006477984,3784675258,1656241687,1656242276,589,3255
3596436822,3470551758,1641741071,1641741386,315,3277
3154537394,3507630340,1654372829,1654373694,865,3263
3239914081,3010944400,1656988146,1656988404,258,1875
3088584782,3813054271,1660112971,1660113454,483,3920
3057975701,3838193402,1666909651,1666910432,781,3925
3890427660,3175619117,1652549564,1652550225,661,318
3433442644,3560361847,1657568678,1657569027,349,4882
3514881380,3141011044,1660046576,1660047180,604,4782
3077895458,3937159277,1644453262,1644454097,835,221
3444041118,3906791819,1652672807,1652673494,687,3996
3670259821,3444056163,1644354193,1644355151,958,4244
3508392031,3676458694,1661878713,1661878836,123,1463
3033792940,3255566362,1641794612,1641795345,733,520
3999864670,3244675799,1647425907,1647426791,884,1314
3857809118,3572540597,1642515038,1642515658,620,3962
3664032860,3664013660,1648373871,1648373980,109,389
3743124479,3106798007,1644113518,1644114227,709,912
3510855684,3066611224,1661542104,1661542921,817,4784
3036989999,3562562929,1654390926,1654391909,983,2565
3809852017,3920929671,1666523255,1666523792,537,3729
3478319040,3741564717,1669132824,1669133323,499,3657
3426996014,3902684992,1662640604,1662641146,542,4566
3668131333,3208531071,1644963938,1644964157,219,2965
3835804957,3955041700,1653674104,1653674500,396,3655
3428378435,3023142667,1660847824,1660848236,412,99
3979536333,3536725346,1644791572,1644792510,938,3158
3960371105,3420984091,1652307048,1652307132,84,1911
3390828797,3063554869,1662087318,1662088247,929,415
3879964617,3287684060,1646660460,1646660794,334,1163
3077651401,3343344797,1667521010,1667521856,846,1102
3106399850,3262884552,1656017218,1656017581,363,4007
3491184633,3051300061,1655958048,1655958103,55,886
3526657232,3590142188,1644413887,1644414248,361,2871
3882773663,3583238250,1663573947,1663574483,536,1809
3695154037,3447964878,1655469352,1655469866,514,2584
3634742630,3361249696,1656359421,1656360099,678,359
3136750793,3496227523,1658209250,1658210160,910,3195
3409764438,3443682844,1656728592,1656728762,170,2943
3635413733,3064448378,1665815056,1665815066,10,2271
3901759267,3259038765,1648591302,1648592167,865,2475
3392906595,3836384404,1653321112,1653322095,983,4448
3328105106,3845813946,1662386941,1662387121,180,3829
3763699675,3996840079,1659626794,1659627723,929,4523
3818373837,3882529473,1663743621,1663744334,713,4651
3303297716,3614136251,1654224609,1654224855,246,2108
3458789205,3378049518,1650065235,1650065489,254,3881
3972014541,3709973483,1651578085,1651578570,485,1045
3266864480,3075764348,1646782458,1646782611,153,2486
3385531288,3766620199,1644683792,1644684761,969,808
3671620104,3605240507,1648122964,1648123033,69,2924
3553903257,3479032856,1653756515,1653756841,326,296
3179467408,3936945702,1657488333,1657488811,478,1914
3545849492,3927958627,1667142645,1667143211,566,2344
3269031421,3238061008,1665061492,1665061948,456,4234
3314217855,3289008377,1651979005,1651979887,882,824
3608358062,3342943620,1655465515,1655466064,549,4171
3220107235,3390535578,1650591911,1650592101,190,4604
3267023803,3443204407,1664106814,1664107675,861,1444
3910542244,3645023619,1647152798,1647153352,554,3161
3974585448,3414872320,1659665304,1659665557,253,4462
3399629206,3876170989,1661149353,1661149968,615,4493
3633812422,3659953541,1668087123,1668087410,287,72
3554674610,3421554113,1641660397,1641660708,311,3359
3353978465,3735443135,1646592268,1646592958,690,4598
3715853939,3715773910,1657972357,1657973011,654,1397
3449835011,3184629480,1658371749,1658372034,285,247
3973267437,3813191475,1658625711,1658626537,826,197
3538648278,3106476213,1649244805,1649244968,163,705
3870343197,3564704199,1646743571,1646744137,566,3936
3034725411,3895291838,1645758914,1645759562,648,2999
3604982417,3343939117,1660647337,1660648224,887,1476
3822183309,3988967864,1665336866,1665336877,11,776
3896804474,3243226430,1647536908,1647537194,286,904
3993236697,3852573159,1666917172,1666917695,523,2116
3143155479,3775588471,1651055916,1651056358,442,3760
3769646693,3863075163,1648235555,1648235807,252,385
3830075123,3967787139,1647191199,1647192152,953,617
3458986761,3549290113,1666395718,1666395962,244,4623
3770638212,3242352892,1652174720,1652175560,840,3034
3969632240,3777655162,1664606814,1664607279,465,468
3056183480,3857215986,1649466545,1649467228,683,3069
3274008025,3976663950,1654995067,1654995500,433,3062
3650499735,3490703955,1649012759,1649013630,871,2699
3410114742,3802535541,1651631407,1651632196,789,1809
3296461721,3739158483,1663654606,1663654987,381,4954
3668259224,3640656611,1654626804,1654626811,7,2271
3702504650,3998595321,1663020805,1663021721,916,4441
3941070339,3994412162,1654186831,1654186965,134,1079
3900227699,3895807342,1661579308,1661580082,774,206
3495520740,3663107626,1642014016,1642014630,614,1891
3568692041,3314967973,1642292009,1642292084,75,1022
3437362063,3270711248,1651750598,1651751056,458,2708
3447499264,3264479876,1647600205,1647600798,593,274
3784968972,3882361205,1664419945,1664420357,412,170
3189668390,3204507671,1655427755,1655427816,61,4075
3743704902,3874290552,1655315345,1655315669,324,3837
3601832128,3880871266,1666988384,1666988410,26,4586
3496295320,3243422769,1652388549,1652389165,616,4041
3094668212,3198542938,1646714923,1646715174,251,2395
3123852397,3974377277,1664138881,1664139001,120,4290
3696120707,3718798646,1644087247,1644087471,224,1681
3228398926,3063538301,1667826345,1667826579,234,2490
3474068192,3075279430,1662195445,1662195624,179,2600
3650412990,3745719293,1647905926,1647906888,962,3231
3596608314,3781693395,1668152487,1668153124,637,2507
3424664812,3275057634,1654436559,1654437357,798,4081
3884178429,3959578704,1655239862,1655240625,763,3295
3759510808,3121932661,1644707341,1644707605,264,3137
3961150194,3088239577,1659182939,1659183218,279,3508
3161866929,3386949131,1654697898,1654698139,241,578
3307874121,3943082444,1648049433,1648049692,259,554
3377437275,3207415979,1661991009,1661991179,170,1054
3081838996,3540778011,1661989536,1661989881,345,401
3332900327,3172012164,1667956561,1667957530,969,4601
3785086534,3649287447,1645380009,1645380394,385,1736
3078545833,3387409603,1643692259,1643692841,582,131
3308950897,3165318184,1645319838,1645319915,77,1983
3759293020,3522276562,1648079116,1648079135,19,1783
3803312233,3026167479,1668258137,1668258691,554,524
3639142068,3441850800,1661559766,1661560014,248,3983
3656737803,3744252778,1666230890,1666231807,917,50
3614871387,3646362641,1655342825,1655343129,304,2508
3719286112,3118491708,1654795252,1654795618,366,2610
3829532180,3065630014,1648383167,1648383226,59,4011
3332331224,3889545534,1654519338,1654519881,543,717
3201974958,3419968811,1667629362,1667629944,582,1350
3467450689,3775469247,1651668683,1651669060,377,207
3544641177,3183240161,1654262279,1654263073,794,4587
3063075486,3512301650,1663750731,1663751240,509,2247
3782861158,3075479593,1656603747,1656604039,292,2134
3222380535,3693300748,1647019574,1647020371,797,1598
3449878310,3336281612,1652095239,1652095976,737,3974
3088198118,3974736938,1653816472,1653816610,138,1321
3308404848,3369106537,1660549341,1660549531,190,2846
3108643153,3076590887,1643792147,1643792772,625,612
3071704816,3895573497,1647062500,1647063163,663,964
3843249844,3065847601,1642713876,1642714790,914,1223
3361591790,3471039135,1656992556,1656993409,853,74
3274320984,3483287241,1648096805,1648096865,60,4165
3010977126,3971561825,1654669144,1654669390,246,1921
3091214193,3207670851,1648859399,1648860320,921,2058
3902638535,3076226730,1666433720,1666433985,265,566
3435564865,3096331230,1657446261,1657446640,379,3312
3290433502,3074470140,1644984571,1644984596,25,3171
3869060185,3514601368,1653467142,1653467602,460,2328
3613297292,3782633007,1647769244,1647770023,779,2557
3574084743,3646389725,1643577676,1643577682,6,3465
3244153028,3368281339,1641739167,1641739206,39,3797
3200880378,3806226687,1646964441,1646965268,827,914
3666421833,3548005211,1665625491,1665626047,556,1389
3974440234,3395779705,1643033153,1643034004,851,4583
3387321048,3912685623,1645475787,1645476734,947,2133
3879611534,3145913877,1651471055,1651471524,469,1743
3275291584,3711622931,1651682051,1651682677,626,1689
3771968923,3231772750,1654438500,1654439016,516,4669
3129606258,3395576347,1649940197,1649940351,154,4675
3635282338,3699018752,1656661362,1656661653,291,3564
3611085279,3794342546,1664794420,1664795278,858,302
3655532527,3445645835,1659322116,1659322547,431,2937
3958134339,3803711117,1655928814,1655929735,921,1370
3327506523,3132672557,1651857199,1651857927,728,1576
3319401450,3394641209,1654295871,1654296158,287,1936
3335144039,3042361659,1669039865,1669040136,271,797
3402978425,3920396749,1660201822,1660202317,495,2333
3435662457,3818413245,1667694304,1667695222,918,1192
3927958627,3623136205,1646308034,1646308582,548,922
3891575136,3697649110,1643216540,1643217365,825,1140
3598220272,3210390217,1662048147,1662048654,507,2851
3340788492,3116300704,1655100778,1655101140,362,2949
3185914561,3082820173,1650931189,1650931484,295,2517
3892565312,3771066385,1665370188,1665371148,960,1749
3633294774,3409205147,1667893261,1667893954,693,203
3842284141,3506327926,1666905752,1666906446,694,511
3544180264,3123551332,1653140144,1653140871,727,2449
3428526390,3657573932,1664293281,1664294238,957,3953
3569680773,3036271337,1653890690,1653891494,804,1184
3654756004,3735181059,1656730473,1656730860,387,531
3519582695,3474113877,1645877502,1645877521,19,1646
3446688519,3606211621,1666372650,1666373280,630,4340
3437959976,3569604140,1657339950,1657340843,893,679
3774977406,3148109044,1664988180,1664989123,943,4033
3308322840,3131311563,1664246641,1664246705,64,1844
3583032348,3214854107,1641571244,1641571918,674,4720
3776384999,3703445319,1651142822,1651143540,718,4716
3259692235,3308823791,1660203750,1660204397,647,2552
3423026531,3196757947,1650963061,1650963119,58,4269
3836291726,3722963607,1659030514,1659030652,138,2698
3070693097,3629064118,1643047518,1643048325,807,3179
3491189142,3369164882,1657415207,1657415913,706,4232
3721039858,3583925187,1663655913,1663656879,966,770
3048408862,3613458957,1652074713,1652074923,210,4295
3452967320,3819719254,1652733836,1652734361,525,4829
3870872363,3920797652,1652654507,1652654893,386,622
3347186850,3475351931,1664680927,1664681308,381,208
3805020695,3917811754,1647216038,1647216819,781,4104
3158666908,3400594837,1653483077,1653483588,511,2583
3593442633,3041812946,1650256112,1650256461,349,1917
3783763558,3636412334,1667016669,1667016775,106,4339
3488516115,3757004545,1643088362,1643089211,849,2641
3005561409,3202200736,1666023024,1666023236,212,213
3035677649,3224598271,1662266388,1662267175,787,1819
3441918659,3110704410,1668101048,1668101060,12,3761
3225021996,3036329588,1658975757,1658975983,226,3053
3869415431,3068074133,1662073720,1662074196,476,102
3997959441,3197262219,1654238058,1654238320,262,3401
3620366662,3993630542,1654122941,1654123168,227,2923
3973393648,3897027827,1642761036,1642761657,621,3063
3956801179,3467084647,1645775899,1645776893,994,678
3882839926,3922117559,1657284785,1657284983,198,3121
3012053749,3751937283,1641580854,1641581639,785,216
3942523346,3525399207,1649668158,1649668707,549,1449
3955077775,3473131387,1646017115,1646017790,675,2875
3518683067,3257711203,1659163326,1659164181,855,2510
3501285772,3188039095,1648220908,1648221856,948,4420
3360354628,3238385209,1666005106,1666005137,31,3064
3374496229,3813781382,1655572076,1655572175,99,3665
3122714554,3452781762,1661776058,1661776321,263,3127
3919571584,3068946112,1663434743,1663435256,513,1184
3195296187,3747893737,1666762019,1666762367,348,1388
3153010255,3112535992,1653050362,1653050409,47,2354
3429018245,3053606428,1647835129,1647835474,345,157
3376525243,3650668318,1651253118,1651253281,163,4383
3086567978,3322296817,1658763966,1658764221,255,4749
3308307785,3808504690,1666646953,1666647873,920,4673
3258940273,3018843477,1668099750,1668100312,562,3719
3529825416,3796567839,1657577860,1657577874,14,2525
3956071485,3891873199,1663825985,1663826214,229,4105
3628633629,3308107739,1668774708,1668775159,451,756
3422150123,3746209858,1664144515,1664145428,913,197
3127029877,3487711639,1652091677,1652091831,154,1278
3933612442,3487700059,1662890930,1662891766,836,1769
3853962964,3395908617,1652632570,1652633241,671,3528
3656263471,3032290138,1656170130,1656170342,212,1095
3176157353,3781139304,1642919800,1642919813,13,2902
3051677844,3567801745,1655144996,1655145405,409,4215
3955045496,3005913870,1650396389,1650397185,796,4050
3195950392,3559207452,1651027768,1651027839,71,3735
3360020522,3451284315,1643076738,1643077463,725,3109
3022128246,3441758049,1665536001,1665536180,179,1706
3412728064,3111070215,1656173665,1656174486,821,427
3940706273,3771500395,1661273596,1661274284,688,2527
3341592783,3195498025,1647494505,1647494856,351,1529
3118195021,3188525478,1663497947,1663498615,668,3094
3975750523,3770243238,1663261742,1663262366,624,1475
3125410114,3692692875,1651683841,1651684095,254,1972
3394964033,3646602312,1642451015,1642451569,554,24
3953998566,3452168517,1664645380,1664646214,834,4619
3134331205,3164770283,1666368281,1666368746,465,3131
3571417930,3745702043,1654629124,1654630037,913,211
3139493222,3271661264,1651591075,1651591912,837,3113
3918189035,3387244975,1645116054,1645116215,161,2085
3941659968,3800118670,1667353455,1667354032,577,1622
3792905169,3414109700,1654974529,1654975240,711,1576
3533575542,3394669895,1643013831,1643014807,976,2706
3477524552,3195704897,1648183716,1648183785,69,3879
3324751922,3320841973,1641403487,1641404453,966,3005
3588495554,3754957976,1656496643,1656496953,310,4779
3341782912,3457030203,1655499450,1655500046,596,4034
3639631238,3524737604,1664212533,1664213218,685,2410
3889868411,3254697155,1641864337,1641864648,311,3367
3068166797,3173804738,1661992044,1661992140,96,121
3450918932,3645723920,1654175753,1654176440,687,3479
3513958415,3603947409,1642913580,1642914350,770,1078
3360395166,3691978209,1651708029,1651708294,265,3698
3457507058,3149289330,1668072431,1668072563,132,3096
3809718040,3035401527,1666881480,1666881493,13,176
3908368394,3848497698,1668398025,1668398613,588,3700
3467524737,3935913789,1656545274,1656545547,273,2131
3812393091,3524393322,1649615018,1649615874,856,51
3496809915,3225387968,1656180105,1656180653,548,2243
3684361613,3237875154,1651837749,1651838540,791,1566
3653357650,3853470548,1659272730,1659273268,538,1922
3903890113,3502646857,1648069550,1648069895,345,2293
3600746869,3331328122,1669075478,1669075771,293,367
3760551567,3840629545,1656498682,1656499550,868,1301
3173281096,3341584335,1647217436,1647218375,939,3946
3407451850,3987420490,1668254528,1668255501,973,4558
3513208046,3598317438,1644689974,1644690322,348,3889
3922953774,3701503934,1661682313,1661682780,467,879
3109516154,3201057323,1666360520,1666360941,421,2248
3720193132,3814869698,1667381327,1667382034,707,943
3176113624,3783237209,1663409564,1663410380,816,4621
3572711424,3799207156,1647568676,1647569581,905,1167
3723505887,3158251141,1647427367,1647427579,212,4564
3331556612,3371031656,1667823981,1667824077,96,2595
3789234902,3439393257,1653694285,1653694777,492,1734
3524737604,3428153154,1646584659,1646584922,263,1776
3098357002,3209569784,1667380089,1667380111,22,2054
3481261501,3341387235,1654987821,1654988258,437,2939
3142378585,3900117415,1652774195,1652774695,500,738
3104085624,3506065287,1650180865,1650181383,518,126
3058815452,3397936007,1664714146,1664714812,666,4542
3278599582,3270609722,1658493950,1658494474,524,3217
3319647227,3742656130,1657811542,1657811716,174,3485
3271592630,3569631934,1647192271,1647192705,434,2228
3163208462,3489019288,1650212635,1650213100,465,3580
3631523971,3945022162,1668237075,1668237818,743,3743
3060169729,3846789039,1656016649,1656016699,50,2672
3784981064,3915045705,1663806273,1663806956,683,1870
3958995868,3859408437,1658281224,1658281715,491,1138
3076953391,3781096663,1658003592,1658003703,111,2199
3122408079,3876542438,1653183321,1653183976,655,3567
3392930497,3597078105,1656487412,1656488223,811,2623
3443004864,3061870706,1643725730,1643726658,928,452
3425845336,3166170862,1650522612,1650522625,13,1139
3247349790,3866573976,1642721205,1642721645,440,2221
3948472606,3038403419,1657162285,1657162660,375,3996
3799483775,3439766384,1649483888,1649484653,765,4629
3810993308,3317419455,1666392718,1666393377,659,4283
3655553205,3059528600,1662264664,1662265269,605,4077
3401353607,3925123046,1660771096,1660771429,333,2694
3204683487,3400077334,1667235873,1667236428,555,3074
3976301584,3525848050,1641871646,1641871868,222,3032
3090936896,3478843761,1669436681,1669437535,854,824
3328422462,3476176190,1663177546,1663178273,727,1223
3171824137,3713050877,1658508376,1658509093,717,3672
3547768453,3929958723,1645192521,1645193402,881,3935
3578993502,3432983886,1661059350,1661059372,22,3514
3196952600,3718307274,1662614818,1662614849,31,4820
3490292939,3097000762,1663701104,1663701358,254,2982
3181135365,3589434063,1660378182,1660379137,955,2132
3370115286,3508197077,1657825314,1657825890,576,3392
3896858512,3320901541,1669378412,1669379282,870,4960
3909838323,3173157689,1669176462,1669176536,74,4941
3698885483,3985417707,1666950560,1666951039,479,3280
3173905666,3304106599,1654885405,1654885723,318,178
3610461239,3895379354,1642867409,1642868378,969,1241
3660358846,3671784370,1663918012,1663918014,2,963
3983520968,3753149901,1647564830,1647565626,796,3171
3830594842,3468959393,1657668540,1657668843,303,806
3440930895,3756598428,1667267834,1667268787,953,1794
3665898494,3771386351,1669378011,1669378899,888,3400
3385403096,3209983516,1642847619,1642847926,307,716
3879143202,3639886237,1662308968,1662308975,7,4397
3806904168,3073130464,1654982382,1654982461,79,3844
3248371186,3771626209,1648310298,1648311236,938,2237
3607985379,3895200838,1647800505,1647801290,785,2405
3497337540,3601794859,1660453053,1660453267,214,455
3482431049,3678850376,1652519329,1652520284,955,2545
3097697187,3249808945,1666661905,1666662823,918,1167
3963247421,3234867736,1655043006,1655043734,728,2371
3337648590,3133842051,1655593546,1655593726,180,4588
3115189870,3419743918,1644244751,1644245239,488,2521
3024645793,3469116860,1648346267,1648342869,202,1413
3220006134,3291878661,1660564830,1660565797,967,1987
3910604688,3267177196,1648331800,1648332016,216,1195
3672241230,3054608601,1653581114,1653581522,408,4518
3930676998,3933184597,1657168461,1657168642,181,4639
3984801194,3840750717,1657410973,1657411033,60,4826
3170510141,3191084525,1654027404,1654028281,877,2205
3813941804,3792835292,1667075874,1667076282,408,1757
3092008237,3959536143,1642610927,1642611594,667,3763
3840293769,3254233464,1665036798,1665037301,503,2357
3798964218,3008099090,1648672400,1648673045,645,72
3374851161,3964871313,1658104962,1658105021,59,625
3076392848,3615935023,1667421132,1667421814,682,410
3677670323,3359503677,1668329191,1668329614,423,224
3435884416,3594717921,1651758452,1651758784,332,4129
3958764205,3411758938,1662129832,1662129985,153,1318
3079328786,3305478480,1643906767,1643907751,984,4171
3689423482,3190228745,1644977308,1644977395,87,1688
3338805502,3596010260,1646254976,1646254998,22,4134
3276449250,3319147911,1653308851,1653309042,191,2939
3749029248,3911051421,1662757204,1662757500,296,1097
3307250144,3941295550,1648547895,1648548253,358,2708
3247940891,3987041389,1643223152,1643223220,68,2394
3966892258,3388129809,1654945944,1654946210,266,593
3272654497,3997766388,1650471489,1650471894,405,318
3723205501,3066924765,1660335352,1660336100,748,3628
3426708961,3334597775,1657051692,1657052678,986,2902
3392258439,3391872780,1666053119,1666053931,812,1184
3812746235,3383832620,1646209126,1646209484,358,2147
3219874613,3981933543,1641574449,1641574878,429,475
3257823277,3899951087,1651025603,1651025684,81,3345
3866058359,3067669950,1658312854,1658313031,177,4037
3063549647,3151992299,1668538095,1668538423,328,257
3630392437,3122541417,1651188489,1651189183,694,694
3924659639,3093564943,1649553876,1649554847,971,4783
3034950484,3866669576,1657969660,1657970524,864,2244
3196052965,3871811976,1641769410,1641769447,37,3870
3181688803,3416280796,1658010517,1658010589,72,3441
3917377566,3619945046,1669313099,1669313536,437,2956
3924369876,3793274718,1649358013,1649358963,950,1850
3371591348,3345623091,1667656200,1667657084,884,2564
3156511404,3456130441,1664851081,1664851091,10,4401
3628384586,3135373293,1647673593,1647674037,444,4929
3795049435,3008791582,1646731447,1646732022,575,3388
3304879925,3183572154,1662521042,1662522035,993,4022
3991765502,3100154244,1661024028,1661025013,985,4337
3373818152,3865667894,1641771792,1641771945,153,2515
3851703156,3066706381,1661595443,1661595919,476,4112
3211679936,3964540864,1654337534,1654338083,549,950
3466754307,3165443296,1666901877,1666901995,118,3590
3533472869,3972800755,1649992630,1649993493,863,4690
3370648285,3261014761,1668564944,1668565277,333,498
3814851954,3051638042,1665920690,1665920926,236,3645
3349502007,3674085963,1645039465,1645039829,364,4960
3866799658,3317312103,1660616665,1660616727,62,3866
3856494518,3115559370,1653483296,1653483666,370,1753
3700838406,3675948895,1657541425,1657541668,243,4401
3206722100,3457839149,1655055905,1655056504,599,2930
3173576946,3905321773,1660502457,1660503207,750,1068
3520433266,3706322994,1655681797,1655681848,51,3708
3158662045,3757863334,1649498127,1649498862,735,2158
3940133773,3282398546,1641187188,1641188111,923,613
3781544960,3956628387,1649472457,1649472864,407,4994
3429255445,3134083053,1644631052,1644631490,438,3093
3409102148,3024235320,1643610087,1643610739,652,394
3144531954,3073956730,1649721363,1649721703,340,4442
3849954153,3733085399,1655786722,1655787408,686,596
3458576912,3335519480,1648660761,1648661153,392,699
3818943892,3300853611,1653679352,1653679522,170,4744
3126832756,3097781353,1643846390,1643847115,725,978
3489373054,3993632252,1651019018,1651019748,730,2093
3200789143,3699798917,1666578717,1666579442,725,643
3996990207,3547968888,1650435034,1650435902,868,435
3939080234,3794727315,1666784743,1666785354,611,1111
3687498185,3683415669,1666425747,1666426572,825,4980
3024666714,3435937275,1645863326,1645863825,499,1133
3378529115,3414830461,1661681452,1661682349,897,4445
3149477904,3985320917,1657510279,1657510766,487,525
3137520784,3906230137,1659117768,1659118401,633,1685
3718507951,3572840073,1643164199,1643164522,323,1630
3910737633,3114902597,1664366045,1664366236,191,3987
3307658542,3539259688,1648255750,1648256617,867,1633
3862467569,3081169850,1655537097,1655537228,131,4869
3968115812,3259961230,1657656461,1657657395,934,3944
3571198359,3557454618,1663134789,1663135629,840,1886
3234010505,3945826930,1648482907,1648483547,640,4519
3742523318,3054147970,1661313143,1661313346,203,4397
3589454691,3192529090,1654220091,1654220157,66,344
3244153028,3505809392,1669247200,1669247416,216,3732
3841324221,3460833702,1647112357,1647112693,336,3484
3405504646,3765436939,1667966821,1667967306,485,2085
3909433362,3641231480,1656688727,1656689380,653,704
3295031563,3304359114,1654757694,1654758196,502,1156
3806787212,3238781410,1667433259,1667433689,430,3558
3681624977,3734220214,1659511647,1659511925,278,622
3995850299,3941986290,1650719784,1650720058,274,347
3277753683,3745432566,1649340381,1649341145,764,3211
3399681145,3614558350,1658818359,1658818616,257,1484
3139383915,3239396615,1660804852,1660805671,819,295
3377480360,3830789844,1646625325,1646626256,931,2039
3592532994,3630156548,1668028184,1668028457,273,3346
3637482861,3182074201,1654590663,1654591147,484,525
3974043122,3042621737,1643361675,1643362516,841,4155
3119029095,3097542740,1646899246,1646899799,553,3277
3005475015,3698744242,1655540322,1655541072,750,4068
3368670549,3131137692,1655354443,1655354894,451,1120
3080508911,3910375857,1652727161,1652727598,437,16
3482271373,3396798111,1649527825,1649528728,903,3385
3657296224,3707565051,1654511545,1654511963,418,2288
3925118331,3009111445,1650602769,1650602946,177,2660
3711695728,3970194963,1663032018,1663032309,291,2633
3754421076,3308324125,1642632047,1642632321,274,3604
3991086156,3886294660,1645850265,1645851195,930,700
3890519479,3870483839,1660012208,1660012289,81,3800
3517625137,3178570779,1649361644,1649361824,180,3432
3612092841,3649699377,1657840884,1657841819,935,2813
3656386539,3628377645,1646290136,1646290482,346,2121
3633294625,3533085088,1657520249,1657520507,258,2705
3950118942,3478051628,1661401540,1661402036,496,3528
3737350934,3474344022,1656451655,1656452363,708,2557
3177323156,3286175801,1660859938,1660860886,948,1463
3259208382,3405631097,1664496778,1664496970,192,1850
3884346728,3790996464,1647508407,1647508774,367,1633
3274283746,3470522148,1651676505,1651677493,988,2434
3426432725,3056094935,1667337903,1667338437,534,1975
3683269757,3823458968,1657067957,1657068044,87,2655
3233823514,3870742499,1642120816,1642121137,321,4203
3164894957,3854448214,1665921355,1665921946,591,3564
3130232765,3853796208,1652054845,1652055761,916,2056
3089666135,3062462151,1653094144,1653094852,708,2655
3124727982,3977191143,1649368492,1649368972,480,140
3481674773,3400993378,1665686736,1665687693,957,2717
3438895465,3623856560,1659699776,1659700562,786,3291
3896415327,3251602898,1647100441,1647101413,972,34
3416327702,3924077227,1659251714,1659252465,751,4089
3464530622,3499569791,1643787969,1643788780,811,435
3540891964,3863250275,1651408852,1651409389,537,897
3043726457,3221177092,1669113785,1669114716,931,880
3716530655,3690583229,1668867571,1668868460,889,4810
3793754849,3682132666,1665929101,1665929505,404,456
3356674606,3927999630,1645625210,1645625402,192,1496
3098199734,3404390609,1661872554,1661873325,771,1964
3747743910,3260176573,1664482579,1664482874,295,3033
3814607542,3991810771,1660152844,1660153450,606,4466
3827654699,3376067220,1644848204,1644848582,378,145
3114902597,3260662201,1652323712,1652324264,552,3513
3379504014,3252240818,1656567656,1656567827,171,3903
3496508921,3928860236,1665951840,1665951915,75,928
3793995297,3994254686,1655599859,1655600799,940,3481
3490260424,3206377878,1653233902,1653234162,260,2279
3228970616,3043848533,1668808888,1668809730,842,1180
3489186205,3810508540,1644143764,1644144513,749,4263
3225853975,3029591040,1655874748,1655874932,184,4199
3345430019,3337291692,1660411330,1660411659,329,659
3899162817,3591697760,1653479782,1653480609,827,3568
3754176901,3887703009,1665964971,1665965710,739,3421
3296849762,3522298174,1652985191,1652985206,15,3195
3217188518,3205159794,1668946269,1668947248,979,3206
3827806973,3488839264,1645158989,1645159850,861,2294
3454709166,3635401784,1664860251,1664861148,897,2037
3837236321,3077737019,1651489134,1651489824,690,4716
3825243625,3141345427,1652777334,1652777884,550,1384
3689699733,3947067250,1663545792,1663546162,370,2946
3808593309,3218825798,1657507599,1657507748,149,2018
3670572097,3636612831,1668910823,1668911029,206,2640
3723575335,3802215994,1641765565,1641765834,269,3497
3533941949,3462143739,1652862011,1652862031,20,3362
3504343059,3990076376,1661807288,1661808171,883,2217
3865305265,3245255677,1647147600,1647147637,37,4901
3623590852,3083232016,1645969400,1645969682,282,2275
3373012337,3943362047,1654155304,1654155701,397,842
3750680422,3493776126,1650432217,1650433125,908,3356
3694262909,3324460415,1645052651,1645053348,697,3199
3251723029,3902805505,1664684704,1664684817,113,1374
3025632609,3556393500,1644523095,1644523510,415,2955
3846051448,3446075343,1655865150,1655865613,463,1512
3805301708,3744085047,1645981729,1645982304,575,3978
3543576488,3712537271,1649421107,1649421997,890,1945
3694376595,3451589165,1648484345,1648484676,331,2712
3491143159,3832263568,1654959206,1654960177,971,1067
3166013630,3877364397,1666972358,1666972595,237,2795
3861284749,3328623154,1645440692,1645441179,487,2594
3271924040,3383267750,1648839798,1648840756,958,4957
3849774043,3136243443,1652181918,1652182769,851,2898
3104694099,3362340268,1656060580,1656061544,964,2823
3052362611,3360719832,1647220322,1647221046,724,2930
3671197199,3178848387,1650379783,1650379989,206,708
3117371170,3192987946,1654551411,1654551422,11,3166
3544313709,3018906787,1651268802,1651269512,710,788
3319924243,3764805154,1658272796,1658273197,401,2112
3852857492,3908368394,1653107945,1653108488,543,2881
3702785626,3037009116,1654145334,1654146258,924,4621
3425874329,3526807668,1649438364,1649439070,706,3204
3954783789,3123923599,1657762240,1657762992,752,1387
3269685526,3938422071,1665288237,1665288864,627,549
3100154244,3931576780,1665821086,1665821214,128,266
3834639908,3324279322,1651193889,1651194755,866,3455
3066035235,3041497740,1655341429,1655342229,800,2076
3864938570,3894879680,1650276035,1650276278,243,2636
3758909465,3714934892,1653494664,1653495567,903,1470
3074805197,3081023213,1668278295,1668278305,10,4496
3899765401,3858608859,1658237334,1658237475,141,1173
3746950422,3055175363,1641415088,1641415228,140,288
3949174101,3753907045,1653139616,1653139929,313,2180
3174439614,3399251156,1661268496,1661269045,549,1844
3578576019,3184459749,1653525962,1653526198,236,4110
3023363906,3346879865,1654214279,1654214981,702,3346
3190925436,3516438673,1665160113,1665160978,865,3672
3766907247,3165396996,1657765532,1657766501,969,2109
3765440112,3337267516,1661978168,1661978780,612,4515
3637659719,3255655854,1642468070,1642469054,984,3845
3333672862,3627675289,1645157257,1645157939,682,4532
3029129983,3555931800,1658861334,1658861619,285,969
3578480850,3445100694,1647999217,1648000019,802,897
3354143281,3888790718,1669462602,1669463212,610,314
3237482028,3679441161,1663726943,1663727367,424,1657
3176813239,3090936896,1658045362,1658045385,23,4520
3344821692,3189081850,1657587228,1657588050,822,1685
3457287176,3219489439,1654203263,1654204191,928,1078
3999373772,3432628140,1660842443,1660842735,292,1485
3846592587,3815399609,1659675035,1659675912,877,2245
3813431392,3958130699,1661098129,1661098440,311,4015
3548613846,3485586835,1655291560,1655292516,956,4667
3053616542,3505436881,1661030907,1661031207,300,2437
3782784620,3046217066,1666123293,1666123998,705,2400
3211065321,3787377883,1667101203,1667101875,672,1905
3314217855,3052287118,1641086826,1641087710,884,1748
3320578732,3080755420,1652193637,1652194324,687,1173
3027574478,3072985565,1647265866,1647266711,845,2701
3083017317,3411756007,1652565742,1652566676,934,309
3241474982,3579998759,1664039513,1664040466,953,1733
3561759087,3409718912,1654291430,1654292025,595,2237
3471701168,3281697636,1664209786,1664210696,910,3481
3887461996,3509561059,1663169290,1663169486,196,718
3221375820,3853990048,1658557168,1658557422,254,378
3029595271,3743479909,1642656560,1642657318,758,679
3709208661,3775055517,1655882495,1655883141,646,442
3716992314,3763855343,1653398792,1653399523,731,2458
3060662060,3869170430,1654394940,1654395763,823,3082
3375691835,3377299825,1644154427,1644155356,929,4978
3615984239,3264924936,1666600644,1666601075,431,3229
3320364497,3207112874,1660414252,1660415053,801,2362
3360383020,3221042849,1667458091,1667458231,140,1117
3158981531,3970033443,1669113507,1669114004,497,3105
3075083814,3646000539,1667919086,1667919735,649,526
3759706015,3939777968,1654104235,1654104259,24,4790
3799864099,3211761162,1653035841,1653036086,245,3307
3081125855,3142069197,1663750666,1663751023,357,1244
3589859682,3145423898,1649970358,1649970544,186,3378
3336928352,3277298376,1668711807,1668712387,580,2829
3044122748,3959574866,1667521047,1667521831,784,896
3877063038,3217535514,1662144459,1662144594,135,2848
3964719945,3253155958,1664910318,1664910582,264,360
3917263913,3964443585,1656411527,1656411913,386,2694
3174866443,3700291044,1659391438,1659392365,927,657
3902431500,3264737149,1641810088,1641810470,382,1439
3817804522,3944835290,1645624076,1645624439,363,3096
3217756815,3628899414,1659505365,1659505879,514,2684
3930957767,3507241300,1655966220,1655967195,975,2458
3263452238,3700636236,1641305618,1641306570,952,4828
3563884394,3189438542,1668565622,1668566219,597,1340
3059428717,3117918794,1652848194,1652848757,563,4525
3329134051,3567199031,1653727367,1653727386,19,234
3672977926,3612240417,1658234667,1658235295,628,1309
3680971963,3442459169,1655069186,1655069937,751,2200
3940036147,3283736355,1668420788,1668421132,344,701
3007621202,3540854404,1665499491,1665500043,552,259
3482960905,3345617791,1652164325,1652164678,353,2501
3271463836,3593973386,1645369343,1645369889,546,2312
3748511097,3832133567,1662166668,1662166810,142,4419
3640847709,3475394571,1641371393,1641371603,210,288
3897126899,3155221047,1655863453,1655864387,934,1466
3271592630,3744019254,1667741215,1667741951,736,2204
3580149635,3064415447,1644665294,1644666187,893,3766
3464548988,3851660113,1644138630,1644139417,787,3663
3821351436,3007179985,1656954125,1656954773,648,3621
3519419250,3316269769,1641658908,1641659209,301,2338
3411735438,3681723784,1658754652,1658755465,813,1427
3372666561,3472358830,1648968176,1648968624,448,356
3412399418,3050133656,1648673011,1648673826,815,3908
3896634881,3030288322,1663179592,1663180564,972,2610
3448302623,3055852003,1667051324,1667051528,204,3426
3285900150,3692726723,1651408446,1651408889,443,487
3018422123,3030814995,1665468675,1665469078,403,4574
3105957444,3774274515,1644163812,1644163841,29,871
3477528034,3061716258,1652232284,1652233241,957,1056
3320285045,3410714472,1667933246,1667933392,146,3074
3396934934,3068132601,1664632451,1664632580,129,173
3831356789,3317423411,1658949413,1658949674,261,2999
3074175715,3611077911,1642964200,1642964914,714,544
3496346055,3737985373,1652536737,1652537529,792,330
3848344278,3024833816,1663600018,1663600124,106,3489
3198801764,3403353653,1662485271,1662485556,285,4927
3993495418,3180207484,1649970609,1649971378,769,1539
3562864363,3285461822,1659764123,1659764792,669,764
3655713414,3835537596,1643407097,1643407114,17,1234
3899093814,3815749450,1656014310,1656014812,502,618
3172099965,3608343385,1644953495,1644953784,289,3411
3126959155,3684583060,1666755484,1666755614,130,925
3689796798,3675150821,1655019855,1655020548,693,316
3272483309,3232342967,1660780663,1660780737,74,3092
3045579552,3759592477,1667248244,1667249027,783,4941
3119073935,3148994058,1669659264,1669659559,295,3080
3568772963,3791574822,1667781766,1667782521,755,383
3831001237,3954652002,1649178778,1649178845,67,2881
3921299193,3903778713,1660341851,1660342630,779,2178
3075005341,3075445565,1655438412,1655438902,490,996
3215078102,3643604418,1653479870,1653480251,381,1849
3689470659,3236851371,1657170933,1657171084,151,2770
3466509106,3078622803,1644743360,1644744035,675,4958
3994149817,3883481756,1669643017,1669643990,973,775
3527825231,3848834484,1644279645,1644279697,52,1252
3258021104,3524621695,1665395478,1665395851,373,530
3919798845,3345238764,1653476275,1653476624,349,869
3363975987,3156254475,1642567324,1642567762,438,4225
3687491889,3367014910,1661282148,1661282402,254,3004
3648946066,3864938570,1662108665,1662108689,24,2453
3976323965,3024454131,1643676705,1643677066,361,3537
3486285836,3648047683,1660179387,1660180278,891,3074
3984727568,3832645143,1648048881,1648049323,442,749
3014670366,3784291987,1642261310,1642262096,786,4026
3448816793,3242918651,1655304707,1655305630,923,1955
3834560929,3866505848,1665182735,1665182775,40,1893
3780484860,3774884344,1650795125,1650795382,257,2845
3669145415,3645744896,1657957346,1657957986,640,2482
3245982027,3349539399,1654602335,1654603318,983,2309
3016168885,3138133018,1666615825,1666616151,326,4639
3955659613,3445194592,1649101610,1649102288,678,2721
3754747672,3216102446,1658045772,1658045859,87,3027
3087168737,3020158378,1658484770,1658484870,100,984
3583033387,3308236155,1658020860,1658021762,902,2127
3585183548,3815016037,1645415237,1645415866,629,583
3007222519,3991235738,1667684381,1667684718,337,362
3127814241,3132287704,1665543167,1665543269,102,4175
3585215907,3243461727,1668343763,1668344738,975,2275
3470184000,3182872240,1641250520,1641251489,969,382
3298142873,3434613902,1642787682,1642788419,737,1752
3710696523,3335498673,1658713995,1658714921,926,3779
3138111726,3646234504,1643155728,1643156034,306,3853
3727418078,3405812712,1649365793,1649366579,786,591
3239385575,3049923776,1653163649,1653164309,660,2461
3101861760,3815399609,1665483626,1665484586,960,4251
3481202616,3715880882,1658101886,1658102554,668,4895
3410248676,3269323815,1654083273,1654084020,747,731
3331011081,3831001237,1642687906,1642688288,382,1127
3629772420,3989541490,1644936909,1644937514,605,4607
3240882363,3059730078,1649885796,1649886495,699,1050
3565924395,3931972135,1669638897,1669638948,51,67
3963516509,3929972703,1643463468,1643463533,65,2921
3448604719,3957648139,1653515321,1653515779,458,3910
3490799263,3660609634,1645625425,1645625531,106,3973
3220874979,3146208701,1644254650,1644255582,932,2930
3758005742,3988967864,1646831576,1646831829,253,1402
3375841428,3647813019,1652245928,1652246141,213,3325
3123592757,3409282136,1657197191,1657197798,607,4301
3260598893,3431164351,1661392536,1661393109,573,1052
3209018811,3164787527,1652014320,1652015123,803,1598
3906121924,3610550655,1645451273,1645452173,900,3898
3883707872,3629171853,1647011323,1647012259,936,4723
3417650341,3420407231,1666211108,1666211678,570,1741
3741725937,3149462747,1660915331,1660916092,761,3016
3189462755,3419246813,1642002003,1642002686,683,432
3812237109,3779490028,1658355663,1658355728,65,4225
3492949774,3540358652,1643057536,1643058287,751,2663
3508097014,3434128686,1642627590,1642628400,810,4765
3795212981,3871783249,1651864186,1651864767,581,3326
3197953496,3444649999,1656774867,1656775404,537,2902
3705523519,3914746340,1651881884,1651882303,419,2219
3195800877,3009592813,1653078291,1653079233,942,4898
3686884624,3103252168,1664962135,1664962633,498,2979
3895722070,3374360488,1642709125,1642709572,447,1829
3695689434,3833639831,1655466715,1655467327,612,4498
3748239436,3719343681,1645820665,1645821526,861,4012
3597728352,3205187226,1661888124,1661889018,894,2925
3045213352,3015435710,1641930316,1641931242,926,1300
3925294188,3399580106,1663461870,1663462181,311,911
3549436189,3268686750,1661689085,1661689869,784,4520
3470534567,3452363604,1643223076,1643223982,906,4669
3166165887,3255636081,1652821605,1652821755,150,1901
3204730036,3828169063,1660393411,1660394343,932,1542
3411349563,3138107351,1660975622,1660975856,234,994
3406686123,3322446846,1664678742,1664679031,289,2395
3464917312,3548393037,1662911706,1662912379,673,3662
3695328102,3085345821,1644452260,1644453165,905,830
3962466904,3284100349,1668438133,1668438636,503,2223
3453432045,3821004468,1644879421,1644880049,628,2633
3063163587,3021751485,1643558310,1643558684,374,223
3169342884,3699760435,1651265236,1651266098,862,4469
3551699377,3781941836,1668519371,1668519687,316,3099
3862305908,3695813011,1665403261,1665403354,93,2410
3607564587,3747835929,1654020744,1654020770,26,4577
3173521898,3422527969,1646849098,1646849545,447,3200
3320412137,3329793866,1651539098,1651539393,295,1246
3381759128,3091674002,1650760925,1650761630,705,4590
3375960727,3633820209,1663361377,1663361625,248,1940
3755278426,3108068105,1658041621,1658042341,720,1292
3502634966,3677622968,1652827621,1652827791,170,3487
3523472755,3297654809,1668348818,1668349329,511,4568
3417653135,3607157795,1666133557,1666134090,533,4417
3882743616,3896295289,1659931929,1659932310,381,4846
3599938740,3598360380,1644179015,1644179748,733,3000
3674366436,3837254292,1657500207,1657500943,736,3755
3675891624,3826637086,1645279599,1645280553,954,4132
3814537747,3199291546,1647172312,1647173112,800,1177
3814499203,3424504785,1648232327,1648233192,865,177
3222767775,3635833874,1665259321,1665260011,690,3495
3680362753,3620912319,1658395980,1658396108,128,905
3813062614,3834983789,1655019297,1655019802,505,253
3318073525,3491564562,1659733669,1659734093,424,4637
3952698379,3896857203,1647752606,1647753560,954,4860
3493972539,3591246670,1645283955,1645284025,70,29
3970307170,3196930315,1642911370,1642912194,824,1895
3540568708,3787914782,1664508193,1664508278,85,4086
3295694684,3977999074,1660269968,1660270440,472,1940
3159116432,3497951534,1652303664,1652304188,524,3919
3154835196,3911959263,1656882001,1656882770,769,1071
3770836550,3706172553,1651759160,1651759982,822,1352
3282700221,3003687852,1657558281,1657558930,649,816
3412065637,3919859778,1669523079,1669523711,632,1041
3475545052,3692147274,1658697430,1658697690,260,2922
3587781489,3209202196,1644342217,1644342400,183,3132
3193603011,3437149191,1650437580,1650438132,552,1848
3506323405,3736398553,1661318765,1661318802,37,1119
3757637128,3668306612,1646295480,1646295839,359,861
3245323219,3669028375,1655833241,1655833946,705,3657
3242227622,3948369279,1665257720,1665258181,461,2072
3255700020,3220571307,1644771900,1644772690,790,4502
3792990979,3083003214,1654557630,1654558566,936,4815
3366012778,3135079295,1643094138,1643094223,85,1229
3811267030,3138729811,1669271781,1669272129,348,1342
3999184910,3052628388,1662197105,1662197749,644,747
3604148887,3640940784,1659734200,1659734826,626,1508
3195838746,3217259805,1660962951,1660963804,853,1212
3079802181,3325210608,1657576679,1657576792,113,2016
3873179973,3534257330,1668362696,1668362935,239,2950
3405265585,3358599862,1646067990,1646068547,557,1684
3101534203,3205314230,1662757437,1662758204,767,2494
3700414530,3475787429,1641618201,1641618508,307,4129
3840729097,3958724617,1645179430,1645179642,212,2296
3653627789,3634876741,1651173969,1651174632,663,1329
3299401087,3416021440,1664391448,1664391536,88,1304
3085340994,3315480625,1666452215,1666452782,567,1179
3443899670,3405852703,1648587051,1648587720,669,2826
3562250404,3803664761,1655740109,1655740972,863,876
3924518061,3295994300,1645227195,1645227479,284,2256
3140371772,3447771246,1667658824,1667659467,643,897
3440485352,3887870670,1654730518,1654731186,668,131
3046405761,3522470433,1652786877,1652787730,853,488
3836024041,3755597207,1652551496,1652552443,947,3862
3403261843,3858054969,1654077647,1654078005,358,1582
3053532115,3358441222,1664594395,1664594561,166,1430
3820152902,3615626902,1659768114,1659768513,399,3212
3758639635,3778585295,1644153213,1644153265,52,1492
3641900197,3710005596,1665595320,1665595820,500,2746
3965191878,3781349420,1660319668,1660319938,270,3882
3379020408,3995984506,1647844267,1647845211,944,3373
3594804462,3963034088,1652370848,1652370992,144,589
3066266098,3684821330,1655331742,1655332278,536,1618
3756120214,3135069931,1651000158,1651000846,688,4691
3771481912,3461805572,1665077673,1665078219,546,3092
3296896742,3418161434,1667132451,1667132482,31,4788
3777012002,3201004432,1661830745,1661830881,136,1977
3378931938,3176401272,1651927844,1651927867,23,1645
3374529900,3109116807,1644276069,1644276526,457,1102
3388738658,3363635039,1662130356,1662130611,255,2224
3138082936,3197706852,1660641215,1660641419,204,3598
3610931350,3222845267,1657287441,1657288057,616,3573
3060265658,3217995713,1651324388,1651325226,838,552
3154805848,3028629526,1641185049,1641185254,205,1785
3133931483,3391978797,1645186151,1645186702,551,1002
3636602873,3802174187,1641137680,1641138201,521,191
3821807478,3470110935,1646393953,1646394728,775,1693
3828211606,3170187460,1652792886,1652793568,682,96
3218748459,3250671877,1645851930,1645852537,607,187
3267886383,3864835113,1643787172,1643787635,463,364
3260702674,3984924502,1657369975,1657370061,86,316
3250802715,3759721679,1667887335,1667887903,568,2717
3494148718,3549834121,1669136670,1669137059,389,1569
3154848848,3205920912,1644969379,1644969692,313,2957
3970659367,3879637242,1654069760,1654070033,273,330
3097036620,3008709799,1658697249,1658697381,132,2948
3579629247,3971474276,1656580539,1656580975,436,3289
3023490718,3666218394,1648687380,1648687394,14,543
3220144689,3881359866,1658513221,1658513282,61,1302
3873658973,3107234900,1641004770,1641005552,782,1961
3596370081,3264256117,1665800816,1665801404,588,4861
3851078029,3265839921,1657417759,1657418027,268,3303
3495880335,3879301117,1662127285,1662128114,829,1408
3401966726,3010347452,1666600112,1666600920,808,1165
3277162994,3655710411,1660414465,1660415256,791,2441
3959153200,3711566507,1668645001,1668645810,809,2549
3080279390,3985882015,1654458618,1654458763,145,3114
3978045964,3249140465,1647213302,1647213931,629,1043
3529514326,3574161741,1647191391,1647191679,288,1326
3597005495,3844059983,1669291759,1669292680,921,702
3136532548,3874903181,1646853766,1646853880,114,3453
3694238156,3410875794,1661515623,1661516206,583,3951
3422243685,3279477296,1655820102,1655820712,610,4502
3642874688,3620747969,1645571458,1645571542,84,444
3617760285,3345000219,1665316469,1665316472,3,1469
3344133193,3442435608,1654011737,1654012174,437,115
3854047982,3766691799,1661842689,1661843215,526,787
3744393215,3684093495,1657194316,1657195245,929,1425
3901161780,3959264781,1660773269,1660773530,261,2997
3640360200,3139643237,1668227133,1668227261,128,2040
3470686969,3447155078,1644092878,1644093019,141,3646
3751455379,3325916852,1668936034,1668936491,457,730
3539596411,3330116312,1643456759,1643457402,643,825
3632919726,3553330110,1649264054,1649264831,777,3995
3721430925,3121012148,1661601611,1661602034,423,71
3008374032,3986047260,1650423547,1650423886,339,4235
3947701642,3899061816,1647697247,1647697485,238,3620
3647129869,3935290612,1650354026,1650354198,172,4614
3777012002,3345623091,1660187006,1660187497,491,3766
3211148794,3690024197,1657532147,1657532749,602,4352
3155255446,3140858291,1650756094,1650756294,200,1886
3986861710,3005644710,1655657218,1655657682,464,683
3416510823,3703312350,1667593589,1667593705,116,1104
3124027627,3785131332,1660347417,1660347757,340,2024
3993462753,3531530005,1658360335,1658360717,382,3412
3420528105,3658587583,1650265041,1650265330,289,4100
3601799283,3477106844,1663035320,1663036168,848,4379
3561062614,3503645395,1644331165,1644332105,940,4879
3594802363,3946899169,1667574615,1667575073,458,1892
3673047047,3862770581,1669268015,1669268885,870,3431
3461015987,3009601208,1652867845,1652868572,727,4923
3214702699,3451737402,1650800717,1650801254,537,2127
3062701713,3963699765,1649376371,1649377280,909,2965
3769712121,3909136652,1668251028,1668251088,60,480
3701818830,3000332771,1650558893,1650559732,839,2975
3422312903,3433999086,1650037178,1650037650,472,2599
3363590970,3130671431,1650069731,1650070585,854,2031
3888767549,3800523755,1652759670,1652759790,120,4651
3472524476,3599510786,1661414336,1661414725,389,1634
3247894037,3172110663,1668231274,1668231288,14,297
3888736958,3964997501,1666245841,1666246489,648,2766
3888285622,3711346836,1668733363,1668733793,430,3474
3745912081,3500922839,1641496191,1641496666,475,961
3586423852,3023692160,1657980310,1657981032,722,4778
3955161904,3354770915,1660098652,1660098677,25,4174
3984822975,3905996178,1664773368,1664773834,466,3991
3858433880,3256445373,1650269912,1650270027,115,3097
3359324201,3867425208,1658118633,1658118880,247,1756
3025733690,3795572527,1647838812,1647838913,101,2954
3939593742,3726441611,1664011326,1664011595,269,1840
3678572129,3792430356,1661974310,1661974574,264,4647
3450530320,3827833120,1642160670,1642161163,493,4428
3310287124,3664976635,1648023386,1648023980,594,1654
3826408828,3418147683,1648681972,1648682161,189,4159
3822337538,3463281237,1663328901,1663329282,381,1616
3660101266,3687200818,1665309002,1665309829,827,4332
3878284088,3279564393,1666280717,1666281075,358,4053
3914264832,3998104658,1655805676,1655806453,777,4062
3009321196,3034699224,1652633286,1652633848,562,752
3768467530,3807635993,1658075862,1658076141,279,4407
3751845284,3053153714,1641630925,1641631674,749,576
3597557442,3630397157,1650042591,1650043366,775,4080
3044473088,3245323219,1662717873,1662718183,310,238
3805424949,3900426162,1645555401,1645556378,977,66
3085533806,3445669770,1668615626,1668616415,789,2358
3409718912,3492471935,1647142985,1647143914,929,3048
3757768244,3631755561,1644694052,1644694877,825,2563
3940498584,3060103466,1664122131,1664122183,52,1804
3227149147,3577321848,1652117305,1652117399,94,3464
3725100452,3083623399,1659225633,1659225870,237,2410
3169976571,3819755143,1643088138,1643088908,770,1288
3410557201,3762761472,1642612615,1642613355,740,2020
3667823830,3343692663,1669135949,1669136532,583,3500
3871334961,3940517004,1644172558,1644172618,60,1812
3300182849,3220669019,1664946705,1664947426,721,794
3295129785,3331408438,1649537739,1649538095,356,4438
3972836435,3292927397,1652803422,1652803890,468,1606
3108868282,3025632094,1664168813,1664169615,802,2461
3592657350,3280997918,1642854635,1642855163,528,3605
3817243606,3820267404,1645252109,1645252485,376,3029
3350127756,3099481146,1660687318,1660688117,799,1653
3842818946,3506036312,1656921980,1656922409,429,3260
3302615601,3583307274,1668817509,1668818133,624,3254
3052072124,3970424595,1656920784,1656921583,799,1253
3276405976,3701006303,1648730445,1648730856,411,2048
3828334495,3665976972,1649236386,1649236568,182,1947
3127755703,3578098475,1657216940,1657217750,810,2588
3920705428,3699583947,1663062409,1663063397,988,1807
3696240948,3457477439,1661354564,1661355380,816,1616
3089947404,3192751113,1648752020,1648752107,87,2232
3074208809,3616616450,1661256895,1661257254,359,1521
3294827974,3706450066,1667570933,1667571227,294,4730
3297081809,3069624657,1650894740,1650895358,618,3829
3245541877,3673146707,1642575284,1642575745,461,1326
3954321538,3171045110,1646565282,1646565550,268,710
3876485567,3959664573,1658309774,1658310571,797,4089
3858763091,3837397314,1642167997,1642168786,789,1188
3269215621,3290853449,1666277952,1666278694,742,3344
3180050375,3030811385,1664498990,1664499022,32,3772
3742322658,3344272405,1641063318,1641064307,989,1241
3774991835,3419338590,1654636521,1654636991,470,3952
3093017638,3388890928,1665789935,1665789947,12,1084
3792772686,3859477660,1666432703,1666432763,60,2383
3693961994,3903970192,1643484121,1643484244,123,2823
3581055856,3229493421,1644318511,1644318641,130,2132
3288406906,3250415356,1650158195,1650158993,798,1628
3045910362,3032002992,1664581875,1664582348,473,517
3225782408,3399118470,1656018857,1656019626,769,1115
3494651827,3170748084,1658508738,1658509178,440,4595
3728513222,3792009672,1661379205,1661379983,778,337
3902805505,3220090401,1664737319,1664738100,781,3512
3443698325,3407843993,1645974712,1645975613,901,413
3830134955,3961996182,1641397928,1641398625,697,3236
3554753249,3734245190,1643459815,1643460784,969,3652
3838089292,3862144711,1666037590,1666038110,520,2740
3159026525,3312402844,1645656195,1645656834,639,4324
3574748576,3584012085,1664234788,1664235343,555,3445
3397588951,3452663190,1646847513,1646847688,175,2259
3241135751,3906791819,1659221351,1659221615,264,112
3435225128,3290731519,1662046144,1662046663,519,4121
3440497186,3662146971,1650936738,1650937004,266,2326
3779477642,3305656642,1658188484,1658189076,592,842
3868366591,3867905777,1655230099,1655230504,405,2515
3561003471,3755365005,1643759549,1643759879,330,2394
3045556437,3089394319,1649580764,1649581693,929,547
3777503528,3820322115,1644790854,1644791015,161,427
3556587998,3569773084,1662925656,1662925933,277,3065
3481065579,3115107738,1647447647,1647447820,173,4592
3903719147,3481513764,1641412797,1641413583,786,1720
3431078222,3503250192,1643132550,1643133395,845,550
3368737966,3979782567,1664758599,1664759471,872,673
3211799890,3760594942,1664460115,1664460641,526,2376
3374473948,3499273112,1648353159,1648354020,861,990
3951930541,3057572096,1666536451,1666537184,733,1037
3129862892,3040477935,1658154156,1658154252,96,3487
3056788810,3781391787,1666186774,1666187734,960,1177
3833182181,3405489919,1641276961,1641277276,315,1121
3453442191,3257888097,1661901002,1661901755,753,2559
3385807856,3159841448,1642731322,1642731471,149,4688
3066582307,3355877698,1642720016,1642720406,390,416
3043861168,3388856770,1652789299,1652789487,188,4850
3327992857,3126197243,1668610603,1668610953,350,2037
3536604280,3968018437,1653678234,1653678529,295,3564
3970759614,3087905808,1651469763,1651469914,151,4728
3392623061,3988217140,1657976896,1657976902,6,2198
3107738598,3068005675,1642409899,1642410263,364,1313
3942465012,3607213550,1652734389,1652734495,106,4023
3090523036,3053310359,1654128091,1654129018,927,2143
3124623349,3087738066,1665697720,1665698204,484,2241
3183726963,3323299488,1665993612,1665993845,233,3517
3103367262,3887870670,1657657564,1657658542,978,4463
3578130753,3594248532,1649234992,1649235672,680,915
3477100880,3755626607,1667660995,1667661984,989,2545
3559285579,3584424211,1660183124,1660183733,609,3098
3185186471,3498362708,1660806640,1660806808,168,3277
3710593213,3421158224,1657562241,1657562268,27,4078
3780302939,3855526340,1660233335,1660233667,332,2170
3609546055,3937285880,1643185527,1643186008,481,3397
3815329793,3379548313,1667105531,1667106373,842,2309
3842106836,3551289584,1658595717,1658596491,774,4946
3811584845,3630817765,1644774426,1644775023,597,566
3286089046,3676180382,1659744064,1659745027,963,675
3414830461,3914147110,1651054224,1651055060,836,4254
3771099338,3167053305,1649724856,1649724956,100,94
3520993977,3209407721,1659851579,1659851732,153,2178
3617070792,3810023824,1646323032,1646323287,255,607
3259839260,3466180845,1658346089,1658346732,643,4692
3842994533,3130203702,1648643239,1648643302,63,2562
3950157075,3222176074,1650996320,1650996815,495,3829
3014085035,3790252173,1641764117,1641764973,856,631
3595479202,3977921545,1664145749,1664146038,289,4655
3880296823,3946786992,1644311752,1644312090,338,1495
3946561378,3374360488,1665221811,1665222167,356,2844
3025043846,3497320846,1659137735,1659138602,867,1728
3408278947,3936116684,1652778005,1652778238,233,3315
3892645692,3805248541,1652250321,1652250936,615,2405
3961306026,3365978893,1658657007,1658657459,452,722
3532257206,3087839469,1642737502,1642737686,184,2427
3786583756,3485344898,1664218960,1664219187,227,4069
3388345781,3111115455,1642366839,1642367377,538,1340
3399341051,3700714883,1664757626,1664758004,378,2613
3001313583,3458040811,1667983899,1667984745,846,3854
3324919567,3154450991,1658689446,1658690029,583,1707
3994158000,3269847957,1662307000,1662307236,236,4266
3406146344,3395730273,1666438694,1666439364,670,4314
3427077162,3412966749,1666595024,1666596023,999,810
3737566326,3100785583,1647847492,1647848478,986,19
3879579524,3665622003,1643200670,1643201658,988,3888
3522302709,3805156480,1654569650,1654570186,536,167
3364909387,3116741147,1659702854,1659702886,32,3243
3524781191,3857353750,1648098693,1648098883,190,2652
3749707658,3433889473,1654655861,1654655924,63,1090
3357947898,3347596592,1664706591,1664706707,116,467
3800118670,3869779988,1661748904,1661748934,30,3629
3995428308,3226442392,1661935489,1661935970,481,3126
3788432573,3714098625,1656485441,1656485449,8,982
3955003593,3737291045,1653663898,1653663997,99,2990
3422232219,3795318510,1647778407,1647779168,761,4359
3587977218,3013973784,1654904431,1654904451,20,2081
3276616332,3266645542,1663837889,1663838867,978,1825
3318782382,3397588951,1659269052,1659269286,234,56
3087937469,3632256828,1651855456,1651855590,134,202
3008426037,3329038935,1659539341,1659539389,48,4666
3176177792,3094412335,1666880532,1666881388,856,330
3820997352,3591028007,1668823265,1668824085,820,809
3439256481,3218902407,1652492979,1652493562,583,1783
3060206169,3495848758,1654906482,1654906852,370,2448
3236515427,3938738638,1669021599,1669022247,648,3343
3263452586,3031426699,1655188833,1655188928,95,401
3567311484,3447124642,1663193317,1663194013,696,2634
3017295273,3528938613,1644138694,1644139015,321,2453
3225605645,3973108256,1653095967,1653096825,858,741
3764679616,3889642463,1649114326,1649115027,701,84
3679069101,3933412892,1666099148,1666099391,243,3050
3214002643,3652694465,1647582478,1647583139,661,1254
3561231936,3599370503,1648270952,1648271345,393,923
3937090490,3999987453,1663181715,1663182578,863,1448
3107879346,3368448059,1664738402,1664738685,283,4196
3670092960,3543629707,1651817119,1651817799,680,299
3880099880,3075310063,1649949673,1649950039,366,386
3921453384,3553277782,1663164870,1663165249,379,737
3023378843,3751742661,1642019960,1642020063,103,4075
3081301738,3060490972,1649127237,1649127477,240,1553
3336566539,3797176823,1665040987,1665041741,754,868
3396203734,3435113233,1666344599,1666344963,364,1232
3625308933,3719681940,1641948540,1641948860,320,4416
3735829791,3350226257,1645506730,1645507015,285,865
3034775084,3857911364,1644845266,1644845819,553,4767
3105143463,3181755697,1662592937,1662593276,339,4383
3658059015,3439804109,1642501986,1642502222,236,345
3017565540,3811984854,1663589163,1663589567,404,2122
3538337371,3481025975,1660686429,1660687131,702,3675
3837753188,3274078281,1642654329,1642654764,435,391
3135962737,3944213825,1662170197,1662170865,668,35
3784817348,3805955818,1668824070,1668824982,912,1348
3450675805,3049459760,1655259450,1655259608,158,3113
3852064188,3786483762,1666438397,1666438478,81,1013
3434301181,3458237705,1647689890,1647690185,295,4223
3305872695,3709804825,1664498915,1664499202,287,2173
3191859481,3968169834,1658456459,1658456895,436,1894
3910623649,3261844772,1649653854,1649653938,84,1010
3178232268,3211464891,1641488588,1641489173,585,1953
3084203471,3823606691,1659807672,1659808660,988,690
3731312652,3139606680,1656197927,1656198060,133,3133
3944302958,3976755259,1661678425,1661678913,488,3254
3077012068,3690666636,1647993900,1647994659,759,4714
3124699350,3301144933,1666512850,1666512957,107,517
3458771068,3104318370,1661517980,1661518731,751,2966
3781753438,3983770416,1654671679,1654672437,758,4328
3452722284,3468958350,1646494640,1646495461,821,4255
3962012593,3015850118,1641791691,1641792641,950,3450
3832001337,3033116130,1657741166,1657741339,173,312
3522545248,3966917835,1665242462,1665243026,564,3894
3221686514,3953358126,1646649128,1646650126,998,171
3138059648,3365264986,1643907726,1643908710,984,1554
3405097457,3991677492,1645262155,1645262403,248,1891
3627842616,3553767578,1659312628,1659313358,730,3012
3536566015,3159626197,1658230198,1658230640,442,622
3368448059,3568599627,1643209596,1643209849,253,436
3512719280,3308072025,1651558698,1651559422,724,4176
3924579667,3189707605,1667319130,1667319394,264,2846
3144362652,3658912807,1658175087,1658175663,576,3884
3042406328,3333340141,1655743842,1655743992,150,809
3286731668,3937159277,1661696362,1661696777,415,1614
3866539585,3014919671,1664794732,1664795303,571,4396
3378003645,3582605005,1651404185,1651404386,201,3510
3424802617,3987112835,1660466591,1660467299,708,1209
3646223465,3669599176,1654775485,1654775974,489,184
3895728738,3173502463,1668980613,1668981138,525,1149
3701058424,3319924243,1645830337,1645830974,637,744
3155174090,3587401915,1646230476,1646231165,689,1420
3523053624,3346578296,1661472966,1661473918,952,2764
3775313220,3259691329,1660445066,1660445158,92,3023
3801839495,3601463643,1669159551,1669159884,333,1592
3982517320,3182860171,1657892628,1657893307,679,1706
3814466973,3403519678,1648000602,1648001274,672,4599
3101846998,3272300777,1651986761,1651987606,845,4952
3948370870,3822640712,1648594058,1648595049,991,4121
3072117514,3890073496,1664853188,1664854069,881,1685
3790793064,3501472465,1649139789,1649140261,472,3528
3089764977,3359846818,1656308888,1656309690,802,1357
3430222610,3883617582,1649845822,1649846210,388,1493
3960109857,3015253555,1650364612,1650364834,222,897
3940530785,3754863632,1664988113,1664988509,396,2084
3607480255,3953215537,1654395905,1654396749,844,4991
3879140750,3052967887,1647338285,1647338883,598,2033
3275774771,3231623668,1648543348,1648543556,208,3547
3300182849,3920045915,1642643967,1642644648,681,3777
3559459027,3237684307,1666528365,1666528804,439,3437
3905850075,3385282882,1667182701,1667182874,173,3147
3623942799,3473632708,1654651480,1654652143,663,4401
3516446984,3247930777,1652357392,1652357947,555,4942
3680802317,3330217564,1658695311,1658696184,873,1420
3860729986,3114610444,1659622065,1659622455,390,4688
3154872754,3716035817,1655369768,1655370270,502,3903
3983839783,3218384375,1648882479,1648883331,852,3076
3777506440,3439486266,1645594244,1645594533,289,3509
3890457528,3333729012,1669086470,1669086735,265,26
3779500936,3822771621,1662491087,1662491248,161,4445
3525836777,3909064420,1663211962,1663212616,654,2234
3028400124,3618426173,1648310993,1648311844,851,2043
3395507412,3279312756,1652580044,1652580246,202,592
3154812811,3030010856,1644033432,1644033625,193,1050
3671334317,3370554865,1642486177,1642486610,433,3112
3192874375,3364165492,1667276055,1667277026,971,1379
3185731041,3311460602,1657594678,1657595231,553,3531
3670858051,3652643536,1647276781,1647277071,290,3190
3029354569,3482854332,1645366025,1645366652,627,865
3291741021,3130355220,1641063282,1641063556,274,499
3229093230,3777874726,1653982934,1653983236,302,3125
3268256538,3755944217,1658521184,1658521411,227,2462
3019537640,3817569054,1641029939,1641030800,861,2890
3988610068,3763487799,1655774725,1655775368,643,2912
3482431049,3231628342,1653526907,1653527100,193,4792
3181618160,3339101005,1663557168,1663557845,677,2938
3343939117,3289924589,1660084945,1660085041,96,3388
3548231594,3691689085,1661987719,1661987951,232,3926
3050538264,3224002310,1651949304,1651949624,320,3904
3677116126,3754419335,1657121523,1657122067,544,3066
3917456882,3238899536,1657909549,1657910054,505,4763
3720275481,3103569177,1662400311,1662401015,704,277
3923024869,3828391675,1658828144,1658828212,68,2052
3136763617,3257779966,1655885160,1655885831,671,2902
3130950930,3345962084,1664715772,1664715934,162,902
3380973083,3736372110,1653786983,1653787182,199,4038
3476112078,3854439825,1661191644,1661192111,467,1192
3359916315,3994491716,1666981096,1666981596,500,2854
3098971137,3670075353,1654617849,1654617858,9,2789
3770090363,3779801118,1652231283,1652231304,21,1263
3228108855,3623308882,1650710492,1650710927,435,2968
3633846676,3616937474,1641344479,1641345017,538,3220
3665862213,3521601118,1663214834,1663215075,241,714
3307628553,3717075547,1648094535,1648094864,329,2840
3246485667,3576485830,1647993923,1647993929,6,2296
3212913483,3598460668,1653896062,1653896199,137,2441
3463804885,3816022321,1665219071,1665220071,1000,3983
3922267848,3559600871,1667523619,1667524089,470,1578
3668306612,3201004432,1668438247,1668438465,218,4300
3967108487,3972382702,1658647517,1658647812,295,4407
3816217267,3246468967,1669662476,1669662765,289,2735
3165799497,3778524560,1641681637,1641682091,454,1493
3105317337,3615738957,1653797532,1653797938,406,4305
3968497213,3184444444,1658375183,1658375365,182,2955
3958883587,3379339690,1660202548,1660203245,697,4564
3680010922,3460459222,1667395456,1667396237,781,2435
3373764829,3818084232,1643057158,1643057739,581,2532
3823115093,3064958563,1646133870,1646134460,590,1345
3368173677,3862919995,1662773475,1662773692,217,2466
3538888702,3402205389,1649599838,1649600820,982,4392
3750766957,3524273028,1653583208,1653583352,144,4560
3136167220,3451428332,1642837005,1642837690,685,4470
3211799890,3630608744,1650422174,1650422506,332,1665
3153459747,3884231351,1641277864,1641278784,920,781
3464247653,3451077292,1668724137,1668725100,963,4894
3946572614,3392638111,1662285964,1662286045,81,1757
3554694370,3545085972,1664579655,1664579733,78,3831
3457507058,3870121609,1656385585,1656386395,810,1926
3415471081,3599246300,1641177482,1641177598,116,4097
3662846606,3338480275,1659597579,1659598132,553,4186
3429224552,3846986655,1667862224,1667862419,195,4878
3753326211,3059820625,1666347390,1666348180,790,3782
3875953429,3374159433,1668029073,1668029443,370,2842
3031985576,3076739101,1657074269,1657074599,330,3331
3538211134,3664088220,1663528948,1663529010,62,240
3717185476,3254729598,1665487160,1665487478,318,1714
3638709459,3625937356,1646637866,1646638851,985,791
3214898853,3306891569,1663571608,1663572134,526,3439
3015856390,3159546546,1660881309,1660881405,96,3308
3509930642,3994033167,1668034420,1668035157,737,3410
3637115759,3096448428,1649232939,1649233540,601,3007
3638972464,3113302059,1645932561,1645933540,979,1138
3832755526,3452212485,1655166028,1655166407,379,809
3484731477,3112950139,1648476516,1648476541,25,2440
3617584940,3972800755,1668259496,1668260148,652,1231
3717168918,3761677873,1659242996,1659243870,874,3982
3267860186,3121313427,1649063146,1649063268,122,2213
3323750828,3953994762,1667988518,1667989250,732,4067
3423747545,3355194209,1665409725,1665410110,385,1467
3023681549,3369808394,1665090992,1665091926,934,2075
3058242686,3923122573,1665598384,1665598707,323,4891
3726821575,3742204367,1645175434,1645176379,945,3553
3904160237,3242252042,1654466817,1654466833,16,4362
3415594156,3341323083,1643545247,1643545761,514,1263
3446177045,3620207727,1651985469,1651986164,695,4324
3274129394,3438881272,1657871768,1657872285,517,2400
3396760149,3925899779,1647776869,1647777514,645,3268
3483946111,3516464212,1665695409,1665696097,688,3648
3923417237,3830524021,1650898969,1650899350,381,4160
3541949859,3982564767,1659718922,1659719299,377,2942
3909895539,3163042872,1668114527,1668115089,562,1672
3950905576,3997007533,1641589115,1641589661,546,1487
3488337450,3385645320,1642150153,1642150157,4,2199
3819732645,3063356750,1646141714,1646141729,15,1629
3211060153,3188031685,1660221132,1660221240,108,4590
3960158491,3565164170,1650869411,1650869633,222,653
3874124033,3369558063,1664814431,1664814561,130,1785
3902943104,3023425807,1653059019,1653059282,263,3169
3725766601,3737101729,1656193283,1656194148,865,3361
3249808945,3611910363,1669438612,1669438807,195,2127
3832263568,3157894477,1656749196,1656750047,851,4270
3115326899,3964264741,1666491020,1666491783,763,1074
3785284002,3242505041,1647301371,1647301463,92,4352
3344821692,3980946484,1654915307,1654915890,583,3552
3713996043,3933708762,1654341468,1654341625,157,2375
3412386472,3168664267,1657609750,1657610309,559,2829
3677175406,3265293443,1663422738,1663423546,808,3485
3184438077,3325372844,1665689465,1665690018,553,3357
3201853355,3147365029,1641846831,1641847245,414,4365
3110048758,3813132313,1646514776,1646515322,546,4110
3585962670,3072359826,1667879607,1667880309,702,4577
3542413106,3002120023,1648735234,1648735701,467,2348
3574510841,3225910847,1669044920,1669045560,640,841
3327545347,3355553085,1644460737,1644460973,236,3148
3000632565,3249392558,1642396335,1642396715,380,4383
3211268708,3417154463,1667473281,1667473298,17,506
3526710110,3691593748,1643337989,1643338729,740,1587
3271071447,3514578879,1658490333,1658490486,153,4703
3061895941,3565222853,1659918301,1659919042,741,682
3426612720,3509028266,1654191985,1654192783,798,2138
3569013642,3524213773,1652288999,1652289569,570,2997
3082580140,3460506995,1659473264,1659474094,830,505
3806943617,3808738376,1669469412,1669470162,750,1633
3179536824,3572613822,1656344514,1656345186,672,4467
3381722654,3929358431,1653557042,1653557998,956,2018
3244479204,3827753154,1657962356,1657963061,705,450
3892788757,3328267955,1657437669,1657438274,605,4229
3281463216,3820547430,1664275287,1664276070,783,663
3039482139,3005561409,1649126482,1649127357,875,3878
3180135087,3845180016,1641084633,1641084835,202,3417
3104435179,3090550202,1660990327,1660990381,54,1499
3713473226,3602096361,1655581040,1655581364,324,2829
3206552444,3771663774,1667704316,1667705171,855,60
3753393424,3410459279,1652499553,1652500181,628,105
3835770026,3129273872,1669366487,1669367018,531,150
3759183844,3794727315,1658453306,1658453573,267,2674
3010401202,3963469649,1652937894,1652938831,937,15
3266361335,3606612724,1669103486,1669104394,908,630
3434194125,3403816701,1650044453,1650045223,770,3166
3337877459,3042584481,1668887974,1668887975,1,4782
3631469913,3439954950,1660582750,1660582945,195,3863
3829697424,3749467475,1647220377,1647221060,683,4402
3806112013,3604084753,1666989235,1666990027,792,4134
3466950756,3652354202,1649823564,1649824474,910,3617
3001568374,3903310014,1655323688,1655324438,750,3682
3741859787,3476949824,1658146320,1658147119,799,2161
3912880086,3883877942,1649023272,1649023279,7,3199
3277339182,3623867478,1651595392,1651596075,683,999
3741493904,3841933093,1659556533,1659557093,560,853
3453796822,3349226696,1645341890,1645342536,646,2919
3136785389,3143389374,1649345043,1649345344,301,4555
3723451039,3528327869,1661266693,1661266865,172,726
3041621002,3804317416,1660117588,1660117664,76,3514
3645429457,3493009548,1658164974,1658165734,760,4519
3739591328,3981637291,1662620225,1662620227,2,249
3445848947,3945351888,1664948347,1664949253,906,2816
3540558930,3070670978,1662447458,1662448266,808,2655
3145669198,3198005133,1655826657,1655827450,793,1628
3757598104,3272885044,1660870722,1660870841,119,3374
3742380227,3985143816,1660903965,1660904646,681,191
3200139454,3736029237,1657466903,1657467787,884,2683
3984408992,3998650267,1643602749,1643602968,219,2656
3606090147,3958666442,1656052153,1656052789,636,788
3528187774,3275934862,1664107067,1664107814,747,4948
3675012720,3958080274,1659695468,1659696436,968,229
3474730167,3988840653,1643728478,1643729351,873,2133
3603272107,3228595111,1668861299,1668861444,145,2690
3729056403,3214392484,1648321943,1648322332,389,3418
3827735759,3091664888,1641563488,1641564486,998,1962
3073832455,3157486136,1644929229,1644929409,180,96
3063360139,3731277164,1644039429,1644040071,642,4578
3223292781,3265472219,1655923348,1655924223,875,2420
3581159370,3879415149,1653432868,1653432871,3,497
3137324433,3879182569,1669226357,1669226567,210,3546
3435103399,3302874943,1657061500,1657061506,6,2469
3580514310,3101654176,1655067956,1655068665,709,1954
3483756305,3985765365,1646529361,1646530215,854,2231
3277422426,3658117050,1648680769,1648681749,980,1800
3152263098,3053016127,1665205840,1665206229,389,1261
3430092559,3420112588,1644427674,1644428348,674,3406
3337119208,3912867876,1662640103,1662640733,630,2132
3259076972,3799327281,1654782177,1654782846,669,2794
3493223436,3907730333,1645853348,1645853868,520,2850
3194856708,3562849774,1662030100,1662030505,405,1114
3732412476,3009622051,1665251142,1665252037,895,1169
3498397597,3358373260,1654034079,1654034516,437,2250
3135939239,3139283601,1664400125,1664400427,302,4526
3482788709,3252503248,1642939369,1642939722,353,1103
3770522759,3787620432,1642646454,1642647216,762,1530
3149478757,3347756351,1643117156,1643117445,289,91
3309181019,3942661220,1658663500,1658664092,592,196
3822003858,3717175586,1669329197,1669329303,106,4868
3307422306,3030338463,1657579713,1657579930,217,4204
3209418078,3787544465,1665632391,1665633295,904,3772
3291068880,3086751535,1659454553,1659454753,200,3091
3159298682,3158898827,1649308584,1649308670,86,4880
3935906213,3832953507,1643183865,1643184590,725,1407
3334397191,3673059843,1664305821,1664306551,730,2808
3616476692,3555564544,1643319960,1643319985,25,95
3711963374,3924121352,1650263795,1650264572,777,3854
3329037555,3112488079,1650732085,1650732204,119,3015
3906745414,3843226877,1668577279,1668577339,60,2990
3765230332,3037496995,1648955494,1648955537,43,1233
3782397778,3290668440,1656618202,1656619141,939,3714
3514259494,3947337342,1641044300,1641044783,483,1163
3492695883,3641003494,1649412652,1649413150,498,1822
3073090807,3598752083,1658675151,1658675735,584,4368
3833553165,3813612154,1662174389,1662175224,835,3551
3640213416,3643269160,1650276351,1650277336,985,1519
3637891254,3557316330,1655621585,1655621997,412,21
3341886522,3263236183,1650786062,1650786081,19,1930
3536291205,3395416381,1648913266,1648913784,518,4064
3772615212,3661298405,1656135640,1656135929,289,1039
3264053571,3247367957,1649347956,1649348137,181,264
3641934666,3718997482,1648255301,1648255546,245,4241
3623387971,3757469512,1654071809,1654072316,507,3650
3682997869,3051594212,1665259829,1665260557,728,2545
3880901201,3973352145,1667107368,1667107664,296,988
3823128902,3862748514,1644347160,1644347471,311,1452
3871388949,3247148423,1669049985,1669050975,990,3251
3647678468,3441087140,1656294050,1656294552,502,4144
3334336929,3082929579,1657449654,1657449658,4,4265
3844646904,3134256298,1659341711,1659341901,190,4456
3261439770,3442810514,1653993325,1653994166,841,2129
3181809341,3116387546,1665300860,1665301354,494,3551
3386181606,3804668537,1652135184,1652135423,239,995
3845529515,3820890109,1659874935,1659874946,11,2026
3255848521,3050958931,1664900743,1664900826,83,4041
3694368546,3120411431,1645914812,1645915096,284,318
3634240684,3912221483,1654062447,1654063199,752,2837
3611748946,3760295123,1647174035,1647174121,86,846
3951396407,3381618779,1663420849,1663421738,889,3570
3386276544,3679149611,1643210083,1643210944,861,3768
3789931978,3127881080,1660025329,1660026214,885,4000
3794370946,3665320387,1643299643,1643300018,375,4421
3047487943,3713782701,1658211690,1658212334,644,1854
3593774455,3488711394,1644806186,1644806449,263,1909
3985404274,3902380263,1655486066,1655486648,582,4182
3527856630,3286101576,1668315256,1668315437,181,1304
3767037006,3431366083,1664879493,1664879879,386,649
3584561148,3076127789,1656858378,1656858513,135,710
3067104456,3976705280,1653301109,1653301651,542,258
3814921306,3365428989,1667215576,1667216483,907,4741
3092082725,3720671086,1664232891,1664233392,501,3525
3866567078,3208882388,1664017813,1664018251,438,4655
3418147683,3069575249,1642853465,1642854324,859,190
3045368263,3926351393,1649288089,1649288520,431,4627
3904148312,3447107941,1659215501,1659215960,459,314
3926508454,3623439465,1655760525,1655761161,636,2759
3057682168,3792463580,1645217424,1645217751,327,4816
3018599745,3079363329,1658948142,1658948998,856,671
3448052494,3261724438,1667505933,1667505982,49,1917
3393547537,3066446860,1644489703,1644489886,183,1848
3284651474,3500647057,1664561956,1664561981,25,1433
3387913952,3667950439,1643921679,1643921980,301,2368
3145069503,3054780860,1644381853,1644382345,492,1524
3191705346,3003687852,1649392579,1649393331,752,3599
3599695681,3869446897,1642199575,1642199737,162,1837
3673655137,3768233137,1645304732,1645305010,278,3005
3792812306,3207414996,1662654746,1662655363,617,4741
3968472010,3943962631,1645854230,1645854504,274,2214
3076714600,3605802050,1669121128,1669121732,604,1836
3989348839,3216028009,1652047604,1652047919,315,4781
3944668867,3786159373,1665937389,1665937622,233,2458
3137476353,3557606292,1663125858,1663126163,305,2376
3911438971,3402556692,1644524283,1644524613,330,3943
3139911755,3815313271,1646136557,1646137537,980,3560
3943249237,3811398231,1664270896,1664271821,925,1355
3574776578,3271971595,1661407801,1661408150,349,3994
3631849805,3519755435,1666658916,1666659487,571,2644
3949914960,3154246341,1664061884,1664062362,478,3485
3370611750,3436291796,1646185807,1646186060,253,2111
3052583435,3779084070,1652699800,1652700098,298,3926
3164912152,3259711601,1667702073,1667702936,863,720
3958208486,3588575126,1667923109,1667923829,720,2461
3688719909,3332387952,1647970938,1647971410,472,1792
3055175363,3040977445,1668124682,1668125390,708,3984
3419676182,3820406843,1646159739,1646160410,671,338
3332107906,3687308952,1645179654,1645179751,97,1882
3608736715,3559723273,1659963539,1659964244,705,3121
3868327260,3512255018,1663530963,1663531708,745,2584
3966862833,3990803943,1642012186,1642013110,924,2033
3655182581,3306382960,1669022081,1669022659,578,3208
3677800042,3712930071,1642610003,1642610497,494,4503
3056028452,3246805770,1643192228,1643192792,564,818
3541512525,3716574298,1665444716,1665444801,85,2981
3800063859,3391179963,1661239838,1661240451,613,1379
3810825212,3009801644,1642110279,1642110747,468,1778
3315081627,3304626203,1643249070,1643249529,459,352
3333121153,3946703804,1665423499,1665424178,679,1382
3705031781,3247330134,1652087520,1652088510,990,3937
3946294528,3256190136,1643848088,1643848255,167,3722
3998550302,3561163861,1664421117,1664422103,986,3116
3524213773,3439323864,1668216664,1668217113,449,1785
3227615398,3552765654,1645333821,1645334751,930,450
3473942276,3407592947,1651605568,1651606017,449,4609
3567036568,3979293986,1664840581,1664840937,356,4087
3466287204,3256641417,1651056165,1651056195,30,237
3978073526,3105103564,1660238427,1660238553,126,1267
3991680201,3915112757,1659959508,1659959906,398,1416
3699270170,3789690390,1665783817,1665784364,547,3075
3211227944,3386666661,1665935349,1665935775,426,2434
3353914572,3845506789,1667099986,1667100137,151,878
3723795549,3763372820,1655485281,1655486050,769,2422
3866247688,3336298567,1665962237,1665962763,526,1424
3432759464,3670636018,1642098035,1642098582,547,19
3005075419,3573434871,1648456942,1648457935,993,2993
3925507867,3425137326,1654410098,1654410246,148,298
3536179210,3678700999,1655182326,1655182381,55,1196
3238822034,3637257236,1652372947,1652373319,372,3376
3019204419,3043149455,1668107853,1668108063,210,2312
3135484435,3401411025,1656822458,1656822773,315,1032
3898864594,3201363044,1647404536,1647405386,850,4714
3842404623,3487456647,1669236263,1669236736,473,2108
3960902598,3145410704,1645070671,1645071017,346,1492
3109761877,3655739739,1646369644,1646370628,984,1084
3630112462,3564121347,1656301157,1656301458,301,3450
3469640733,3923445402,1651586465,1651587323,858,1307
3875248572,3295887778,1651350088,1651350440,352,3215
3420460694,3884776195,1650851378,1650852015,637,4269
3547039571,3730497062,1660511108,1660511850,742,4434
3720186346,3314454310,1652420447,1652421188,741,1190
3153097097,3134799726,1656473438,1656474284,846,4468
3675124518,3060949108,1664055101,1664055398,297,2511
3292171001,3562799004,1642601653,1642602487,834,4152
3028061746,3030037566,1662180885,1662181175,290,4519
3670284324,3736796446,1644146992,1644147401,409,1240
3354044070,3343196497,1645739146,1645739177,31,2594
3785593798,3027017534,1668854639,1668855449,810,310
3600466145,3013297825,1667308657,1667309014,357,3861
3333189937,3597571774,1657926730,1657927555,825,2782
3760568744,3384101741,1661348195,1661348479,284,4958
3993846883,3603379639,1655515192,1655516105,913,616
3236341780,3146452835,1665134995,1665135595,600,2175
3790585675,3906257500,1646956203,1646957150,947,4701
3077742877,3632346285,1652135060,1652135078,18,2005
3110080633,3281937877,1667147768,1667148214,446,655
3707046229,3866534623,1642473466,1642473497,31,1732
3263801818,3995886547,1646316480,1646316807,327,2420
3744231893,3815107969,1646596507,1646596549,42,2278
3876426793,3279087942,1668416815,1668416984,169,1015
3232599669,3656613985,1645101804,1645102745,941,301
3385614517,3527082118,1654325701,1654326489,788,1712
3168395096,3274743828,1649734437,1649734755,318,4116
3466114675,3820346370,1660912202,1660912923,721,2365
3834022000,3147431112,1661670462,1661670659,197,4056
3959844300,3008249589,1645326832,1645327039,207,3970
3890339954,3835058556,1650869375,1650869646,271,4217
3083543674,3856365924,1665013187,1665013329,142,4391
3486680000,3035678474,1656007390,1656007964,574,4755
3307958324,3948361393,1649805098,1649805596,498,4547
3017028510,3793708425,1648440923,1648441184,261,470
3392832322,3924031193,1662968675,1662968856,181,377
3255956952,3803675716,1657153392,1657153910,518,591
3488198251,3381957598,1652914621,1652914879,258,1357
3835384093,3783511377,1649645123,1649645271,148,2013
3010811886,3728325277,1643966200,1643966455,255,3364
3437048648,3128450558,1652919051,1652919967,916,3470
3289044958,3529591851,1649323049,1649324042,993,3615
3321919217,3259429773,1663507127,1663507784,657,2946
3465802950,3322856969,1651277868,1651278393,525,587
3946501911,3438823224,1653578067,1653578671,604,4878
3582421941,3128309221,1649712581,1649712604,23,1838
3327178856,3188530906,1648523768,1648524457,689,4312
3605120753,3822037185,1647606669,1647607634,965,1167
3603174887,3526058988,1643020561,1643021516,955,3286
3840696120,3035335317,1652845400,1652846217,817,2353
3045792174,3037769041,1642760918,1642761473,555,4039
3582421941,3643014941,1654268931,1654269087,156,2649
3260808383,3600451169,1658596087,1658596284,197,4984
3759592477,3689946213,1667712511,1667713117,606,2383
3193072219,3593655160,1645868839,1645869599,760,1858
3709789062,3847184629,1668423230,1668423863,633,4807
3858608859,3163918797,1647073028,1647073962,934,4482
3000528617,3109302924,1643724797,1643725797,1000,1100
3462145524,3837504743,1663445507,1663445532,25,2368
3383274677,3186849205,1648177368,1648177610,242,4220
3572272626,3307408339,1651110451,1651111446,995,813
3510418300,3750216706,1644476854,1644477309,455,3169
3061189617,3917862956,1643764433,1643764713,280,2222
3267918155,3032363267,1664277206,1664277232,26,3238
3507902428,3024053486,1642197225,1642197442,217,72
3353259434,3154352499,1653438572,1653439569,997,1839
3121761720,3722444853,1666995200,1666995481,281,2862
3921998548,3638764832,1669419801,1669420482,681,2494
3360960337,3503250192,1643010299,1643011058,759,3880
3118358759,3451800530,1642816503,1642817271,768,4846
3012520763,3375547528,1652488439,1652488935,496,1964
3123388189,3479115574,1651619732,1651620213,481,1463
3769034625,3649899740,1655202989,1655203743,754,4158
3878936540,3661722946,1643716463,1643716535,72,3105
3790593932,3238437717,1641115309,1641116101,792,1863
3968070044,3990092190,1664546358,1664547147,789,2394
3243844053,3636519833,1660130773,1660130870,97,519
3787201457,3688953004,1665652080,1665652546,466,983
3155025060,3691976720,1665983998,1665984180,182,2976
3275572865,3766921373,1646658569,1646659213,644,1227
3186179938,3903551202,1647530746,1647530943,197,729
3599775172,3564495908,1648195030,1648195610,580,3485
3305363873,3621442920,1652679361,1652679865,504,1233
3225135694,3618584256,1663283894,1663284340,446,4634
3931368985,3579571648,1652364533,1652364645,112,3843
3148752689,3534209931,1666197688,1666198655,967,3122
3621507110,3834983789,1643160768,1643160927,159,3461
3013340762,3161801275,1669299769,1669300712,943,4405
3154233220,3821408588,1663811191,1663811814,623,2134
3134986915,3114493446,1658766412,1658766816,404,4396
3269030429,3242063235,1659123307,1659124024,717,3854
3858318040,3256745557,1658278377,1658278987,610,3238
3440894629,3630617290,1664697939,1664698802,863,4825
3597971937,3684339172,1642720494,1642721283,789,4156
3661143913,3477655309,1647012295,1647013117,822,2997
3549606832,3833856251,1650759885,1650760499,614,4144
3516824419,3302880977,1651769905,1651770564,659,4985
3875282971,3955854532,1641796632,1641797204,572,4046
3342923973,3983031562,1647183335,1647183730,395,3086
3947812507,3441638040,1666658637,1666659182,545,3501
3123824742,3762732150,1655576105,1655576480,375,3203
3513956717,3676839502,1650171248,1650171739,491,2358
3705065659,3371707521,1654780501,1654781126,625,626
3528354504,3755827163,1642982338,1642983169,831,3383
3512004863,3964811958,1653850488,1653850929,441,2231
3550381908,3530793202,1647989317,1647989862,545,4063
3972848318,3212684094,1665725568,1665726470,902,567
3445807188,3214702189,1644398204,1644398491,287,2147
3204909862,3797073229,1660725771,1660726116,345,3508
3691769787,3636138635,1649705678,1649706479,801,4702
3227603301,3472914330,1665992125,1665992147,22,2121
3889373034,3062031613,1644243189,1644243382,193,2077
3967609570,3375508617,1658453618,1658454045,427,3783
3735164696,3040794099,1663799239,1663800056,817,1737
3862897301,3263422452,1659087338,1659087778,440,1942
3170213854,3319889838,1642627783,1642628651,868,4775
3478813303,3316590538,1664167140,1664167189,49,1620
3457580112,3806212538,1661167834,1661167945,111,1270
3983252894,3061881929,1667504648,1667505002,354,1305
3676040349,3672171681,1642275293,1642276047,754,2299
3737618411,3757687252,1669290908,1669290967,59,992
3740528956,3468422226,1651352388,1651353373,985,2159
3284638426,3097906784,1656144477,1656145457,980,2260
3201115641,3370144177,1646397196,1646397882,686,1557
3018173496,3513972679,1645381989,1645382096,107,3223
3576307315,3456884030,1646425638,1646426092,454,3785
3864560336,3143026008,1667515394,1667515643,249,619
3739718138,3335449906,1659904412,1659904705,293,2975
3184163358,3095160769,1647718756,1647719348,592,3357
3331761189,3271213638,1655184975,1655185836,861,1740
3508831844,3501877880,1654148810,1654149657,847,231
3371605865,3894475722,1668214533,1668215232,699,1103
3663777805,3291753747,1665916224,1665917160,936,2934
3893411218,3573567075,1650788303,1650788936,633,988
3877777748,3867954657,1663499549,1663499764,215,724
3917775939,3970498740,1647426470,1647426856,386,4504
3173205572,3057904436,1660444003,1660444551,548,4216
3937696679,3724271208,1661876311,1661876461,150,4963
3479975139,3956128159,1642119129,1642119768,639,4360
3294678521,3976828104,1658295594,1658296547,953,1939
3431890923,3947555669,1650486143,1650486390,247,2097
3811739626,3171957391,1666526617,1666527164,547,426
3143664381,3102372117,1668830934,1668831466,532,424
3669760254,3522765158,1665014890,1665015533,643,2450
3501154169,3487835391,1642052674,1642053459,785,3587
3765329141,3197858237,1659451332,1659451711,379,3427
3068132601,3799396875,1643136619,1643137291,672,4077
3151331865,3534517425,1655976471,1655976804,333,1172
3974763024,3864087449,1653893243,1653893397,154,3894
3082615069,3024008219,1643759099,1643759692,593,1436
3870351207,3987952482,1656303610,1656304008,398,2785
3706752145,3589551369,1660579169,1660579860,691,3386
3970656723,3434438732,1663625342,1663626012,670,3305
3704228225,3735129535,1647990345,1647991227,882,2216
3201280383,3693696188,1661608838,1661609285,447,1125
3114298247,3057962595,1642340605,1642341196,591,1387
3763770491,3162517803,1658655262,1658655407,145,824
3334148580,3064848988,1656018327,1656018771,444,2464
3040333221,3313191011,1645647071,1645648029,958,2898
3642309632,3511524649,1663589431,1663589584,153,361
3246428809,3087506515,1664796323,1664796824,501,3285
3467728419,3523843114,1644169082,1644169416,334,4121
3122951451,3473345154,1666634878,1666634902,24,4005
3727372735,3997874674,1669140914,1669141501,587,1307
3764183075,3450509623,1660447849,1660448195,346,861
3373688714,3525746036,1646585346,1646586330,984,3772
3920570237,3496096243,1659186028,1659186240,212,1647
3576994439,3749056057,1656711261,1656711277,16,3447
3208442779,3638727969,1665988150,1665989030,880,4684
3143725281,3189707605,1647454503,1647454629,126,4151
3997623977,3629119455,1647627729,1647627952,223,3540
3769472058,3609341315,1667234142,1667234401,259,395
3388025437,3125264873,1649724422,1649725199,777,3998
3282537831,3100186130,1649265567,1649265649,82,2722
3193578408,3352672295,1667164632,1667165486,854,262
3470126617,3349594510,1647842276,1647842940,664,3763
3868125106,3288647153,1652184805,1652185326,521,4700
3062317302,3559260396,1663343039,1663343814,775,2085
3267633982,3897017768,1659378781,1659378855,74,4539
3036232702,3220148986,1666954029,1666954336,307,2628
3441054174,3753372904,1648695213,1648696038,825,1581
3789628849,3554761808,1644106976,1644107275,299,846
3102568581,3308214956,1652552586,1652553126,540,592
3267292800,3164493300,1648475926,1648476588,662,3087
3282701240,3042486506,1669565648,1669566239,591,4220
3660637610,3570007174,1659126122,1659126581,459,754
3763057296,3086894990,1659260914,1659261179,265,1631
3639781012,3365121849,1664750946,1664751755,809,604
3481662797,3270582294,1663877513,1663878403,890,3255
3643787699,3685477070,1647137512,1647138498,986,203
3775725785,3582711031,1658730112,1658730508,396,4277
3484070440,3565970001,1651665257,1651665318,61,1620
3756891776,3348611893,1660509919,1660510788,869,3597
3459311309,3189749051,1640993339,1640993475,136,2503
3636806984,3580231918,1663768520,1663768574,54,2740
3427547559,3194228684,1656330209,1656330531,322,2091
3466287204,3924459540,1641038529,1641039010,481,2597
3075110944,3379961104,1661233064,1661233134,70,4148
3706985672,3914364895,1642578105,1642578498,393,2688
3302218881,3705101334,1645912473,1645913160,687,1967
3235299120,3553766634,1647783706,1647784204,498,4150
3603641613,3217164133,1661689065,1661689864,799,967
3807700806,3736868946,1661725900,1661726258,358,587
3441879075,3405852703,1653034537,1653035233,696,1291
3859408437,3647901249,1643593053,1643593508,455,360
3666911358,3299563079,1660197138,1660197867,729,1447
3249801956,3464152483,1654958534,1654958795,261,2339
3788190944,3375426571,1654607933,1654608295,362,527
3375666463,3053620613,1652070103,1652070565,462,2221
3614286032,3172999403,1657581798,1657582202,404,3085
3538165872,3852871683,1652613796,1652614701,905,4321
3163357153,3105650543,1648694715,1648694814,99,2052
3106858321,3659257046,1667968725,1667969158,433,4120
3049684125,3344536847,1654612565,1654613139,574,3749
3270497527,3605233671,1669568658,1669569016,358,2229
3461015987,3927258804,1656390956,1656391859,903,3851
3306254664,3173161845,1666431973,1666432306,333,79
3000850654,3984550958,1653693146,1653693936,790,47
3343377097,3281504996,1659177623,1659177863,240,2206
3884549884,3155728102,1663643988,1663644169,181,3218
3533322410,3750166742,1650764647,1650765638,991,3400
3622838302,3300421434,1669373540,1669374310,770,3453
3141205838,3675408809,1646705003,1646705180,177,2513
3772346285,3050398306,1665019151,1665019231,80,2740
3305493225,3701547167,1648662613,1648663117,504,645
3541720366,3513945447,1642217942,1642218518,576,2617
3004398992,3217556365,1649027012,1649027594,582,1336
3933249274,3010435800,1657326953,1657327137,184,3869
3095850201,3739747630,1660245784,1660245945,161,1572
3756547291,3909571198,1644668738,1644669458,720,4101
3660719328,3905225730,1666868550,1666869291,741,48
3999935046,3073537628,1650629678,1650629988,310,4108
3949864361,3516077358,1647516554,1647517083,529,656
3878165259,3015815988,1646059379,1646059682,303,3190
3687400393,3209595012,1666386809,1666387179,370,4482
3082540737,3543080213,1649955243,1649955557,314,750
3774617549,3643612786,1647274840,1647275272,432,2931
3183804269,3763582408,1642229559,1642229906,347,3740
3508017760,3799627760,1657031365,1657031826,461,646
3166579014,3198824805,1647858887,1647859721,834,635
3007687601,3809367187,1656366363,1656366881,518,1551
3254180162,3843177750,1663602950,1663603627,677,1627
3603890232,3269599073,1660262518,1660263056,538,2079
3571431998,3686268953,1667117697,1667118453,756,3457
3327247438,3646195232,1651562834,1651563119,285,481
3218695996,3137398422,1646526177,1646526615,438,1766
3107077762,3728340289,1656862022,1656862071,49,1465
3176850501,3725238516,1654591070,1654591776,706,4661
3808702129,3999559767,1654508042,1654508133,91,1259
3035467930,3453069099,1650770011,1650770164,153,3874
3701416771,3517656553,1657200429,1657200447,18,776
3669432282,3647972414,1642559831,1642560608,777,1155
3997766388,3535770151,1657734283,1657734343,60,972
3911051421,3389462796,1658744564,1658745072,508,1286
3525858559,3944051797,1669068681,1669068924,243,2670
3773486270,3383700200,1655874154,1655874227,73,3117
3072805217,3914479049,1644456703,1644457260,557,3946
3441623616,3855206034,1659531439,1659531501,62,3540
3701936724,3796946268,1669174585,1669174942,357,3693
3991721118,3071572593,1653244998,1653245719,721,3079
3747063027,3385810249,1655413423,1655413858,435,1297
3079977606,3388550362,1661187865,1661188658,793,967
3050526279,3901433341,1661727101,1661727958,857,1741
3368764687,3358547290,1654058702,1654059441,739,4286
3831012828,3246272493,1660117915,1660118564,649,4670
3804864870,3368343825,1652950874,1652951735,861,2101
3633375341,3547443390,1648905649,1648906079,430,4061
3328159738,3269017260,1641614753,1641615197,444,195
3610782990,3155692735,1660287425,1660288058,633,492
3068144044,3422105461,1668441798,1668442076,278,1197
3042241525,3965243096,1663001489,1663002480,991,4840
3381450088,3114672241,1644238086,1644238872,786,1975
3814499203,3249150340,1657971060,1657971979,919,732
3293415458,3354234810,1665101977,1665102582,605,4164
3476457987,3662608273,1652715082,1652715831,749,1819
3857415360,3855007387,1661510154,1661511037,883,193
3212821462,3437531125,1655259690,1655260511,821,4106
3084833041,3581672589,1642160709,1642160750,41,999
3039876524,3668508141,1646105784,1646106537,753,3440
3085340994,3743425086,1652833833,1652834196,363,2316
3733252730,3371779263,1665987750,1665987838,88,2597
3225565264,3699677313,1662034275,1662034880,605,1563
3512796603,3111788633,1658466027,1658466679,652,2272
3823442965,3150843219,1652698461,1652699077,616,3981
3405594626,3518869767,1653383343,1653384219,876,4095
3040147155,3369520455,1649702598,1649702725,127,1138
3765984446,3688176110,1642866464,1642867204,740,4524
3822903970,3288852848,1646882355,1646882557,202,2969
3622109505,3631356045,1669412591,1669412994,403,497
3740020651,3128706338,1655003620,1655004280,660,4589
3327727015,3520138473,1669600996,1669601148,152,1596
3190948657,3977773913,1642380302,1642380448,146,966
3743600464,3896286285,1664721226,1664722070,844,835
3495610642,3808659200,1665455495,1665456058,563,3312
3259834884,3787038703,1647071296,1647072124,828,1960
3110490428,3042826459,1652161816,1652162549,733,1266
3900591356,3436683329,1643459142,1643459461,319,1820
3203463150,3933708762,1667705128,1667705622,494,1278
3598891073,3191557776,1652556932,1652557468,536,1959
3618903483,3074399461,1662019139,1662019504,365,1820
3000781332,3424205488,1654421348,1654422233,885,4980
3598838944,3022734399,1656148982,1656148983,1,758
3910334146,3001415608,1658710815,1658711546,731,1643
3889917950,3350370672,1661396583,1661396617,34,3030
3998323765,3452164189,1663855303,1663855983,680,4769
3172894527,3360742965,1661568964,1661569095,131,109
3733246420,3563975495,1646378857,1646379051,194,797
3008878002,3012081532,1653226903,1653227682,779,501
3860337022,3615558744,1656729255,1656729440,185,2929
3003685997,3477151983,1643758460,1643759094,634,431
3303304654,3527107002,1667527139,1667527768,629,2205
3407576289,3035977536,1654810341,1654810771,430,2133
3052246371,3236059196,1658991546,1658991597,51,2459
3620207727,3133506328,1667706026,1667706686,660,1405
3081671397,3177940786,1658880275,1658880846,571,4937
3521382117,3758184846,1657923450,1657924102,652,3608
3529895878,3898356981,1653026170,1653026254,84,81
3744333624,3487477725,1664961909,1664962474,565,915
3750251546,3016167089,1660283232,1660283445,213,312
3132622860,3903493255,1666736032,1666736307,275,1283
3541178128,3300845561,1656844955,1656845562,607,2059
3685069817,3406458921,1664257669,1664257734,65,2030
3955642126,3909248832,1661113050,1661113340,290,2651
3280202960,3797999300,1667497342,1667497348,6,2768
3964284088,3172840709,1664688880,1664689302,422,4666
3961098607,3529921898,1664442399,1664443266,867,1233
3438302350,3199291546,1647943588,1647943658,70,1553
3353942911,3364165492,1662931746,1662932099,353,3632
3650557003,3637057297,1660354112,1660354599,487,2044
3054455968,3872794549,1668566730,1668567385,655,3818
3974158707,3389353024,1655692022,1655692837,815,892
3011525862,3989947514,1643711318,1643712168,850,2012
3785034056,3909810189,1658984799,1658984970,171,4358
3960819815,3754795560,1669544632,1669545298,666,1509
3005930489,3806451329,1647643382,1647643925,543,1880
3721462941,3223604217,1664941149,1664941196,47,1878
3010128156,3344072816,1667413523,1667413628,105,4797
3229381809,3238512976,1642869079,1642870002,923,1355
3705102925,3898057832,1669183844,1669183973,129,892
3947001564,3454269626,1663863846,1663864380,534,1485
3190520209,3623116592,1649180130,1649180932,802,2726
3806502782,3433103286,1668599040,1668599360,320,2526
3390813605,3321693767,1644180754,1644180948,194,943
3541893577,3195270337,1668802109,1668802725,616,2140
3890780019,3084190701,1645942761,1645942765,4,2228
3040744778,3788879848,1645677260,1645677301,41,3953
3837334133,3989747957,1642324321,1642324657,336,1275
3599543242,3479339986,1662147520,1662148016,496,4002
3889271406,3769337542,1662773307,1662773514,207,3616
3589587083,3949864361,1652924907,1652925084,177,2844
3772509613,3410149700,1662094398,1662094963,565,3216
3848330885,3888978631,1652520025,1652520346,321,4310
3979124874,3107725779,1641750184,1641750342,158,3651
3158305365,3135621215,1668913574,1668914440,866,297
3940004420,3028576638,1656798121,1656799087,966,4083
3427806893,3240394168,1649546536,1649546847,311,1400
3307393959,3625394714,1644997098,1644998042,944,2640
3355160043,3158315966,1647553304,1647553867,563,3605
3962679270,3796671143,1643404057,1643404705,648,2452
3230919307,3406416281,1665259085,1665259093,8,1074
3876007278,3424347482,1666861317,1666861525,208,2527
3693116193,3328613780,1659613592,1659614408,816,4427
3693236607,3614915772,1645798908,1645799645,737,2029
3907782250,3814149558,1664644816,1664644907,91,2055
3968291500,3844716717,1651473177,1651473757,580,3304
3910646836,3034629346,1660164927,1660165115,188,2425
3270595897,3871881956,1646674467,1646675062,595,3655
3875065466,3351805003,1658787848,1658788409,561,1230
3421460587,3716679968,1655207046,1655207191,145,240
3236059196,3527800125,1647745722,1647745962,240,1653
3824619158,3598342738,1647442346,1647442590,244,3924
3354979853,3005500245,1653850036,1653850702,666,3517
3145706716,3811215477,1653696401,1653696403,2,3558
3777845046,3565624661,1646944978,1646945061,83,2064
3083126828,3919389021,1657902544,1657902598,54,109
3718382298,3399157631,1658267926,1658268277,351,4861
3281811538,3310706696,1648291896,1648292497,601,4487
3641207122,3175585152,1642872724,1642873213,489,4472
3279175439,3794140014,1652436027,1652436853,826,3431
3458534209,3877117516,1641391408,1641391666,258,4313
3113302059,3812234916,1666015802,1666016193,391,2555
3184201047,3462949306,1649976974,1649977755,781,634
3882360636,3575890861,1657334123,1657334738,615,2374
3829346847,3911179962,1661271658,1661272222,564,1682
3769471488,3962058941,1647590899,1647591247,348,1422
3830280677,3088505951,1643475165,1643475557,392,1301
3036347825,3589865984,1643476898,1643477081,183,4739
3295096840,3515598897,1642888565,1642889142,577,3982
3963154484,3117040063,1664601985,1664602708,723,4843
3466584947,3529983062,1645528814,1645529585,771,2348
3067380854,3674764890,1646195142,1646195246,104,1440
3457277136,3454572814,1656509713,1656509800,87,2170
3443947859,3436983272,1658815769,1658816008,239,2186
3600710693,3323524548,1643871224,1643871424,200,4591
3576822394,3374850612,1644392922,1644393501,579,3330
3648092277,3651962653,1666772748,1666773495,747,4994
3579506544,3895704820,1661211526,1661211853,327,4416
3570385891,3212583406,1649322332,1649322962,630,247
3332797349,3951426845,1647758901,1647759771,870,1130
3747056610,3077790953,1666771449,1666771801,352,471
3129423994,3721369025,1664256770,1664257364,594,1428
3538967869,3309572802,1662058526,1662058747,221,4980
3196844617,3553597593,1660525554,1660525607,53,4430
3312485475,3113868857,1667668205,1667669170,965,1105
3740540189,3424596992,1666740474,1666740684,210,2689
3387913952,3499188255,1647998381,1647999015,634,4044
3515194949,3402683249,1652732454,1652732751,297,1583
3673553502,3283736311,1645856654,1645857056,402,161
3626118104,3335117553,1653227900,1653228102,202,2828
3778468541,3331681636,1658192234,1658193199,965,270
3202744745,3752529908,1650069040,1650069434,394,2648
3967219553,3440790583,1659593796,1659594131,335,2475
3387938260,3577843089,1647390361,1647390530,169,3419
3060066847,3341787762,1653432414,1653433298,884,3692
3418258405,3086921564,1648459948,1648460840,892,1752
3122353698,3664917871,1661965763,1661966711,948,1915
3090925577,3443284113,1664907748,1664908587,839,960
3880085706,3641422471,1655560392,1655560436,44,1124
3639835134,3023258168,1657784112,1657784384,272,1371
3438578762,3862773947,1658294359,1658294540,181,4572
3483435194,3349374636,1650993842,1650994424,582,1868
3611949595,3619980652,1643651466,1643652056,590,2794
3831339201,3241895383,1648206550,1648207408,858,4396
3600761138,3831601795,1666001457,1666001680,223,3466
3416975226,3076902799,1666307012,1666307593,581,716
3063888826,3008095293,1649634332,1649634484,152,1228
3336573050,3219261745,1652481743,1652481950,207,3985
3797351628,3481818231,1657659647,1657659892,245,1182
3173945958,3533391954,1653573292,1653573809,517,2543
3217996739,3859489587,1641896576,1641897244,668,3927
3160460240,3462696511,1662111019,1662111225,206,4125
3399398289,3705879914,1664549624,1664549816,192,4547
3062151258,3238550068,1665371438,1665372088,650,2437
3086098084,3800578186,1653148581,1653148686,105,1192
3213256400,3856652867,1643955597,1643956040,443,4561
3514844818,3227603179,1647791985,1647792543,558,572
3013718466,3825338264,1667551894,1667552086,192,2852
3664890853,3768321531,1644722466,1644723224,758,363
3055939853,3636851687,1642941868,1642942711,843,4774
3512403848,3031617610,1663873817,1663874405,588,1424
3210208378,3904988600,1663205692,1663205881,189,3999
3882452932,3159280376,1662197970,1662198826,856,433
3937549351,3079468759,1669112498,1669112863,365,4594
3377049160,3517103795,1643194682,1643195661,979,2825
3899381048,3819955275,1657460074,1657460940,866,4051
3535930084,3909194627,1665092750,1665093234,484,2455
3316396015,3506759560,1650561209,1650561581,372,1923
3467537345,3021342206,1647601451,1647601955,504,4555
3443524200,3208014354,1669335600,1669335633,33,4005
3792095617,3421215930,1667088235,1667088269,34,1170
3976008709,3735351740,1664431417,1664431472,55,3189
3161312218,3742708434,1653783832,1653784164,332,4387
3178727571,3145140078,1663121280,1663121608,328,4043
3940136412,3591726999,1662273402,1662274303,901,1727
3930899814,3426464397,1645740790,1645741785,995,3419
3708540653,3279448501,1641719850,1641720176,326,4899
3926402738,3998928524,1642021885,1642022494,609,3314
3830396714,3254086590,1668974755,1668974962,207,3881
3110069598,3813764957,1647433681,1647434052,371,992
3183058851,3916777252,1650929017,1650929645,628,352
3795733654,3769529689,1658189243,1658190071,828,1981
3462231554,3774983415,1655653123,1655653561,438,224
3909772162,3257347439,1656220196,1656221021,825,1010
3228854664,3069021770,1650160362,1650161361,999,1041
3211924838,3204477678,1649413366,1649413654,288,2276
3964862062,3408471644,1662699194,1662700053,859,2212
3974934699,3477998776,1658931118,1658931127,9,590
3277577865,3431164351,1647856454,1647856537,83,3124
3467628695,3075075444,1661019315,1661019767,452,2500
3644406090,3698919193,1666228008,1666228620,612,349
3257588927,3857647617,1643086236,1643086374,138,3445
3255642659,3226231536,1662906792,1662907552,760,2644
3615865580,3222463865,1647271803,1647272010,207,1512
3283968318,3490784760,1665212625,1665212944,319,1979
3521102156,3998895101,1647578218,1647579165,947,4755
3639263553,3105391742,1649632380,1649633097,717,2018
3545164062,3555482344,1647792212,1647793066,854,974
3035977536,3797673153,1661333654,1661334548,894,3477
3326580630,3935050862,1658798992,1658799390,398,4636
3265151799,3163155088,1666612016,1666612935,919,3187
3925038955,3329359434,1642708979,1642709132,153,916
3034603377,3229145212,1652575352,1652575862,510,1791
3259214045,3231899666,1656504450,1656504647,197,4813
3841181690,3463114945,1645404697,1645404791,94,4251
3442558411,3572721350,1662375299,1662376066,767,2318
3456130441,3527412988,1668949760,1668950104,344,3014
3632716737,3688447019,1641989882,1641990807,925,4595
3252740524,3558336067,1649404223,1649405128,905,121
3485751234,3752496398,1651002404,1651002859,455,2333
3313907477,3925395619,1658694237,1658694834,597,1113
3677218328,3167441365,1644925487,1644925545,58,4393
3689296332,3495965960,1657742592,1657743436,844,4877
3082718950,3729025106,1643360599,1643360967,368,2613
3041479789,3402563013,1655793466,1655794208,742,4933
3879581488,3561906699,1650770818,1650771336,518,93
3446475838,3081681657,1645566996,1645567232,236,1821
3821734188,3455837683,1647350264,1647350734,470,3252
3185743441,3855147487,1653353149,1653353592,443,4206
3067149929,3427385429,1655747365,1655747993,628,4672
3369870688,3338319226,1645041234,1645041782,548,3492
3696099964,3917113016,1659715539,1659715732,193,3240
3082478179,3592543803,1651749462,1651750126,664,1834
3613023155,3392642337,1658948701,1658949266,565,694
3170164728,3187374576,1660373486,1660374150,664,2387
3622914265,3113841720,1665267629,1665267702,73,1246
3054832740,3911804867,1656055939,1656056030,91,2776
3844748354,3835179782,1661698780,1661699417,637,1050
3561575823,3970999039,1656175699,1656176559,860,3911
3446679239,3822537971,1642290953,1642291400,447,3457
3463253534,3188338830,1660778119,1660778675,556,2706
3620851600,3428056547,1653693721,1653693919,198,2097
3613468573,3537995418,1662314032,1662314607,575,1866
3565381331,3940080673,1653248821,1653249330,509,1951
3184702264,3363604412,1646568320,1646568841,521,639
3200327848,3829995497,1665681898,1665682329,431,1574
3176178492,3710212944,1653018468,1653018504,36,4621
3217576943,3552242419,1651044673,1651045372,699,2074
3002921015,3602694809,1655641476,1655641577,101,3066
3925964140,3900915117,1665046386,1665047037,651,3811
3717399980,3472910519,1646506813,1646506822,9,1586
3088008070,3650499735,1664858073,1664858792,719,2297
3614890037,3127511149,1644238278,1644239139,861,1686
3355750084,3809340472,1661576866,1661576957,91,1147
3603379639,3857569252,1651775267,1651775737,470,1374
3684086032,3616799264,1650836461,1650837198,737,4774
3945979719,3608745506,1649509220,1649509477,257,1661
3450339536,3206869016,1643449604,1643450554,950,3970
3935953186,3297931054,1648862346,1648863236,890,1168
3363889958,3309486049,1653149947,1653150095,148,4518
3068177895,3659191092,1641153816,1641154150,334,950
3142637195,3561264193,1643676442,1643677090,648,734
3546604223,3830812437,1646473640,1646473812,172,3055
3535430718,3459105998,1644502574,1644502923,349,4336
3541390083,3561020930,1645850879,1645851208,329,3941
3783342776,3015253555,1661950896,1661951482,586,1830
3741089503,3997835039,1649913999,1649914894,895,1800
3080369889,3238686388,1648760712,1648761316,604,923
3658059015,3366042906,1648436842,1648437251,409,3141
3517729954,3316421862,1649668558,1649669351,793,2659
3530955127,3840491886,1653963414,1653964300,886,3437
3972035107,3245310549,1650978680,1650979035,355,4810
3845892329,3723463446,1657554085,1657554344,259,4524
3482579170,3841686085,1657135656,1657136610,954,4703
3598535607,3955935314,1641999772,1641999961,189,4624
3894996786,3770820417,1659002969,1659003829,860,2640
3264795702,3340633589,1669428292,1669428475,183,4634
3798610037,3413834719,1656299107,1656299549,442,3032
3330723224,3265492228,1646544926,1646545371,445,3932
3974736938,3926507776,1661257483,1661258421,938,3815
3907644180,3026019286,1658968540,1658969099,559,750
3049756034,3631131236,1669566337,1669566852,515,2453
3533499707,3749146897,1642697372,1642697677,305,2355
3687599635,3880263658,1651393572,1651394290,718,3657
3634846190,3823397607,1660564079,1660564471,392,1914
3360102106,3987506166,1641754633,1641755134,501,3462
3016761822,3136739082,1664724407,1664724552,145,2821
3794850029,3045189131,1645237641,1645238085,444,436
3634477170,3337582745,1665070553,1665071539,986,3189
3877980092,3771853165,1656617059,1656617212,153,2684
3763811213,3630392437,1667691621,1667692372,751,3406
3397510237,3350054357,1649654319,1649654321,2,2428
3742820233,3101768262,1667963333,1667964293,960,650
3453138179,3748096648,1661627628,1661627859,231,4230
3634940654,3015186827,1645906194,1645906887,693,4695
3165076896,3421885447,1668310214,1668311206,992,4972
3290364543,3651607873,1661475944,1661476356,412,4600
3371685317,3132732122,1669378116,1669378342,226,4257
3049637214,3527957989,1665208456,1665208706,250,3857
3413241176,3483602518,1656182617,1656182921,304,4202
3064562981,3960580531,1652018324,1652019143,819,867
3149950727,3812582309,1657306488,1657306771,283,1835
3522356359,3607651659,1667031335,1667031376,41,4783
3489078507,3506521217,1646082139,1646082467,328,1552
3933024012,3145481149,1659126251,1659126365,114,2176
3197760219,3837549791,1653736815,1653737552,737,698
3535557737,3117413346,1647105525,1647105564,39,207
3854047982,3898344861,1656151262,1656151539,277,2939
3714144278,3434678217,1668433662,1668434067,405,3404
3329329657,3947059259,1663235982,1663236239,257,413
3732881105,3794811880,1657455755,1657456560,805,4061
3966829660,3128101193,1658942622,1658943617,995,852
3118727307,3018015322,1649229971,1649230585,614,2578
3536191542,3806970959,1651103336,1651103715,379,2445
3776451407,3906703890,1642664040,1642664758,718,2811
3026991972,3328876746,1658253108,1658253955,847,2620
3046407651,3702397803,1664917027,1664917444,417,934
3642499443,3578887499,1661433845,1661434431,586,3160
3002983100,3509645231,1660258166,1660258187,21,1349
3653721550,3098150784,1660350194,1660351006,812,1754
3874112690,3972753920,1648567646,1648568174,528,4897
3700502207,3204477678,1659900357,1659900525,168,48
3136763617,3252079222,1662849537,1662849756,219,2386
3166658545,3791959756,1653286226,1653286361,135,1573
3810033598,3868573410,1663999115,1663999715,600,1162
3626825551,3769660801,1649639053,1649639258,205,2133
3283190030,3650378079,1643300586,1643301370,784,116
3184201047,3608663536,1662906634,1662907288,654,1831
3586239739,3397836854,1657047179,1657048150,971,1702
3949120542,3426945278,1657226403,1657227009,606,4937
3077575038,3926422243,1652491083,1652491988,905,2785
3491700552,3757074219,1659888075,1659888742,667,954
3266620723,3066707608,1660621374,1660622311,937,2746
3183619338,3819227817,1662254495,1662255229,734,2917
3274319663,3058503583,1664961820,1664961874,54,189
3551273951,3383536144,1651453836,1651453867,31,799
3413990898,3120750008,1663880897,1663880906,9,3976
3252527940,3112715200,1663081787,1663082291,504,1586
3852899714,3297253814,1648845195,1648845233,38,481
3388699972,3953200815,1654528161,1654528368,207,4145
3871039126,3322365853,1644508966,1644509086,120,2097
3473692260,3225425947,1648363334,1648363514,180,2537
3932212815,3995295861,1652969779,1652970533,754,1591
3798748993,3534688876,1657099165,1657099893,728,2498
3780414345,3056898901,1656850131,1656850164,33,4908
3085636020,3298442759,1660021420,1660022323,903,2727
3867433430,3453807346,1653841353,1653841680,327,266
3021098962,3000987605,1659378568,1659379489,921,109
3691957502,3741529969,1656466382,1656467016,634,2093
3663992784,3103477495,1649505711,1649506315,604,3851
3138012640,3792356291,1659534887,1659535229,342,4638
3111888330,3705669912,1648635913,1648636210,297,4131
3213490951,3290915964,1662106638,1662107159,521,3736
3315319642,3552411042,1660428174,1660429111,937,4188
3535616555,3858925187,1662849348,1662850075,727,595
3090948212,3007176392,1650022404,1650022615,211,118
3941885227,3143573890,1663555401,1663555893,492,950
3583197502,3735036131,1667830314,1667830773,459,323
3641639442,3662267604,1641304135,1641304536,401,2110
3287386112,3262907833,1643837361,1643838217,856,2319
3749172299,3809309875,1642510027,1642510875,848,2211
3967447786,3279929521,1656578838,1656578977,139,3083
3044112871,3297366785,1664952892,1664953128,236,3173
3616787095,3000300838,1653592061,1653592972,911,554
3465351956,3752478330,1668369854,1668369973,119,848
3619210945,3480381795,1662639807,1662640590,783,342
3981770478,3720780503,1663930972,1663931657,685,888
3666980789,3189863122,1653700844,1653701713,869,3064
3735183692,3802218414,1659536160,1659536362,202,1533
3020475836,3817569054,1644767824,1644767983,159,165
3525099244,3849751952,1669287873,1669288339,466,4886
3656605804,3938669754,1666660866,1666661262,396,1618
3022653771,3272497119,1667149487,1667150395,908,1336
3428482642,3218256646,1649895514,1649896049,535,2257
3765955791,3231628342,1644299004,1644299203,199,3223
3711123383,3002339022,1644835536,1644836109,573,3187
3980432722,3836409318,1664088705,1664088754,49,4182
3351501492,3280183771,1647290864,1647291304,440,941
3005127713,3727749190,1655888641,1655889624,983,1338
3860037182,3514844818,1665979098,1665979206,108,781
3942464718,3378900759,1651440756,1651441574,818,323
3282733794,3118453050,1662577885,1662578457,572,2156
3682435846,3051181037,1648946338,1648946650,312,4587
3661143913,3880939173,1653077355,1653077962,607,4658
3827538342,3314637157,1642544422,1642545024,602,4015
3723580596,3172375931,1668835254,1668835498,244,1018
3460542261,3013582418,1645888674,1645889070,396,4306
3725593198,3094914088,1655444256,1655445026,770,3486
3231652511,3080923726,1658894614,1658894626,12,4035
3597482436,3049204519,1649893972,1649894727,755,3511
3124910327,3223371074,1646808470,1646808791,321,2166
3446197446,3145941278,1652319476,1652319537,61,4449
3146635707,3266615001,1645234952,1645235758,806,4825
3877215791,3874697289,1647456117,1647456479,362,3157
3919689381,3599656359,1649213408,1649213995,587,1364
3407740591,3093740359,1665448913,1665449886,973,4723
3418442245,3423418863,1641596315,1641596538,223,539
3992324553,3553868102,1641851576,1641852286,710,3307
3382824764,3862352922,1657226883,1657227144,261,232
3436378157,3814675917,1666966744,1666967328,584,2517
3560695594,3086189885,1653730114,1653730890,776,4248
3485206621,3000777584,1648408316,1648408983,667,99
3481737481,3152762161,1644146521,1644147325,804,3428
3977333689,3919576963,1664846965,1664847803,838,3855
3972490998,3327962942,1650361587,1650361910,323,3769
3445669770,3688640640,1656247254,1656247974,720,3437
3889661255,3940052010,1663672085,1663672378,293,653
3591962260,3326976710,1654031360,1654031960,600,904
3925947416,3328795890,1651348521,1651349174,653,3289
3590983518,3285454330,1657670155,1657670577,422,1393
3710570700,3775951771,1669336652,1669336894,242,2093
3650925241,3564524597,1647522196,1647523095,899,3578
3891201278,3293974842,1648638254,1648638927,673,4576
3008396666,3043150583,1648798632,1648799364,732,3522
3576005251,3940698316,1644688982,1644689319,337,1433
3714726773,3551907368,1646859935,1646860560,625,3644
3626661866,3535840824,1660796809,1660797372,563,3234
3125473460,3672130984,1647466576,1647467351,775,2522
3808470907,3827833120,1667871078,1667871624,546,671
3637958798,3770345694,1647526103,1647526596,493,4776
3885254359,3628262530,1655332841,1655333042,201,380
3051154738,3084541595,1666174882,1666175679,797,851
3959477290,3586488590,1646609803,1646610616,813,2664
3225259870,3551811858,1653124668,1653125113,445,2684
3396984452,3355597214,1643123789,1643123810,21,271
3821841293,3068811838,1657621338,1657621951,613,1124
3867820996,3276474232,1666119765,1666120014,249,4388
3973223095,3307034778,1649721518,1649721762,244,2638
3958370657,3303384693,1660665863,1660666405,542,4557
3255979226,3553590781,1641748294,1641748666,372,799
3457839118,3387995930,1661181745,1661182069,324,1448
3334414503,3848674374,1643068567,1643069472,905,1459
3725238516,3146904731,1666167283,1666167365,82,283
3720739886,3519839632,1660949436,1660950127,691,4729
3174028646,3127857507,1641520064,1641521044,980,4248
3671183234,3713670141,1646637467,1646638432,965,2814
3948252258,3632044026,1643672141,1643672616,475,1777
3643050789,3315457540,1648258026,1648258427,401,3750
3985598274,3926422243,1642800035,1642800584,549,2155
3496093462,3238177489,1644127540,1644128131,591,2192
3962544531,3777046746,1648738573,1648739535,962,4862
3838188401,3418081405,1656279900,1656280004,104,4993
3067066401,3899356160,1656764239,1656765192,953,2499
3682878682,3681139527,1649636110,1649637048,938,2272
3529323880,3072421902,1666863380,1666864077,697,2993
3233796576,3023152185,1652923488,1652923536,48,3736
3993870878,3954540686,1668098345,1668098949,604,541
3416327702,3391409969,1667642881,1667643725,844,2789
3455426036,3089287706,1646569871,1646570801,930,4546
3878085326,3435977910,1655799478,1655800093,615,2010
3426338159,3789035075,1659247286,1659247550,264,3566
3439180584,3024890829,1645138071,1645138647,576,2107
3417783612,3215885777,1662140853,1662140887,34,4899
3247297181,3824388874,1653161632,1653162050,418,3095
3694292540,3942434125,1647876964,1647877762,798,2828
3981598340,3103277344,1666288849,1666289027,178,4002
3094701660,3977573328,1653051529,1653051751,222,1387
3307431232,3877818117,1649418036,1649418651,615,2322
3663576982,3215882297,1657991064,1657991605,541,4204
3363584619,3133044639,1643892626,1643893602,976,3897
3524213773,3378600006,1660599090,1660599864,774,4819
3101944160,3015143331,1666329019,1666329832,813,4220
3353155274,3655091873,1653063433,1653064188,755,213
3174505209,3218985473,1648328286,1648329137,851,3426
3184624522,3220006893,1662425485,1662425826,341,41
3596653543,3694949646,1654777107,1654777571,464,1348
3484388817,3400900622,1654026362,1654026841,479,2377
3291303913,3403811428,1655356475,1655356925,450,3263
3461828539,3338830335,1641533858,1641534079,221,1170
3612757052,3926156293,1657758948,1657759803,855,1452
3325861270,3078593169,1644532534,1644532587,53,2194
3251040613,3041471502,1648043992,1648043993,1,4392
3776159622,3133603332,1657558494,1657558555,61,2263
3624680090,3151580081,1658377976,1658378605,629,3030
3709112456,3440187163,1648412525,1648412556,31,2825
3172910011,3478399772,1647487594,1647488239,645,971
3930782625,3397509650,1666115640,1666115670,30,760
3657701107,3737369178,1644989357,1644990069,712,2238
3907669516,3477367664,1667474941,1667474957,16,2533
3864338639,3844114113,1647340347,1647340725,378,1096
3106183790,3945461392,1646672042,1646672606,564,1829
3557989218,3479032856,1658075543,1658076424,881,2310
3982425939,3056980094,1668667288,1668668031,743,2276
3279454994,3761246422,1669525967,1669526871,904,1234
3874029637,3328713134,1647930038,1647930209,171,4381
3866587459,3323808299,1651946076,1651946757,681,3805
3002665903,3607821319,1656283982,1656284593,611,1638
3725777687,3259452222,1657950049,1657950561,512,2139
3081811367,3297645400,1662371207,1662372008,801,1508
3045180104,3556406313,1657882962,1657883653,691,4718
3736513867,3536598185,1667813713,1667814496,783,1329
3899265189,3768200079,1648275254,1648275870,616,3134
3682237973,3050046778,1657111617,1657112102,485,2492
3791463996,3523775039,1650005923,1650006674,751,3529
3562622374,3190019122,1656042271,1656042960,689,395
3542523788,3098996104,1669303477,1669304000,523,2631
3024106091,3022510352,1651672589,1651673217,628,2681
3819501429,3100153605,1659419846,1659420640,794,1997
3790163815,3967989504,1666310341,1666310472,131,4735
3783816213,3109683938,1650800217,1650800660,443,4093
3330177013,3356365962,1669436879,1669437598,719,3003
3471793941,3506797880,1658077478,1658077705,227,2777
3008093072,3131927436,1664785578,1664786493,915,3144
3543971995,3467248730,1668552955,1668553644,689,2991
3295323467,3161381718,1667808639,1667808670,31,1505
3619156775,3701851995,1662550058,1662551037,979,4966
3127066696,3662280997,1656155336,1656155716,380,2056
3804759686,3171516489,1644936540,1644937445,905,2813
3226812558,3285015797,1659113710,1659113837,127,4364
3107884854,3076549827,1651622465,1651623189,724,2620
3370613928,3520095153,1652118402,1652119122,720,1863
3895755329,3720435849,1642890303,1642891273,970,89
3606419290,3966795405,1658752479,1658753369,890,1154
3982127482,3287889003,1655583486,1655584251,765,2780
3566050668,3599938740,1664064406,1664064592,186,3722
3664897532,3951778331,1649105087,1649106027,940,3091
3671064670,3232090721,1641243060,1641243072,12,3774
3994417612,3070592019,1646942336,1646943236,900,654
3215713805,3127853856,1658444086,1658445005,919,933
3538553275,3357427091,1645461330,1645461938,608,3298
3619786433,3325242361,1665464605,1665465498,893,1351
3740897893,3515833727,1665168341,1665169131,790,1778
3551718421,3458518544,1650291848,1650292403,555,4757
3282481843,3551523925,1667144761,1667145185,424,1415
3655301421,3204616845,1660511764,1660512672,908,1132
3058249430,3926953163,1651109126,1651109531,405,441
3515049879,3893645170,1643443341,1643443887,546,437
3262875263,3650412990,1645192546,1645193245,699,3500
3536566015,3000632565,1664657528,1664658228,700,4176
3797718990,3128332247,1660351289,1660352030,741,1266
3112732686,3299697081,1666905971,1666906790,819,1561
3070646986,3460986006,1641520078,1641520696,618,1045
3274971479,3703799067,1663176388,1663176536,148,3985
3861343983,3354457595,1653912629,1653912673,44,108
3775427465,3581501029,1653135104,1653135348,244,3354
3835804957,3865146021,1654809400,1654809425,25,4410
3905260211,3358389552,1644666078,1644667037,959,4593
3130185988,3213834314,1641673152,1641673921,769,1701
3666565356,3734644194,1652369811,1652370245,434,4367
3174143571,3913607838,1669393427,1669393457,30,4222
3979428233,3459247420,1661924640,1661925582,942,40
3044164743,3722119684,1661227324,1661228253,929,4292
3742915490,3293844751,1653557120,1653557983,863,2120
3651527248,3419551703,1650162680,1650163157,477,3380
3593955652,3217894263,1650897802,1650898103,301,2613
3700042495,3157602232,1656807246,1656807355,109,4904
3354432570,3593048207,1669094183,1669095071,888,19
3035051052,3796843137,1643589996,1643590472,476,2719
3445538764,3987117333,1643213709,1643214102,393,873
3321354339,3054165640,1666163428,1666164404,976,2952
3832302061,3894598607,1665647892,1665648295,403,3161
3229416521,3088203172,1651053385,1651054020,635,2192
3188577000,3748062692,1658718889,1658719803,914,4435
3030643545,3196713477,1659617426,1659617648,222,1403
3801261961,3502091403,1647436360,1647436749,389,3659
3196422633,3358441222,1651445166,1651446144,978,4581
3315778566,3152962342,1657996897,1657997440,543,4741
3302240195,3830970131,1650492093,1650492557,464,3662
3933557465,3139630055,1650288894,1650289800,906,4809
3981789706,3895058436,1643037316,1643038047,731,3522
3548072886,3046808005,1667123705,1667123918,213,416
3108201556,3932171883,1655865441,1655865856,415,366
3264795702,3094015426,1658022600,1658023367,767,1383
3792905169,3465660779,1662312594,1662313269,675,1172
3756892601,3673757678,1644437038,1644437793,755,1858
3247298411,3559443829,1662503940,1662504619,679,3732
3053295096,3158315966,1662571447,1662571530,83,2581
3894594915,3769194711,1665175139,1665175634,495,1258
3605588889,3937798710,1651168826,1651169734,908,3242
3180994924,3884346728,1669523107,1669523418,311,1559
3086894990,3132313453,1651572480,1651572833,353,959
3337412780,3570232006,1667086884,1667087851,967,2022
3540074508,3063260290,1669436748,1669436797,49,4858
3811768458,3773211747,1655887394,1655888051,657,3588
3901365554,3920943187,1655689337,1655690229,892,4745
3895533573,3583895221,1651803440,1651804102,662,2462
3237002479,3207087109,1661769400,1661769412,12,4129
3629462196,3677564955,1654280515,1654281339,824,1439
3284129446,3017022543,1651804293,1651805023,730,3720
3886327713,3062807420,1654250309,1654251246,937,4688
3687588205,3217074763,1669357308,1669358094,786,2315
3972777485,3477178333,1654445274,1654445891,617,4588
3247940891,3659527696,1643225825,1643226311,486,4168
3972205448,3260662201,1667334351,1667334636,285,2573
3813243437,3671224661,1643544681,1643545401,720,577
3876485130,3603947282,1662820382,1662821024,642,3294
3540828390,3866505848,1662190710,1662190898,188,1778
3477092186,3616928367,1660052437,1660053234,797,3345
3784235217,3510735732,1660842459,1660842861,402,2788
3137041715,3787975698,1657463191,1657463937,746,3011
3252418150,3673426774,1657837853,1657837863,10,156
3868880234,3503362611,1655668877,1655669127,250,3829
3953444166,3193286388,1660716160,1660717112,952,3486
3246173620,3930660594,1664760852,1664761274,422,2119
3774454294,3696274407,1648145738,1648146502,764,2748
3277706327,3276967834,1654391630,1654391975,345,2208
3949230297,3816936816,1660886883,1660887201,318,3299
3921530188,3278129796,1665682883,1665683576,693,1169
3445280338,3446513131,1662934593,1662935249,656,1449
3117606092,3992324553,1656889848,1656890424,576,2261
3670594396,3083445485,1663999688,1664000013,325,1498
3579362251,3846670008,1668539771,1668540152,381,28
3747505622,3031185596,1646264702,1646265497,795,3556
3497360678,3502190073,1668459951,1668460136,185,1093
3952707314,3962849264,1651128492,1651128970,478,4101
3022097016,3181819266,1651899710,1651900205,495,2565
3995196091,3230753646,1669056790,1669057228,438,3386
3256961085,3825649068,1663269790,1663270232,442,1009
3830428465,3985976852,1641558554,1641559416,862,4147
3876088343,3739466446,1644767326,1644767535,209,4158
3293533440,3419938419,1646792637,1646793454,817,286
3077140841,3693406084,1668397762,1668397869,107,2892
3071572593,3506093967,1651612038,1651612707,669,1757
3351666034,3380579280,1664347813,1664347857,44,4262
3524160297,3281125274,1668278346,1668278496,150,1902
3927913455,3856670938,1654248904,1654249146,242,4889
3831646837,3863116847,1646316891,1646317024,133,4895
3601574938,3116655950,1650849407,1650849586,179,4373
3103014879,3086631800,1668461713,1668462081,368,2998
3102510690,3296549334,1649123080,1649123564,484,4482
3510516111,3220087284,1651457982,1651458546,564,1977
3843740269,3333900622,1648318608,1648319399,791,1962
3157265777,3848696650,1659338001,1659338019,18,4139
3660773811,3600198157,1642119376,1642119625,249,800
3090340714,3255232235,1667209595,1667210101,506,2661
3683231041,3349151454,1653467788,1653468356,568,873
3917994924,3041938015,1651200166,1651200482,316,3210
3501154881,3249377255,1656913419,1656913841,422,2132
3920794900,3004062146,1643331543,1643331955,412,4917
3756190828,3282465122,1644792130,1644793115,985,1152
3853251093,3964094391,1646827197,1646827931,734,4930
3003228752,3407106603,1656857767,1656858446,679,4103
3360942361,3860147179,1660289403,1660290092,689,3754
3800238008,3831270311,1654943926,1654944401,475,2821
3504087035,3421922592,1649687076,1649687783,707,925
3528327869,3739049861,1645550022,1645550307,285,1267
3509776498,3854113094,1645089768,1645090576,808,1509
3592129771,3499104089,1668890860,1668891810,950,2385
3570748923,3145083953,1662160856,1662160963,107,282
3788121812,3965580965,1652176427,1652177412,985,217
3398208409,3823141960,1648262774,1648263478,704,4541
3714930088,3649138589,1659507164,1659507928,764,2626
3148204916,3464209866,1669449724,1669450305,581,3713
3798984201,3688712956,1655504650,1655504923,273,3508
3757623530,3110048758,1642787851,1642788564,713,4113
3102805061,3882743616,1668184286,1668184893,607,1929
3800221930,3774272265,1658620072,1658620123,51,1935
3713129893,3774642945,1651945305,1651945534,229,1382
3653867679,3947443343,1664537059,1664537506,447,1475
3348162701,3387475625,1663417155,1663417362,207,2064
3322235920,3823679136,1655551022,1655551375,353,371
3332597374,3306751197,1650628601,1650628874,273,182
3780387189,3344482513,1665234776,1665235434,658,924
3619504898,3123847161,1667861240,1667862072,832,2798
3811850446,3047862436,1662493462,1662494428,966,3347
3859663482,3399681415,1669099619,1669100188,569,4151
3212873835,3718552739,1661601336,1661601496,160,3219
3654855695,3270447729,1642027046,1642027819,773,4072
3993870878,3235497444,1666226577,1666227265,688,3542
3886341692,3005018279,1659281527,1659281719,192,4129
3048561735,3048619894,1655113302,1655113761,459,4188
3801914384,3444607292,1651342359,1651343312,953,4675
3687109785,3388887968,1651400135,1651400466,331,3538
3280071657,3898666596,1652253762,1652254691,929,3391
3630510243,3793342839,1668108048,1668109031,983,3974
3152239049,3215067054,1667480244,1667480594,350,4322
3005500245,3114979883,1663085189,1663086183,994,1727
3570931476,3886462343,1651270642,1651271504,862,3385
3185822046,3730333181,1649309164,1649309981,817,141
3942136242,3490953897,1653084993,1653085873,880,2469
3961645511,3572881460,1668563288,1668564069,781,4827
3011916399,3386193656,1658844746,1658845398,652,932
3926695152,3355371655,1645317322,1645317412,90,2106
3901955240,3975298922,1662729389,1662729921,532,454
3348829287,3628808158,1645650664,1645651553,889,4895
3356787591,3278851208,1662221903,1662222788,885,3054
3304135650,3212703613,1667103784,1667104087,303,2751
3671606332,3928196429,1649563815,1649564244,429,1164
3422808605,3341030469,1655137786,1655137892,106,1819
3929049982,3866930785,1647114372,1647115074,702,1956
3923170849,3063260290,1656258509,1656258577,68,3811
3629019073,3332331224,1668171281,1668172078,797,2332
3857903424,3431074910,1662527503,1662528492,989,4987
3609599088,3289050073,1666017122,1666017578,456,3797
3751538416,3048235712,1646195754,1646196333,579,811
3081740321,3771958460,1654297144,1654297963,819,664
3850639270,3929476314,1645830175,1645830584,409,24
3023806706,3346389906,1665458235,1665458832,597,1136
3789537648,3700109310,1662828142,1662828714,572,4018
3023340923,3890829269,1663281113,1663281305,192,1940
3824287014,3073849235,1652082542,1652083208,666,2039
3180094242,3685079051,1648210344,1648210694,350,2100
3522458445,3182910480,1644869000,1644869949,949,2885
3783403809,3702289708,1644953219,1644953661,442,1175
3852378953,3505838762,1660682749,1660683733,984,3042
3212537920,3290282184,1647861162,1647861207,45,791
3917174142,3563407285,1650340585,1650341027,442,1680
3160926693,3034638474,1661511454,1661512250,796,2067
3177375885,3201536668,1669507761,1669508111,350,2570
3567149977,3474668280,1651869078,1651869192,114,4258
3125264873,3254891327,1662936382,1662936549,167,583
3264053571,3297605826,1661469384,1661469865,481,1496
3568863592,3335910845,1660736949,1660737629,680,1014
3485219572,3758375927,1647428345,1647428899,554,4328
3782817054,3106668897,1652175998,1652176113,115,1319
3500734881,3534471571,1654710506,1654711451,945,219
3276030925,3280071856,1642098891,1642099056,165,2779
3514916026,3123737130,1651035485,1651035927,442,2820
3244242965,3302704432,1650226813,1650227268,455,1014
3696791408,3895765892,1666986005,1666986695,690,4417
3916999249,3708524645,1669377064,1669377754,690,4332
3919923285,3365978893,1660736680,1660737575,895,2472
3624252308,3103733390,1646633244,1646633610,366,2202
3061596583,3942745955,1658751599,1658752263,664,4854
3079325672,3401159219,1646055593,1646056050,457,2721
3543270697,3142894685,1648155627,1648155842,215,4882
3219453676,3839475972,1654967246,1654967266,20,832
3960199140,3404126363,1653109616,1653110237,621,4550
3150494365,3629295586,1661378635,1661379507,872,2639
3449423330,3340109597,1651330594,1651331111,517,2173
3028499189,3376526121,1655419973,1655420664,691,3864
3199369701,3369980509,1668032999,1668033011,12,2076
3170157229,3798242250,1649500568,1649501280,712,4217
3011590813,3529389687,1655701577,1655702039,462,3593
3924716423,3835669294,1652469983,1652470426,443,3409
3500528712,3050727687,1659521789,1659522663,874,437
3136410259,3650555449,1649062088,1649063034,946,4442
3034145229,3742479968,1657050653,1657051185,532,215
3732518163,3610509582,1645892169,1645892206,37,1923
3978571895,3180135087,1656988814,1656989112,298,4244
3382673218,3868868288,1649097161,1649097488,327,3750
3599980068,3707733364,1651967933,1651968886,953,3184
3924621942,3214783139,1642741888,1642742323,435,2259
3719040657,3751322103,1667451083,1667451887,804,1422
3671542998,3493546506,1661838798,1661839538,740,700
3810192382,3512734877,1664843479,1664843817,338,4553
3966959266,3791513253,1662004442,1662004839,397,1490
3685705420,3929147116,1658546694,1658547356,662,1444
3593450663,3778113952,1656060339,1656060839,500,1644
3940092752,3045283565,1660314669,1660315037,368,2430
3497418051,3251212659,1655256536,1655257415,879,357
3024520701,3900249703,1657250173,1657251103,930,4997
3863135438,3755946440,1652684596,1652685374,778,2345
3396197103,3204581510,1648426733,1648426769,36,4620
3405618913,3851433314,1654969871,1654970583,712,3646
3415414519,3378817808,1659749590,1659749851,261,2035
3424768525,3367945499,1649661917,1649662853,936,738
3158671624,3782817054,1647605926,1647606503,577,4822
3384301693,3394831592,1649751512,1649751561,49,4558
3241369763,3955452635,1666496845,1666497347,502,2905
3657296224,3570145301,1650938964,1650939324,360,4747
3295918120,3742599098,1665563140,1665563229,89,3952
3211057005,3534091143,1651387369,1651388359,990,3978
3566780826,3491847204,1650273246,1650273831,585,4715
3672104680,3110466168,1642267703,1642267762,59,4351
3079523741,3314311163,1658016474,1658016640,166,909
3197104513,3295396319,1649206291,1649206857,566,2597
3468107907,3900714072,1665243732,1665244067,335,4608
3448530410,3052341005,1643333587,1643334471,884,4836
3958858181,3086553919,1657753683,1657754502,819,2018
3731206854,3602123893,1660816355,1660816906,551,629
3907060869,3016980170,1663222033,1663222413,380,1945
3726343062,3928400494,1641998181,1641998677,496,1572
3929419754,3258270972,1667898103,1667898352,249,2318
3322593811,3315544559,1653765498,1653766037,539,3857
3740878944,3620082962,1653715529,1653716230,701,1404
3874874412,3849315875,1667559479,1667560070,591,1465
3819191058,3508558679,1642395029,1642395088,59,1090
3798694181,3638869708,1654473412,1654473437,25,3988
3002511127,3315319642,1664212794,1664212960,166,4716
3256385650,3964754990,1653807739,1653808074,335,3679
3912423710,3936642736,1668927569,1668927962,393,2442
3011820150,3076226730,1653417847,1653417923,76,982
3949174101,3566133307,1649440821,1649441235,414,4694
3330181753,3604344640,1654090171,1654090655,484,4635
3211588368,3262085569,1657798902,1657798966,64,796
3784158515,3652629334,1650920791,1650920898,107,4953
3237730103,3176437658,1643998752,1643999616,864,2981
3906678252,3924548945,1649609685,1649610072,387,3931
3126104468,3490303473,1655263104,1655263237,133,4717
3630171403,3452796738,1665379356,1665379449,93,1815
3625530640,3225587296,1644584124,1644584530,406,4255
3407588650,3611061145,1645522449,1645523229,780,280
3103325231,3517146221,1647127795,1647128007,212,3467
3075096231,3222788871,1658486199,1658486898,699,68
3681540111,3590591396,1660465323,1660465956,633,3308
3968592671,3054902934,1643327252,1643327435,183,1096
3289461516,3268839426,1656910767,1656911535,768,4353
3093017638,3326196887,1656838060,1656838286,226,3562
3717178889,3470368884,1664834880,1664835819,939,4458
3625521774,3881185461,1646074850,1646075486,636,4398
3923620547,3532420475,1657644591,1657645487,896,4975
3388125010,3357427091,1656627909,1656628568,659,4450
3240186143,3662194945,1649412693,1649413201,508,1750
3508815456,3901291870,1650020855,1650021338,483,2460
3255516283,3265681622,1657540446,1657541378,932,1402
3018015322,3570071219,1657767459,1657768093,634,3359
3387928993,3579481317,1649197561,1649198467,906,4412
3431109721,3113918445,1650327463,1650327481,18,4593
3899970690,3885196648,1666683320,1666683947,627,1647
3774361797,3020378908,1652879151,1652879744,593,2682
3668346722,3386516134,1660485716,1660485822,106,2485
3444591982,3381480306,1653718913,1653719068,155,565
3256745557,3016388045,1649833641,1649834001,360,3652
3839517121,3539706965,1641582369,1641582998,629,4620
3899423474,3286875767,1668776231,1668776684,453,19
3041225314,3492029198,1655578031,1655578392,361,120
3023799058,3991761809,1641553056,1641553864,808,3148
3398350656,3923343822,1651140232,1651140691,459,3839
3656246900,3327962942,1668088983,1668089571,588,3010
3323712160,3727841807,1654948710,1654948736,26,3136
3495046692,3252670992,1655559227,1655559905,678,3527
3265727268,3773142091,1668827017,1668827781,764,4741
3303948913,3221587316,1652956597,1652957331,734,571
3557425592,3864380649,1652745138,1652745328,190,3288
3799805405,3113194639,1648946786,1648947032,246,3696
3857944117,3182857925,1649407096,1649407494,398,1619
3882773663,3928466062,1645735437,1645735677,240,337
3158801151,3993946061,1643056852,1643056861,9,3930
3366403546,3714183495,1647478218,1647478267,49,4798
3343380988,3897972817,1655295175,1655295642,467,1099
3891896810,3549090316,1649584422,1649585205,783,3183
3904706749,3697881708,1649701663,1649701783,120,4642
3309451455,3733213183,1663241765,1663241856,91,1642
3097348673,3353308721,1662430650,1662431332,682,2693
3876485130,3408556696,1652613203,1652614087,884,2909
3702774099,3916304063,1642175793,1642176423,630,4106
3775535997,3378049518,1657276806,1657276928,122,2009
3505070787,3654559291,1644289481,1644289667,186,2025
3889266008,3716885400,1645336577,1645336742,165,236
3217874606,3605512680,1646799166,1646799544,378,322
3606968171,3764836773,1663945106,1663946021,915,3174
3943724939,3823128771,1641065501,1641065547,46,1097
3204477678,3862891719,1668563609,1668563961,352,3441
3309996646,3126926742,1662294478,1662294707,229,4544
3731559955,3091339714,1649996387,1649996885,498,2782
3258281762,3186218398,1664254336,1664254626,290,1968
3896515196,3492331094,1645207091,1645207152,61,1915
3961111825,3844681427,1645218127,1645218258,131,3029
3283273805,3745235937,1650404961,1650405496,535,1140
3371547486,3422128299,1642317520,1642318461,941,4200
3657701874,3243784091,1652976861,1652977477,616,4314
3248192231,3660213388,1665684016,1665684957,941,2315
3043547704,3511449556,1666180000,1666180947,947,798
3689545780,3788805231,1669613729,1669614507,778,304
3105134605,3586881485,1652763258,1652763604,346,4388
3366556475,3923471509,1645910758,1645911194,436,632
3181678560,3760575972,1661850534,1661851435,901,1930
3301137418,3964730022,1663245566,1663246451,885,1933
3576994439,3983442151,1660469154,1660470140,986,2171
3806292620,3108315569,1645650503,1645651013,510,633
3396151782,3895268314,1659031623,1659032017,394,2259
3303712370,3755859764,1656178750,1656179328,578,4883
3999931942,3922117808,1668113035,1668113983,948,2070
3271079983,3636900603,1641431118,1641431886,768,2701
3236397906,3819716077,1646105844,1646106130,286,4307
3390654617,3038269258,1644974089,1644974780,691,3779
3605499752,3957551988,1663404654,1663404841,187,3933
3910016492,3537831923,1650084736,1650085553,817,2122
3932447661,3456861771,1648986802,1648987466,664,2088
3115029134,3212199137,1648369861,1648370332,471,2430
3281292759,3218937088,1645721976,1645722404,428,1389
3206772638,3756111523,1660459242,1660459841,599,3091
3892773491,3392702000,1647587618,1647587700,82,4246
3900338726,3240432333,1649069990,1649070636,646,2576
3966862833,3270060950,1649641778,1649642213,435,2949
3367634581,3656546194,1644943600,1644943718,118,3463
3325114816,3785736751,1668544539,1668544585,46,2954
3264660782,3522652676,1660947312,1660947822,510,3575
3951747829,3867929248,1656552696,1656553024,328,177
3897738037,3553499489,1646604469,1646604771,302,4778
3547363784,3772923056,1661700030,1661700091,61,2927
3846749639,3113302059,1664742042,1664742814,772,3485
3807796968,3328683206,1644785828,1644786553,725,4912
3739140570,3283367191,1641892857,1641892941,84,3088
3920813221,3086160273,1648738122,1648738394,272,3450
3859590791,3756056140,1665473333,1665473774,441,748
3144427040,3543016647,1649690687,1649691303,616,4749
3269179448,3546110364,1661876657,1661877536,879,3437
3894544950,3349289425,1648755286,1648756089,803,4745
3059751436,3014333893,1642006056,1642006773,717,4649
3991561829,3633232643,1644580471,1644581423,952,4088
3160776513,3777790107,1658290420,1658291407,987,1841
3092543636,3781196131,1655062397,1655063085,688,2253
3363840894,3128661369,1665802395,1665802592,197,2775
3725047244,3907460190,1650897546,1650898360,814,326
3974778353,3823570847,1646091029,1646091341,312,1530
3241877102,3566565471,1659246524,1659246659,135,703
3523202698,3654219328,1664285575,1664286024,449,4781
3057004890,3835275726,1646583731,1646584133,402,302
3958046328,3401695999,1653659265,1653659517,252,992
3677597969,3734343483,1653635780,1653636025,245,2253
3974800301,3071560690,1654632310,1654632948,638,2335
3507118179,3335036378,1657277542,1657277821,279,3129
3144846457,3472584132,1665716498,1665716819,321,1331
3696348860,3811017752,1662858304,1662859043,739,4299
3323570041,3378409361,1664214697,1664214955,258,4233
3035401527,3898442961,1665718655,1665718714,59,1242
3927363786,3366897538,1665597925,1665598865,940,3074
3901300403,3858696762,1655402811,1655402876,65,3398
3587458772,3955624078,1659471987,1659472785,798,4510
3347372641,3550798768,1661477949,1661478947,998,3296
3929173099,3881728060,1656096350,1656097338,988,915
3830387031,3877329620,1668190701,1668191646,945,1922
3847670717,3348968729,1666392579,1666393405,826,4430
3755483750,3760262207,1655359496,1655360233,737,1607
3748272915,3807962677,1642658448,1642658514,66,3345
3413699836,3095506888,1642769657,1642769968,311,4409
3264852155,3884749694,1642273388,1642273647,259,469
3595691615,3674947498,1660516968,1660517444,476,488
3159552864,3908735696,1666668732,1666669402,670,1842
3477641364,3594185970,1653931802,1653932702,900,4319
3792410187,3551754439,1652500509,1652500836,327,2323
3869431556,3732318995,1661683773,1661684361,588,2356
3700099770,3377281897,1648829879,1648830199,320,4886
3669599176,3730751471,1668431688,1668431983,295,3962
3960520382,3463312452,1666011900,1666011905,5,1996
3261788316,3851496169,1646084404,1646085004,600,4143
3802448669,3841358811,1652550175,1652550221,46,2829
3052781217,3651060672,1659782768,1659783414,646,2970
3551985031,3665173881,1642213630,1642213656,26,575
3716736439,3335703722,1641497484,1641497944,460,697
3102609085,3689135289,1660043214,1660043751,537,1768
3167002941,3782855374,1661651511,1661651988,477,4740
3257116391,3371218609,1662454074,1662454724,650,3603
3206647295,3279853419,1651519545,1651520287,742,1193
3618651419,3212781886,1643017614,1643018265,651,2755
3290428693,3745442239,1644710402,1644711258,856,978
3003772735,3751970902,1648089639,1648090430,791,4856
3679859290,3952799212,1656451999,1656452268,269,2298
3113284442,3337378232,1643689218,1643690130,912,4362
3942738614,3314147390,1650385205,1650385508,303,0
3180945574,3363950718,1667236666,1667237556,890,22
3566246534,3062505595,1654710791,1654711632,841,1058
3136111899,3255352285,1641652022,1641652344,322,4979
3140917234,3491609352,1652508447,1652508692,245,586
3565644629,3512075866,1664217984,1664218120,136,4353
3790444892,3371407234,1664807568,1664808323,755,4560
3410557201,3451417029,1666785500,1666785986,486,1410
3121136603,3186255109,1647202168,1647202986,818,3182
3274139564,3568163982,1662227468,1662228075,607,4023
3604301676,3395540384,1662661428,1662661880,452,2806
3151953010,3629978781,1653058255,1653058393,138,660
3698243099,3218367112,1652361215,1652362000,785,4206
3130746135,3250435653,1666562614,1666563058,444,3179
3689174551,3518869767,1666668750,1666669366,616,3975
3092041020,3264200868,1664117894,1664118838,944,405
3484547892,3100326996,1667529977,1667530727,750,4608
3170337860,3679937993,1660629226,1660629330,104,2339
3539108464,3606704725,1661699862,1661700001,139,796
3038993104,3679212300,1667996116,1667996268,152,621
3856989985,3964753218,1654479280,1654479432,152,1935
3568320981,3235542528,1641816106,1641816307,201,2269
3335508925,3972377288,1662925548,1662926477,929,366
3881236404,3094590444,1644974642,1644975534,892,4113
3698224737,3082718950,1659415304,1659416110,806,2681
3262600921,3435826176,1662985082,1662985249,167,4768
3128478952,3463698702,1652356092,1652356445,353,4318
3417131373,3022258124,1650042031,1650042639,608,785
3878982520,3294855295,1662714611,1662715442,831,160
3702763025,3369124351,1646974001,1646974459,458,3998
3172213343,3796095717,1655196241,1655196853,612,3552
3872896870,3661456053,1655533134,1655533575,441,4139
3117371170,3534519770,1649025521,1649026294,773,4813
3703219708,3544831376,1659293687,1659293832,145,823
3738193672,3926953163,1669214882,1669215137,255,2404
3623716085,3245617910,1648605020,1648605755,735,359
3136806740,3544627924,1653305779,1653306040,261,2859
3498715093,3198801764,1644008665,1644009173,508,3133
3922760945,3803266114,1664636792,1664637315,523,1435
3245779002,3281479156,1647700779,1647701230,451,1001
3908091584,3876114785,1661430314,1661430881,567,3089
3105441175,3992512017,1651562654,1651563545,891,3958
3691001371,3161532225,1664408515,1664409199,684,2850
3853001983,3920561907,1666494524,1666494694,170,2422
3640857000,3961133062,1652500075,1652500550,475,2420
3205026260,3848119697,1650329453,1650329937,484,1769
3029747883,3029194267,1657475701,1657476425,724,3574
3666156605,3780005222,1656463588,1656464054,466,3093
3336571353,3170687947,1647684792,1647685265,473,4196
3899973771,3956697114,1652585518,1652586171,653,3132
3411211118,3701921723,1662826195,1662826257,62,3293
3905004365,3030805178,1657919219,1657920053,834,4655
3153305792,3629253050,1655479605,1655480300,695,3624
3069942484,3275254040,1659955976,1659956698,722,1910
3250030722,3772399969,1666361512,1666361958,446,1507
3902124914,3790971344,1641340547,1641340912,365,3567
3211387549,3356423168,1662660162,1662660384,222,4524
3080474664,3255158254,1668599076,1668599803,727,4419
3416450352,3214360309,1664271189,1664271562,373,1705
3826731963,3714782021,1646137297,1646137930,633,1971
3704242970,3546910237,1666476555,1666477540,985,1501
3169703898,3110596758,1655689085,1655689826,741,4126
3463264968,3571092589,1650023798,1650024189,391,2735
3343380988,3893029579,1665460719,1665461576,857,1386
3346835380,3352815407,1649748702,1649749414,712,1500
3916916989,3090383244,1663099516,1663100015,499,484
3434166876,3521999622,1651056996,1651057133,137,924
3873004804,3431747879,1652490666,1652491093,427,296
3007481878,3780865787,1645089851,1645089924,73,1433
3185647518,3434852926,1643354738,1643355334,596,4903
3098081794,3423301842,1668015621,1668016557,936,840
3909548432,3601865261,1653943909,1653944067,158,4310
3361263103,3673904999,1642613576,1642614304,728,4862
3139569293,3047846341,1664850959,1664851340,381,3416
3837232608,3778560253,1643608878,1643608971,93,4398
3185108722,3230013516,1668656115,1668656622,507,1170
3927368496,3223098506,1669040099,1669040630,531,4888
3302780847,3682976395,1661454438,1661455088,650,1045
3925294188,3431796434,1648091829,1648092202,373,3978
3572872138,3060673853,1661040460,1661040594,134,4400
3242768930,3018077741,1661339854,1661340776,922,3525
3975074726,3005293414,1644906101,1644906503,402,1873
3501812131,3105308250,1661461691,1661461725,34,18
3029433226,3731465660,1658437145,1658437452,307,3780
3022642438,3759698759,1649172172,1649173008,836,2232
3869050766,3073100079,1646045362,1646045444,82,3229
3050397980,3093073368,1656610088,1656610302,214,4350
3249803144,3096382279,1652573468,1652574231,763,2441
3467785568,3784174326,1649379498,1649380200,702,870
3893951950,3277909792,1648371446,1648371579,133,2284
3022635840,3575194349,1650491758,1650492125,367,4280
3516026835,3346223902,1663780068,1663780702,634,4077
3795318510,3075256742,1644613492,1644614150,658,2217
3682462570,3915408897,1664750961,1664751387,426,3199
3550731743,3436291796,1641295286,1641295734,448,404
3575160443,3387004753,1647531579,1647532064,485,4644
3704200719,3235696499,1665958519,1665959358,839,4207
3573022997,3408381591,1651472054,1651472790,736,1524
3146857543,3282875379,1652707370,1652707909,539,1099
3792095617,3085057775,1643620479,1643620889,410,3172
3522302709,3825992792,1651482989,1651483862,873,4853
3249285950,3276575967,1662228273,1662228995,722,4036
3944930219,3254608338,1668814446,1668814615,169,2384
3197421878,3868619454,1667018038,1667018199,161,983
3823206434,3913855716,1665149483,1665150393,910,4291
3993967284,3041454333,1652419720,1652420467,747,4128
3637365769,3236957113,1656850040,1656850253,213,4613
3309812377,3452400248,1667135978,1667136724,746,1423
3555564544,3952442685,1644093374,1644093435,61,4918
3471290768,3834318974,1655184572,1655184821,249,3743
3022925198,3412547707,1642123382,1642124286,904,3069
3304300005,3705706387,1657605571,1657606065,494,4160
3272308454,3686911728,1649857309,1649858177,868,1866
3598015262,3633768630,1647648434,1647649202,768,2911
3943080912,3493618468,1664139318,1664140088,770,2050
3870667653,3797529243,1666885093,1666885316,223,3881
3607985195,3967609570,1661083495,1661084202,707,2297
3117572938,3398167128,1642874488,1642875486,998,2156
3486093263,3029504666,1656495693,1656496172,479,3381
3607115080,3811387687,1657655997,1657656194,197,2756
3322275438,3139426042,1647489191,1647489665,474,348
3670723579,3117146640,1647714759,1647715604,845,631
3867426408,3626994050,1667917048,1667917765,717,2441
3898517782,3600253556,1653380104,1653380662,558,4278
3595680524,3924933898,1646722655,1646723323,668,3810
3774078109,3211924838,1662087524,1662088262,738,3442
3410714472,3493091570,1658753572,1658754200,628,1172
3164633886,3760353718,1641409657,1641410033,376,1447
3440841044,3980141361,1652483859,1652484320,461,3938
3338418647,3434562365,1668583355,1668583685,330,49
3750260653,3045140214,1660563587,1660563864,277,3568
3788145763,3184657906,1645710971,1645711058,87,354
3033726715,3424326868,1645895113,1645895854,741,4025
3092887356,3023258168,1661495475,1661496268,793,3336
3219983909,3652542985,1664917810,1664918187,377,899
3682349571,3654093421,1654255419,1654255855,436,1369
3646280234,3696722393,1654941530,1654942523,993,3903
3815344984,3809488593,1651676692,1651677359,667,3474
3783650154,3122112936,1655948128,1655948607,479,75
3109916295,3625460614,1653671943,1653671975,32,3975
3937798710,3930997158,1650379554,1650380096,542,2744
3286718970,3219683379,1641642341,1641642644,303,217
3023164113,3717374461,1666064735,1666065583,848,3197
3264010013,3812615881,1667005010,1667005897,887,1813
3652422790,3709844745,1665095544,1665095611,67,636
3836747886,3042788818,1645621178,1645621631,453,3743
3884073960,3445351463,1648488595,1648489358,763,3956
3454462240,3918147723,1643007009,1643007858,849,565
3891575136,3061640397,1654175330,1654176136,806,4413
3846118450,3924579667,1654062795,1654063594,799,672
3487407006,3825840468,1651006979,1651007749,770,2694
3631578326,3650514979,1649648589,1649648966,377,3431
3476536144,3567974973,1646722986,1646723184,198,3517
3211807761,3864630788,1665236250,1665236941,691,1369
3684126275,3341455922,1658326429,1658327153,724,487
3768893677,3435180082,1641100222,1641100942,720,4895
3511784389,3817414693,1665914258,1665914617,359,1531
3628875578,3866093710,1655152471,1655153035,564,734
3260238593,3501096055,1654310205,1654310437,232,3239
3707525679,3839989873,1650031817,1650031888,71,3889
3318078986,3537177106,1662673026,1662673056,30,2422
3599788319,3785000900,1645066720,1645067546,826,4782
3357826552,3657701107,1653049720,1653049981,261,1239
3462547638,3358611900,1644309227,1644309674,447,1199
3441527119,3307750861,1654972840,1654973009,169,187
3829716332,3670636018,1654700389,1654701125,736,987
3316032372,3906225812,1645256111,1645256845,734,4924
3467937781,3930874089,1647493819,1647494490,671,4316
3417594126,3013271599,1645776631,1645777562,931,3462
3880254025,3009162261,1654357594,1654358001,407,1951
3989522312,3022372589,1646378610,1646378689,79,3043
3813893703,3056072725,1643918200,1643918856,656,4461
3140166512,3060894080,1660995200,1660995717,517,3812
3238737351,3352531236,1656072171,1656072270,99,2027
3099340639,3629022069,1648835378,1648836229,851,2825
3587696223,3432798650,1644296446,1644297153,707,898
3845090243,3796685054,1642821342,1642821747,405,3507
3181058137,3144689285,1644231667,1644232009,342,4989
3325255768,3372864032,1656434629,1656435007,378,3204
3091608897,3816047167,1658902825,1658903043,218,4294
3721919025,3803410602,1654888082,1654888705,623,380
3377437275,3433767779,1666724754,1666724799,45,2463
3984897672,3276608612,1652619055,1652619504,449,1449
3896467054,3530536371,1653218522,1653218986,464,523
3725940599,3010364260,1654562446,1654562793,347,3440
3639743413,3277870455,1655258637,1655259443,806,2389
3102851139,3299525116,1655600657,1655601628,971,3744
3882361205,3970307170,1646134280,1646135225,945,883
3481190729,3088463507,1648562726,1648563028,302,3714
3245767678,3185909266,1655040000,1655040286,286,4951
3299874686,3151153168,1643465271,1643466049,778,3148
3654175434,3089169972,1655845005,1655845839,834,2189
3898760289,3526254452,1647885473,1647886004,531,2800
3128856128,3680227361,1663395888,1663396824,936,4586
3466436519,3205081589,1669388235,1669388264,29,1560
3131344735,3901961286,1668382959,1668383166,207,2773
3703691386,3324598496,1643102524,1643102858,334,642
3876595866,3109959938,1649049530,1649049896,366,205
3514017128,3929186507,1659471643,1659472278,635,4200
3508387431,3643225904,1641048334,1641048855,521,4272
3350309041,3679831748,1649104663,1649105551,888,251
3553502538,3979531737,1667901469,1667902252,783,386
3295531245,3369477332,1655169542,1655170542,1000,4149
3187464386,3868211949,1646647061,1646647758,697,1738
3178036033,3726807374,1642305095,1642305310,215,142
3978911813,3079053296,1660644401,1660645076,675,3219
3253243066,3816915806,1651311414,1651311486,72,1885
3271642893,3835928816,1646687628,1646688625,997,3165
3263617498,3363949700,1663845384,1663845939,555,1048
3042802950,3714916783,1645696757,1645697307,550,3293
3469763166,3832125153,1668549383,1668549735,352,3668
3505062751,3481564669,1664744223,1664745027,804,649
3488070612,3118262533,1652901862,1652902115,253,3887
3026363489,3847243643,1656073570,1656074170,600,4528
3821477213,3913922144,1658888986,1658889556,570,4450
3770005384,3920323207,1659195023,1659195459,436,3789
3527879368,3950014351,1664237815,1664238109,294,4721
3070189817,3801878633,1656370890,1656371290,400,725
3157074861,3087366442,1647613093,1647613314,221,4417
3818396514,3482921040,1655529159,1655529963,804,12
3784445090,3205554100,1661222303,1661222331,28,3056
3465558808,3570415684,1663763395,1663763634,239,359
3970033443,3445869713,1644232031,1644232864,833,1756
3033641390,3708131511,1641247332,1641247932,600,2103
3934475675,3890916538,1667742023,1667742800,777,3099
3906691792,3477930959,1665667573,1665667721,148,184
3227391180,3892930184,1667011553,1667012249,696,2897
3950406942,3217381234,1666970641,1666971321,680,1265
3149242785,3891480506,1646949253,1646949593,340,2353
3737713865,3870084361,1665452311,1665452714,403,2822
3705366980,3459772846,1664256939,1664257706,767,2918
3880153642,3503577719,1651142394,1651143281,887,2786
3477320668,3409632414,1665860223,1665860306,83,4829
3061306631,3377178183,1642206216,1642206779,563,963
3884636297,3743250717,1655220547,1655221412,865,1579
3631586708,3386090894,1666761793,1666761915,122,802
3122275078,3065575990,1663953033,1663953666,633,562
3802080840,3864081232,1659722134,1659723061,927,1408
3568621227,3914060071,1648138912,1648139792,880,1345
3232849887,3000186808,1658824885,1658825137,252,2110
3782855374,3023799058,1666677941,1666678023,82,3232
3330108378,3279640046,1653925724,1653926548,824,3337
3881566510,3132684710,1656131918,1656132825,907,1796
3045122599,3045189131,1645241390,1645241578,188,1643
3136786623,3485041379,1662158019,1662158035,16,2671
3665563214,3466869677,1653716386,1653716743,357,723
3721874583,3233162683,1649341878,1649341953,75,4992
3632589963,3757087656,1658048432,1658049023,591,42
3281039884,3593400836,1646435571,1646435849,278,1897
3144781078,3216835525,1646250876,1646251578,702,2951
3443517533,3410892927,1662268063,1662268933,870,85
3983856989,3439103663,1643210134,1643210358,224,4105
3060265658,3213874874,1669380351,1669380358,7,2513
3668634476,3911101411,1652262772,1652262854,82,4878
3621386133,3359018736,1654600523,1654601138,615,1887
3739204908,3936304659,1669374208,1669374921,713,4585
3079485276,3941041541,1656270178,1656270830,652,1914
3278152467,3790470679,1668656840,1668657776,936,1213
3618146499,3060105472,1647396941,1647396995,54,1076
3984190380,3999187619,1659221333,1659221469,136,2487
3957678571,3628403283,1660561656,1660562590,934,4665
3242951123,3368671870,1654363048,1654363551,503,1001
3670104010,3338059684,1659259684,1659260647,963,1114
3079083700,3527165195,1650604651,1650604697,46,799
3900515352,3056798508,1659454123,1659454893,770,3854
3277384384,3703105547,1669557861,1669558763,902,1325
3097031512,3341471470,1659215679,1659215772,93,4141
3122353698,3396127210,1667952882,1667953785,903,4460
3148685796,3014869508,1646549606,1646549698,92,1909
3445109276,3143045628,1643676098,1643676208,110,4271
3558341565,3080036164,1666308597,1666308947,350,4178
3005427224,3656107881,1660456405,1660457088,683,1358
3677597969,3456074930,1643010996,1643011218,222,2999
3565922541,3416790003,1652815333,1652816143,810,993
3867364781,3573552591,1649542434,1649543363,929,1770
3261053545,3763028224,1646740727,1646741153,426,3346
3476144609,3983554658,1665899678,1665900249,571,1080
3566940053,3522542856,1652003010,1652003517,507,4177
3692067644,3370935153,1653346631,1653347434,803,2455
3717824241,3215523009,1664684431,1664685265,834,3848
3854113094,3483855519,1642410489,1642410764,275,1069
3484347555,3797496847,1663651236,1663651955,719,1210
3950574902,3133032080,1667126990,1667127328,338,627
3339982117,3155974815,1660260237,1660260741,504,3194
3445514011,3707565698,1654046990,1654047142,152,4981
3818150764,3637523541,1662585311,1662585372,61,3463
3698854461,3364991363,1653780012,1653780459,447,4721
3914803262,3214531172,1653549570,1653550303,733,1011
3043429912,3433115781,1662977106,1662977196,90,1800
3277717146,3697399132,1650821374,1650821616,242,4902
3760622244,3251088778,1654011672,1654011944,272,2783
3391836618,3001492410,1642484488,1642484957,469,1091
3106235760,3603689662,1658097696,1658097825,129,967
3226199336,3289806050,1664436239,1664436399,160,4001
3222075185,3343759135,1649268043,1649268270,227,1376
3909101703,3192632223,1649238902,1649238968,66,1821
3200477494,3577976345,1656511564,1656512561,997,4387
3091314618,3459309183,1664740688,1664741080,392,413
3680098063,3339526869,1662228131,1662228265,134,428
3571579371,3448195241,1644480130,1644480227,97,3975
3562206730,3910957507,1660527716,1660528151,435,3785
3267001898,3695367264,1668934956,1668935278,322,1142
3456238891,3725075886,1663158447,1663158710,263,1482
3145268311,3743855298,1656868485,1656869077,592,4890
3993870878,3861796568,1665170728,1665170981,253,1560
3532544666,3210003341,1663454755,1663454983,228,4569
3444270563,3858570972,1653619024,1653619283,259,2849
3231037857,3578258582,1643008083,1643008707,624,2388
3077809558,3051997948,1665388444,1665389146,702,3466
3454309894,3935755058,1660539355,1660540132,777,2923
3684910815,3159380056,1653100413,1653100962,549,2406
3664808959,3924395077,1657045178,1657045660,482,4471
3547656396,3051924516,1651516768,1651516782,14,344
3662372183,3590038552,1668600507,1668601203,696,3532
3030160375,3996393217,1664363629,1664363642,13,4911
3791800982,3461619716,1667693132,1667693908,776,3430
3383511698,3068664446,1668793818,1668793944,126,4313
3337413673,3968320854,1646832589,1646833044,455,109
3185251217,3394449617,1653721386,1653722160,774,4698
3207017020,3817246710,1656389779,1656390362,583,4959
3451920326,3418813364,1668580745,1668581587,842,2992
3037800513,3168743384,1655322502,1655322855,353,40
3420418460,3929484466,1659869984,1659870789,805,183
3783598272,3059919695,1666225541,1666226017,476,1554
3156558887,3854761901,1650136238,1650137166,928,3802
3394399318,3976603443,1646019342,1646019895,553,299
3845653556,3928386923,1666733764,1666734437,673,4522
3144372234,3818059014,1667201901,1667202308,407,1929
3448280556,3080554194,1650852074,1650852409,335,2481
3877329620,3533989647,1643235557,1643236282,725,4670
3110871974,3774702155,1647270257,1647270352,95,815
3067960497,3778931042,1646700120,1646700265,145,2443
3863744178,3934465890,1649153583,1649154565,982,2014
3858158012,3370950508,1668579945,1668579980,35,1661
3165265558,3019149926,1662385597,1662385952,355,4208
3738260889,3570557783,1644067991,1644068055,64,2274
3082929579,3076738962,1642889064,1642889800,736,4825
3081529265,3358974886,1647912795,1647913601,806,2259
3946899169,3130000796,1644923268,1644923666,398,4376
3427690971,3151310722,1667375368,1667375800,432,4765
3856150109,3001758030,1658962208,1658963016,808,4429
3628422325,3411476008,1648639355,1648640315,960,171
3025109920,3074835049,1652759215,1652759324,109,4717
3226640766,3964466587,1664563856,1664564379,523,3520
3455878279,3734934833,1652120997,1652121723,726,3025
3369980509,3898253745,1658200219,1658201122,903,2206
3920239045,3855247642,1663224470,1663225123,653,3297
3562816372,3026332023,1656414455,1656415186,731,1333
3749069705,3426612720,1651377724,1651378121,397,316
3814792686,3119131679,1657084957,1657085924,967,2823
3535319436,3592864784,1654806574,1654806731,157,1228
3254019420,3296436091,1665517290,1665517722,432,4299
3227617763,3443768679,1653841093,1653841852,759,3765
3782725650,3025535241,1657639771,1657640296,525,2541
3558507293,3827616267,1668982170,1668982538,368,3581
3074608115,3063260290,1662205271,1662205842,571,3971
3443496614,3257327386,1653941970,1653942023,53,2766
3231652511,3705442235,1652585945,1652586551,606,4137
3305721544,3464239870,1650098024,1650098607,583,1457
3506239600,3554151286,1650905065,1650905847,782,2392
3455429890,3633886512,1657524437,1657525329,892,3966
3909182287,3574625362,1661352817,1661353638,821,3627
3977439555,3671262437,1656487036,1656487963,927,1846
3423795145,3515004368,1654175345,1654176187,842,4132
3271540983,3431983892,1657448148,1657448816,668,774
3369486603,3380211592,1666050029,1666050648,619,1944
3265319206,3915669768,1664161632,1664161653,21,373
3516418754,3166550460,1641881023,1641881953,930,2973
3333240804,3689907441,1652693743,1652694118,375,2111
3727799741,3401892016,1642843696,1642844275,579,2373
3412423766,3726452850,1655395141,1655395341,200,3897
3241715468,3588103948,1668552094,1668552405,311,2066
3289284546,3480836267,1657830487,1657830782,295,2666
3694472069,3686053471,1662519674,1662520481,807,1126
3291868269,3824893907,1649594025,1649594824,799,2392
3647434099,3704951413,1651519227,1651520073,846,1202
3428527940,3699495298,1643806840,1643807512,672,1187
3756592161,3813206720,1668301295,1668301392,97,4854
3442435608,3367814330,1642438477,1642438740,263,4788
3207964311,3358110136,1659541096,1659541813,717,3703
3316204027,3780539981,1649869052,1649869367,315,1904
3189197469,3781199232,1648107522,1648107702,180,4787
3847751016,3140735865,1660187339,1660187480,141,3616
3397851223,3765156334,1650114779,1650115018,239,1284
3414931778,3232064537,1666384518,1666385138,620,2231
3783222042,3731478537,1647480841,1647481716,875,2550
3549462661,3802621779,1653406268,1653407023,755,1241
3097324508,3898275539,1647916011,1647916593,582,1396
3869212677,3135903003,1650469399,1650469839,440,4095
3299865489,3316391600,1658977575,1658978307,732,3886
3977959803,3382548430,1645133669,1645134601,932,4680
3381985243,3592543803,1643180290,1643181123,833,796
3599550195,3495674155,1662201689,1662202208,519,1393
3281704610,3076491034,1664846522,1664846890,368,1916
3862988343,3212120269,1643887625,1643887893,268,3343
3897930575,3569117449,1656368883,1656369604,721,404
3596292621,3251067662,1664399396,1664400053,657,4947
3538088542,3268223077,1665748409,1665749107,698,360
3258106408,3835437922,1646167803,1646167831,28,3332
3089321617,3904416353,1663205853,1663206229,376,4487
3473634739,3267587804,1653441569,1653441937,368,4467
3844473669,3373384586,1653494152,1653494861,709,913
3445065394,3719744703,1668452682,1668453204,522,1995
3233282808,3895024512,1642041279,1642041812,533,685
3498222829,3912876518,1651452239,1651452568,329,4548
3173383447,3345430019,1667056973,1667057055,82,1170
3607624884,3956455577,1654616945,1654617241,296,4573
3949648990,3897158579,1662095509,1662096181,672,4609
3314793789,3194439418,1643253583,1643254322,739,724
3244156824,3440910501,1661044135,1661044662,527,2402
3767131657,3710221400,1645870262,1645870750,488,4496
3617256849,3963643380,1667553725,1667554376,651,1985
3975833256,3206066459,1642952500,1642953093,593,678
3872483563,3982615269,1655182600,1655183161,561,3259
3903070109,3154803157,1643596269,1643596463,194,3476
3367682409,3652432049,1664296548,1664296715,167,4928
3469262728,3593053824,1644957502,1644957583,81,1030
3816195321,3780021744,1651412451,1651412818,367,4874
3412196585,3166021104,1663136039,1663136230,191,970
3058059586,3974224545,1649668350,1649669006,656,1648
3815157588,3203167041,1654923263,1654923277,14,499
3001189845,3201179021,1644494536,1644495190,654,2275
3328278775,3170510141,1660064895,1660065886,991,2095
3947935441,3437404779,1662063926,1662063990,64,1506
3988610068,3156161352,1649931470,1649931686,216,3508
3859484727,3898176038,1664932415,1664932880,465,457
3487366263,3216282246,1650689214,1650689567,353,4294
3742818812,3215421634,1658351609,1658352341,732,680
3916351161,3068920016,1654355327,1654355427,100,4184
3874874412,3419437957,1648696512,1648697428,916,2478
3876332468,3475231203,1650005917,1650006381,464,4615
3378230648,3433517654,1660848530,1660849274,744,760
3953200815,3956454295,1655410846,1655411445,599,1137
3939030777,3079349925,1656506479,1656507230,751,3406
3023722205,3409091313,1643486164,1643486273,109,3682
3848781061,3514376125,1647069818,1647070749,931,316
3517942854,3739299597,1660512113,1660513000,887,1161
3833198014,3647051242,1664070460,1664071112,652,4363
3979311210,3871938272,1645009195,1645009283,88,311
3712781278,3789907243,1646774949,1646775849,900,4763
3968146958,3061760638,1661939623,1661940244,621,2085
3892900508,3931600134,1654374227,1654374880,653,2245
3558583699,3430820196,1662432192,1662432599,407,1804
3871012739,3430903781,1644752489,1644753124,635,822
3251465453,3668305564,1647115018,1647115864,846,2854
3104030682,3277580324,1669506328,1669507233,905,2812
3425540385,3988692380,1656388390,1656388813,423,2011
3683525058,3724686563,1641855569,1641855841,272,1362
3070908197,3052628388,1643452421,1643453254,833,221
3557059956,3444649999,1649484914,1649485664,750,43
3148428162,3531947880,1652228105,1652228135,30,3292
3596776338,3295096840,1651089852,1651090343,491,2284
3840179007,3368431316,1643477759,1643478354,595,4730
3434623547,3451876412,1660810022,1660810060,38,3300
3843318944,3350688125,1664266061,1664266075,14,3263
3043462876,3525821402,1651050694,1651050851,157,4720
3020957734,3658581958,1648281421,1648281888,467,627
3530009430,3892097665,1657344323,1657345101,778,3687
3372394754,3767254954,1641660851,1641661710,859,169
3365744077,3464525670,1661058325,1661059017,692,3527
3064944303,3750458171,1650339399,1650339444,45,1507
3479225836,3443906484,1654724985,1654725726,741,4960
3865008039,3409215056,1649138973,1649139259,286,1546
3849410100,3063589841,1667036855,1667037634,779,4308
3050943525,3157360712,1664362521,1664362951,430,2542
3132958260,3783974128,1655582133,1655582676,543,1670
3034395018,3527254252,1668590399,1668590564,165,4359
3426961270,3418615739,1645698078,1645698419,341,3527
3179839712,3076998115,1646133398,1646133792,394,1872
3299012677,3153179684,1667328162,1667328211,49,3662
3417375546,3546145776,1660433716,1660434058,342,3818
3997944711,3804229446,1655927614,1655927995,381,3326
3350355966,3977001128,1663425434,1663425437,3,2229
3515923017,3976890963,1647874384,1647874987,603,286
3711602535,3951989199,1642841386,1642842113,727,2635
3782216115,3220427284,1642760943,1642760965,22,147
3123656587,3214263309,1654300246,1654300333,87,2235
3299268443,3047841471,1641703920,1641704694,774,1741
3836152692,3989673622,1666172045,1666172705,660,1415
3790268021,3303363255,1654248470,1654248539,69,3644
3677943959,3653304396,1656552457,1656553242,785,3907
3037009116,3784291516,1668690258,1668690304,46,22
3214362121,3042977542,1647042326,1647042870,544,1196
3338216516,3025497176,1661210211,1661210777,566,3918
3857324738,3464052954,1650056480,1650057321,841,2357
3678096922,3106966356,1668779829,1668779874,45,3061
3515881713,3432290385,1648743061,1648743666,605,4139
3124155811,3591829084,1656601879,1656602871,992,4775
3441037234,3274129394,1644591026,1644591040,14,2626
3961041767,3149219099,1664204196,1664204728,532,178
3691460880,3828395714,1655775990,1655776319,329,571
3848353945,3192137267,1658837194,1658837517,323,2649
3851124542,3590941300,1656813281,1656813536,255,802
3081764211,3996278895,1669308898,1669309703,805,4522
3993998325,3742338632,1666849771,1666850063,292,4901
3029449531,3428843089,1648826341,1648826783,442,1700
3592592827,3646222216,1643969036,1643969758,722,3097
3831324961,3953893004,1664559991,1664560055,64,2236
3533132834,3458534209,1658512085,1658512843,758,702
3034049142,3864794067,1641477621,1641478150,529,1537
3007561852,3191079784,1646671326,1646671429,103,3009
3172764399,3016523322,1646905122,1646905360,238,2891
3923045511,3632946724,1651389029,1651389833,804,4232
3961187632,3497396767,1660732428,1660733106,678,1335
3760353891,3610182594,1667330082,1667331043,961,2493
3068703847,3796065097,1662963520,1662963857,337,2805
3725462908,3565448295,1667788266,1667788436,170,294
3447661239,3488454509,1650083156,1650083790,634,3320
3873000268,3470958472,1668666977,1668667430,453,4322
3047433022,3395566851,1654684942,1654685464,522,3090
3119026442,3579481317,1649688843,1649689275,432,16
3778137029,3698188096,1648317890,1648317896,6,1519
3798964218,3521051600,1648155665,1648156227,562,3541
3329284002,3832822553,1665733372,1665733420,48,3348
3902545222,3435131446,1651655505,1651656008,503,2024
3088958883,3735289385,1655145098,1655145696,598,3358
3913107092,3147325416,1666959758,1666960504,746,849
3116157197,3096115976,1647414553,1647414899,346,3006
3958685255,3429257774,1669062250,1669062415,165,3268
3678539314,3317053487,1663277635,1663278233,598,1924
3228265828,3846300597,1660422522,1660422934,412,3761
3782943068,3849883869,1661914874,1661915133,259,4465
3076075117,3557536594,1641994914,1641995173,259,4506
3908479815,3142110115,1648179524,1648179829,305,1507
3110922799,3424555048,1642654884,1642655440,556,3648
3374962927,3161681101,1642113627,1642114291,664,229
3375108576,3500860813,1664896755,1664896975,220,316
3570565278,3674726949,1664518634,1664519387,753,332
3084882127,3320784164,1667633067,1667633562,495,2541
3391719991,3644648089,1667899731,1667900473,742,194
3130691228,3965503512,1661488423,1661489131,708,4876
3834133270,3787211069,1649941214,1649942173,959,3720
3855007166,3343193466,1641957245,1641957883,638,1224
3536536801,3792000751,1658610743,1658610820,77,1193
3913037602,3843263973,1658582307,1658583038,731,1902
3369276385,3536796324,1659080333,1659081268,935,4304
3860082576,3881533201,1650157599,1650158411,812,4015
3891919762,3661061925,1646464413,1646464707,294,1525
3944930219,3325224233,1651651223,1651652065,842,2678
3484506933,3656679449,1667340061,1667340810,749,3743
3958098725,3722469154,1652048935,1652049653,718,733
3203470133,3901802435,1641627389,1641628174,785,3368
3366444929,3880186142,1658528414,1658528569,155,859
3378140141,3139283601,1652298709,1652299245,536,3959
3327966493,3734477467,1648290960,1648291105,145,2153
3785320773,3287876699,1669146247,1669146602,355,3796
3781981317,3234867736,1661437882,1661438021,139,1289
3190662083,3693363567,1666790920,1666791158,238,1571
3496925966,3261122056,1663586084,1663586192,108,4161
3370724262,3370611750,1647845244,1647845814,570,3138
3414172132,3784291516,1646793344,1646794108,764,3553
3373070568,3342296552,1654911533,1654911551,18,4719
3279498450,3311069604,1652132290,1652132988,698,2566
3116166389,3863823598,1659813746,1659814649,903,1470
3755537817,3649699377,1667175264,1667175489,225,1274
3948930784,3704923093,1649060335,1649061225,890,3482
3244801476,3958478681,1648674315,1648675144,829,460
3508599720,3808504690,1668758327,1668759081,754,4588
3029695265,3622353445,1644708167,1644708769,602,573
3365315150,3556913763,1654813018,1654813789,771,86
3764024467,3622659091,1649882392,1649882850,458,3216
3089676264,3563011265,1668756015,1668756584,569,4877
3319924243,3700479199,1653798810,1653799431,621,338
3774716421,3146740347,1668044991,1668045795,804,1651
3882801332,3142176516,1665813159,1665813994,835,670
3355076067,3546215855,1656519540,1656519995,455,3022
3350903430,3331443701,1647918230,1647918430,200,1744
3390845421,3122818936,1659660906,1659661836,930,2508
3358789954,3523733420,1654587384,1654588279,895,4860
3423519815,3773264221,1666256148,1666256709,561,108
3242444182,3734873190,1650875528,1650876507,979,2592
3272758363,3378597544,1654188424,1654189063,639,2441
3451181628,3953742105,1658850893,1658851838,945,2294
3438702442,3044012108,1668097289,1668097479,190,2537
3584958866,3093151882,1641895476,1641896177,701,2136
3526326694,3262366532,1654186642,1654186719,77,2124
3610182594,3681778831,1657518297,1657518805,508,2919
3935943702,3861675171,1662802522,1662803101,579,1677
3715016740,3643934526,1654447341,1654447640,299,1345
3751322103,3745413022,1646621444,1646621445,1,732
3853565094,3750382271,1642154887,1642155149,262,1109
3817800543,3688301510,1647239953,1647240462,509,2905
3352930571,3382926037,1665742137,1665742242,105,1214
3477772411,3339621481,1642558743,1642558874,131,876
3809381196,3454259449,1650500878,1650501259,381,1089
3082156748,3144531954,1654362101,1654362764,663,4394
3849892747,3041247529,1657330860,1657331264,404,2452
3916025813,3913075772,1647812088,1647812718,630,1151
3918039620,3609474562,1658236312,1658236485,173,540
3812256701,3018689592,1652074103,1652074551,448,4047
3941572663,3549513239,1661111668,1661112021,353,4657
3824180818,3135962737,1667576173,1667576976,803,3856
3005558739,3372959476,1660001410,1660001740,330,4198
3677564955,3501440276,1662444032,1662444721,689,1959
3012056504,3375975175,1646991348,1646991452,104,320
3634492585,3590232634,1650530396,1650531245,849,1345
3757743221,3932625615,1650457749,1650458424,675,2191
3454854012,3838951531,1650373966,1650374142,176,4425
3221052130,3104926030,1645911109,1645911158,49,4258
3918554529,3690852106,1644704527,1644705283,756,1126
3320728937,3356481416,1662087183,1662087611,428,4658
3813612154,3831794778,1658174627,1658175436,809,1622
3200418783,3591656228,1643475652,1643475687,35,1716
3315209236,3083596124,1641246117,1641246825,708,1067
3145927425,3779500936,1651684133,1651685125,992,2984
3741858764,3978635158,1642915768,1642916550,782,2276
3890010767,3842878464,1655523866,1655523934,68,2928
3213059617,3288358386,1646436140,1646436368,228,4947
3667716231,3129987770,1658243945,1658244911,966,2978
3824340036,3998881704,1661849162,1661849320,158,3926
3570640076,3089981512,1642371797,1642372717,920,2823
3448872370,3186764281,1644708512,1644708854,342,3798
3242301149,3806996079,1654251233,1654251857,624,3982
3569224571,3377531048,1643350768,1643351300,532,2238
3249890435,3649583457,1666138919,1666139020,101,297
3807693592,3597525696,1649316401,1649316489,88,2239
3076643181,3333348696,1650654799,1650655655,856,1601
3489900178,3122681664,1647067495,1647067644,149,1784
3761511653,3869679281,1658081740,1658082046,306,3705
3012015863,3187900038,1641355617,1641356222,605,3017
3648807536,3678159088,1657295802,1657296662,860,4167
3195691322,3956732204,1667508679,1667509433,754,2126
3658310925,3831737665,1663513929,1663514919,990,2383
3599312075,3940530785,1653154111,1653154139,28,680
3396800738,3832036870,1661973454,1661973569,115,1611
3163953494,3310254093,1664445140,1664446032,892,299
3018077741,3006126426,1653638522,1653639129,607,939
3596242962,3486583204,1668376629,1668377115,486,786
3988234156,3992438379,1654089548,1654089610,62,3305
3335872777,3160525099,1650577852,1650578148,296,1725
3648973955,3739390834,1661635035,1661635172,137,481
3184366801,3122493685,1668236665,1668237164,499,3518
3258847399,3266459412,1662231572,1662231818,246,2487
3962221914,3457202038,1649705928,1649706444,516,247
3261869599,3252145034,1643593506,1643593563,57,3098
3917110897,3323766792,1663465433,1663465843,410,4531
3643653071,3885115880,1655523332,1655524198,866,3606
3284702627,3656350321,1663216669,1663217590,921,2991
3051756990,3244814318,1663922880,1663923376,496,469
3188334956,3923057399,1650466873,1650467172,299,2188
3897964650,3695788698,1641464090,1641464353,263,1766
3984689917,3382403228,1657431307,1657432247,940,3823
3065837370,3087374999,1663572489,1663572637,148,2689
3464236057,3415246126,1647676209,1647676552,343,1832
3996821494,3096461772,1655496327,1655496964,637,3188
3394274049,3597900526,1650945696,1650946259,563,4833
3707426714,3784435033,1657376186,1657376488,302,2277
3127498989,3929983721,1655278432,1655279315,883,2148
3112877985,3210685299,1668982542,1668983193,651,1563
3799247219,3987814245,1664456412,1664457131,719,1921
3667075384,3887692955,1652185027,1652185833,806,1373
3050833101,3933213214,1641453111,1641453411,300,2908
3267177196,3389346429,1668355033,1668355591,558,4486
3581298178,3947905878,1658404170,1658404663,493,4826
3269986546,3125854014,1656940124,1656940430,306,1598
3172774179,3761075662,1659750044,1659750837,793,4443
3453377853,3750416443,1665208268,1665208651,383,2988
3206066459,3710371105,1641138092,1641138278,186,4037
3785971353,3156606122,1661060890,1661060976,86,4778
3919213919,3408958202,1654116249,1654117109,860,4208
3143434346,3888736958,1651297387,1651297925,538,2083
3845519766,3925935062,1651729006,1651729559,553,2529
3012907956,3821887104,1644087906,1644088422,516,2282
3806232168,3617601444,1669663409,1669663433,24,2934
3005610084,3155691797,1655437074,1655437937,863,2252
3042356463,3619993394,1644797695,1644798226,531,4699
3735218526,3897965389,1668865322,1668865935,613,2787
3623873042,3484161582,1649135525,1649136467,942,1270
3146054210,3832605781,1656292625,1656293293,668,2249
3334034555,3189976762,1655006557,1655007225,668,2820
3675670581,3468131711,1669564668,1669564890,222,4647
3200122105,3823920692,1645493956,1645494690,734,1996
3853073743,3269118492,1656609458,1656609539,81,3435
3627601605,3437132118,1657904782,1657905682,900,3677
3555620491,3207363943,1651036129,1651036298,169,220
3348960378,3087226112,1657674453,1657674538,85,1389
3308254915,3987579969,1651980856,1651981339,483,1197
3160694320,3125733639,1665798791,1665799450,659,4573
3017875893,3328804256,1659293052,1659293686,634,3025
3261171535,3961847155,1657590449,1657590948,499,2620
3718215406,3579996740,1666987251,1666987869,618,3286
3651942527,3572340793,1642089489,1642090152,663,3260
3701992893,3498564286,1656708455,1656709437,982,287
3682831286,3350033581,1642982599,1642983463,864,2647
3806382436,3150044907,1660917171,1660918043,872,4488
3201536668,3034942750,1668088429,1668089157,728,4196
3903659712,3981770478,1651955429,1651956217,788,558
3844078755,3378941931,1647792523,1647793100,577,597
3495298548,3086100023,1659540612,1659541383,771,2921
3313088639,3394701965,1645218837,1645218992,155,4783
3191925689,3199831180,1641370550,1641370680,130,3260
3072755599,3327754436,1649533234,1649533908,674,3712
3085513278,3317607511,1641229457,1641230300,843,3467
3642882194,3538214486,1662971352,1662972332,980,3175
3150843219,3559190402,1644098718,1644099376,658,2416
3706822878,3397657376,1664191708,1664191805,97,1057
3659955234,3383636230,1649500122,1649500406,284,2952
3869405311,3362731534,1662505145,1662506078,933,3442
3721504366,3792066141,1662466234,1662466578,344,3105
3789826062,3078756663,1653336519,1653336572,53,1448
3478233716,3729025106,1641549051,1641549659,608,4815
3662781895,3243276267,1654506415,1654507405,990,1930
3867345342,3693457344,1645269191,1645270056,865,1429
3533063112,3062796599,1654464485,1654465444,959,4538
3113302059,3885608699,1647610639,1647610661,22,4197
3471819911,3004778742,1654186495,1654187060,565,1296
3829113799,3484598001,1659112990,1659113107,117,3075
3567131111,3371945928,1646003891,1646004626,735,669
3071034943,3908949773,1662755007,1662755644,637,1426
3898275539,3637336471,1666430146,1666431064,918,2635
3951713253,3445794166,1662627430,1662627511,81,889
3825705338,3199699486,1656835172,1656836120,948,4396
3335370530,3374998187,1663489823,1663490100,277,1170
3557261325,3836260215,1651389279,1651389647,368,3086
3178128825,3964581590,1642156698,1642156948,250,616
3724935392,3964658107,1656275530,1656276163,633,1222
3711534763,3502869296,1647318421,1647318452,31,3817
3507424111,3453519646,1644269306,1644269687,381,4570
3301485510,3453377840,1658114756,1658115251,495,1158
3682878682,3880570286,1643978747,1643978902,155,2677
3119914736,3762499535,1661732742,1661733682,940,2223
3691081662,3311904794,1644766834,1644767276,442,250
3051673194,3845407473,1642026699,1642027309,610,4788
3745484426,3026922707,1650401700,1650401767,67,2988
3256540092,3423533973,1661683672,1661684362,690,3594
3205312464,3476949824,1656101721,1656101819,98,3756
3002584689,3422646363,1659258314,1659258354,40,834
3982330066,3480211499,1650911908,1650912225,317,4139
3240635026,3393169503,1647771671,1647772569,898,4612
3075083880,3897728656,1664292797,1664293360,563,4452
3684975697,3976493485,1650576027,1650576487,460,2545
3177504496,3602177415,1662624201,1662624597,396,43
3768577194,3479860927,1667751218,1667751476,258,541
3969502578,3890300715,1661647982,1661648058,76,1981
3428307103,3164430472,1658940005,1658940452,447,845
3464952022,3193022871,1662030686,1662031329,643,4052
3288708952,3525020045,1667013090,1667013779,689,4670
3732962693,3892611205,1661543247,1661543544,297,4153
3091268477,3484014684,1663864625,1663865468,843,3316
3663094803,3595170995,1662790955,1662791471,516,2482
3311951312,3582304911,1655318076,1655318531,455,1708
3061915042,3244531925,1642262181,1642263033,852,2263
3024017404,3167784026,1651446999,1651447248,249,4247
3958764205,3796623414,1668688078,1668688469,391,252
3933387870,3243844053,1652851567,1652851963,396,4670
3475583763,3917846737,1667295948,1667296656,708,4764
3342699909,3722430385,1662723452,1662724098,646,2062
3363238511,3062090577,1655617722,1655618596,874,4211
3640237467,3856887065,1667735258,1667736126,868,3064
3226351955,3122859284,1665963232,1665963822,590,2360
3708108136,3085659557,1653002722,1653003505,783,1939
3208631454,3982717965,1645286684,1645287427,743,3394
3012333754,3447462278,1665629235,1665630046,811,1295
3804674797,3973399049,1651012938,1651013264,326,2003
3870351207,3624712792,1659374157,1659375005,848,3984
3688690675,3064001825,1648446552,1648446823,271,4450
3641962509,3438985366,1658414694,1658415671,977,4781
3861882077,3853102147,1648933419,1648933922,503,1452
3286793296,3704019406,1655992781,1655993542,761,3380
3495439642,3093852831,1653604008,1653604983,975,824
3923622759,3736586693,1646513550,1646513680,130,1292
3777695659,3585359487,1661761930,1661762123,193,3235
3240034252,3653642241,1666445607,1666446409,802,2128
3587554366,3093186680,1644559729,1644559996,267,2817
3082863077,3841933093,1657443129,1657444123,994,512
3824770149,3549276761,1663728760,1663729529,769,1736
3200790991,3946453978,1661754352,1661755040,688,1297
3280956123,3335129594,1657213879,1657214151,272,1897
3328501760,3475805441,1646191138,1646191157,19,4581
3044325325,3859597370,1658652319,1658652343,24,2088
3231069976,3499026026,1666489313,1666489457,144,642
3017727937,3513943285,1663938431,1663939348,917,521
3502211586,3088014074,1667041812,1667042150,338,2102
3962012593,3678350272,1667742769,1667743625,856,3739
3365993658,3133089330,1669537251,1669538216,965,3450
3553313980,3938267443,1665057088,1665057362,274,3089
3565927763,3003683521,1656908243,1656908565,322,3326
3871538113,3732987593,1652609897,1652610855,958,4408
3787693343,3681647584,1665876359,1665876676,317,3760
3327398385,3113777799,1652106455,1652107344,889,2740
3112064071,3568420958,1649458150,1649458884,734,3664
3477902262,3865834906,1664901281,1664902145,864,1186
3665442438,3056821923,1651197455,1651197815,360,1352
3875657836,3573567438,1647078146,1647078832,686,3079
3178958906,3502917635,1644515165,1644516114,949,270
3597204641,3590126654,1669456814,1669457336,522,1207
3302151151,3265510349,1644633834,1644634329,495,1507
3960014768,3245829465,1652497564,1652498432,868,2714
3660570507,3673867215,1666173363,1666173375,12,420
3014119309,3002983100,1664358929,1664359184,255,1513
3147680546,3197519044,1643381974,1643382194,220,3961
3491679811,3922145678,1648853653,1648854186,533,2324
3627315149,3610275848,1642809693,1642810293,600,2260
3068732030,3330421887,1654491199,1654491708,509,2847
3743020542,3572108460,1668008303,1668008610,307,1396
3948218140,3492458975,1669423316,1669423851,535,45
3205929120,3444769976,1644109624,1644110162,538,3503
3898356981,3711451831,1665827039,1665827068,29,3238
3340304126,3558775400,1667277257,1667277985,728,4171
3110791920,3159639608,1663154405,1663154666,261,4902
3136420824,3955583243,1648935389,1648936172,783,2744
3697831234,3550798768,1645024105,1645024522,417,1270
3769238066,3239218584,1650172450,1650172788,338,3781
3465946260,3431953832,1653567713,1653568235,522,2341
3740897893,3691316121,1657625465,1657625716,251,3158
3416280796,3775986853,1642513808,1642514434,626,4918
3575467131,3482312319,1655311087,1655311124,37,231
3219568410,3869405311,1661704223,1661704628,405,2004
3009381584,3762201582,1643888923,1643889773,850,4121
3427631190,3065167214,1645164808,1645165506,698,3881
3803900936,3920349365,1662988896,1662989886,990,2178
3710261190,3273508181,1643346722,1643347030,308,1435
3237683883,3247414855,1663640106,1663640987,881,4711
3888960760,3178411090,1660842726,1660842828,102,555
3584236526,3638857901,1667492622,1667492822,200,2841
3545116472,3028112121,1647348042,1647348298,256,2574
3549489129,3034869946,1641498738,1641499649,911,4276
3248446740,3872027839,1659354541,1659354754,213,53
3622972030,3606639183,1650819695,1650820244,549,202
3525734223,3910588313,1651837047,1651837231,184,3574
3768064603,3160651463,1668321704,1668322207,503,3003
3052774189,3504312402,1655316143,1655316315,172,3751
3981643233,3022818148,1641714948,1641715466,518,2610
3676486083,3830107441,1642352163,1642352656,493,2162
3802929730,3279315018,1653554649,1653554784,135,3619
3432550154,3513085103,1667144356,1667145074,718,2902
3708546696,3665335474,1663180036,1663180953,917,4376
3278599582,3004379156,1661491392,1661491928,536,3527
3733910421,3217057550,1664243786,1664244145,359,39
3681214294,3056118904,1648821733,1648822340,607,3999
3815775842,3537306050,1664288391,1664289181,790,3952
3556333041,3394701965,1643972309,1643972536,227,1454
3591599102,3368715903,1647571028,1647571436,408,1813
3661222488,3184784530,1665086142,1665086481,339,101
3836564619,3986644485,1656604105,1656604245,140,4732
3249150340,3703997828,1641197209,1641197536,327,1827
3278073126,3893736934,1664152131,1664152925,794,507
3979627508,3473345154,1650806716,1650806717,1,3007
3043832096,3843249844,1643498316,1643498351,35,4667
3606868074,3148336162,1642698231,1642698670,439,2939
3062026599,3387269802,1650098679,1650098795,116,2914
3218135276,3357527132,1641176778,1641177329,551,2596
3349120485,3249824790,1647597799,1647598543,744,4913
3482948222,3925093886,1653422901,1653423778,877,1707
3898479402,3947810360,1647884058,1647884895,837,3138
3191456854,3924174084,1648282774,1648282827,53,4662
3299327598,3935396168,1657228228,1657228799,571,30
3608406498,3146204554,1654871411,1654871662,251,1439
3641740365,3226768654,1662062278,1662062526,248,884
3107585819,3797441508,1651426075,1651427007,932,4193
3170489006,3042621737,1667107004,1667107922,918,3288
3133801504,3048423004,1669413630,1669414038,408,1983
3405383179,3076152352,1666886582,1666886802,220,635
3443776761,3544813488,1665672264,1665673123,859,4639
3898312867,3447149842,1645639157,1645640114,957,2469
3432550927,3409443749,1661943851,1661944065,214,3180
3085403038,3991923809,1658405140,1658405255,115,417
3710495816,3810835749,1646827743,1646828060,317,4938
3824287014,3762638994,1644051422,1644051707,285,2474
3644114371,3516628441,1666987098,1666988026,928,2373
3537187702,3261732187,1641975139,1641975719,580,216
3107493087,3480805374,1647709870,1647710284,414,4660
3635916359,3937610547,1664966155,1664967094,939,2630
3883185696,3306198925,1658845468,1658846180,712,3825
3394288757,3789046953,1651128422,1651128647,225,1038
3849367008,3031357615,1666762619,1666763275,656,2104
3907219774,3567845547,1650875094,1650875878,784,2577
3963675461,3147623448,1661899273,1661899659,386,3939
3728345738,3261869599,1647268716,1647269218,502,3956
3111855485,3280858204,1661161861,1661162441,580,1030
3325390450,3172651732,1654861490,1654862060,570,1614
3063371297,3873254635,1665533019,1665533699,680,4541
3650293555,3450746305,1648595825,1648596184,359,3976
3901524785,3304234390,1656754725,1656754879,154,3182
3547769449,3102007219,1645556440,1645557068,628,4718
3027206398,3618588633,1657593566,1657593684,118,2080
3896627335,3941948663,1646801152,1646801725,573,4657
3453624088,3764994244,1661395931,1661396565,634,4717
3131382766,3978973892,1643991492,1643991843,351,2837
3472952595,3774479145,1664724925,1664725861,936,1097
3870121609,3406977771,1658585171,1658585934,763,3877
3791478684,3789668386,1645918171,1645918949,778,3526
3444153830,3806966233,1663348887,1663349737,850,1289
3846069232,3870038623,1668691293,1668691404,111,4684
3306481790,3847086716,1664442348,1664442981,633,3801
3743855298,3854127450,1666848075,1666848541,466,492
3489056597,3139328233,1656793063,1656793242,179,2234
3624416229,3355831908,1664983958,1664984662,704,1555
3988387540,3011049810,1657969980,1657970251,271,4823
3676927379,3171212885,1643486639,1643486857,218,4063
3111240688,3127622907,1648865573,1648866423,850,4003
3417397673,3533168714,1664642396,1664642937,541,4751
3569253309,3408766225,1658907722,1658908347,625,4385
3241404129,3018228413,1644620249,1644620932,683,4104
3346021282,3554677452,1666381877,1666382705,828,3748
3595331258,3256603851,1643173764,1643174534,770,2927
3802037110,3397851274,1643997296,1643998246,950,3453
3478410909,3805215093,1653662981,1653663274,293,2698
3298547745,3548358011,1655157219,1655157780,561,1938
3741965451,3178875661,1644727515,1644727972,457,534
3948459036,3264633899,1641717426,1641717686,260,2657
3452643512,3884038930,1652561403,1652562268,865,190
3896515196,3527018814,1652600166,1652600251,85,2012
3760256421,3209791324,1651638972,1651639733,761,3499
3877242605,3758115844,1667102573,1667102848,275,3665
3742981511,3418621167,1644514732,1644515284,552,1701
3564843816,3998032634,1648855708,1648856290,582,2788
3545052593,3751586261,1643434078,1643434568,490,1591
3629208057,3066918615,1646719679,1646720211,532,971
3739689014,3361141172,1644334159,1644335040,881,645
3863292761,3727907634,1669184209,1669184220,11,4000
3738563015,3933197100,1641703877,1641704198,321,3328
3641316373,3080082063,1666824869,1666825627,758,838
3933024012,3890115968,1663548972,1663549123,151,1866
3906520033,3744460426,1646625953,1646626578,625,4172
3197733249,3231874101,1656455696,1656456569,873,1415
3291850021,3675498161,1662954895,1662955120,225,1129
3616532441,3425489272,1664576774,1664577375,601,4856
3972406008,3575937104,1667617487,1667617770,283,4141
3300889569,3520477328,1668435753,1668435975,222,2864
3655713414,3361606856,1663122061,1663122917,856,1750
3042271961,3500090307,1667053589,1667053616,27,4237
3371169439,3919266631,1656981285,1656981486,201,3021
3584283057,3222912632,1658999662,1659000056,394,4133
3793736884,3919038879,1643613104,1643613405,301,3829
3826299330,3626061205,1645388792,1645389062,270,373
3689144103,3861106872,1653038831,1653038973,142,3417
3959627010,3486151108,1654916835,1654917360,525,2152
3451764941,3249055229,1641591642,1641592206,564,1387
3796813080,3301121908,1643659256,1643659417,161,310
3440609595,3310688428,1649024783,1649024831,48,4594
3555973295,3985320917,1658899904,1658900242,338,2232
3278602085,3043076656,1668422380,1668422717,337,4608
3162582003,3070202988,1655706364,1655706504,140,3290
3677926040,3410447207,1664111741,1664112463,722,1214
3075398084,3627955432,1647773468,1647773915,447,477
3308696867,3328551308,1668386208,1668386892,684,4555
3412065637,3272914052,1651956404,1651956724,320,2675
3657914202,3481644527,1665361475,1665361581,106,4290
3473047274,3324753973,1663600585,1663601092,507,4140
3762542789,3856003865,1665271237,1665272121,884,4604
3318073525,3127949383,1665490713,1665491032,319,3903
3741821613,3112893058,1653953635,1653953973,338,641
3254086590,3191045705,1642374335,1642374438,103,1126
3816671029,3201225446,1652539702,1652539941,239,1194
3252929927,3938848792,1655322673,1655323387,714,4144
3973949550,3108415142,1641605887,1641605908,21,4259
3322962916,3101654176,1651892809,1651893135,326,3560
3371624474,3976242306,1657457620,1657458446,826,2582
3089051368,3215698022,1650485062,1650485610,548,1539
3640656611,3656664553,1664861380,1664861489,109,207
3741381858,3248660235,1665763600,1665764547,947,4469
3754071228,3308372442,1654135154,1654135761,607,384
3040477935,3301102707,1654530351,1654530422,71,3562
3624015816,3813095250,1667990175,1667991041,866,54
3140299715,3556533706,1646304986,1646305523,537,878
3254820304,3627315149,1653814790,1653814823,33,1607
3682197557,3986574498,1649552873,1649553820,947,4345
3213408463,3354169760,1643878966,1643879661,695,4821
3697830972,3827735759,1660946905,1660947404,499,4815
3887397857,3261069527,1648913742,1648914561,819,4267
3881533201,3282585323,1658107948,1658108768,820,907
3830075123,3268868248,1649483238,1649484092,854,3016
3488930420,3028463968,1648595491,1648596164,673,4736
3232192144,3311813357,1668141596,1668141925,329,4837
3908333999,3528042607,1649332964,1649333243,279,4046
3673253111,3194507848,1643834598,1643834726,128,216
3375948369,3123461133,1660038362,1660038684,322,3372
3356094954,3956127047,1659457756,1659458396,640,3743
3826731963,3697856150,1661397078,1661397524,446,2926
3988051316,3939879197,1652166405,1652166782,377,4281
3220694688,3685749337,1653471386,1653471710,324,1219
3232055652,3222646654,1667928480,1667928665,185,2667
3540036965,3993394456,1666128544,1666129387,843,382
3931108062,3686787637,1647189216,1647189935,719,3173
3407214010,3170559012,1669281410,1669281473,63,4474
3984977628,3451764941,1661270085,1661271074,989,3655
3977624588,3991561829,1648764522,1648764988,466,2521
3145170215,3217015191,1649354213,1649355188,975,4714
3004664077,3386081884,1641769429,1641769804,375,3064
3851756930,3096269350,1648100974,1648101025,51,3084
3408054028,3084130944,1643660144,1643660580,436,4526
3472759235,3845813946,1653431031,1653431970,939,4758
3422238331,3312167578,1654438782,1654439688,906,551
3800189101,3813054271,1656300635,1656300700,65,806
3660893685,3879826228,1645391015,1645391487,472,2378
3774901762,3151917396,1663601640,1663602029,389,4937
3284835792,3797722601,1649375044,1649375613,569,1743
3508353625,3625330023,1653849506,1653849963,457,4546
3288360958,3734276570,1648959989,1648960589,600,3012
3883379946,3756922690,1659393582,1659394115,533,862
3064234912,3099232962,1669424458,1669425158,700,561
3168843088,3150270288,1648580369,1648580396,27,4699
3075370598,3703176620,1661530003,1661530403,400,2906
3201604858,3514788564,1661411725,1661412607,882,186
3780043955,3044133418,1668290549,1668291124,575,1152
3145148947,3812624017,1644307433,1644307823,390,1270
3986786112,3637549531,1662936703,1662937162,459,2445
3534767479,3729173549,1658203670,1658204571,901,2511
3800115370,3972542945,1646539832,1646540688,856,608
3219489171,3533969022,1657197900,1657198376,476,3886
3754191536,3017022543,1641387483,1641388045,562,3620
3264389877,3240394168,1665870619,1665871376,757,1960
3194031766,3053243658,1663022771,1663023001,230,4945
3253300853,3879143202,1644900456,1644900759,303,4085
3199976851,3840568725,1653680031,1653680094,63,3983
3613065836,3095416076,1643403705,1643403736,31,1118
3284293161,3139096235,1666345225,1666345496,271,2986
3883044961,3097164614,1660695551,1660696299,748,149
3375303642,3543682550,1662018824,1662019120,296,603
3548112217,3959536143,1653442928,1653443494,566,182
3749838058,3220715046,1656324568,1656324872,304,1724
3203029416,3801278284,1659063806,1659064056,250,1265
3004749393,3330789371,1656284360,1656285135,775,2577
3374446477,3092326926,1643371220,1643371515,295,300
3136834252,3546877998,1658670338,1658670775,437,1453
3715988636,3796153761,1663403459,1663403849,390,1834
3667250435,3330892190,1663121343,1663121590,247,3621
3577105915,3092012792,1641806403,1641806581,178,2989
3469852602,3498763046,1665190405,1665190862,457,4539
3719082801,3342647384,1664048391,1664048568,177,701
3623291596,3788962862,1652886809,1652887197,388,4163
3497631575,3238317727,1648899221,1648900196,975,2979
3298949166,3564278423,1669022597,1669023163,566,1136
3668203983,3797894323,1668966407,1668966628,221,681
3315999033,3049049781,1654754253,1654754967,714,4519
3340472924,3748085148,1644362594,1644363443,849,1924
3862699076,3650486912,1667077918,1667078274,356,1972
3894315969,3304551189,1641757507,1641758403,896,685
3525856169,3921796024,1642244963,1642245095,132,4188
3915113893,3560501171,1665310224,1665310517,293,2782
3466958938,3901961286,1646958491,1646958598,107,3122
3122991020,3601057666,1654733782,1654733862,80,3194
3063935429,3514118794,1667213020,1667213520,500,3702
3284176195,3263421221,1644398142,1644398921,779,1654
3644240042,3014853237,1661615858,1661616188,330,2269
3834067288,3153236153,1643957112,1643957298,186,2017
3589258001,3649174716,1646748851,1646749160,309,3207
3158460795,3271466747,1653093034,1653093175,141,3835
3926963598,3325944808,1653095615,1653096177,562,2748
3424991570,3303671322,1654303439,1654304106,667,450
3174710668,3795538549,1668486715,1668487691,976,4528
3322856969,3735134965,1644080071,1644080203,132,1151
3749220666,3286875767,1648500157,1648500990,833,2414
3993206047,3521417861,1652820151,1652820468,317,588
3916968322,3104766226,1668412011,1668412506,495,2109
3224958361,3339180649,1649217801,1649218545,744,863
3959522207,3384151655,1650710162,1650710215,53,2729
3851880083,3818613098,1649353948,1649354712,764,1281
3694456158,3550246298,1642741106,1642741494,388,815
3393450997,3534433888,1663443691,1663444484,793,2718
3595142423,3528047207,1647031581,1647031799,218,4088
3909835317,3002489974,1667893579,1667893898,319,4031
3592939027,3647790269,1667651065,1667652052,987,3224
3540992781,3581498358,1664781380,1664782251,871,782
3655516532,3680019007,1657360008,1657360597,589,3794
3932143246,3142224139,1644575956,1644576545,589,3540
3343389691,3653001904,1652235787,1652236361,574,3000
3481506427,3850889515,1666744322,1666744863,541,2426
3053540438,3513993879,1665792572,1665793373,801,2414
3979845620,3678457575,1642887078,1642888072,994,4018
3982157583,3314217855,1660870987,1660871667,680,4033
3650866546,3842376903,1651191634,1651191803,169,1288
3986473313,3531447439,1645396918,1645397094,176,3769
3024559496,3610349042,1667299688,1667300189,501,4766
3450061945,3276790051,1661162079,1661162869,790,63
3290384543,3305285421,1667201776,1667202025,249,4528
3005707205,3609414187,1666125499,1666125700,201,2547
3798581058,3179864411,1662902347,1662902537,190,4697
3286943159,3262905161,1649841977,1649842927,950,2202
3683916845,3645815097,1655258302,1655258880,578,2787
3563884394,3363384382,1661355455,1661356155,700,3115
3741482073,3392885061,1667780635,1667781390,755,551
3792276109,3685436860,1642680612,1642680922,310,2061
3935657002,3402898882,1647674387,1647675209,822,4009
3032880460,3973462158,1661882385,1661882900,515,3882
3591219624,3911655993,1645639578,1645640306,728,315
3131319021,3700026466,1661564173,1661564230,57,4477
3852054864,3481000823,1643529132,1643529190,58,3806
3461719660,3880629692,1658191682,1658192539,857,4026
3078719288,3814308150,1666438155,1666439070,915,2763
3378931938,3925294188,1667817773,1667818315,542,808
3794370946,3000248235,1652586857,1652586940,83,3482
3706272145,3083809311,1644540063,1644540916,853,1238
3149834452,3404827782,1654121819,1654122264,445,3308
3706463258,3585215907,1666438950,1666439608,658,1357
3689444295,3821021657,1662976037,1662976090,53,4947
3271542185,3859875949,1648723996,1648724194,198,1106
3555671070,3090781090,1668013183,1668013971,788,262
3318427160,3565448295,1642080244,1642080996,752,1931
3502882074,3613084499,1644594970,1644595492,522,1489
3843992751,3879610924,1653301038,1653301918,880,1028
3418424682,3815240235,1641576073,1641576947,874,4227
3976301880,3094701660,1665154993,1665155103,110,1006
3694238156,3935480285,1663649783,1663650180,397,1513
3431125051,3273026392,1641367977,1641368003,26,643
3606573323,3396422672,1654046164,1654046322,158,579
3895474864,3437453624,1659050860,1659051256,396,3187
3541843055,3983801015,1651235883,1651236168,285,4116
3063409869,3682558979,1647417539,1647417562,23,4264
3953842547,3411698710,1657765459,1657765495,36,4553
3639381647,3208882388,1663389983,1663390520,537,1468
3673588211,3253913478,1662995460,1662995774,314,3806
3859294959,3424750969,1651199149,1651199798,649,3738
3559281202,3175097142,1647631351,1647631810,459,3885
3790073082,3340917511,1654282359,1654283096,737,1765
3827529634,3095798503,1643434669,1643434722,53,3737
3973753041,3433653912,1668284340,1668284589,249,955
3079053296,3253792795,1656414048,1656414721,673,3380
3567274066,3978329074,1655282883,1655283759,876,1970
3946392500,3382863391,1650175922,1650176281,359,2004
3860603440,3060206169,1654051947,1654052474,527,1168
3006464137,3806900901,1643212089,1643212802,713,3484
3541616155,3883303839,1649390443,1649391176,733,4581
3771873834,3183225593,1648652860,1648653307,447,323
3476514630,3543208645,1655600156,1655600783,627,1617
3736684652,3931328480,1665790844,1665791823,979,263
3117421949,3450707838,1663790092,1663790464,372,1193
3254637510,3628384586,1657968868,1657969050,182,1078
3817716275,3124299765,1648341266,1648342069,803,1817
3261446069,3927026686,1645726345,1645726660,315,1909
3440941042,3425350335,1642248170,1642248993,823,824
3569441472,3514120076,1665455497,1665455575,78,3061
3993841688,3221415790,1648407078,1648407494,416,2273
3613679040,3090901098,1660467310,1660468146,836,3678
3347506051,3928449136,1645779133,1645779707,574,4619
3956974503,3117310728,1653694351,1653694730,379,128
3083074676,3580599484,1668943929,1668944434,505,4252
3333010243,3801083412,1659820444,1659820692,248,427
3857737525,3711803550,1651596769,1651597340,571,1541
3889211526,3220952063,1657317483,1657317913,430,4590
3124066014,3658627082,1654486051,1654486519,468,3444
3570595023,3291991263,1662103037,1662103778,741,1047
3727628991,3243411778,1650003304,1650003934,630,1124
3684372833,3073090807,1652365346,1652366139,793,2393
3359079048,3496881187,1660847776,1660847784,8,2757
3417939058,3442895723,1663070374,1663070413,39,3593
3061083947,3656635748,1664526778,1664526919,141,2017
3825649068,3977580927,1656431038,1656431608,570,2356
3608573353,3510987628,1642501011,1642501210,199,2747
3541980122,3458518544,1652898852,1652899816,964,297
3083077234,3777772210,1659492677,1659493231,554,1488
3317016080,3453149003,1667847482,1667848048,566,3956
3024874821,3420029790,1641241660,1641242509,849,530
3031092513,3179508870,1668025634,1668026099,465,1334
3861499417,3720924319,1663854757,1663855739,982,3397
3483450771,3235746341,1651772223,1651772980,757,4667
3403284622,3571618691,1645521990,1645522294,304,3590
3809072311,3014560378,1651907472,1651908188,716,1782
3478268289,3737390932,1647532641,1647532811,170,4691
3204150036,3580567300,1660047147,1660047303,156,579
3074964997,3149444613,1656281827,1656282199,372,1339
3281113315,3271096147,1668230997,1668231099,102,277
3995169221,3391499986,1648233233,1648233602,369,1454
3401159219,3547587979,1664832461,1664833231,770,4957
3853073743,3653711353,1649193055,1649193781,726,1661
3661414524,3744559481,1660478697,1660478965,268,1784
3535503264,3096509601,1649118671,1649118864,193,2876
3685946257,3389892787,1642200683,1642201450,767,3724
3552933097,3167547770,1655916718,1655917495,777,3789
3081961517,3630623050,1666734551,1666735119,568,4256
3951396407,3689231557,1646298383,1646298621,238,4581
3087260916,3183912697,1644259924,1644260485,561,4045
3348593736,3150833362,1666130906,1666131838,932,3215
3219971651,3109230084,1643511724,1643512055,331,3143
3046911291,3394962825,1664756976,1664757428,452,553
3828110239,3303697434,1666833865,1666833990,125,3780
3459251258,3421158224,1652149972,1652150193,221,2310
3883017440,3802644627,1643547979,1643548304,325,1507
3832834035,3204940253,1669027573,1669027633,60,4350
3910506243,3742656130,1653132834,1653133035,201,1463
3495312495,3598292834,1651997341,1651998262,921,3283
3131928871,3096796071,1645295208,1645295928,720,4764
3381679879,3939924025,1660447838,1660448000,162,4316
3758944968,3892437307,1659364691,1659364741,50,1990
3675424615,3735134697,1642301865,1642302373,508,3609
3317150444,3392090286,1655799881,1655800817,936,3465
3303849685,3115429164,1653832437,1653832481,44,1606
3568647625,3384030137,1654656993,1654657711,718,3749
3468858374,3931363583,1642744412,1642745053,641,135
3360686365,3193927135,1660676803,1660677210,407,1795
3464584976,3998860780,1641670446,1641670743,297,2979
3269028656,3729002894,1645368241,1645368648,407,2507
3481841923,3069252539,1646184022,1646184725,703,3844
3558370378,3777562161,1659533692,1659534327,635,2900
3232947580,3589840486,1665304006,1665304075,69,1818
3970746839,3434157391,1662477845,1662478330,485,1407
3536514731,3586714343,1652988481,1652989205,724,354
3061259288,3714613662,1645980352,1645980818,466,4388
3077706830,3478504370,1659858006,1659858601,595,4303
3155153365,3753033363,1646635489,1646636078,589,2873
3859484727,3175132637,1658628735,1658629287,552,3448
3889753480,3084444347,1647032774,1647033519,745,2807
3810288559,3247018258,1648535595,1648535851,256,4054
3521138429,3789661647,1643028744,1643029531,787,4873
3125907037,3162098531,1664626997,1664627024,27,4146
3763385424,3041900393,1656987559,1656987981,422,2781
3767930506,3312473718,1643082073,1643082917,844,3241
3168743384,3268148771,1661919069,1661919146,77,1541
3179317449,3094856193,1647680422,1647681300,878,2963
3202041756,3657572577,1654236146,1654237095,949,4141
3593446198,3866049112,1661985732,1661986404,672,4050
3643146380,3477320668,1645213893,1645214496,603,4388
3291991263,3118116155,1668522843,1668523221,378,4177
3829770307,3725033796,1660432203,1660432841,638,2004
3180820900,3902743228,1648173815,1648174692,877,1762
3754050527,3338711283,1666637704,1666637704,0,489
3775216453,3426995294,1652413051,1652413312,261,4298
3457815499,3949762205,1650092904,1650093531,627,2140
3082823143,3422655967,1664090584,1664090695,111,1385
3045293045,3146648924,1653556398,1653556872,474,461
3049366364,3292094383,1664126628,1664127362,734,4893
3069653549,3735474472,1661937503,1661937831,328,2156
3841596953,3743490821,1648104633,1648105429,796,2129
3456326017,3615147933,1646957678,1646957810,132,1725
3584424211,3140923726,1661033842,1661034498,656,3341
3792543052,3360686365,1649679702,1649679912,210,2787
3087346595,3804097229,1663422240,1663423084,844,2058
3849585054,3536119139,1648597152,1648597960,808,530
3207618376,3601452441,1657701117,1657701309,192,4938
3425594776,3009919402,1666302694,1666302757,63,416
3853590826,3370847861,1652058706,1652059155,449,1140
3470783033,3424191832,1663037158,1663037571,413,1683
3919040659,3293055282,1653727344,1653727493,149,2108
3828784944,3514774040,1647578965,1647579565,600,3574
3911071601,3072171157,1654136141,1654136208,67,2121
3420175722,3607137390,1646676376,1646676694,318,528
3984137223,3011510623,1643949374,1643950042,668,2177
3876344947,3966829660,1659604405,1659604565,160,2585
3920298601,3672846747,1665618007,1665618256,249,2876
3180832705,3322347665,1663037046,1663037112,66,1155
3874664799,3221473509,1656465686,1656466085,399,2729
3778100048,3228171291,1641899451,1641900377,926,399
3072061712,3628751161,1668294493,1668295439,946,2177
3742380227,3764001778,1646351580,1646351674,94,3352
3118074522,3293732414,1658329604,1658330044,440,2744
3394827528,3695225697,1667152254,1667152717,463,758
3517838274,3458286194,1657576442,1657577327,885,333
3439056198,3956459188,1656453256,1656453778,522,2123
3762638994,3930480302,1661628420,1661629418,998,3911
3172367634,3029330071,1663493379,1663493662,283,1077
3614667018,3766976578,1642771959,1642772844,885,768
3606553862,3675124924,1659439856,1659440115,259,3289
3902589701,3875584454,1649461522,1649461610,88,1205
3912867876,3095268261,1645053710,1645053906,196,2569
3997613157,3389132837,1650711233,1650712230,997,3984
3901910175,3106927689,1667899525,1667899635,110,4183
3809825295,3888994572,1647591705,1647592321,616,2288
3951352387,3844729020,1661340323,1661340789,466,4993
3232273801,3681356450,1664416957,1664417660,703,2567
3040807534,3344005191,1665833974,1665834645,671,2917
3274971479,3454253501,1645388171,1645388904,733,4980
3564650850,3193654816,1644274422,1644274650,228,4843
3910127594,3728913669,1668799373,1668799721,348,524
3575869325,3108679688,1665514729,1665515590,861,3500
3303630987,3081811367,1660531741,1660532548,807,3918
3396885995,3527648712,1666043252,1666044198,946,1789
3623777627,3610743372,1644566720,1644567614,894,1036
3174671043,3713920144,1655331641,1655331993,352,1783
3664141685,3937837553,1654229379,1654229709,330,2131
3254187859,3216674636,1665577812,1665578618,806,1149
3092366477,3806650542,1665893655,1665894528,873,4717
3608649039,3138702223,1645155222,1645156116,894,535
3747662701,3885345387,1642100503,1642101490,987,3668
3503490921,3578495174,1659682435,1659682620,185,1932
3395154963,3409554521,1652062621,1652062703,82,2153
3804741264,3238252679,1649661168,1649661323,155,1468
3448978952,3457816580,1654857410,1654858014,604,3889
3831613719,3429140385,1653158049,1653158566,517,3533
3056859634,3202560106,1659167760,1659168554,794,4141
3693759420,3243496269,1653147850,1653148043,193,4684
3559783311,3947134120,1648479251,1648479312,61,4193
3406793991,3310153295,1660986123,1660986896,773,2602
3365722403,3526849039,1666759450,1666759494,44,1196
3650072854,3178881017,1663544531,1663544785,254,1701
3322446846,3455419281,1657717939,1657718517,578,2537
3439070644,3052187349,1655970240,1655970297,57,2100
3179599159,3616903644,1653572686,1653572722,36,4442
3754321119,3413814367,1651341363,1651341762,399,2717
3691976720,3094747684,1660957272,1660957518,246,3758
3654540190,3045168364,1662222254,1662222818,564,4997
3550276637,3299786381,1661896821,1661897536,715,3676
3229470789,3851245476,1653546202,1653546306,104,2818
3561233568,3362539931,1655536558,1655537357,799,1269
3800107297,3096905200,1666556082,1666556794,712,446
3679798005,3359303604,1647924989,1647925535,546,1950
3953695222,3216201224,1658977976,1658978689,713,452
3911135862,3076149612,1660898501,1660899336,835,259
3867711537,3282627521,1667340883,1667340948,65,3808
3697324368,3082970109,1662520433,1662520635,202,2748
3585543296,3897367580,1641749460,1641750252,792,2563
3172260751,3479396223,1659479237,1659480058,821,4207
3266212806,3790402100,1646431345,1646431764,419,2525
3654927119,3938114446,1655890793,1655891597,804,1022
3915257407,3623961794,1641038511,1641038817,306,3372
3203017250,3215724482,1654771165,1654772084,919,4970
3722593835,3374443725,1641710045,1641710099,54,2717
3755600495,3448418475,1651632249,1651632668,419,1156
3671477002,3184271512,1649366226,1649366758,532,1887
3371412374,3940166421,1668962146,1668962893,747,3028
3185056159,3193131854,1663780062,1663780984,922,4996
3292736964,3013011856,1660145978,1660146225,247,4112
3875281115,3336075887,1642724068,1642724904,836,4778
3804870279,3604573450,1652349412,1652350208,796,65
3819981613,3587306879,1663517522,1663518331,809,350
3175305380,3782044819,1668736811,1668737199,388,3986
3210418313,3974194002,1652890639,1652891206,567,2398
3019310843,3542081697,1652429019,1652429674,655,2621
3396197103,3534481835,1645896286,1645897201,915,1153
3366453099,3530406495,1653568609,1653568684,75,1575
3110083295,3652520634,1643407985,1643408661,676,538
3168607678,3471083661,1664422297,1664422963,666,2669
3475730185,3167053305,1654018287,1654019127,840,4765
3143692502,3440543378,1659768656,1659769202,546,4096
3478025831,3142208537,1660053359,1660054340,981,2077
3513638658,3090045346,1645742368,1645742970,602,400
3807693592,3545754464,1655126240,1655126410,170,3118
3075124344,3150592107,1669178035,1669178663,628,4549
3081152155,3153745256,1665527616,1665527915,299,184
3695894799,3523690678,1648680872,1648681582,710,2563
3032880460,3417478263,1641163983,1641164121,138,1022
3489170963,3192646112,1643534855,1643535068,213,2997
3082027526,3650341114,1651121485,1651121735,250,4248
3143841651,3900640910,1666522862,1666523678,816,1121
3699434698,3139666034,1653698027,1653698431,404,4272
3379542492,3117028459,1660867179,1660867964,785,4070
3905453277,3726907881,1643066998,1643067917,919,329
3947490437,3203014376,1660344054,1660344650,596,584
3099717179,3450787589,1658850535,1658851022,487,1745
3855125161,3259208382,1667885421,1667885697,276,1973
3241895383,3102654799,1645133782,1645133968,186,593
3442784720,3060297315,1664802547,1664802801,254,3344
3330558147,3561178011,1669665625,1669666356,731,2068
3443835417,3786583756,1664183131,1664183825,694,2492
3241837303,3953795786,1643434641,1643434774,133,1674
3838979104,3712790112,1659721654,1659722538,884,293
3270091447,3680628394,1657985941,1657986759,818,4644
3289032376,3046290148,1663880308,1663881046,738,1075
3548128156,3495645457,1650069839,1650070808,969,3717
3165396996,3452952503,1661724392,1661725254,862,212
3101429770,3085324044,1651464046,1651464440,394,989
3733959624,3995355430,1645657154,1645657932,778,4085
3714858578,3459933434,1644207767,1644208220,453,2774
3395237646,3312050281,1645187994,1645188452,458,1946
3043986799,3218591816,1655082315,1655082868,553,4695
3817466298,3318381278,1650249191,1650249356,165,4260
3720117772,3097787031,1662867655,1662867843,188,2814
3402037509,3769034625,1647956500,1647956837,337,3557
3172894527,3943462221,1644767588,1644767783,195,2240
3075547302,3261965161,1654085061,1654085660,599,4293
3693584788,3158394960,1660068892,1660069787,895,3986
3582612378,3320160333,1652818228,1652818796,568,39
3254782349,3142868309,1661836484,1661836791,307,3738
3101376605,3449856885,1655158804,1655159215,411,2882
3815313271,3630700709,1664355144,1664355928,784,3988
3332959729,3890829269,1643828271,1643828492,221,4761
3853437304,3247946934,1650382981,1650383189,208,4448
3668892410,3113383628,1645408469,1645408718,249,778
3844279103,3259370815,1665755983,1665756257,274,2749
3328105106,3361608690,1668687922,1668688055,133,2647
3585962670,3340388478,1654470593,1654471538,945,3817
3107201408,3418078700,1651974786,1651974805,19,3866
3350227654,3543842056,1647787847,1647788505,658,4147
3996623251,3882360636,1658309564,1658310562,998,1826
3055063771,3874491484,1664409842,1664409975,133,2573
3840099439,3123499289,1656561795,1656562272,477,1469
3660101266,3775336064,1659152145,1659152882,737,3692
3525953481,3964890365,1661455564,1661455755,191,3123
3000260329,3142740089,1659017754,1659018107,353,1300
3607595547,3804299472,1642809881,1642810815,934,183
3701953101,3873735785,1666708970,1666709616,646,4339
3653725635,3515494616,1648853009,1648853827,818,2299
3506532607,3411168815,1649889409,1649889929,520,3620
3857770896,3710949404,1653900995,1653901375,380,4676
3130539505,3283173348,1652855430,1652855469,39,933
3172923300,3026311350,1657433815,1657433834,19,4341
3024460069,3113442014,1653602692,1653603144,452,2750
3499323103,3153873767,1643476319,1643476336,17,4711
3116249804,3089516860,1660181373,1660181982,609,2949
3687109715,3139377155,1646647132,1646647843,711,2474
3322622306,3921356092,1649639467,1649640298,831,3666
3563678352,3877481442,1657862719,1657863155,436,4171
3636311225,3535599168,1667980202,1667980575,373,4970
3173784614,3311435245,1668964751,1668965370,619,1519
3545477421,3294031778,1643549602,1643550144,542,187
3168679235,3938080049,1642645448,1642645766,318,3291
3374584372,3212754887,1646231085,1646231807,722,1944
3767131657,3086228984,1660096450,1660096918,468,4791
3571256897,3179864411,1653249214,1653250078,864,1391
3568772963,3274780089,1647394275,1647394520,245,3766
3010538475,3780566660,1641579423,1641580416,993,4136
3532345923,3075846175,1646958494,1646959361,867,1553
3995467650,3924467261,1642710307,1642710924,617,553
3992612218,3504955473,1642866831,1642866943,112,4304
3935185752,3522291028,1651416256,1651417161,905,2603
3828261511,3563307036,1647216997,1647217981,984,3801
3244909566,3446795417,1667833239,1667833643,404,4837
3899265189,3561562308,1651740743,1651741091,348,841
3143002878,3040661285,1668632177,1668632483,306,3007
3319568787,3352042834,1641080934,1641081582,648,2815
3800397775,3008824019,1655749083,1655749998,915,4614
3590057826,3207298990,1663559114,1663559902,788,582
3339833232,3327548384,1644386431,1644387400,969,2118
3004861657,3376182698,1645892259,1645892981,722,2861
3928777340,3159383504,1643734502,1643734504,2,25
3175499371,3725015575,1648125955,1648126426,471,1709
3117576935,3714912933,1653612279,1653613276,997,1165
3270037911,3843617139,1647622094,1647622669,575,1733
3957835206,3829160999,1655827027,1655827818,791,1027
3170303894,3479461401,1648794922,1648795643,721,2598
3132235214,3237141858,1641347863,1641348129,266,3049
3115737467,3695523367,1664111458,1664111939,481,4792
3778524560,3733706666,1649289853,1649290684,831,2430
3138842106,3563758204,1649921215,1649922144,929,3186
3002489974,3433938928,1667165391,1667166254,863,3474
3508278732,3025396159,1657358820,1657359294,474,2660
3642652657,3829824772,1659331539,1659331540,1,194
3860670862,3745203131,1651274300,1651275249,949,4378
3407857370,3635401784,1644273663,1644274591,928,1408
3611121019,3844992831,1653928030,1653928686,656,312
3905955810,3808648109,1660518504,1660518837,333,988
3868262620,3384368615,1650048882,1650049111,229,4566
3250966722,3367402445,1668824581,1668825414,833,327
3638534988,3537783466,1646502271,1646502666,395,90
3686884624,3384130210,1643814204,1643814654,450,4518
3701126500,3729732241,1642313474,1642313486,12,4761
3168743384,3183302811,1659554482,1659554631,149,4720
3360056383,3578222656,1646198051,1646198245,194,3164
3238320201,3636413229,1660112309,1660112731,422,1361
3075398084,3351961998,1656364047,1656364375,328,3475
3839783802,3802195833,1661236048,1661236421,373,2023
3406804114,3655532527,1649199926,1649200258,332,132
3175273902,3875751295,1644966587,1644967373,786,2683
3286875767,3250448149,1660922114,1660922130,16,4593
3673171887,3572702667,1668328400,1668328490,90,3563
3454533373,3393000549,1667784609,1667784709,100,660
3809072788,3528803946,1669264504,1669265432,928,2961
3374601543,3365986973,1644395691,1644395967,276,3037
3204370077,3453519646,1665646872,1665647289,417,693
3926263454,3088450370,1652124636,1652124797,161,2404
3220861766,3961013117,1668061303,1668061799,496,2976
3080101311,3760898228,1652278349,1652278350,1,2893
3225647684,3054625154,1641899302,1641900240,938,1646
3144464316,3760120984,1648059112,1648059799,687,1532
3523678483,3943406702,1669190764,1669191639,875,546
3925427784,3446554130,1667430378,1667430886,508,2071
3189994722,3201280383,1663676659,1663677605,946,4947
3246968651,3789891437,1657967432,1657968107,675,3962
3205092970,3340109597,1645385554,1645385815,261,2162
3993245941,3132684710,1658003648,1658004485,837,3387
3694949646,3395941659,1655768763,1655769630,867,1594
3953322552,3216245837,1651884842,1651885092,250,364
3097589748,3197991826,1657914998,1657915611,613,689
3386420786,3323744835,1644189875,1644190669,794,1765
3825405054,3727198518,1649457935,1649458274,339,4395
3875444627,3363357001,1644849030,1644849243,213,3560
3202903414,3836781591,1644099962,1644100651,689,4827
3238476226,3433075669,1651337965,1651338724,759,2736
3673775226,3005304983,1655898215,1655899146,931,1671
3268781528,3278129796,1656723947,1656724269,322,672
3579874854,3686066203,1656219959,1656220145,186,4088
3189582728,3608184535,1657342808,1657342857,49,4314
3013889616,3523651249,1643822828,1643823752,924,4667
3708599252,3489825168,1658339282,1658339782,500,3170
3205875437,3164825814,1663050084,1663050732,648,950
3711734221,3511251286,1654033574,1654033851,277,2760
3764489792,3563714007,1655736036,1655736057,21,1702
3753326211,3638177565,1667478552,1667479358,806,4524
3315337507,3460426144,1647324570,1647325216,646,4630
3589006128,3710082817,1664293907,1664294670,763,469
3944291531,3776298776,1646387448,1646388421,973,4812
3294061440,3080763759,1656409947,1656410499,552,2297
3924369876,3024918879,1664376629,1664376632,3,3268
3107797706,3735771445,1668680717,1668680974,257,1638
3839686838,3489310322,1663037785,1663038131,346,1687
3740822791,3833259388,1656542797,1656543215,418,2982
3561178011,3674883294,1653225980,1653226453,473,3332
3158982885,3824091105,1643165329,1643166256,927,2512
3909761840,3706255143,1648297864,1648298257,393,1341
3601277359,3257848054,1653673809,1653674370,561,1071
3740020651,3407478959,1649274170,1649274533,363,1187
3123277770,3176543755,1651116640,1651116643,3,4755
3604457911,3008625343,1659586037,1659586463,426,2852
3760438658,3094580842,1649479348,1649479357,9,185
3633428273,3010699341,1646417281,1646417571,290,2382
3963088715,3865051639,1655271017,1655271407,390,2812
3915131148,3524780325,1657889125,1657890025,900,1203
3372394754,3318651224,1644799539,1644800358,819,3517
3557056575,3056427193,1662947143,1662948102,959,1847
3904148312,3569147692,1641948548,1641949351,803,2115
3890501078,3006553976,1669511236,1669512128,892,3276
3000925385,3483605950,1644914893,1644915161,268,928
3832772998,3809576141,1650645728,1650646546,818,4560
3516446984,3169808958,1658003108,1658003753,645,3196
3125556151,3231874101,1664399115,1664399736,621,3403
3901346643,3118136904,1647232529,1647233251,722,4203
3892121986,3325494172,1655883478,1655883577,99,3802
3512712981,3597632549,1665368956,1665369294,338,2777
3222970366,3676886812,1665536031,1665536815,784,2108
3750878999,3183654612,1660689939,1660690388,449,2834
3386474801,3092529181,1660135483,1660136138,655,4062
3214174738,3336979638,1661230920,1661231440,520,3551
3108698747,3793611914,1648854348,1648854409,61,1368
3005568139,3443654027,1646857870,1646857988,118,1432
3458596730,3383274677,1662426518,1662427484,966,3292
3919579039,3563960739,1656760545,1656761543,998,4539
3346389906,3391354986,1658338659,1658338844,185,4153
3973317582,3055401845,1649547945,1649548626,681,1172
3065226488,3294294359,1644426791,1644427583,792,2376
3520568409,3456086980,1658306509,1658306850,341,3302
3501285772,3666543217,1661220147,1661220750,603,1317
3309363836,3200377538,1668686374,1668687254,880,2394
3484626337,3319617947,1653845411,1653845582,171,642
3646281148,3874722035,1642972241,1642973230,989,254
3060816444,3697813071,1668563613,1668563835,222,3190
3403171483,3211466666,1647432046,1647432311,265,4548
3142224139,3957528101,1656608293,1656609161,868,1422
3076000062,3266566393,1663553891,1663554672,781,1097
3742888906,3549446558,1664610861,1664611456,595,1951
3511100240,3311824678,1645862370,1645862765,395,555
3875460840,3420950230,1642395249,1642395831,582,901
3493364973,3976031127,1668553080,1668553251,171,3769
3589502112,3299061588,1660721520,1660721988,468,2095
3268060116,3504377968,1650128832,1650129559,727,4755
3024717832,3524862314,1642262159,1642262213,54,1804
3792824540,3171799255,1642792847,1642793615,768,3199
3956510642,3939126454,1644125818,1644126669,851,1391
3583938191,3398080573,1655419675,1655420399,724,2123
3536566015,3341686802,1669182505,1669183234,729,3254
3632526439,3057402484,1643065449,1643065829,380,695
3103470936,3423049778,1664406121,1664406901,780,4044
3479290090,3043059031,1668806000,1668806195,195,3969
3303591589,3493988000,1668040954,1668041691,737,4837
3208127603,3700260953,1650677902,1650678311,409,817
3467130556,3239667517,1654272976,1654273320,344,4277
3940752714,3400731922,1656735841,1656735914,73,4823
3705108011,3573171734,1657451275,1657452088,813,2811
3454642414,3342108934,1641807119,1641807842,723,2724
3515609832,3704139956,1656496358,1656496522,164,2619
3252294819,3940735351,1641350665,1641350723,58,2905
3677106509,3227657037,1653378508,1653379316,808,2096
3129342432,3306643496,1665744177,1665744350,173,4110
3866276289,3457266955,1665360234,1665361095,861,123
3594370879,3534919289,1663740911,1663741502,591,4888
3081496630,3152840399,1657633810,1657634794,984,69
3486142606,3794665153,1662470491,1662471358,867,876
3532645740,3068780367,1651926429,1651926713,284,200
3031345942,3629714114,1647260346,1647261340,994,2782
3194589251,3372936694,1653165564,1653166045,481,2209
3472589912,3395507412,1666883050,1666883608,558,3791
3285210608,3625456529,1645838348,1645839236,888,4259
3527039876,3705589380,1652202478,1652202698,220,4182
3031818801,3316684934,1662114543,1662114789,246,420
3210200789,3704089554,1648771476,1648772270,794,462
3697301333,3363818107,1664424141,1664424880,739,4915
3320455638,3492176160,1656572942,1656573440,498,4331
3190396816,3014328258,1655012955,1655013873,918,4598
3292349573,3219013910,1645090348,1645090515,167,3032
3312932954,3542188681,1665291250,1665292243,993,1683
3827504446,3512604979,1650380695,1650381455,760,2928
3494943858,3269705875,1646123559,1646123606,47,2003
3423404694,3048593520,1660928844,1660929054,210,1881
3666345389,3238867282,1647721115,1647721795,680,1213
3376901552,3235505257,1656375763,1656376674,911,4972
3800139278,3863708382,1645899133,1645899240,107,4509
3024099780,3278846174,1659037342,1659037463,121,1793
3254431462,3783782548,1641926418,1641927062,644,4470
3942059854,3594464311,1664853620,1664854380,760,2958
3069029103,3417628236,1643589452,1643590286,834,3970
3606953030,3756501396,1651884991,1651885683,692,1026
3591710539,3547587979,1655353707,1655354349,642,4248
3890916538,3599657940,1646834405,1646835156,751,197
3382760465,3773747698,1664724368,1664724930,562,1848
3814771858,3898318606,1642265816,1642266622,806,4855
3537831923,3723201186,1663094762,1663095746,984,4500
3559142177,3336057266,1663424173,1663424407,234,4236
3420865163,3607860424,1659618529,1659619396,867,4858
3655043782,3067149929,1667866626,1667867188,562,475
3054856129,3554200592,1661145075,1661145528,453,2845
3733080746,3516983531,1663634623,1663635510,887,2779
3492004766,3796997887,1657411545,1657411973,428,1598
3778466051,3307511619,1656952282,1656952289,7,2831
3999834946,3790494711,1647844045,1647844331,286,4477
3499932593,3223698813,1654474432,1654474505,73,462
3619173340,3147165666,1646073843,1646074103,260,204
3126903373,3462253758,1649684896,1649685548,652,1069
3987052343,3673718908,1647564908,1647565191,283,4145
3932985358,3796146265,1666284991,1666285130,139,3754
3816958419,3393169503,1663592368,1663592783,415,4363
3816250291,3584855745,1645028383,1645028699,316,1464
3289682032,3855077149,1664756491,1664757483,992,1356
3521435743,3145593691,1663532295,1663532800,505,2837
3341148108,3346848840,1641373450,1641373625,175,3299
3787211069,3336469388,1655046212,1655046993,781,3129
3942094629,3727803947,1661302426,1661302568,142,1019
3738652889,3016365798,1659948711,1659948892,181,383
3008704930,3571085325,1642174933,1642175803,870,4474
3471464964,3080509717,1663844423,1663845228,805,2186
3141002422,3482419877,1646338496,1646338505,9,673
3317927034,3645760963,1658428970,1658429098,128,3473
3247245837,3234672453,1646663618,1646664259,641,3314
3346893152,3003657813,1658819874,1658820320,446,2572
3804668537,3139850302,1653654142,1653655019,877,4183
3465105860,3433410703,1650756921,1650757425,504,2994
3171338130,3994533627,1642028769,1642029711,942,1172
3320112038,3287185333,1657708193,1657708264,71,3576
3538281221,3691566991,1656040537,1656040614,77,3750
3229145940,3325192379,1653738387,1653738737,350,1490
3161462204,3426500676,1662045568,1662046371,803,2181
3279021672,3960158491,1644951085,1644951497,412,3
3778862849,3796458887,1666214444,1666215399,955,1149
3698243099,3965120862,1650545668,1650546642,974,1590
3479866469,3372554784,1666827172,1666828016,844,332
3672484120,3223773659,1653322762,1653323610,848,3862
3737098411,3767794557,1669136123,1669136212,89,3841
3366453099,3264233763,1651370485,1651370739,254,3442
3476285841,3224641955,1656890722,1656891310,588,4082
3764610867,3284078810,1666730200,1666730685,485,1073
3228459185,3146074715,1657452135,1657452769,634,4175
3852601060,3984822975,1650161337,1650161701,364,1911
3486645535,3406980090,1657385187,1657385666,479,1082
3789446593,3583315317,1666234963,1666235562,599,3162
3075770953,3301620193,1653093711,1653094606,895,4460
3996156351,3019922898,1657919426,1657920338,912,1407
3625194498,3352968644,1664989952,1664990031,79,4454
3494209957,3737047212,1656614059,1656614797,738,2110
3643345511,3250870693,1644507630,1644507982,352,2698
3766823413,3335727983,1653502684,1653503141,457,382
3087924540,3421217854,1669545866,1669546633,767,3963
3156414954,3372998014,1665719397,1665719908,511,4908
3818919641,3285101489,1656318523,1656318743,220,4325
3373704663,3852956395,1657387828,1657387999,171,2546
3370414924,3730849380,1643804975,1643805673,698,1882
3317451484,3219119197,1667182001,1667182689,688,3378
3563197528,3651527248,1665205724,1665206538,814,3291
3482768971,3949807139,1654886560,1654886985,425,39
3316312609,3029009072,1643018996,1643019390,394,581
3925203183,3322004826,1664006976,1664007503,527,1327
3835850395,3069848950,1659972529,1659973330,801,649
3488929976,3051223929,1661121070,1661121796,726,4383
3113487354,3025019949,1668062809,1668063620,811,2335
3315209236,3965990120,1642513500,1642513791,291,2301
3407121093,3203583172,1663751756,1663751985,229,4225
3412074791,3023207261,1647823210,1647824112,902,1133
3506469857,3591611058,1644530702,1644531150,448,1307
3420899323,3591722120,1666023632,1666023874,242,2793
3485350463,3621771926,1660854794,1660855013,219,4626
3092592883,3413942815,1652603142,1652603467,325,582
3890404370,3326803365,1663947544,1663947673,129,1919
3398922196,3864363231,1658171088,1658171535,447,3546
3037978061,3257320255,1668584805,1668585561,756,4054
3122201865,3164197754,1647081548,1647082330,782,3669
3632454018,3269017260,1668371166,1668372096,930,3125
3440623322,3075782493,1668775874,1668775975,101,2991
3966732336,3245166473,1658080801,1658081201,400,2905
3090805195,3162435695,1649292628,1649293564,936,2283
3480131178,3600785993,1659056576,1659057325,749,2216
3976828104,3792990979,1664817440,1664818178,738,3936
3521391257,3393033642,1648267652,1648268625,973,2341
3741482073,3941304016,1654681268,1654681304,36,259
3312473718,3719672882,1646299277,1646299753,476,1762
3966462386,3710495816,1666514437,1666514689,252,3343
3357431353,3027206398,1647852920,1647853648,728,4828
3419968811,3244252611,1667500952,1667501705,753,2972
3961024801,3200941723,1658700459,1658700489,30,94
3308383909,3443665239,1665357963,1665358111,148,3546
3076883893,3716027130,1658518897,1658519676,779,780
3158711994,3108290265,1669471877,1669472089,212,1353
3338323573,3668988695,1647445167,1647445287,120,3441
3853242415,3319475794,1668974634,1668975613,979,3621
3518022492,3996454327,1654413442,1654414301,859,2321
3076821662,3994511673,1659264992,1659265671,679,1104
3582898883,3054424435,1666248007,1666248063,56,4405
3592880981,3852873909,1659639147,1659639452,305,1839
3702465059,3251128195,1657713700,1657714069,369,3519
3328278775,3452799582,1663813747,1663814581,834,188
3145294397,3358202917,1654033343,1654033957,614,1732
3499819904,3253967097,1655600274,1655600491,217,3018
3880064346,3684731486,1659297026,1659297576,550,2053
3532544666,3961417157,1666162646,1666162997,351,1885
3561906699,3461943902,1660581738,1660581918,180,339
3088958883,3607676806,1651040042,1651040292,250,3882
3054147970,3783283475,1664195120,1664195684,564,350
3311316281,3245166940,1652303349,1652304200,851,1657
3637217452,3966768625,1654092379,1654092715,336,2166
3490663129,3605098388,1647867722,1647868450,728,4307
3738413879,3866318308,1653248336,1653248444,108,2369
3697784923,3233491178,1648796031,1648797008,977,800
3977186146,3083658616,1654118053,1654118490,437,1858
3467147707,3006647556,1647085637,1647086187,550,1189
3598752083,3447656188,1642697112,1642697181,69,1755
3422492244,3679146251,1667640212,1667641154,942,4307
3714829728,3002736537,1641574751,1641575383,632,2716
3799393607,3305712713,1661532404,1661532816,412,3128
3678507766,3896101455,1664872845,1664873571,726,3952
3279355708,3868951425,1654863235,1654863560,325,536
3671601284,3073610679,1668939941,1668940170,229,3856
3937474637,3442017285,1657632569,1657632751,182,592
3467324527,3525104901,1666947142,1666947432,290,4247
3138308720,3985810750,1654813813,1654813843,30,3221
3500281781,3671401598,1650250774,1650250921,147,2308
3902159288,3905799852,1650275909,1650276653,744,2852
3721146202,3762026030,1642381342,1642382230,888,2376
3502899556,3012780748,1650639773,1650640519,746,2449
3307914407,3445304569,1648220258,1648221043,785,3836
3064062428,3362525662,1660698127,1660698936,809,4130
3153873767,3243515582,1649679656,1649679990,334,503
3159715043,3945707270,1651196081,1651196942,861,4752
3485513545,3632521261,1650613998,1650614431,433,807
3056779528,3854705795,1661555426,1661555694,268,1267
3200139454,3838510194,1651201617,1651202298,681,1062
3961887261,3188512404,1647096210,1647096270,60,4872
3592712415,3972746765,1656341168,1656341543,375,4736
3784989805,3726907881,1655872369,1655872524,155,701
3246327567,3140589036,1668865154,1668865617,463,2521
3822360438,3022925198,1643335074,1643335503,429,4721
3321731828,3137690277,1652717819,1652718340,521,2394
3458042525,3989656059,1650331431,1650331729,298,1043
3259080400,3888263752,1645099344,1645099525,181,4738
3555820391,3350141652,1643701582,1643702570,988,2972
3508074321,3180819008,1643203136,1643203542,406,3330
3425662854,3772541673,1641211327,1641212218,891,1463
3141256348,3864571681,1663508161,1663508683,522,3248
3329827457,3893725093,1657283774,1657284550,776,4721
3072800133,3426770614,1656917650,1656918128,478,297
3275694990,3157930168,1657250062,1657250231,169,1287
3492004766,3589215525,1661227832,1661227974,142,2012
3932988011,3401913809,1646173009,1646173634,625,484
3517896589,3287473999,1655684573,1655685441,868,2345
3659404116,3714541281,1647501285,1647501647,362,4402
3170653085,3386090894,1642117946,1642118312,366,2815
3869592212,3255979226,1650748935,1650749859,924,3501
3234037073,3107102305,1654563435,1654563648,213,3769
3581501029,3786289498,1665251367,1665252150,783,1208
3008275329,3733820361,1644856063,1644856339,276,4444
3523344143,3198632948,1644107751,1644108045,294,3814
3629253050,3684555597,1653912777,1653913235,458,930
3010796611,3902123773,1655058347,1655058593,246,1819
3561405304,3623115120,1659720950,1659721354,404,1445
3270447729,3029793208,1653168056,1653169025,969,3355
3611664990,3944209948,1652751754,1652752687,933,1371
3973196966,3694647374,1648489597,1648490212,615,4753
3129580366,3733679376,1652803422,1652804002,580,1026
3569336916,3785913456,1653018046,1653018461,415,299
3969916273,3508467149,1651756613,1651757466,853,1098
3384938932,3149389626,1659049997,1659050703,706,3692
3765440112,3239021425,1659243153,1659243661,508,2779
3431747879,3837741121,1665209293,1665209298,5,563
3274077542,3266744708,1667557055,1667558052,997,2353
3822069487,3217051580,1669578166,1669578943,777,1736
3341701232,3821082374,1657369280,1657370139,859,4158
3541170429,3742016817,1669367893,1669368220,327,3164
3298442759,3707215229,1659764554,1659765176,622,1174
3583895221,3180184614,1641851303,1641851527,224,4247
3107802207,3980809309,1649714636,1649714929,293,1216
3206185528,3993169017,1653963343,1653964138,795,578
3256758875,3438954617,1663282695,1663283429,734,70
3276159094,3270098679,1643820489,1643820735,246,867
3751612582,3233930036,1664860603,1664861439,836,4852
3422553398,3656591782,1665198944,1665199313,369,3942
3826365519,3059157075,1652385313,1652385500,187,1430
3870573246,3233009398,1643100948,1643101339,391,718
3782712445,3753740977,1659833314,1659833911,597,4400
3937996125,3455520901,1649569407,1649570012,605,2591
3441337782,3534767479,1646294433,1646294686,253,3732
3000500455,3132149630,1662504635,1662505002,367,2754
3630240378,3318387267,1653357787,1653357909,122,4682
3047799353,3206848583,1643921463,1643921827,364,1237
3445446313,3846618285,1667550312,1667550785,473,4631
3824619158,3862735850,1646401998,1646402761,763,2498
3552275616,3928638052,1662010276,1662010512,236,885
3290738844,3305896883,1663598994,1663599576,582,1375
3536379721,3555665658,1643197420,1643198363,943,2037
3032143528,3727471904,1642170055,1642170925,870,3591
3174439614,3914708655,1642823425,1642823462,37,3943
3085324044,3522342751,1662308546,1662308994,448,4718
3298973974,3402326879,1653813775,1653814495,720,1485
3476207849,3397332560,1643091414,1643092239,825,3860
3331051701,3698974401,1641984352,1641985279,927,2449
3437855357,3230983558,1647846013,1647846589,576,333
3520802494,3126193291,1646425481,1646426158,677,763
3370760537,3460121550,1662741610,1662742161,551,4502
3789499934,3071630259,1658918480,1658918596,116,4100
3822978551,3910542325,1654768888,1654769481,593,4341
3009678862,3650385205,1642198772,1642199243,471,225
3328018111,3825317290,1652610449,1652610671,222,4272
3652903434,3084640692,1652141226,1652142104,878,3890
3859666058,3025044598,1651390878,1651391649,771,386
3535861011,3894198518,1648210573,1648210835,262,907
3042077809,3731754759,1644542373,1644542595,222,3807
3792333119,3897979142,1642249059,1642249208,149,1063
3415346042,3253460222,1662344794,1662345124,330,1570
3746544022,3109600436,1655726273,1655727215,942,2826
3526535122,3070497830,1653612419,1653612913,494,4471
3765324022,3432223016,1668758750,1668759187,437,997
3955762172,3629736311,1646565543,1646566429,886,1552
3607313116,3203862936,1654330799,1654331275,476,4676
3873643737,3876540994,1649182025,1649182271,246,523
3938093985,3493043629,1663904142,1663904740,598,2651
3069467419,3181591886,1656453788,1656454180,392,2012
3927913455,3105476138,1649959123,1649959711,588,4127
3339042642,3021291752,1666229292,1666229531,239,411
3989668941,3167947616,1660854628,1660854793,165,4413
3210546201,3922345300,1644057967,1644058710,743,4883
3397965913,3112421327,1641805193,1641805788,595,1300
3439180584,3978335381,1659001140,1659001860,720,3097
3297005305,3049339075,1650423629,1650424066,437,4842
3436273122,3671871426,1666545325,1666546293,968,1088
3259219925,3652982610,1656570248,1656570976,728,170
3593035533,3317899326,1652074088,1652074335,247,4836
3814344689,3285027088,1659216500,1659216761,261,2985
3599938740,3786808098,1653301724,1653302176,452,3864
3301988068,3747203448,1654881968,1654882118,150,4743
3392211362,3525860307,1662747112,1662747709,597,576
3864571681,3323120568,1661626145,1661626381,236,2833
3319296370,3668834398,1658584319,1658584941,622,266
3313443935,3952213373,1662622050,1662622750,700,3894
3695955919,3767428382,1669443087,1669443574,487,1289
3243949456,3200635815,1649785716,1649786622,906,4169
3767168683,3391681521,1664004692,1664004751,59,4786
3072883855,3170787937,1666432242,1666432773,531,1251
3622055634,3848696593,1652796914,1652797184,270,4572
3751234379,3110677719,1659290300,1659290377,77,162
3281553609,3572962300,1658518312,1658519140,828,4443
3239962950,3866580878,1651131348,1651132011,663,4225
3502495699,3720230196,1663018966,1663019514,548,2008
3803921166,3958378809,1649863180,1649863798,618,2043
3249693090,3037700159,1652088554,1652089151,597,465
3444014437,3408527241,1665653663,1665654388,725,4110
3934844053,3214165542,1668341828,1668341912,84,593
3452397768,3053080986,1666888712,1666889278,566,2821
3203636883,3315319642,1656600361,1656600954,593,960
3128097611,3509051943,1656168217,1656168462,245,1813
3961019252,3526157243,1662920439,1662921050,611,3086
3624407289,3760596314,1646152097,1646152178,81,1581
3344510396,3052863908,1649402303,1649402426,123,286
3712287130,3821310561,1667798610,1667799534,924,2078
3743082205,3155682412,1666022541,1666023280,739,821
3849728634,3710080711,1661328771,1661329109,338,1159
3348593736,3178232268,1662084693,1662085214,521,2025
3206634647,3740960337,1663746487,1663746997,510,4729
3310294878,3507953967,1654391402,1654392209,807,2335
3899223920,3014999423,1656503576,1656503824,248,129
3086631800,3626913596,1643910731,1643911707,976,602
3247104925,3342653430,1656686418,1656686590,172,1971
3736057937,3638507390,1654813745,1654814144,399,400
3364787893,3969687892,1667512885,1667513666,781,2747
3599750353,3714538528,1644909444,1644910320,876,1734
3240489425,3132463122,1658635735,1658636210,475,4798
3135365026,3491847204,1649113710,1649113841,131,3799
3190926609,3029330071,1642656587,1642656603,16,4727
3563090998,3135907322,1663561289,1663562211,922,3332
3792113702,3342667089,1668785278,1668785455,177,4070
3695935659,3019991717,1661948899,1661949802,903,4189
3409426483,3174509423,1641658484,1641659154,670,763
3862817448,3898889112,1657121946,1657122551,605,2758
3553174654,3403261843,1647382625,1647383449,824,4792
3078480300,3460656420,1644303888,1644304845,957,2355
3831001237,3014408397,1656364679,1656365056,377,1957
3717168918,3758318122,1668950628,1668951498,870,1515
3668461165,3572668190,1657206925,1657207211,286,3653
3450080647,3869773694,1658383284,1658384162,878,4105
3207071946,3193245532,1653713723,1653713750,27,3427
3363362880,3921132963,1663856040,1663856269,229,2357
3007828992,3960432247,1653187670,1653188383,713,1750
3952017716,3204737834,1668068078,1668068198,120,2925
3698766633,3945816329,1667144428,1667144528,100,3533
3584503979,3725047244,1652867180,1652867498,318,3282
3832258074,3838436594,1656597680,1656598298,618,4380
3590738588,3395317046,1642988558,1642988559,1,3412
3295151002,3933262001,1662823207,1662823643,436,4338
3251213980,3660027138,1642564485,1642565075,590,4616
3100371069,3975515131,1653241308,1653241996,688,1347
3420083053,3536291205,1655837902,1655838712,810,3320
3079676030,3361766490,1649609232,1649609586,354,3264
3304453121,3641835531,1667801520,1667802027,507,812
3377169388,3267943757,1644501238,1644501823,585,2676
3336075887,3569157763,1655308104,1655308793,689,2478
3400862565,3951370590,1654770185,1654770905,720,2062
3468110494,3380041219,1666003780,1666003811,31,945
3762017994,3541439408,1651135816,1651135922,106,746
3269031421,3762925910,1669638074,1669638883,809,1851
3045293045,3423242922,1651573682,1651574480,798,1414
3962407099,3270108365,1662506091,1662506475,384,3420
3498150330,3283666560,1644883258,1644884049,791,1396
3047321893,3235494798,1648350108,1648351066,958,3932
3404869574,3997818003,1644817576,1644818359,783,2797
3486530952,3761075282,1667452670,1667452861,191,468
3762823322,3269194577,1669086527,1669087285,758,155
3050662540,3335794672,1651829539,1651830253,714,4119
3648034084,3414078563,1666665293,1666666148,855,3746
3585601266,3610550655,1655595148,1655595512,364,2982
3760568744,3125561171,1657093552,1657094455,903,1215
3842972047,3117953981,1658836426,1658837101,675,3910
3260513833,3829649370,1666869467,1666870320,853,3844
3092728025,3079236165,1664345548,1664345851,303,3170
3110527351,3889211526,1648297539,1648298529,990,2272
3384005030,3949677816,1658217109,1658217995,886,4289
3811947730,3074744487,1649502416,1649502983,567,3040
3441785129,3064878006,1663923315,1663923959,644,1300
3640213416,3946379510,1643375607,1643375631,24,4152
3650228111,3738672380,1647830803,1647831565,762,4
3919950563,3006093915,1667359840,1667360774,934,1731
3559382028,3165466385,1650173122,1650174022,900,657
3042147760,3884636297,1653317522,1653318285,763,2465
3910929654,3626118104,1655822378,1655822574,196,2397
3579304906,3322901875,1658857506,1658857536,30,2578
3995586979,3823952522,1661670147,1661670558,411,4115
3884755439,3845317494,1665761588,1665762436,848,1161
3927164305,3828952821,1650092432,1650092681,249,2329
3868043587,3509394214,1647408446,1647409316,870,348
3149804785,3706877672,1668920620,1668921392,772,2440
3190402767,3614700469,1667568503,1667568775,272,4452
3745184443,3234728323,1663335473,1663336233,760,1372
3395495556,3727678185,1658104791,1658105558,767,1919
3201934742,3866204680,1667288232,1667288501,269,2864
3297402794,3029185582,1641449537,1641450399,862,1947
3597481173,3580700816,1663229189,1663229879,690,2794
3526846877,3463281237,1641042135,1641042963,828,3383
3100887144,3190506496,1666525635,1666526297,662,4633
3065575990,3478099341,1660704777,1660705121,344,2868
3833049222,3115338913,1644191247,1644191715,468,4237
3695747045,3830400471,1656366235,1656367170,935,435
3914000198,3410076350,1666230198,1666230315,117,912
3658834552,3837318366,1666790340,1666790419,79,3484
3984362440,3112876870,1659978463,1659979287,824,3326
3482209872,3726343062,1649018035,1649018902,867,3678
3937134873,3663605033,1653262313,1653263005,692,1432
3076744396,3510841642,1650548689,1650548710,21,4147
3316724348,3710935335,1657321638,1657322298,660,105
3699093487,3721919025,1641000116,1641001088,972,787
3058987638,3967871621,1644455476,1644455810,334,1161
3612834608,3369558063,1657230832,1657231760,928,3492
3639904747,3423968417,1641674123,1641674382,259,743
3657476491,3751230497,1665176566,1665177324,758,4070
3255994645,3892477698,1642694277,1642694334,57,2780
3590548172,3824786816,1642613272,1642613509,237,3779
3420450964,3376107213,1665377333,1665377488,155,674
3677300760,3505323913,1642201005,1642201798,793,3741
3505062751,3365121849,1667546149,1667546879,730,1603
3423211226,3691035983,1651378167,1651378972,805,3039
3963516509,3220104340,1643074049,1643074905,856,1932
3650079227,3110424238,1662406428,1662407335,907,619
3801539017,3419495864,1667059072,1667059243,171,1470
3783019508,3010364260,1663937342,1663937862,520,3747
3395819846,3414959656,1659720394,1659720991,597,4113
3357625425,3213408463,1664589350,1664590254,904,2012
3307199681,3070530168,1668248601,1668249315,714,4735
3225460038,3143157038,1646294261,1646294906,645,1676
3961695258,3462928237,1650651167,1650651624,457,1321
3246610009,3328876116,1664021010,1664021949,939,763
3864835113,3791932063,1643574522,1643574701,179,2941
3185991841,3671064670,1642185010,1642185313,303,40
3704895679,3416872317,1658757929,1658758539,610,959
3308856183,3261222825,1648858552,1648858675,123,2722
3515478187,3079696769,1656906600,1656906811,211,3064
3045986697,3283968318,1660756601,1660757017,416,811
3519619564,3224915789,1664068703,1664068721,18,580
3661578043,3197483144,1659460522,1659461358,836,4971
3208196164,3254825792,1641203565,1641203922,357,4892
3592712415,3673375981,1668830968,1668831214,246,784
3759508272,3443760486,1642925931,1642926539,608,965
3483853932,3763543423,1662961441,1662962271,830,4462
3207875792,3463114945,1665316191,1665316374,183,4283
3754701455,3209719382,1641910780,1641910859,79,4571
3517221813,3126275800,1654389304,1654389331,27,2529
3764912522,3436689056,1666464576,1666464790,214,1245
3878307830,3254906080,1659654895,1659655239,344,101
3049612052,3217969160,1667435513,1667436051,538,711
3462464690,3618794714,1650340437,1650340479,42,3264
3778980305,3197183850,1651520652,1651521152,500,3358
3993536532,3632246676,1641105584,1641106578,994,336
3812542748,3301437674,1664707310,1664707511,201,3454
3369932365,3288647153,1646966135,1646966589,454,3143
3477788278,3743563742,1641069080,1641069273,193,4661
3912633203,3059792532,1668643008,1668643236,228,1665
3222582084,3297251697,1660125591,1660125718,127,3732
3585369468,3195270337,1660427388,1660428207,819,2015
3398829223,3138747595,1669198748,1669199405,657,3477
3074177187,3885617330,1650011650,1650012548,898,2199
3794948789,3365730481,1644049114,1644049694,580,240
3946469485,3019739136,1656971074,1656971387,313,3114
3549699805,3045497149,1649373546,1649374413,867,1906
3270498123,3333953163,1666729665,1666729984,319,478
3339214450,3738632434,1666557756,1666557826,70,92
3760698016,3204370077,1650925059,1650925750,691,4930
3812668912,3614348647,1655927746,1655928154,408,461
3786834057,3155988847,1668417658,1668418414,756,2086
3363384948,3072446828,1642980498,1642981480,982,153
3185787322,3898841413,1656185222,1656186108,886,3975
3475472972,3998576006,1667749370,1667750232,862,4173
3139283601,3759441447,1647988078,1647988431,353,1545
3804506816,3337664865,1643954231,1643954349,118,1228
3104938370,3894543553,1658766881,1658767494,613,1999
3686319207,3458269444,1647176392,1647176729,337,3475
3595032432,3802767577,1644610803,1644611367,564,4517
3824343645,3955117415,1668424961,1668425181,220,927
3443900880,3192953931,1651853046,1651853249,203,1703
3146560239,3635430076,1646490386,1646490389,3,2812
3542290808,3636771961,1646013485,1646014308,823,262
3066466801,3797756066,1668996675,1668997459,784,587
3462712136,3110362623,1645287672,1645288033,361,3914
3166355541,3293273386,1646443026,1646443668,642,4989
3651871367,3564380058,1647209369,1647209738,369,4163
3385303347,3496824941,1645298270,1645298878,608,62
3855378789,3552921399,1664821815,1664821997,182,1463
3079966102,3939387580,1648318375,1648319363,988,3516
3288541072,3791929130,1656971069,1656971656,587,3028
3360377763,3743117885,1654391214,1654392132,918,4
3584309441,3349076142,1667937635,1667938487,852,1517
3541154369,3328267955,1659637704,1659638084,380,447
3853470548,3463773839,1655402797,1655403742,945,3765
3329907838,3630369453,1647095176,1647095293,117,2074
3370392223,3112310059,1645647393,1645647770,377,4052
3315720094,3932460650,1644317567,1644318349,782,4557
3856318954,3211473990,1654733239,1654734166,927,3642
3809367187,3105959909,1666766769,1666767072,303,1974
3533985776,3439056198,1659609704,1659610114,410,624
3578216368,3566492488,1661818629,1661818998,369,4009
3435840297,3365153320,1647133909,1647134294,385,282
3130376082,3654387952,1652287300,1652288299,999,3702
3895151722,3702986870,1661749755,1661750291,536,3927
3612646904,3795348345,1641670430,1641670865,435,4453
3098332512,3179016456,1649110188,1649111057,869,3777
3320530272,3265239060,1660431785,1660431792,7,4825
3629197913,3769985200,1654414058,1654414604,546,2783
3986566438,3542244259,1643888525,1643888611,86,1250
3861555640,3944415476,1652510026,1652510772,746,3689
3986605620,3196872677,1669593723,1669594500,777,2482
3019204419,3185997004,1649491998,1649492586,588,2442
3320432101,3208730422,1642021894,1642022335,441,2068
3987887342,3571358383,1649798213,1649798279,66,1670
3694803952,3375761162,1653151388,1653152241,853,2696
3804839992,3360850882,1667750815,1667750893,78,1442
3699798917,3530637326,1668849792,1668849915,123,842
3572710978,3351501492,1652235467,1652235967,500,1282
3670075353,3004878690,1651258252,1651258291,39,3500
3580190750,3257572412,1652842956,1652843179,223,4616
3038064437,3800067310,1662746719,1662747385,666,4240
3641934666,3253472379,1645189746,1645189860,114,1368
3120193611,3220148986,1653046377,1653047053,676,4809
3185938674,3372013510,1664482625,1664483103,478,618
3397675055,3392545785,1666668161,1666668195,34,1925
3442017285,3834983789,1644598751,1644599434,683,358
3667542309,3060770046,1651522140,1651522957,817,3522
3298284917,3106243598,1648715299,1648716007,708,3140
3911641800,3402311888,1643361822,1643362690,868,2448
3356117515,3638042267,1662265891,1662266180,289,2936
3011008113,3022392102,1658215505,1658215869,364,3190
3721011848,3264313628,1641293999,1641294525,526,730
3745389315,3142035857,1653167797,1653168415,618,1581
3187304058,3355795111,1663632335,1663633153,818,4601
3645912837,3946610562,1655276315,1655277062,747,1435
3780539981,3969809087,1641046614,1641046897,283,3219
3478841971,3178747977,1645412459,1645413450,991,224
3633882171,3251953263,1661964882,1661965282,400,2088
3763286791,3401832227,1656428643,1656429481,838,3416
3310624561,3075710755,1659539584,1659540236,652,579
3865761684,3627213492,1663657977,1663658565,588,3555
3514763577,3543449192,1665300997,1665301008,11,4127
3291134691,3784291987,1652354010,1652354361,351,3610
3201707729,3925036457,1644922114,1644922720,606,4565
3406092441,3353104430,1662802571,1662802728,157,2946
3044562697,3964820605,1643488157,1643488988,831,1320
3451729611,3421418134,1655496114,1655496363,249,2341
3975236291,3221018384,1669059572,1669059598,26,4324
3073393979,3964144721,1652373399,1652374028,629,2706
3503389084,3447627746,1660732570,1660733468,898,2582
3862506832,3342331681,1656963414,1656963847,433,4503
3675978003,3255141981,1644960191,1644960569,378,4071
3299748797,3825705338,1654876688,1654877342,654,2920
3718366458,3864575949,1652956376,1652956396,20,53
3897027827,3272972514,1666282998,1666283298,300,4278
3672594078,3229111074,1664171142,1664171478,336,2422
3948117478,3500566525,1660094601,1660095375,774,2369
3839404233,3100536624,1650735428,1650735505,77,4536
3905859786,3373534685,1652661773,1652662471,698,2416
3736340459,3440833380,1664414849,1664415669,820,2919
3836215297,3706625930,1642815656,1642815770,114,2793
3636527435,3175386893,1641741001,1641741022,21,646
3208212084,3635916359,1655310893,1655310940,47,4337
3606186606,3830913582,1657149416,1657149565,149,1991
3355452698,3334877427,1654331330,1654331945,615,588
3755483750,3671401598,1642606917,1642607687,770,2675
3316997450,3408606602,1647694097,1647694835,738,2097
3318112460,3374980891,1649183497,1649183533,36,408
3265717921,3632983413,1662588455,1662589210,755,439
3212788166,3405384223,1664081026,1664081865,839,4346
3781152146,3139377155,1655605111,1655605286,175,2848
3216587090,3946246763,1651501190,1651501767,577,2530
3619504898,3769768555,1658091983,1658092306,323,301
3658540338,3997243436,1650858694,1650858885,191,931
3133400523,3774497386,1666622482,1666623457,975,4208
3974738104,3136610770,1669264497,1669265199,702,4793
3479447609,3156104216,1641032749,1641032922,173,8
3705616526,3047169442,1656505074,1656505863,789,1029
3784711763,3622143386,1654027039,1654027489,450,4902
3692147274,3689989518,1650720403,1650720615,212,1538
3123183615,3091303115,1648691080,1648691239,159,2858
3081081008,3081301738,1651175493,1651176084,591,1326
3811159865,3399151207,1657755876,1657756445,569,1130
3348228601,3665951390,1648717582,1648718265,683,3732
3473438606,3927827230,1657936160,1657936696,536,490
3734045329,3122059600,1665858716,1665858858,142,2432
3336259779,3954652611,1658250307,1658250539,232,3235
3248363364,3152432714,1663478950,1663479185,235,2007
3708373701,3949495655,1662623477,1662623837,360,1595
3953567293,3741471272,1663775932,1663776458,526,996
3794173201,3041888829,1652022657,1652023086,429,1108
3046166829,3375949977,1646215617,1646215911,294,4289
3683871803,3245105159,1645276813,1645277443,630,644
3906073877,3004766482,1660950893,1660951002,109,792
3777241469,3902984046,1661156973,1661157028,55,426
3466503454,3875352511,1650923080,1650923875,795,4590
3234556840,3233603851,1662307802,1662308438,636,4057
3150068605,3805248541,1660653831,1660654432,601,4178
3545189181,3145658934,1652570411,1652570633,222,549
3711617208,3478177176,1664537120,1664537293,173,4543
3903887738,3727262132,1643682772,1643682984,212,3913
3768624075,3555086923,1664216084,1664216400,316,2072
3205394908,3602314120,1660422329,1660423122,793,1941
3879459647,3273004874,1644616368,1644616526,158,3627
3532165586,3849095902,1655164863,1655165391,528,4164
3407458642,3518557531,1649610802,1649611230,428,4010
3424892474,3309171876,1647989521,1647989523,2,40
3784675258,3792099237,1659775926,1659776039,113,760
3375747719,3148983668,1668073099,1668073581,482,1054
3373547075,3609557194,1665534406,1665535215,809,553
3603909303,3148513442,1665425181,1665425778,597,923
3579426717,3713539646,1646762382,1646762574,192,248
3864665605,3524964462,1643583337,1643583875,538,845
3472832857,3167823865,1641945204,1641945745,541,2314
3839998185,3354821159,1647011300,1647011491,191,2706
3581286385,3349873744,1663610403,1663610839,436,755
3239838007,3303712370,1646723411,1646724248,837,1920
3311956125,3421103766,1646157464,1646157944,480,4720
3899156096,3039961622,1652929125,1652929955,830,3648
3297064190,3312611936,1658636254,1658636412,158,1843
3935392492,3922429611,1658129616,1658130399,783,766
3013619066,3412017760,1644907054,1644907574,520,1792
3242237411,3493424640,1654933508,1654934067,559,4770
3407313696,3208973201,1669433212,1669433652,440,1420
3887048809,3351501492,1663079161,1663079937,776,1239
3885184211,3414872320,1642663386,1642663580,194,276
3495145945,3540776428,1644158065,1644158790,725,639
3791660670,3313617295,1650629493,1650630413,920,3173
3709844745,3144646519,1643966095,1643966635,540,3080
3398278270,3827573101,1665083358,1665083896,538,3092
3199504847,3515071811,1662052253,1662052377,124,718
3829716332,3710559357,1664753081,1664753560,479,4911
3747743910,3259525071,1649301892,1649302075,183,2448
3360354628,3279551226,1667993663,1667994480,817,3960
3837851285,3186979566,1661143021,1661143846,825,2205
3217894263,3481398354,1642367570,1642368281,711,1960
3664202785,3696607703,1659145389,1659145866,477,2665
3422271418,3698627611,1649148343,1649148451,108,1020
3771442581,3966218175,1656042163,1656042284,121,465
3077354623,3517441575,1668389816,1668389984,168,1142
3387119406,3739243841,1648107042,1648107691,649,115
3167754003,3805874853,1658865022,1658865391,369,3425
3657976913,3008398614,1652401140,1652401810,670,3471
3078354183,3467882402,1644942467,1644942989,522,3916
3372891134,3453558483,1643836763,1643837371,608,1646
3319050571,3629693575,1653798579,1653799476,897,3248
3665255940,3122408079,1665472268,1665473088,820,4828
3995512160,3888994572,1659721729,1659722047,318,3462
3664962170,3595664598,1657675620,1657676036,416,1657
3725852934,3735596000,1651335944,1651336671,727,792
3258106408,3756501396,1645283412,1645283950,538,2270
3114750376,3788758730,1657260779,1657261390,611,1035
3605422788,3414195974,1644252441,1644252493,52,910
3084605062,3353948877,1654105879,1654105925,46,4160
3240488759,3570232006,1666367703,1666367800,97,3196
3313443935,3910281608,1651522931,1651523674,743,3306
3579233622,3323622071,1667973248,1667974106,858,3916
3595056202,3664220053,1663500455,1663500576,121,2241
3494965404,3346337479,1642225624,1642226244,620,3656
3770471656,3473961047,1651748393,1651749197,804,263
3534430043,3528963771,1642882547,1642883184,637,3814
3812655084,3425941241,1641062630,1641062999,369,1757
3797229217,3041372113,1652685453,1652686004,551,42
3403228911,3568031848,1648966816,1648967446,630,3582
3315564052,3249204623,1651718362,1651719088,726,3884
3995196091,3214703004,1661706396,1661707263,867,118
3244419119,3015118504,1653557173,1653558086,913,4420
3247561072,3426540385,1666323047,1666323258,211,4831
3294224967,3637008303,1659587025,1659587226,201,2335
3641244352,3455975848,1645502141,1645502389,248,4390
3673450028,3488620633,1663410814,1663411336,522,1758
3578114200,3582055685,1664143866,1664144384,518,3015
3003897592,3994878630,1666899735,1666899879,144,4993
3801324007,3241464922,1661993898,1661994818,920,4788
3486583204,3155692735,1660462657,1660463555,898,84
3527919292,3986830546,1665646690,1665647477,787,1653
3349064971,3223335128,1666144787,1666145519,732,3770
3829641884,3305586588,1652377787,1652378425,638,2068
3517335716,3864087449,1647838713,1647838994,281,382
3405674628,3906779298,1654630642,1654630803,161,4975
3385122130,3895970526,1646890575,1646890609,34,1233
3751071956,3557495639,1661937413,1661937867,454,439
3997025163,3544283549,1641436485,1641437464,979,4806
3190859821,3552242419,1644693862,1644694832,970,1675
3603959832,3078747770,1663672206,1663672325,119,1415
3227410059,3329782634,1661082203,1661082494,291,2008
3844768738,3229493421,1646056014,1646056795,781,4459
3738611471,3318606744,1668024179,1668024931,752,2721
3525327314,3911588813,1665846334,1665846688,354,238
3527018814,3702065366,1666180838,1666181257,419,4209
3976484896,3037624754,1652125513,1652126467,954,3578
3230220407,3521640368,1655039082,1655039281,199,501
3061020589,3698200596,1647599788,1647600135,347,3483
3656543534,3057388611,1666312219,1666312563,344,2883
3489403399,3400900622,1658243520,1658244500,980,2486
3780196622,3069752367,1649954374,1649955100,726,4741
3458993116,3712124629,1650995670,1650996450,780,1662
3026308602,3028043963,1653572028,1653572983,955,1848
3655341043,3873587755,1643322460,1643322679,219,1203
3912777362,3744992556,1659982037,1659982218,181,2258
3625347781,3976072626,1666601586,1666601775,189,558
3790073082,3966462386,1645549101,1645549891,790,2172
3893210511,3360790098,1663767359,1663767411,52,3146
3815218889,3809418349,1654296944,1654297687,743,2558
3521305329,3112074695,1658370686,1658371670,984,252
3847935250,3785166785,1656410726,1656411260,534,3072
3821179894,3561020930,1655009472,1655009619,147,740
3184224166,3567167144,1648442722,1648443176,454,4849
3288277250,3637898011,1658171929,1658172776,847,103
3397825502,3440763002,1642265030,1642266013,983,1010
3656020880,3236841648,1655977558,1655978158,600,4549
3182826062,3305755609,1663135678,1663136423,745,3932
3844646904,3540530768,1641187687,1641188205,518,2610
3642874688,3883280395,1657216549,1657217521,972,2849
3239813178,3947284783,1646390241,1646390375,134,820
3077501623,3485776166,1664580164,1664580289,125,4236
3416642262,3788263192,1650524268,1650524944,676,3832
3110668781,3697829340,1667185162,1667185834,672,4289
3113929144,3039213224,1658646136,1658646171,35,1779
3320167786,3292264341,1652437149,1652437451,302,830
3279624282,3564201233,1643985335,1643985652,317,4533
3048966785,3243131975,1660571630,1660572188,558,4682
3739707377,3633273374,1666512615,1666513510,895,926
3487014928,3463698702,1653454502,1653455342,840,2175
3084566357,3217303094,1650148616,1650148818,202,536
3880523153,3828529104,1669523795,1669524763,968,359
3445173866,3083308277,1662850110,1662850367,257,2048
3234302771,3201321131,1655018904,1655019662,758,4845
3013482061,3200345241,1663772436,1663772514,78,3764
3846709416,3481644527,1653740953,1653741513,560,4342
3999366965,3093813028,1669080213,1669081017,804,3781
3808797170,3443841631,1641440635,1641441467,832,1493
3505317103,3983860211,1655640542,1655641434,892,1770
3029717597,3945483478,1667784603,1667784654,51,4625
3945103062,3467025820,1654649219,1654650071,852,1713
3385603904,3576562855,1663700804,1663701342,538,3858
3276880768,3183539842,1665668179,1665668883,704,4525
3612955530,3925384672,1654356635,1654356785,150,370
3878288306,3338422311,1667162966,1667163553,587,3041
3793611914,3157182181,1650664550,1650664737,187,4459
3566746281,3537830978,1642571365,1642571513,148,3258
3674182955,3725160683,1654598806,1654599002,196,3309
3725048767,3299772269,1642411723,1642412216,493,3128
3373301454,3784772616,1648758577,1648759026,449,1004
3464142288,3907687684,1641141095,1641141964,869,4923
3889962901,3764226479,1655547891,1655548494,603,4956
3207934463,3305256041,1667121741,1667122708,967,2413
3371038504,3634561723,1655633565,1655633619,54,2995
3896073498,3730061027,1663962430,1663962557,127,2104
3548345162,3043455755,1653575604,1653576084,480,2016
3816072519,3266422999,1647507062,1647507429,367,4436
3614718661,3365981782,1655764313,1655764525,212,1687
3230381150,3253394715,1651857548,1651858451,903,3873
3468243252,3888736958,1647055018,1647055780,762,1795
3389433284,3723862198,1669004933,1669005432,499,3464
3521078688,3983115440,1658778014,1658778436,422,1264
3245616980,3668928390,1659468397,1659468579,182,4511
3204674136,3344632554,1661212894,1661213329,435,4433
3726764299,3728574399,1662853085,1662853801,716,4920
3095867982,3417528637,1667684374,1667684403,29,2238
3257147916,3475805441,1662265875,1662266265,390,4235
3035294674,3089714194,1657602448,1657603308,860,327
3762467485,3532867052,1645581142,1645581633,491,4511
3075989753,3642375570,1668887548,1668888531,983,2111
3987435544,3010928389,1653853307,1653854295,988,4228
3038059897,3642625028,1660093590,1660094567,977,1122
3671970896,3540096988,1655532796,1655533437,641,2560
3548709081,3776082383,1647535892,1647536378,486,3150
3735309575,3076127789,1668655775,1668656437,662,852
3958195771,3586808846,1641834803,1641835799,996,2829
3509368042,3444102269,1655275819,1655275942,123,4572
3771653552,3218312619,1646123951,1646124699,748,3047
3228039193,3363150389,1660134980,1660135111,131,2489
3385005383,3286602822,1654836311,1654836378,67,2382
3245684312,3145942289,1653377472,1653377814,342,2397
3750793779,3477791460,1669547184,1669548139,955,1592
3690903252,3534732001,1662517378,1662518264,886,3487
3759457815,3619536642,1668366159,1668367018,859,3570
3874778355,3170397179,1653504183,1653504989,806,215
3326325222,3218761516,1659433818,1659433974,156,2122
3857737525,3028244245,1663104980,1663105254,274,3887
3904617763,3286756968,1656111398,1656111517,119,3544
3852941600,3741855785,1669056602,1669057381,779,1136
3718525033,3170071672,1654223146,1654223737,591,4299
3215821760,3432827292,1641499814,1641500036,222,2604
3981201171,3690839778,1641584004,1641584538,534,1068
3963728258,3386068886,1651679156,1651679305,149,78
3542752085,3426770614,1646048657,1646049221,564,3472
3559890485,3714644817,1658222418,1658222689,271,1789
3149393195,3159050598,1656855849,1656855871,22,307
3248879858,3700412973,1667396333,1667396358,25,1635
3822602707,3187871191,1665242746,1665243089,343,165
3723290857,3349577338,1650542027,1650543023,996,3263
3001886591,3423981974,1651202756,1651203210,454,308
3681727565,3158724663,1655224406,1655225131,725,2045
3616252338,3605069928,1652506228,1652506887,659,1019
3265219388,3924756132,1648933232,1648934081,849,3431
3892387324,3859558283,1655200432,1655200572,140,3119
3766485620,3867284055,1644593598,1644594375,777,3642
3895162440,3060930316,1664039561,1664040426,865,2383
3109224246,3538630528,1668757684,1668758396,712,4209
3346630052,3689724960,1649185216,1649185459,243,3474
3174463386,3884023662,1652153441,1652154370,929,4654
3107822536,3922156314,1643894047,1643894111,64,1509
3853765869,3761072444,1669363427,1669363496,69,1497
3307087808,3393820881,1663371032,1663371172,140,670
3638546635,3658596196,1659023784,1659024038,254,4571
3846547261,3905252380,1656733697,1656734493,796,4746
3685516210,3009729446,1657083980,1657084186,206,2291
3297595089,3231071898,1652484671,1652485438,767,4638
3628899414,3140062158,1644374999,1644375819,820,3446
3139001456,3020190375,1668887308,1668887988,680,4645
3161442511,3456428563,1642145721,1642146565,844,1010
3866681942,3754136555,1654242893,1654243024,131,197
3957261884,3367754482,1663384024,1663384175,151,2111
3310570273,3080833309,1650006411,1650007004,593,4245
3835471462,3764873425,1664904771,1664905453,682,4379
3147471373,3020403160,1648735152,1648735843,691,2245
3913843257,3682826915,1643902830,1643903202,372,4662
3350782941,3688513029,1661846877,1661847466,589,379
3567495196,3178573902,1657634032,1657634236,204,4764
3802638585,3108506563,1666866026,1666866122,96,3356
3555299800,3448780558,1658029673,1658030365,692,3652
3673346716,3281111625,1655942150,1655943136,986,4874
3302113674,3891667097,1653351959,1653352732,773,3385
3861023312,3040389863,1647199802,1647200308,506,4968
3406686123,3105763440,1660524246,1660524345,99,4611
3214374037,3043899882,1665963008,1665963650,642,2768
3055592733,3469425496,1668953697,1668954697,1000,4419
3949528057,3432480803,1657275058,1657275985,927,2312
3889908899,3023591664,1658317975,1658318401,426,3775
3114017165,3158270506,1659496562,1659496610,48,74
3212913483,3839404233,1652022286,1652023039,753,2815
3329284002,3265882697,1668290121,1668290355,234,1074
3391454118,3976125873,1667486135,1667486499,364,362
3624407289,3316030195,1666763169,1666763691,522,2008
3894727692,3663521484,1651696242,1651697230,988,671
3761972345,3796810151,1660360363,1660360492,129,3155
3718456558,3764438926,1650802987,1650803071,84,2315
3595144436,3619252497,1667538714,1667539449,735,589
3308522789,3661046419,1663693132,1663693824,692,666
3972659482,3279915758,1666376360,1666376523,163,2197
3050364178,3292099286,1669016036,1669016363,327,213
3353036293,3633838628,1669075499,1669076263,764,3320
3902747056,3530940372,1644849883,1644850708,825,4965
3659257046,3277210132,1662298045,1662298049,4,4167
3693820165,3855717929,1659639282,1659639749,467,3880
3695046057,3754656263,1648994991,1648995374,383,2941
3068360898,3839266398,1661198001,1661198195,194,4817
3688031763,3381553031,1641320084,1641321077,993,4045
3373948425,3633765533,1664053464,1664053594,130,4200
3743531156,3291488407,1650859175,1650859382,207,407
3607943703,3009452303,1659011846,1659011955,109,4421
3552313902,3974585448,1667802209,1667802970,761,1374
3116157197,3295317251,1644660678,1644661609,931,1865
3850832640,3126202219,1666765446,1666765869,423,3393
3179455869,3516821953,1644290307,1644291270,963,3415
3992612218,3760327994,1658257030,1658257500,470,2583
3291947087,3462949306,1668304209,1668305183,974,3073
3967570770,3997490683,1643257665,1643258052,387,585
3884155476,3596925754,1653907903,1653908338,435,2725
3076520458,3576196242,1655640520,1655640747,227,1000
3964204311,3237205713,1665801996,1665802656,660,1780
3562622374,3947241153,1664581785,1664582222,437,570
3911180429,3877166746,1660378071,1660378600,529,1415
3808235312,3123585176,1653814345,1653814397,52,1932
3267907139,3365121849,1643478632,1643478998,366,3696
3043924151,3211270539,1642622970,1642623711,741,2456
3283234183,3163844853,1649307455,1649307822,367,3093
3030686992,3105391742,1653216473,1653217232,759,795
3780404468,3420203571,1666834024,1666834526,502,3621
3158311090,3605300894,1656444704,1656445155,451,2131
3587655014,3425306092,1641573729,1641573832,103,2672
3889048588,3065442626,1655925557,1655926162,605,1176
3580648048,3536546683,1646359528,1646360215,687,4066
3330177013,3786773887,1656697466,1656697521,55,648
3409182420,3753744111,1651677898,1651678764,866,4578
3150507924,3881818975,1661991481,1661991756,275,3250
3467648575,3473334521,1652318766,1652319523,757,1312
3999100122,3250860907,1659320418,1659320559,141,4859
3563158291,3075782806,1663883664,1663884590,926,3941
3324778594,3863135438,1643795081,1643795154,73,137
3838499876,3539297461,1641116296,1641117270,974,3112
3740509668,3357694829,1649329934,1649330717,783,3881
3123592757,3810102378,1652367737,1652367976,239,3792
3655595120,3182922847,1652399567,1652400562,995,4321
3698774572,3006066019,1641692510,1641693506,996,1699
3115816199,3748006407,1653276127,1653276974,847,2376
3101123447,3764016778,1649989776,1649989911,135,4792
3496827693,3858792568,1659157734,1659158230,496,760
3740122747,3717735568,1659642597,1659643297,700,1068
3224063674,3158983328,1644556934,1644557550,616,2177
3749057667,3390196083,1662904028,1662904466,438,4869
3258744257,3354229764,1645952629,1645953444,815,3722
3442818965,3635401784,1667717529,1667718158,629,3282
3176629604,3606347895,1645846356,1645847185,829,2506
3716957723,3287226554,1669462355,1669462967,612,261
3526232693,3861057159,1668738845,1668739518,673,4599
3072760391,3549924327,1659382466,1659382934,468,1183
3605151927,3516073219,1665824444,1665824863,419,2291
3557502685,3913458186,1661169219,1661169336,117,4914
3324301814,3411079963,1652149373,1652149600,227,1838
3840143923,3365485007,1649594249,1649594300,51,4044
3483552313,3224894158,1659849256,1659849519,263,2984
3416497485,3885654208,1669307758,1669308148,390,1481
3044122748,3453268434,1661712131,1661713045,914,3234
3599980068,3788459948,1666621287,1666621636,349,2585
3721508500,3855181618,1642274208,1642274289,81,2663
3832771110,3248709811,1669094156,1669094512,356,1769
3513974024,3259598148,1650035238,1650035502,264,3941
3992193586,3928204887,1667072042,1667072227,185,1700
3056768960,3511784389,1664707699,1664708272,573,323
3513788085,3680136676,1659805890,1659806188,298,3542
3168646079,3415447299,1666308068,1666308220,152,80
3798960283,3197233544,1646666195,1646666816,621,3624
3992579083,3657205286,1668702301,1668702904,603,180
3918750879,3218595380,1641424586,1641424588,2,1974
3232055652,3413023019,1654004344,1654004850,506,3171
3738343228,3238061008,1645711207,1645712038,831,1975
3031907794,3079900965,1665414156,1665414949,793,676
3107663749,3238927982,1665233882,1665234139,257,384
3565112568,3216325105,1656440221,1656440389,168,537
3586112343,3551382929,1663668401,1663668877,476,744
3911013074,3534380826,1654761184,1654761245,61,953
3358611723,3451952687,1667544325,1667544427,102,972
3867433430,3276756476,1660648585,1660649208,623,1105
3593303261,3982582632,1643814004,1643814532,528,2761
3780238522,3644783005,1642280891,1642281615,724,4973
3353753289,3359439154,1642228814,1642229672,858,648
3564208842,3836214428,1662737791,1662738697,906,4071
3813225168,3680789912,1656570939,1656571040,101,616
3310491692,3921717653,1666136597,1666137316,719,1634
3176805161,3741859787,1642780314,1642781065,751,37
3095057071,3277580324,1669155927,1669156183,256,4546
3414852321,3897108714,1655299965,1655300810,845,1054
3265767393,3741725584,1665276674,1665276793,119,841
3955452635,3507139912,1667207473,1667208235,762,716
3103501036,3804313158,1665976293,1665977289,996,2020
3521837972,3571618691,1653836940,1653837165,225,2470
3363029929,3087175157,1655174757,1655174851,94,2414
3950539628,3976098311,1653490004,1653490433,429,1694
3884749694,3515692865,1669059839,1669060635,796,2709
3087456257,3548925342,1650329048,1650329074,26,597
3955674068,3522188339,1659806181,1659806275,94,3841
3585601266,3443725515,1666420006,1666420354,348,1289
3991777678,3982742048,1660071828,1660072710,882,4060
3927756998,3146691862,1651142942,1651143247,305,2630
3787589292,3676747645,1641173147,1641173794,647,4075
3319736434,3811438527,1647959001,1647959819,818,91
3127565580,3103724721,1662409182,1662409332,150,2412
3009622051,3098555251,1652291562,1652291764,202,4520
3589099142,3743491400,1642032031,1642032246,215,4504
3995850299,3576651332,1646772953,1646773844,891,4478
3754700256,3550272866,1659906019,1659906203,184,4646
3095080781,3015387006,1663405999,1663406488,489,1367
3374733835,3232972981,1659579786,1659580338,552,3681
3297999243,3950360342,1664708672,1664708929,257,588
3722282138,3985086384,1657666029,1657666815,786,1482
3615251031,3626238904,1644812655,1644812710,55,3903
3436271445,3976807169,1665971208,1665972157,949,733
3880200598,3720705220,1653310286,1653310949,663,4243
3962686372,3371947160,1661121059,1661121847,788,1943
3997355681,3337490953,1656413053,1656413077,24,4207
3279211619,3244975470,1654523921,1654523921,0,1977
3134161085,3139517704,1669396302,1669396910,608,77
3549041809,3214900491,1663193986,1663194456,470,4859
3888460983,3843209854,1665247496,1665247879,383,1134
3077437448,3915374804,1664706810,1664707003,193,912
3648495102,3270165876,1669090819,1669091718,899,1557
3387180150,3965940785,1666441819,1666442406,587,3252
3489717742,3236417840,1646864939,1646865014,75,3888
3927258530,3075463289,1650736752,1650737140,388,602
3217407257,3990800215,1643858527,1643859302,775,2019
3726778375,3556044730,1650443213,1650443350,137,4615
3539181077,3671485097,1648261735,1648262098,363,4385
3410216940,3415333666,1650073139,1650073953,814,4432
3545826495,3520362062,1641428491,1641429225,734,1886
3198281540,3487835391,1656054903,1656055863,960,40
3028585085,3636602639,1656646397,1656647021,624,4444
3198920836,3770240951,1665950034,1665950086,52,4587
3076816861,3065077722,1661499685,1661500123,438,4062
3600981651,3417344155,1648600980,1648601131,151,2023
3773082142,3988592172,1649809981,1649810160,179,691
3245616980,3788404681,1660175395,1660175847,452,3634
3655939560,3497578868,1649991408,1649992295,887,924
3249917176,3810685927,1653961923,1653961948,25,3865
3001286851,3747274357,1641107349,1641108065,716,2487
3251752447,3117040063,1667727198,1667727249,51,3794
3879424643,3290280069,1648512925,1648513281,356,935
3018032141,3098556823,1653939701,1653940666,965,2274
3718881343,3322901474,1664385571,1664386262,691,743
3942002865,3687136980,1655764654,1655765308,654,864
3175960289,3025333496,1657121388,1657122307,919,3850
3517319267,3257348748,1651241060,1651241916,856,4369
3950652856,3281385219,1664188636,1664189349,713,1565
3406638601,3290340711,1662987841,1662988647,806,2023
3784981064,3641448981,1642314281,1642315036,755,2177
3305734250,3693844139,1667920728,1667921041,313,3991
3595846893,3842531558,1667145018,1667145841,823,2631
3660875344,3957418216,1645470383,1645471332,949,2247
3555247157,3031364513,1654335110,1654335857,747,1127
3508902927,3008310119,1660047556,1660047810,254,4294
3278359196,3495092306,1652149467,1652149845,378,965
3286952247,3856670938,1647049116,1647049244,128,4714
3998974770,3788494088,1646135838,1646136559,721,2371
3595327080,3013542737,1642331240,1642331949,709,3783
3803921166,3448260070,1666362059,1666362152,93,104
3918960737,3479899475,1653224427,1653224857,430,3630
3203616846,3759469833,1667476003,1667476312,309,2232
3857241854,3187147723,1645710920,1645711159,239,1950
3002418018,3877026725,1662671585,1662672099,514,3625
3313907477,3145228006,1652541443,1652542078,635,4227
3384550301,3233216320,1653028455,1653029109,654,4359
3710688671,3084618414,1651891410,1651891677,267,3494
3262240086,3932550972,1645804846,1645805733,887,2905
3966218175,3479626087,1652928161,1652928891,730,1840
3874443167,3432385108,1643454782,1643455159,377,3027
3325546788,3821377760,1646913550,1646914533,983,3059
3111855485,3576945853,1651188639,1651189542,903,4020
3157216526,3530125869,1648888973,1648889023,50,4243
3642463196,3754071228,1655158663,1655158710,47,1051
3525848050,3966987489,1663650812,1663651577,765,1206
3164510771,3051929573,1653931114,1653931563,449,901
3515686393,3561186066,1655944827,1655945770,943,630
3628618665,3361732891,1656211230,1656211941,711,4890
3107212412,3279474281,1656867118,1656867379,261,849
3566459002,3041355325,1664134748,1664135677,929,3989
3092539330,3667346913,1669185000,1669185975,975,4858
3886931809,3796505288,1661112115,1661112350,235,3019
3981834777,3243222633,1651852586,1651853390,804,2791
3117920600,3772321094,1665294914,1665295516,602,2302
3242751046,3614124510,1648074479,1648075379,900,1721
3305988748,3879012376,1669391140,1669391692,552,4791
3743117079,3485065334,1663010792,1663011286,494,2752
3293687087,3335748836,1664219896,1664219927,31,2349
3572773677,3938366591,1644249497,1644249757,260,2482
3879985975,3689977219,1643221256,1643221583,327,2236
3884433485,3450708050,1662102764,1662103711,947,4542
3237683883,3039546484,1668187987,1668188293,306,4570
3708572893,3592740297,1666806971,1666807780,809,2913
3402205389,3047237012,1659236340,1659236534,194,6
3978583680,3034537993,1655375399,1655376034,635,4424
3904988600,3563975495,1667717014,1667717542,528,647
3232261603,3131820603,1645887470,1645888463,993,2056
3650971831,3666911358,1646024279,1646025055,776,4656
3298492861,3023707326,1654785009,1654785601,592,669
3869782083,3899086507,1643614651,1643615177,526,1361
3212811807,3976493485,1669396928,1669397038,110,1591
3503358896,3475046694,1660639995,1660640102,107,502
3707000908,3587371405,1642523920,1642524887,967,1136
3947952548,3899223920,1646662229,1646663009,780,1862
3575033537,3300531698,1667462747,1667463482,735,1277
3581184918,3932269037,1661570434,1661571113,679,1998
3937610547,3447625781,1663567654,1663568533,879,2884
3249775255,3326235234,1647615516,1647616231,715,3326
3451145691,3420291692,1657200951,1657201834,883,1144
3687182274,3169598934,1668579354,1668579415,61,2395
3439573026,3655664128,1654745038,1654745791,753,2892
3564264061,3127858298,1650980317,1650980979,662,4363
3104834160,3835384093,1662961464,1662962302,838,2349
3201833244,3577883781,1661340564,1661341217,653,907
3940699973,3895548153,1656338008,1656338648,640,3936
3643771717,3538607765,1666812202,1666812756,554,1113
3914168869,3603954453,1664512005,1664512654,649,3370
3925560081,3309682303,1663845077,1663845196,119,1101
3115032059,3152458790,1662542626,1662543247,621,4990
3621016232,3095497543,1669416372,1669416737,365,2694
3118993096,3017173297,1651668576,1651668912,336,959
3282783385,3831899506,1641207474,1641208195,721,3379
3351792913,3581659953,1651168856,1651168865,9,418
3245214008,3082025891,1658215222,1658215557,335,2099
3229713095,3049366364,1659482880,1659483659,779,3317
3512916510,3819952676,1665426826,1665427283,457,373
3415827580,3937306431,1643917535,1643917616,81,847
3192382331,3062662555,1650565130,1650566007,877,3498
3408615617,3406717263,1662661042,1662662032,990,4223
3868038344,3584037920,1655562538,1655562705,167,700
3417473494,3079706847,1655077037,1655077963,926,4632
3874993831,3231829906,1649533100,1649533438,338,1809
3841856819,3753673037,1653057104,1653057762,658,247
3314819974,3711591217,1641668752,1641668760,8,4642
3539488199,3454128725,1656016078,1656016796,718,3972
3955340742,3386964839,1658382502,1658382834,332,3072
3213984595,3993632252,1661760681,1661761075,394,4421
3349780119,3745619362,1669672390,1669673020,630,766
3877325684,3151564446,1658536876,1658537865,989,1573
3567149977,3940176144,1642208544,1642209288,744,2614
3232206614,3960765770,1661819603,1661820575,972,2228
3980353655,3736033971,1660666229,1660666939,710,4966
3451589165,3671183234,1665374227,1665375162,935,551
3955498690,3839681085,1650890301,1650890808,507,8
3442586466,3424429890,1655197367,1655198102,735,3814
3817355675,3598545672,1651999101,1651999571,470,1048
3460246794,3269275846,1648616733,1648617593,860,2175
3628808158,3435974872,1643635896,1643636873,977,199
3425872861,3963578819,1661651239,1661651708,469,2555
3432830412,3703840275,1644068428,1644068497,69,1842
3349076776,3343834311,1653538763,1653539732,969,3576
3853813922,3074168010,1661061758,1661062006,248,589
3740946911,3539108464,1645606343,1645607152,809,1168
3926801858,3808130217,1667318665,1667319071,406,3179
3439533891,3483626254,1643519665,1643520440,775,4009
3573161066,3368244322,1641949589,1641950484,895,1480
3548824303,3488076201,1652564476,1652565133,657,663
3365354923,3711842080,1666941734,1666942618,884,1783
3838499876,3782962445,1645185659,1645186390,731,3939
3346871016,3342395443,1666961265,1666962017,752,1452
3150843219,3529988799,1656273077,1656273323,246,3792
3885182880,3580067293,1654148956,1654149490,534,1028
3757943434,3316260418,1652334584,1652335406,822,2450
3583245141,3678904546,1645524023,1645524420,397,4680
3686202674,3174419458,1656090079,1656090176,97,2281
3769447821,3220679950,1655974200,1655974835,635,2752
3008310119,3711695728,1656853569,1656854392,823,228
3261658270,3069923934,1653028751,1653029236,485,266
3167463673,3314245841,1650107783,1650108453,670,209
3338830335,3964466587,1666227736,1666227759,23,3552
3821174360,3246979451,1644505544,1644506215,671,1929
3365198403,3287034452,1656247824,1656248338,514,4636
3264228748,3654885368,1646753107,1646753849,742,2714
3641330314,3622059529,1664033608,1664034189,581,2016
3501225372,3402563013,1663340629,1663340840,211,3366
3907020777,3239385575,1668638201,1668638580,379,2544
3181544499,3311639377,1658725154,1658725903,749,4491
3493972539,3186863472,1657223675,1657224082,407,2761
3315207283,3718679260,1663659004,1663659629,625,585
3383173006,3416269855,1669097772,1669098085,313,1992
3527768955,3891220861,1654394977,1654395468,491,3214
3892491811,3598742066,1662341353,1662341823,470,607
3605233671,3671932312,1666955784,1666955973,189,3177
3431938152,3223548706,1664307909,1664307996,87,2580
3057224070,3307119928,1646381686,1646382684,998,1732
3908090402,3235934135,1656752081,1656752658,577,2486
3079523741,3148534682,1658259206,1658260136,930,3953
3592939027,3937489377,1648290549,1648291482,933,789
3251148639,3571492642,1658573277,1658574129,852,4630
3083891399,3339620748,1650958174,1650958198,24,3379
3724201179,3486197840,1661381037,1661381837,800,3877
3401024057,3653357650,1647651338,1647651933,595,1144
3575853871,3775837957,1655675522,1655676390,868,1531
3506294771,3293415458,1660800729,1660800836,107,1868
3425497703,3549824090,1667013444,1667013572,128,869
3772053686,3083742977,1651033516,1651034027,511,530
3352858153,3716973360,1660332634,1660333328,694,4200
3923436297,3195596633,1654587113,1654587182,69,3360
3543449192,3453289693,1642190665,1642190840,175,698
3016629307,3433998336,1646134053,1646134166,113,1134
3864083764,3272715091,1648222245,1648222507,262,817
3775791973,3062220533,1658086147,1658086510,363,1981
3057682738,3454904948,1646740549,1646741104,555,3576
3019202241,3380563917,1663203683,1663204020,337,3224
3857847888,3077693119,1653632016,1653632328,312,4548
3223923650,3261999483,1669528125,1669529070,945,3729
3109959938,3786696790,1668401703,1668401992,289,3530
3817253291,3208956531,1650829887,1650830595,708,4881
3740517986,3125824679,1649865879,1649866230,351,3399
3942526286,3740827897,1663779653,1663780546,893,4597
3532483154,3992271484,1655358808,1655359482,674,4694
3389233907,3142790207,1654941362,1654941781,419,1072
3249357481,3829801573,1661792147,1661792344,197,3399
3885743429,3982652058,1644748807,1644749499,692,2691
3230983558,3501225372,1655498397,1655499248,851,57
3679132571,3458997383,1665407886,1665408567,681,1385
3500574860,3454259449,1653961888,1653962610,722,1530
3368132116,3600191299,1659838171,1659838398,227,4116
3557169794,3151964220,1646260806,1646261147,341,4209
3998740759,3101262775,1666381936,1666382844,908,1591
3089981512,3927026686,1657285683,1657286137,454,1966
3062169447,3271459447,1650752770,1650753627,857,4678
3211595511,3178128825,1651133610,1651134151,541,2461
3332522318,3715360782,1649759471,1649759875,404,2442
3013511933,3693268415,1646461697,1646462675,978,3840
3709535435,3942639738,1668316519,1668316652,133,404
3300999286,3138979239,1658795234,1658796196,962,2054
3359900802,3172276170,1641492512,1641492876,364,1315
3955369281,3417149185,1668876961,1668877862,901,3177
3609857014,3950461068,1657572222,1657572873,651,3984
3722357873,3677800297,1655892310,1655892819,509,1249
3295291802,3750623656,1646632262,1646633021,759,3237
3048980559,3877329892,1664601092,1664602058,966,2307
3230802363,3041073193,1655341520,1655341643,123,1136
3306518255,3555323134,1664377910,1664378122,212,4318
3070847235,3390312611,1663671319,1663671347,28,2836
3121847044,3817868890,1647065969,1647066788,819,2393
3291022455,3357999372,1662261163,1662261806,643,3530
3743581958,3629953725,1660802603,1660802955,352,2803
3308355078,3744714348,1653767242,1653767925,683,943
3099045395,3696380184,1657584146,1657585012,866,1857
3846936139,3571089262,1653805523,1653805528,5,4953
3704089554,3793086135,1660269083,1660269433,350,2105
3469249613,3487663638,1647613258,1647613513,255,2672
3435311775,3265549049,1646836090,1646836867,777,443
3711251865,3071138997,1649517324,1649517608,284,4471
3170787937,3934455830,1647488959,1647489142,183,803
3084725482,3857944117,1662650482,1662651413,931,1065
3661122419,3290184660,1653565931,1653566835,904,2347
3406248222,3812033778,1648409606,1648410448,842,2310
3802637353,3011469333,1650589318,1650589615,297,2864
3568163982,3487459881,1664727232,1664727908,676,4059
3254411078,3544161943,1653467176,1653467955,779,2741
3490199074,3703791552,1641675134,1641675393,259,264
3846223669,3905095074,1659857299,1659857783,484,2755
3223356964,3543208645,1646319594,1646319735,141,3134
3538777335,3640557515,1655338483,1655338574,91,608
3883579049,3689802556,1656077755,1656077840,85,1666
3432089113,3394984478,1655096357,1655096571,214,2918
3354571437,3081026169,1666052602,1666052848,246,3831
3481729007,3398477885,1669460397,1669461367,970,2292
3804221083,3446917478,1645719172,1645720011,839,3075
3384993802,3843210787,1663816005,1663816764,759,2957
3973723188,3999675454,1647770561,1647770794,233,4700
3511888387,3085852119,1644769067,1644769518,451,3809
3239290132,3805443158,1665592877,1665593610,733,134
3901276446,3899061816,1647638383,1647639251,868,131
3556613473,3691543896,1658162858,1658163344,486,2033
3311371835,3987320806,1663521177,1663521628,451,826
3567767488,3887779427,1663877447,1663877707,260,3007
3363438789,3623611928,1648566445,1648567043,598,2254
3556998966,3447953673,1660867563,1660867885,322,2101
3408093852,3460483275,1641906061,1641906651,590,1718
3436611894,3708887879,1651331249,1651331852,603,4902
3471691794,3965678413,1652650721,1652651408,687,2990
3440874596,3847328647,1654903723,1654904074,351,584
3686239807,3389433284,1656743384,1656744005,621,3601
3994740725,3509181519,1649194279,1649194883,604,130
3786518486,3171466537,1667578953,1667579343,390,4443
3029677046,3405482476,1642434797,1642435727,930,754
3216719751,3750464789,1655592282,1655592764,482,842
3225154884,3064718042,1643632783,1643633390,607,3416
3679865500,3813075791,1656751578,1656752006,428,2160
3574355220,3137268645,1663157523,1663157930,407,3714
3933240290,3110871974,1668550283,1668550911,628,4148
3058699872,3562389240,1646754355,1646755164,809,4581
3096889822,3484231635,1660644914,1660645896,982,2396
3689802556,3697831234,1658589981,1658590674,693,4888
3858113203,3752720215,1652253890,1652254366,476,1939
3682987630,3565880004,1642224743,1642225110,367,4359
3706944795,3330209196,1643240334,1643241243,909,3803
3840099439,3790493332,1641965229,1641965574,345,758
3392015410,3908109126,1654626183,1654626649,466,2317
3750984707,3981718972,1654395238,1654395339,101,3648
3049905075,3588112145,1657744702,1657745698,996,1299
3246933765,3593172179,1663341388,1663341680,292,3403
3580306912,3382638315,1657748978,1657749898,920,2142
3781228169,3517546674,1667106682,1667107040,358,4184
3604310810,3447689971,1656353419,1656353696,277,3430
3495242668,3377734615,1662626081,1662626488,407,2337
3322004826,3109420286,1646346865,1646346964,99,1379
3097556773,3382098624,1664063187,1664063703,516,1389
3132287704,3745803414,1660870866,1660870997,131,2701
3165296599,3829153108,1668349977,1668350974,997,132
3284907750,3440841047,1641166945,1641167825,880,251
3783818678,3845883358,1663565827,1663566021,194,4269
3588682085,3209278097,1644479158,1644479746,588,2185
3399526903,3974548712,1657916856,1657917668,812,4793
3705459840,3420664796,1642907577,1642908046,469,388
3429006621,3140166512,1669592068,1669592791,723,2206
3867728552,3640914630,1666076407,1666077189,782,3916
3850571947,3222914177,1655457473,1655458064,591,3423
3861661555,3867082245,1663099480,1663100204,724,4521
3197232202,3802621779,1643671519,1643671779,260,563
3576248964,3416658401,1641526357,1641527010,653,2153
3840901770,3754469423,1662528498,1662528614,116,1872
3977000290,3426500676,1662172038,1662172296,258,3215
3749874509,3559772344,1665601860,1665601870,10,2550
3394831592,3873995643,1650390717,1650391415,698,4
3211743598,3279448501,1654362729,1654363552,823,658
3218085847,3810579731,1647098951,1647099678,727,711
3294114415,3029514353,1653667914,1653668299,385,4622
3270819987,3841856819,1655236033,1655236407,374,3514
3084374437,3179207826,1646870496,1646871113,617,1664
3855490631,3689526849,1642743797,1642743970,173,1166
3390826611,3226016679,1660011996,1660012218,222,4048
3981304950,3434573068,1659173944,1659174436,492,2427
3411306570,3996746901,1667416295,1667417226,931,2980
3926736372,3574337472,1658247546,1658248014,468,2561
3274983852,3034869946,1668577090,1668577509,419,2199
3745619362,3208043311,1667677951,1667678743,792,2695
3724391374,3583689703,1643219208,1643219384,176,3711
3122818936,3757478759,1655259702,1655260317,615,48
3395540384,3493068880,1649972853,1649973453,600,621
3769541614,3400245076,1668699147,1668699875,728,3868
3782623928,3641965639,1648801537,1648802530,993,4971
3374663290,3737038017,1664453168,1664453561,393,1528
3319868677,3283829754,1668628202,1668628555,353,319
3786961908,3588824787,1666795548,1666796443,895,2298
3428527940,3294239520,1646177504,1646177832,328,3376
3809718926,3274434499,1661241972,1661242131,159,3609
3616024268,3025853384,1664538926,1664539272,346,1925
3768294532,3693057812,1645091824,1645092584,760,3279
3573191366,3117510124,1652042762,1652043181,419,1322
3823340747,3985707518,1649259744,1649259787,43,321
3451227731,3576462725,1661627509,1661627929,420,2824
3719055544,3569367230,1659624093,1659624821,728,2405
3868282009,3768134302,1643944249,1643944272,23,177
3732570020,3847109164,1667661377,1667661844,467,607
3958378809,3189554911,1643666734,1643667043,309,3732
3230546432,3236119477,1658209750,1658210537,787,2470
3903518498,3749631557,1651971057,1651971796,739,927
3090705245,3400418824,1645074737,1645075538,801,369
3007186505,3356163822,1659891057,1659891725,668,2199
3597348657,3818700984,1645852942,1645853906,964,1318
3470874249,3877408231,1648638788,1648639290,502,31
3558209220,3083883926,1645620707,1645621059,352,2427
3860500916,3128332247,1648992761,1648993088,327,970
3600182070,3185331131,1651721457,1651721909,452,3762
3513601677,3424429890,1661152711,1661153186,475,3156
3022677399,3656866560,1644836707,1644837232,525,1727
3343076273,3509645231,1641665660,1641666257,597,145
3164174838,3599633333,1662907930,1662908173,243,4586
3488198251,3594558058,1648455799,1648456756,957,3142
3567242296,3202786500,1653463131,1653463593,462,1847
3084833041,3512940236,1645434115,1645434526,411,1481
3736565145,3088265322,1655012848,1655013752,904,4938
3479455066,3944158822,1643445583,1643446538,955,4371
3144342861,3664326951,1668599435,1668599679,244,978
3871529431,3805482599,1663454517,1663455378,861,3824
3767201518,3902366239,1651591708,1651592658,950,1423
3952282560,3890739587,1648346808,1648347000,192,910
3043055681,3221036654,1658047441,1658047756,315,4504
3178881017,3215578953,1667718065,1667718659,594,4291
3745666820,3118453050,1665076035,1665076168,133,1608
3679185246,3173399986,1661015954,1661016692,738,808
3387728646,3757687252,1657462636,1657463386,750,898
3680093923,3561389834,1669457891,1669458524,633,3659
3597829521,3938860200,1645386978,1645387563,585,4743
3385884727,3712124770,1644126165,1644126899,734,4376
3249258249,3380749106,1661912829,1661912904,75,158
3159979857,3139858278,1663774022,1663774353,331,3626
3275103912,3521723921,1660796917,1660797916,999,4315
3350303308,3141384068,1659144408,1659145210,802,4094
3774570428,3004229639,1663718766,1663718849,83,437
3264796095,3468600661,1643565679,1643566022,343,938
3311839197,3450715386,1663640543,1663641003,460,3024
3592526627,3790065758,1648123135,1648123760,625,4860
3402338342,3995123802,1641677011,1641677841,830,3692
3881463088,3191658762,1646929814,1646930063,249,3818
3567629592,3622846494,1651312369,1651312794,425,4044
3454888180,3982416724,1645791369,1645791845,476,3322
3518059508,3705233093,1660726749,1660727094,345,458
3601515465,3518389765,1655065435,1655066145,710,4492
3922957717,3779490028,1642953975,1642954419,444,3428
3538596544,3418927372,1654160488,1654160622,134,2414
3827574193,3842922132,1642865899,1642866728,829,3788
3482196045,3818391079,1641546935,1641547409,474,2244
3456720463,3273797116,1652914003,1652914791,788,2601
3689165612,3068948080,1660362127,1660362252,125,3161
3535013475,3021607489,1653429405,1653430287,882,2029
3917194088,3133480783,1651694444,1651694888,444,3062
3446689540,3676234617,1661428834,1661429633,799,1559
3136690038,3042271961,1646465401,1646465937,536,2347
3106476213,3658912807,1645291149,1645291825,676,915
3419758048,3464779087,1646691964,1646692742,778,660
3682105027,3106825542,1657879337,1657879946,609,4619
3540828390,3259259391,1662908810,1662909016,206,2760
3361433068,3035100063,1660256641,1660257316,675,223
3220611213,3777396929,1661380541,1661381499,958,1686
3637760904,3928468286,1649566919,1649566929,10,3207
3411344753,3108075177,1649826140,1649826744,604,1756
3397948941,3436877373,1654465122,1654465440,318,3770
3233724345,3951325128,1662577392,1662577665,273,557
3595016844,3442390945,1641683756,1641683810,54,385
3637437706,3471458886,1661229093,1661229132,39,31
3696871534,3316267553,1654953349,1654953876,527,2941
3607115080,3249132207,1650916053,1650916204,151,2556
3821021657,3752625727,1651132795,1651133022,227,122
3198502597,3237684307,1641152963,1641153588,625,295
3350477993,3073055665,1646177537,1646177655,118,689
3548330638,3081169850,1648131755,1648132477,722,3403
3046850514,3787772289,1650558478,1650559003,525,4615
3805343842,3595701272,1660553297,1660553775,478,563
3270728763,3674124562,1669483592,1669483873,281,4278
3777551006,3587303332,1646915152,1646916080,928,1819
3856671106,3720462060,1665504686,1665505363,677,944
3812117790,3830878566,1657952714,1657953052,338,4392
3929419754,3759441447,1655141429,1655141751,322,4787
3298563169,3217340824,1642676660,1642677169,509,1571
3514083287,3105328373,1666933023,1666933292,269,882
3863778000,3506294771,1660836968,1660837243,275,1192
3252383183,3710294209,1647470642,1647471460,818,601
3175588248,3492897672,1647330163,1647330531,368,2011
3339033522,3622140927,1656989927,1656990701,774,3254
3087048971,3530339759,1652349632,1652350576,944,2866
3711534763,3156155190,1664902620,1664902852,232,3696
3458778448,3386351273,1657893758,1657894320,562,4552
3751113142,3668942387,1660537804,1660538519,715,1167
3989764211,3877408231,1658529180,1658529283,103,4616
3590282280,3859175330,1647372304,1647372801,497,2145
3256436086,3963371837,1642656667,1642656860,193,2964
3337267516,3473515406,1669170429,1669171138,709,299
3427090550,3899223920,1656071145,1656072126,981,885
3668147929,3955498690,1643885707,1643885774,67,3197
3652759507,3784968972,1642992496,1642992527,31,4650
3954651250,3142270474,1648306472,1648307295,823,1022
3330217564,3816671012,1646039194,1646039446,252,1398
3812096190,3632812269,1643421452,1643422364,912,1622
3560133665,3898053019,1654077241,1654077654,413,3717
3124023557,3346923772,1665038853,1665039379,526,651
3496067095,3843879115,1668519849,1668520344,495,2734
3750260653,3020924194,1659680907,1659681519,612,1893
3099351685,3720193132,1650712997,1650713457,460,977
3146741178,3071170008,1656094539,1656095391,852,1751
3167912588,3511218706,1655273286,1655273376,90,4287
3646730089,3836852119,1655149369,1655149879,510,4224
3976008709,3766952367,1658063313,1658063466,153,3974
3522517904,3874904974,1645081589,1645081769,180,1609
3987638685,3806241550,1647781198,1647781202,4,2103
3510535130,3829801573,1646080267,1646081136,869,2869
3374495290,3965900831,1657956401,1657956658,257,900
3531014729,3249908161,1660776266,1660776606,340,4475
3579007394,3550680802,1644519969,1644520923,954,2646
3513414843,3774998319,1643386291,1643386566,275,864
3467704037,3246979451,1645637612,1645637774,162,3628
3407570232,3197664380,1646739542,1646740398,856,1327
3196778798,3288052833,1665687891,1665687968,77,3626
3296862003,3968488047,1650122180,1650122325,145,1909
3446074443,3645895612,1644949607,1644949610,3,1474
3101022088,3057004890,1647741327,1647742128,801,4874
3948457561,3751387391,1660722090,1660722214,124,1895
3542623519,3311354387,1653322457,1653323221,764,2453
3533797319,3770093031,1644674569,1644674762,193,1458
3337376754,3645720205,1669161535,1669161757,222,3597
3448366630,3466090574,1660021410,1660021951,541,1864
3911921547,3433653912,1649132792,1649132937,145,1068
3079187031,3450438360,1667285530,1667285586,56,4934
3101265408,3855247642,1644571708,1644571902,194,2022
3601564918,3888231668,1660454839,1660455583,744,3715
3438836698,3298567956,1657773348,1657773957,609,1607
3560990811,3895384381,1664243662,1664244311,649,4613
3502533485,3701991040,1644218316,1644218373,57,2320
3578906594,3601502706,1661243400,1661243524,124,3556
3089690159,3393886566,1660082454,1660082712,258,781
3849410100,3807915741,1646164329,1646164880,551,110
3620114545,3049560991,1650042684,1650043295,611,4064
3297237052,3007153662,1665567645,1665568065,420,4542
3399670552,3687109715,1650027310,1650028235,925,393
3659487370,3362130816,1667910988,1667911362,374,1251
3427126169,3469254881,1665800898,1665801546,648,996
3471661113,3793961283,1646752857,1646752912,55,1108
3643065625,3257102691,1656230919,1656231427,508,3835
3490728980,3601703333,1665058651,1665059126,475,2582
3222945902,3667462995,1652432632,1652432845,213,890
3468904347,3275572865,1664901067,1664901484,417,1636
3249458917,3463001174,1665937164,1665937508,344,2397
3417888217,3714585039,1654862815,1654863594,779,1743
3111819033,3638415310,1643516209,1643516919,710,1899
3796338864,3239838270,1658997119,1658997674,555,1837
3438268021,3489496850,1655396907,1655397889,982,3365
3009321196,3980338011,1643993423,1643994062,639,969
3205740244,3347636737,1665724494,1665725393,899,1472
3338825318,3041422283,1658467203,1658467473,270,2895
3297133595,3032590521,1666732692,1666733148,456,4365
3073540606,3425662854,1664959609,1664959692,83,534
3568096392,3622894613,1653054505,1653055155,650,4232
3607313116,3352177845,1650219682,1650220424,742,3762
3891658998,3333189937,1658736305,1658737085,780,2248
3228908990,3709316831,1656349546,1656349546,0,3015
3469544565,3311479192,1669627121,1669627451,330,463
3503697970,3652092553,1655879654,1655879841,187,2153
3533840604,3613005846,1660577514,1660578278,764,2981
3907289399,3839229297,1645980990,1645981826,836,569
3762850498,3128160244,1653368401,1653369267,866,4630
3330019271,3519619564,1642674543,1642674914,371,3959
3206617750,3789668386,1647412375,1647413055,680,2685
3451369007,3476042349,1655821401,1655822353,952,1216
3817098387,3789885115,1647874547,1647875341,794,3109
3942354688,3384155412,1658167199,1658167224,25,1371
3723767169,3619964253,1655511587,1655511679,92,3617
3801255527,3661489364,1657552682,1657552806,124,3384
3561036328,3247128476,1656749742,1656750198,456,2540
3348953529,3385219192,1668221223,1668221276,53,1131
3693191948,3614949585,1649808327,1649809085,758,3217
3350703729,3945188997,1655512697,1655513386,689,2509
3706450944,3520911637,1642871127,1642871838,711,4523
3341815723,3300592020,1641665582,1641665831,249,144
3729168175,3307429832,1644834553,1644835130,577,3043
3543351247,3920738355,1649241357,1649241617,260,3956
3634714661,3692342678,1652951808,1652952430,622,3683
3114800452,3737577016,1655822789,1655823496,707,2723
3179952336,3378904751,1654228098,1654228843,745,2004
3589899706,3815867252,1657091979,1657092585,606,2500
3507389821,3746062649,1642407872,1642408828,956,3728
3359574446,3646223667,1664146173,1664146481,308,3610
3581689173,3708943742,1650397398,1650398336,938,3451
3722221185,3723903650,1665579287,1665579367,80,172
3277360700,3409757698,1649426131,1649426661,530,4803
3429504456,3159003467,1657647334,1657647385,51,1712
3165207274,3129172634,1661674135,1661674409,274,2048
3518009541,3503964938,1665066143,1665066628,485,2241
3051485603,3333865156,1643079918,1643080520,602,4063
3848827770,3906460699,1658766765,1658766780,15,3384
3053220557,3983892895,1668841343,1668841426,83,1036
3102623648,3120312313,1663496959,1663497348,389,1912
3754624150,3990741357,1651125503,1651126171,668,3554
3492476776,3756965968,1664053187,1664054032,845,4336
3578480850,3201876236,1653864836,1653864946,110,4311
3727512881,3383442900,1648997238,1648997351,113,1505
3484036619,3564725354,1668222414,1668222918,504,533
3107836984,3645946249,1647066478,1647067290,812,2551
3663164198,3985430745,1668414110,1668414596,486,4399
3567709174,3647518911,1655275201,1655275214,13,2760
3809959611,3225109628,1648541175,1648542132,957,2855
3407864595,3474188174,1646440901,1646441697,796,4145
3536585692,3089306276,1648221139,1648221480,341,3051
3220561986,3205748927,1666153716,1666153757,41,3980
3194790875,3476267965,1653758726,1653759522,796,2258
3160721834,3417344155,1667744045,1667744238,193,2176
3007153662,3851661949,1662083473,1662083911,438,3819
3045866216,3388661207,1657801102,1657801811,709,3707
3727238195,3245331131,1669271362,1669271726,364,1220
3763596097,3941041200,1668042088,1668042777,689,490
3139055946,3844728516,1658022158,1658022781,623,4730
3651732266,3731107764,1650405094,1650405264,170,856
3591809520,3215794422,1666861178,1666861832,654,1542
3702948360,3765685309,1647997550,1647998339,789,2688
3878885119,3216042374,1667611271,1667612188,917,1459
3553165476,3508590257,1667572244,1667573051,807,2034
3991662203,3346674837,1644526644,1644527116,472,2811
3313247872,3663561647,1652835157,1652835359,202,3199
3930070200,3138372881,1657712035,1657712231,196,1075
3876308452,3044374476,1658959862,1658960100,238,1632
3139479177,3064576099,1642320594,1642321492,898,3528
3308376254,3076706678,1659006238,1659007039,801,3051
3439486266,3320951275,1642562115,1642563095,980,2532
3828732309,3949468373,1641524656,1641524755,99,1322
3058771680,3298852203,1664578704,1664578830,126,2124
3751669196,3267671759,1661857378,1661857928,550,3529
3857397414,3834390383,1668568395,1668568488,93,1481
3414257188,3515139960,1648773651,1648773785,134,558
3433410703,3178847922,1655387195,1655387202,7,1233
3880445242,3416975226,1659488791,1659488884,93,3873
3893223973,3444239208,1656253936,1656253958,22,3029
3487862915,3569667203,1669001171,1669001427,256,1
3270980577,3126489123,1647906822,1647907552,730,4649
3540912610,3946911313,1663816524,1663816594,70,3444
3204166080,3067698948,1650663479,1650663939,460,3285
3240759018,3633738517,1667961164,1667961599,435,4555
3477245301,3542428544,1669189044,1669189691,647,1858
3764017896,3461922945,1650178147,1650179081,934,1777
3005987781,3353788138,1661398703,1661398805,102,2270
3603220712,3584936497,1665667105,1665667682,577,2687
3744714348,3813912757,1650556312,1650556831,519,1191
3846545061,3388344451,1668482099,1668483007,908,3899
3657003243,3465678417,1663102939,1663103067,128,2512
3261251371,3538789199,1650160553,1650161304,751,534
3866799658,3023681549,1648246637,1648246669,32,1931
3171226714,3992633840,1652760471,1652760611,140,4864
3254431462,3022574741,1644557585,1644558329,744,2663
3058530945,3436030950,1667041143,1667041463,320,1359
3565279449,3709488401,1665410253,1665411113,860,966
3680836336,3258382368,1651338689,1651339261,572,1297
3346848840,3713705673,1650220373,1650220596,223,2824
3225322788,3757862028,1657208881,1657209316,435,1628
3129227910,3406927167,1652826004,1652826562,558,3630
3034165495,3650668318,1647779174,1647779846,672,3842
3103832887,3218796129,1654690088,1654690209,121,1405
3519158705,3651060672,1650274159,1650274825,666,3264
3923230009,3430101194,1644841540,1644841923,383,3624
3854311352,3192125583,1660870350,1660870761,411,1075
3383627109,3101184924,1652957259,1652957332,73,2517
3636477922,3464532775,1655541329,1655542284,955,515
3540756900,3910110073,1669308903,1669308974,71,1555
3232273801,3230516486,1646731810,1646732720,910,2242
3039602707,3092996934,1648786388,1648786846,458,4179
3044797904,3792905169,1661536557,1661536777,220,4380
3664305026,3239837182,1668235882,1668236807,925,707
3685056251,3076309225,1659071811,1659072539,728,2658
3185296661,3336908169,1659229354,1659229935,581,3132
3389173280,3394259700,1658421930,1658422389,459,3322
3429875558,3057184736,1644347592,1644348568,976,4072
3064271019,3238622083,1644611195,1644611627,432,1395
3594642945,3270502753,1663833478,1663834051,573,613
3155977400,3709864867,1652773226,1652773288,62,4411
3987044188,3656543534,1644481202,1644482031,829,4307
3201305765,3205289088,1656519304,1656519905,601,139
3758687131,3904250651,1648025876,1648026016,140,2950
3673450028,3309750547,1654599904,1654600507,603,1726
3608301040,3428751793,1653448344,1653448820,476,1095
3434624470,3984101721,1642791124,1642791569,445,3878
3607746264,3190019694,1654780839,1654780902,63,4265
3388437567,3590549823,1660628720,1660629380,660,967
3347825186,3981033624,1668192012,1668192594,582,1679
3676631340,3171912067,1655142494,1655143087,593,1047
3916552199,3652841391,1664329310,1664329490,180,474
3959682461,3304453121,1653772713,1653773184,471,4470
3093320275,3619776843,1650854485,1650854505,20,4306
3307876792,3551919129,1644244905,1644245374,469,2673
3602091017,3598580357,1646782016,1646782079,63,4595
3032680724,3444630386,1661570787,1661571204,417,4858
3675949487,3583104826,1657444216,1657444442,226,4128
3451730186,3787082886,1654844873,1654845414,541,2261
3977779126,3458771068,1656634512,1656635276,764,1988
3089400818,3106645563,1664875472,1664876106,634,3729
3097798829,3713920144,1659579673,1659579691,18,2015
3635194212,3448012561,1645388223,1645388792,569,482
3825472699,3449984022,1655682755,1655683475,720,2561
3311282819,3932449171,1651152795,1651153589,794,4787
3491957195,3713761101,1653859037,1653859487,450,2867
3418513250,3998017871,1647460100,1647460591,491,1773
3710029529,3435383254,1658892305,1658892856,551,2211
3435359960,3791008085,1654337836,1654338398,562,2076
3130203702,3194222698,1652743949,1652744156,207,4530
3897688322,3803431623,1652200353,1652200387,34,2719
3875022485,3823676419,1657702541,1657703131,590,1527
3613585509,3792106091,1651884013,1651884853,840,282
3156504163,3495123402,1664341502,1664341787,285,1984
3551162000,3444769275,1665636753,1665637319,566,1122
3601843543,3156816131,1652208095,1652208672,577,70
3478000393,3082827024,1660710733,1660711419,686,3128
3082741953,3397226221,1653992049,1653992516,467,3380
3956501277,3369780152,1657082360,1657082666,306,3130
3490099110,3903100058,1654248088,1654248421,333,455
3111115455,3194233035,1654236104,1654236989,885,3151
3404716614,3225329501,1652783841,1652784009,168,4420
3739306296,3118196821,1654725593,1654725637,44,4863
3059412057,3426175257,1663632511,1663632661,150,4896
3566908463,3658011233,1642572724,1642573113,389,3375
3138961361,3608381066,1642629794,1642630355,561,4271
3169416514,3517943071,1668179376,1668179709,333,2748
3326572386,3795372299,1656694577,1656695475,898,3977
3148202707,3353788138,1668239926,1668240920,994,3317
3598019951,3446057762,1645418549,1645419205,656,1821
3097058664,3668147929,1655540487,1655540536,49,2810
3977315586,3257954252,1664725402,1664725693,291,3609
3930660639,3541399142,1666011379,1666012034,655,2954
3061110765,3621073960,1660020428,1660020763,335,1203
3273823614,3282561401,1662244738,1662245111,373,3686
3283878125,3098028229,1653236875,1653237753,878,39
3620244033,3759683106,1669458402,1669459300,898,1025
3595331258,3108870583,1666802924,1666803432,508,636
3726003372,3004617234,1647901291,1647901678,387,1071
3859135857,3503148491,1665790229,1665790845,616,3729
3311822371,3655058756,1658772299,1658772704,405,363
3081764211,3413370663,1661085970,1661086667,697,4556
3001235255,3848966374,1641450951,1641451737,786,3682
3466910375,3211146215,1646527919,1646528307,388,21
3273727328,3792576453,1651651907,1651652639,732,3428
3828166539,3907552372,1665359625,1665360247,622,3661
3245617910,3846789039,1642155379,1642155809,430,4460
3311733439,3980481626,1642724887,1642725139,252,2878
3704804253,3271702947,1656011791,1656012027,236,2997
3435947790,3101214639,1660714088,1660714181,93,655
3501154881,3068115960,1658684122,1658684251,129,4873
3858561384,3606118563,1649872647,1649873594,947,1975
3182275937,3849140708,1663568942,1663569610,668,3591
3175352388,3820795611,1641694333,1641694737,404,2497
3345454316,3831935042,1651368962,1651369937,975,4914
3643915905,3370731677,1653400947,1653400970,23,1122
3181365511,3941449480,1661608611,1661608850,239,1470
3497360678,3978973892,1644243135,1644243706,571,2836
3490799263,3074502667,1642949612,1642950187,575,4877
3569520235,3470018613,1653006095,1653006525,430,1997
3998971445,3045866393,1651206501,1651207084,583,600
3179817071,3773479305,1646855832,1646856136,304,545
3626825551,3909343498,1669229729,1669230450,721,4825
3821118479,3996513706,1660256652,1660256731,79,1572
3189839526,3243422769,1641484032,1641484954,922,3132
3235525101,3078622803,1668381636,1668382226,590,1485
3656737803,3555580031,1659730786,1659731031,245,4665
3069021770,3089948833,1650848342,1650849151,809,87
3619935619,3737565825,1656540395,1656541228,833,418
3887491754,3928194634,1648994081,1648994546,465,1547
3397723292,3826508598,1660879034,1660879659,625,4051
3971029176,3623354953,1641774275,1641774457,182,472
3990648593,3577700660,1663294607,1663295421,814,3827
3070123730,3117953981,1659845554,1659846159,605,1914
3923488858,3007148586,1655957168,1655957615,447,369
3374943126,3754880702,1642407393,1642408078,685,1328
3556913763,3287281900,1658948095,1658948983,888,2462
3256413913,3795957697,1664371966,1664372136,170,1986
3560951352,3646280234,1660602388,1660602399,11,4257
3954839342,3965063368,1646386945,1646387803,858,2382
3302021985,3089492607,1643613787,1643614783,996,3106
3303971947,3339374838,1659733982,1659734632,650,4229
3760441417,3667101519,1668357911,1668358348,437,2752
3548292696,3349338498,1661272896,1661273122,226,3221
3017581876,3616784735,1661284710,1661284765,55,3673
3593446198,3726171256,1669066469,1669066637,168,4129
3789217177,3405908627,1664260687,1664261007,320,316
3483032688,3582018418,1651952427,1651953333,906,3566
3777978600,3556232905,1656106667,1656106801,134,1832
3289344826,3722228842,1659971150,1659971392,242,3764
3775639568,3979002724,1642974625,1642975401,776,2655
3116291083,3134227961,1656472329,1656472442,113,2315
3376363187,3798960283,1664715167,1664716095,928,3871
3221327999,3054455968,1659928757,1659929354,597,2957
3897705192,3802467866,1643418512,1643419145,633,4297
3795522514,3204804143,1651670541,1651670861,320,820
3338731565,3718251750,1666392669,1666393636,967,578
3786228757,3164443937,1661611475,1661612001,526,1474
3605885892,3686861915,1650180734,1650181312,578,630
3767489085,3526097678,1663863772,1663864469,697,2378
3380579280,3388626150,1642309489,1642309515,26,3964
3940057263,3982615269,1668732129,1668733124,995,4208
3642247952,3462445621,1644633925,1644634845,920,3118
3214499617,3189080463,1650750115,1650750784,669,2755
3062169447,3691907317,1646184209,1646184996,787,4664
3919387722,3614492747,1655026392,1655027097,705,2997
3277898059,3439115662,1653003406,1653003562,156,228
3802887464,3580149438,1661697312,1661697843,531,1350
3693488869,3048909673,1643632375,1643632632,257,3186
3108075177,3822027869,1662550302,1662550765,463,3129
3946960981,3831204443,1650668715,1650669479,764,585
3195691322,3798522127,1657236469,1657237371,902,4128
3555931800,3418588299,1643926886,1643927874,988,4036
3937657152,3785556273,1652765442,1652766411,969,977
3363941944,3020319927,1647560759,1647561458,699,1492
3734045329,3343111013,1660026606,1660026771,165,1810
3222583547,3242917004,1662497132,1662497747,615,3377
3492518658,3203263922,1659549241,1659549528,287,3164
3481190729,3061895941,1648218135,1648218314,179,1581
3875101606,3651732266,1643255708,1643256355,647,3387
3562781309,3423981974,1644428167,1644428730,563,2027
3540938553,3346896327,1651945906,1651946824,918,2134
3340721907,3140067819,1646542185,1646543122,937,1631
3891833299,3118788335,1644101436,1644102123,687,3825
3276038628,3163523358,1667825789,1667826079,290,1333
3836852827,3584939649,1653427727,1653427888,161,4074
3983933344,3739438866,1646769840,1646770052,212,595
3018871189,3659953541,1645317590,1645317985,395,4783
3176770299,3801281858,1658385665,1658386425,760,2229
3279085864,3628633629,1663730036,1663730167,131,3822
3461099222,3606956283,1667548182,1667549035,853,368
3382511693,3449609109,1666519530,1666519985,455,3014
3716677723,3171737388,1665602765,1665603188,423,1773
3458903459,3866076723,1659392718,1659393037,319,4933
3986649666,3388144628,1643679362,1643679535,173,538
3386749464,3720666839,1645434272,1645435178,906,1949
3370221697,3685052000,1666839115,1666839597,482,3486
3451814016,3663708429,1662870653,1662871448,795,1342
3977290832,3146725990,1660102095,1660102211,116,3603
3629227782,3882354292,1648220191,1648220694,503,4612
3237956250,3965226283,1660865485,1660866259,774,1523
3299986981,3934017142,1643318501,1643318737,236,4336
3198362200,3799207156,1651176342,1651176491,149,2512
3575028460,3862541675,1656210493,1656211271,778,3465
3932472495,3875954346,1644004907,1644005632,725,1550
3629998161,3409107628,1642786655,1642787250,595,3972
3797704664,3083883926,1667379795,1667379901,106,3282
3732229746,3109358273,1653422698,1653423450,752,2667
3805208985,3706625930,1668496759,1668497215,456,4155
3847285711,3944405622,1666993690,1666994249,559,4120
3148264406,3965815507,1656962926,1656963036,110,4303
3245644495,3413915595,1659575768,1659576654,886,4125
3598027680,3813893703,1651300883,1651300992,109,4220
3795771777,3628128923,1647457697,1647457902,205,1125
3505398863,3697356870,1655005386,1655006273,887,30
3887246340,3087011275,1655533035,1655533234,199,4328
3275176141,3933668185,1642148743,1642148938,195,2876
3888333006,3159349884,1644752828,1644753494,666,2499
3425906123,3867152678,1643720239,1643720406,167,157
3093423738,3305447001,1651125128,1651125348,220,4914
3759231434,3232273801,1666869158,1666869499,341,3930
3668091588,3963046763,1641866203,1641866837,634,1570
3830594842,3271929329,1646027663,1646028436,773,3319
3686472046,3527342749,1652054155,1652055046,891,1307
3150273601,3354821159,1650362624,1650363449,825,4825
3552210316,3007481878,1668068226,1668068582,356,1471
3019767283,3852058675,1654453823,1654454211,388,1649
3943697626,3884139433,1647613588,1647614056,468,1128
3243508085,3161192306,1665689495,1665689706,211,3881
3471825414,3877247664,1664847717,1664847898,181,3003
3024922770,3686568388,1647536174,1647536503,329,946
3021946929,3860976855,1652750602,1652750789,187,1975
3237423242,3327165104,1667431492,1667432159,667,2206
3621009361,3704821173,1653529421,1653529465,44,1996
3352840793,3694457792,1663247868,1663247870,2,13
3378666657,3355074143,1650269028,1650269806,778,760
3436888819,3103089640,1642851240,1642852163,923,3564
3349014585,3912021975,1646860400,1646860910,510,3323
3479006107,3004368531,1646051084,1646051557,473,3419
3290882153,3289780492,1651901112,1651901982,870,3124
3042239818,3303799120,1656010602,1656010681,79,3922
3330063811,3580105271,1656577169,1656577270,101,1573
3701002489,3143557520,1657456866,1657457725,859,225
3670972259,3804741264,1660527420,1660527539,119,759
3603359440,3041044568,1663166848,1663167685,837,1812
3295220123,3871890038,1661892759,1661893477,718,1130
3248258736,3381463589,1655508993,1655509529,536,1826
3804555009,3176594027,1663279513,1663279684,171,2571
3853978126,3520673335,1663598873,1663599554,681,3911
3270655299,3399977376,1643352273,1643353021,748,3596
3907709579,3289871737,1644801304,1644801521,217,1051
3072062389,3175960289,1649223826,1649224789,963,287
3137917728,3334285034,1641946551,1641947243,692,3441
3592075387,3899264558,1658427703,1658427779,76,2090
3242769505,3153585717,1656244272,1656244791,519,1698
3565970001,3840782718,1668940573,1668940774,201,912
3497430505,3219591081,1643849116,1643849548,432,4272
3623932086,3125021256,1650995325,1650996301,976,4277
3073385360,3436321938,1657881167,1657882099,932,3959
3448382762,3731811281,1650926679,1650927408,729,1205
3257668348,3273508181,1667336825,1667337824,999,3987
3385646718,3533639450,1659545551,1659546068,517,3596
3186186775,3532136171,1642391476,1642391558,82,880
3951645868,3250150647,1651267414,1651268350,936,2306
3720739886,3662291416,1656946896,1656947095,199,2116
3121227933,3951537889,1646591942,1646591983,41,4312
3026926978,3604415225,1656719962,1656720728,766,1453
3481641397,3556334443,1653678494,1653678766,272,1561
3136189024,3782625659,1665099845,1665100620,775,1541
3194968391,3443806510,1653208050,1653209027,977,725
3629476757,3451900239,1642016859,1642017236,377,2430
3108377343,3136975718,1663574671,1663575327,656,2546
3635684954,3436888819,1654725387,1654725580,193,2118
3687274595,3878537688,1667591198,1667592036,838,3405
3196191289,3815240235,1657868242,1657868379,137,2093
3392141672,3287516393,1648079810,1648080263,453,85
3046407651,3429246681,1664785086,1664785322,236,598
3813008015,3633294774,1666816941,1666817008,67,4522
3116264402,3223415031,1664282704,1664282819,115,4828
3354445219,3750944883,1642918849,1642918964,115,4573
3108174917,3680793135,1644711730,1644712059,329,3124
3663039581,3290110898,1654115471,1654116449,978,3870
3849902618,3934721869,1649206785,1649207205,420,22
3956457182,3534355494,1665729916,1665730819,903,3814
3743045270,3577490528,1652842552,1652842758,206,1905
3964669853,3597494620,1664119913,1664120790,877,525
3859406960,3177503127,1646346670,1646346918,248,3916
3470126617,3554759753,1650713161,1650713950,789,2577
3373751811,3939923259,1643627709,1643628648,939,2348
3810996366,3706643648,1665100066,1665100404,338,4705
3168122425,3880674138,1667436501,1667437366,865,1766
3345494168,3460019993,1646273807,1646274042,235,783
3229097757,3122824348,1660911059,1660911822,763,4272
3175187074,3260045835,1660040253,1660041179,926,761
3286874781,3428754951,1647961734,1647962412,678,1276
3838781019,3538072523,1669587719,1669588667,948,2175
3935227717,3056118959,1643964266,1643964537,271,4490
3358441222,3753389514,1652498983,1652499114,131,2619
3293886828,3854152221,1641977575,1641977984,409,975
3599063561,3682433910,1662012866,1662013533,667,252
3429262126,3424190179,1657336863,1657337196,333,3006
3275896435,3722372088,1659029742,1659030533,791,640
3121009313,3708524645,1668903863,1668903947,84,4980
3754492438,3742007492,1647710652,1647711419,767,4625
3909878239,3019232734,1651744608,1651745067,459,1021
3107558628,3077931802,1668128197,1668129036,839,3196
3959850113,3041194826,1652876041,1652876720,679,4086
3828308854,3259243986,1647202283,1647203106,823,1213
3695606718,3101679307,1647765607,1647766310,703,1808
3290873461,3884749035,1651356755,1651357100,345,2832
3581002115,3451250384,1660996244,1660997012,768,2704
3276752261,3184956972,1655311725,1655312713,988,2062
3864007541,3195517717,1665034637,1665035549,912,1120
3420870482,3296865939,1666039975,1666040463,488,145
3351049036,3233603851,1651200792,1651201702,910,4738
3353403008,3658191125,1658241219,1658242105,886,1610
3599543242,3936880578,1654310675,1654310917,242,2993
3211013773,3339068678,1663701197,1663701988,791,4235
3796348467,3576945853,1663911482,1663911880,398,4403
3711923739,3160083285,1650055557,1650056067,510,1750
3536698894,3164760047,1654706953,1654707108,155,4835
3602317391,3708208977,1642732592,1642732969,377,1852
3926524755,3954691770,1647523101,1647523748,647,1942
3219836709,3585781517,1654142945,1654143224,279,3803
3574407069,3083063492,1643981143,1643981950,807,2042
3344060806,3216186955,1657257568,1657257643,75,4691
3104509095,3326331416,1643464450,1643464982,532,3587
3077235859,3577730936,1665556665,1665557094,429,158
3645071242,3570307240,1667791763,1667792573,810,4325
3347103611,3476079800,1667888477,1667888566,89,1104
3028350489,3791569279,1659684952,1659685335,383,1976
3499913254,3743054311,1655464796,1655464901,105,1854
3316522411,3507139912,1651750408,1651750457,49,1154
3670385447,3230693730,1658770888,1658771249,361,4135
3800764524,3106711442,1662569500,1662570461,961,4394
3939262027,3670292851,1645626254,1645627072,818,4654
3583360443,3647003035,1650406134,1650407052,918,3682
3888812871,3189050407,1665159907,1665160154,247,4919
3972382702,3604764934,1654464490,1654464816,326,3417
3096007559,3229084554,1656084010,1656084847,837,1760
3779896749,3224931049,1657117005,1657117533,528,227
3973500175,3418577693,1643881755,1643882728,973,2705
3671606332,3416790003,1669450830,1669450876,46,4725
3980264703,3108321211,1661926429,1661926822,393,1537
3850337209,3559489440,1659705109,1659705394,285,2910
3494534571,3384627801,1641007737,1641008519,782,1275
3693699941,3949720327,1654213293,1654213452,159,604
3703290964,3852762638,1664395234,1664395845,611,3481
3540141594,3825885451,1645562536,1645563044,508,2886
3398073752,3133268326,1657694963,1657695811,848,387
3172545922,3162158185,1653297166,1653297660,494,3695
3517634638,3448291320,1669665906,1669666500,594,1314
3267181747,3651966005,1661493942,1661494928,986,2019
3125433262,3587881509,1647256965,1647257122,157,651
3434408286,3679708385,1661868113,1661868987,874,24
3117801976,3197025750,1663332770,1663333164,394,4710
3570764895,3472882135,1657257247,1657257932,685,3211
3838343795,3133182356,1641151772,1641151774,2,4444
3688696662,3998819176,1644235879,1644236311,432,4619
3539320432,3368794112,1669587937,1669588058,121,340
3554759753,3209322008,1667174996,1667175260,264,3993
3953444166,3278665670,1655978848,1655978949,101,1137
3597733218,3644285239,1657595898,1657596399,501,4800
3883455044,3377022057,1646171256,1646171558,302,3961
3386716086,3861469160,1660571047,1660572029,982,4040
3219097912,3110776518,1659244158,1659244561,403,2725
3841510213,3965711947,1650998028,1650998201,173,3446
3268839426,3074957247,1663204467,1663205262,795,3708
3943323173,3920309309,1665313176,1665313495,319,1684
3997741895,3668132517,1664632990,1664633520,530,4727
3504709233,3221363097,1652610055,1652610860,805,178
3125691100,3757616221,1658870643,1658871157,514,2866
3030989602,3218456871,1651159760,1651160652,892,4681
3065982722,3462034345,1651528553,1651529269,716,3867
3836132642,3780800250,1641334282,1641334742,460,283
3570640076,3862754669,1663754842,1663755820,978,2270
3547686347,3781965051,1653599776,1653600734,958,133
3473303186,3640981953,1668666500,1668667114,614,4083
3653674269,3479350600,1651853864,1651854501,637,4485
3281788574,3102981702,1650077020,1650077430,410,69
3441037234,3509200646,1651421194,1651421795,601,4455
3469620910,3693836087,1650537355,1650537566,211,3351
3297051973,3233441932,1662622672,1662623102,430,3600
3032731620,3941279581,1646224458,1646225079,621,1305
3295434208,3827078804,1659583425,1659583989,564,1897
3153654893,3524159794,1655788211,1655788650,439,4174
3984550958,3710564988,1655538930,1655539857,927,3896
3899850891,3720328301,1653276707,1653277426,719,552
3809038384,3777994793,1645662290,1645663102,812,829
3449307484,3469772437,1662986234,1662987062,828,2643
3511005888,3396151782,1660314285,1660315166,881,807
3039039315,3602005309,1668669110,1668669555,445,1871
3579747326,3185308972,1665606125,1665606356,231,1224
3680321477,3301018781,1653062030,1653062289,259,3351
3377938919,3404811710,1651489811,1651490492,681,4207
3330448113,3526175046,1654465473,1654466324,851,4392
3627445522,3350854620,1658497129,1658498086,957,1180
3976308271,3784122164,1668580524,1668581140,616,3700
3095356509,3675614279,1669153540,1669153937,397,2958
3562061388,3218774316,1643116681,1643117472,791,947
3580076136,3653460345,1656732811,1656733082,271,72
3782383502,3934743105,1653079306,1653079374,68,4619
3229017213,3810759273,1649889748,1649890518,770,3207
3393169503,3920452317,1646518089,1646518258,169,3592
3868044131,3806352395,1659426927,1659427650,723,3535
3098613266,3814874221,1644468603,1644469405,802,4515
3850151620,3273145606,1666564490,1666564940,450,4552
3508901026,3094802523,1664170226,1664171172,946,791
3600564692,3994033167,1667293255,1667293840,585,2254
3131469128,3606723090,1666356590,1666357112,522,1910
3934633606,3671749131,1642833093,1642833147,54,2721
3955882801,3527346945,1662918901,1662919435,534,68
3501776587,3434613902,1661699719,1661700135,416,3429
3039660737,3552635311,1651614432,1651614432,0,2417
3405146574,3018771695,1649374645,1649375583,938,3722
3021591984,3181304991,1645545548,1645546424,876,4331
3213102041,3577028827,1661040236,1661040759,523,3350
3974211459,3324641408,1649630755,1649630989,234,3917
3405489919,3533483387,1664895115,1664895430,315,3916
3304307987,3778863307,1657564739,1657565365,626,280
3060617149,3443718564,1655320684,1655321277,593,3441
3178468976,3952309262,1655873442,1655874004,562,2607
3601637171,3323040513,1658152910,1658153398,488,3326
3064374416,3183707167,1655702652,1655703436,784,1817
3302678173,3643653071,1666970559,1666971083,524,4154
3665934922,3604256831,1648042934,1648043328,394,2512
3162901820,3951536208,1648730474,1648730983,509,931
3237505583,3849425590,1645969654,1645969697,43,2152
3733252730,3920041853,1667689595,1667690002,407,2356
3266744708,3268886142,1649085900,1649085951,51,4286
3400161930,3255636081,1643749692,1643749864,172,3037
3854777550,3672171681,1664575239,1664575896,657,3924
3856337459,3707729215,1660368782,1660369662,880,3067
3791089548,3612962492,1664175460,1664176056,596,2450
3478631035,3939030777,1659134709,1659135015,306,2757
3757074219,3208377302,1651863558,1651864317,759,2714
3627953066,3679595792,1665393801,1665394077,276,3060
3959746791,3089860515,1644147554,1644147820,266,2846
3227763618,3792410187,1644859740,1644860105,365,4590
3943256625,3172033231,1659018230,1659018405,175,458
3425642855,3993424282,1659714668,1659714977,309,4814
3685857995,3846618285,1654193730,1654194545,815,2575
3732518163,3814037228,1649579340,1649579679,339,1045
3564492961,3109154083,1650760821,1650761655,834,4069
3052346390,3406342056,1663793110,1663794080,970,2078
3851116391,3192541295,1669260799,1669261722,923,4111
3414931778,3053963379,1644889985,1644890114,129,4933
3720875814,3650890871,1647914451,1647915027,576,3783
3454277128,3710535233,1663438506,1663438933,427,2172
3049976603,3143326200,1664228006,1664228174,168,2584
3987508015,3352828159,1662974482,1662974497,15,3189
3386622592,3408887366,1659588485,1659588696,211,1614
3513993879,3081395982,1665508990,1665509684,694,2919
3033287969,3027502729,1651353390,1651353934,544,3367
3888412019,3104942704,1664256858,1664256935,77,1911
3573677554,3830820259,1649160678,1649161422,744,4922
3174985655,3911558168,1662629431,1662629750,319,898
3175431788,3798575085,1645760042,1645760916,874,1926
3225996825,3248202351,1669219199,1669219394,195,4170
3733547525,3059862243,1641299759,1641300599,840,2202
3218961303,3425802563,1644775301,1644776202,901,1178
3933127441,3124352668,1648165179,1648165752,573,3503
3210261645,3178881017,1664964063,1664964537,474,1689
3356643152,3082654902,1641317267,1641317879,612,1523
3961706634,3486135139,1657530710,1657530846,136,1733
3135625695,3566976836,1641585743,1641585943,200,4645
3466553334,3813451677,1656089377,1656090140,763,2088
3095057071,3865375856,1663516450,1663516722,272,4737
3054109357,3173973096,1646168949,1646169395,446,4549
3078132402,3316969730,1669643388,1669644016,628,4818
3858693120,3150568196,1648520015,1648520481,466,3826
3170050127,3043542462,1663556839,1663557754,915,715
3975574404,3190408488,1652595148,1652595365,217,4558
3361962528,3097547294,1666482874,1666482910,36,130
3687477140,3108363382,1643382651,1643382655,4,3402
3224170491,3679089253,1666562424,1666562563,139,3582
3619709279,3460780733,1654771703,1654772042,339,1568
3332572487,3116651745,1665110621,1665111020,399,2794
3486646083,3273860388,1661523027,1661523696,669,1704
3220692993,3281255339,1647272557,1647272913,356,4585
3636008847,3617784204,1665750938,1665751658,720,4203
3790593932,3780330991,1646547844,1646547944,100,4291
3513446747,3476617757,1642883243,1642883404,161,2184
3447366453,3430633783,1645716007,1645716819,812,1849
3249469722,3373764829,1663194059,1663194606,547,1111
3645080496,3528312158,1658561238,1658561906,668,1731
3230964050,3237814703,1668617765,1668618095,330,877
3258301721,3436224318,1667574356,1667574748,392,4120
3886405656,3019466139,1666332025,1666332895,870,2038
3362111009,3832902152,1659880750,1659880872,122,1738
3767655838,3269246708,1642960471,1642961227,756,3225
3815518159,3530277569,1660456685,1660456721,36,1873
3221817138,3561981550,1669251525,1669252459,934,4886
3901251975,3138584970,1661900678,1661901461,783,3598
3194827778,3236765179,1662092953,1662093076,123,851
3156779152,3531292815,1664030972,1664031239,267,956
3665590421,3962547003,1662258401,1662258627,226,2687
3243490960,3607221629,1653029088,1653029209,121,4556
3836852827,3926237349,1641311190,1641311989,799,4914
3298976830,3999797423,1658886122,1658886792,670,3095
3541794114,3508958620,1651568854,1651569673,819,4193
3767238839,3698331145,1663328449,1663329251,802,3284
3035696093,3878982520,1668265305,1668265815,510,4721
3226351955,3234469872,1664498907,1664499734,827,275
3887923859,3104435179,1664115836,1664116500,664,3275
3334098088,3240342134,1664080841,1664081236,395,4443
3369124351,3750589446,1655439675,1655439940,265,2799
3846215405,3553403997,1657296715,1657297209,494,1643
3078924348,3393234271,1669455542,1669455775,233,2016
3229738606,3461554808,1662255280,1662256143,863,3207
3880542409,3705847402,1655529126,1655529549,423,235
3449718514,3464282361,1665218634,1665219160,526,3079
3087091686,3249305427,1658657797,1658658395,598,1005
3210070646,3628384586,1661304838,1661305704,866,3827
3747979899,3745055138,1651186107,1651186193,86,1523
3610455599,3496289015,1648769287,1648769499,212,2728
3640642311,3979489184,1649944470,1649945154,684,4134
3649172923,3764567985,1652162261,1652162788,527,2857
3663618047,3982279685,1664017844,1664017910,66,2686
3572518932,3330650085,1654484970,1654485695,725,4229
3674851869,3118910208,1658213251,1658214092,841,603
3605668712,3158291784,1650309452,1650309854,402,3758
3523689381,3365343289,1656703696,1656704227,531,2547
3773633240,3378604587,1648894016,1648894253,237,2125
3364165492,3066365544,1656810040,1656810874,834,3691
3207150659,3804555009,1655127370,1655128292,922,2690
3129955542,3187591427,1653207803,1653208245,442,3569
3492264155,3650822815,1661655772,1661656502,730,464
3699307013,3386508268,1655715997,1655716961,964,4574
3600759975,3542358798,1657693030,1657693528,498,3966
3122628490,3834318974,1653585408,1653585716,308,4546
3979714596,3064973628,1658683149,1658683364,215,4031
3675842897,3985515938,1666028852,1666029168,316,3978
3061281346,3679074435,1653640031,1653640115,84,1597
3943471689,3849161886,1669425391,1669425615,224,1557
3790793064,3204940253,1661392057,1661392660,603,3441
3276574926,3533132834,1666542365,1666543245,880,983
3950406942,3213914525,1657591082,1657591953,871,1895
3368350636,3057548452,1648745605,1648746121,516,309
3788368181,3126378277,1652006057,1652006128,71,3158
3088224921,3424178720,1653494194,1653494930,736,4434
3059853115,3674404896,1652117654,1652117962,308,2440
3333287324,3502460378,1646094865,1646095241,376,4712
3174439485,3752867470,1644470203,1644470330,127,417
3634626426,3487043778,1642501428,1642502126,698,4479
3023174113,3585989556,1658818735,1658818737,2,1721
3057371138,3218767432,1649471606,1649472277,671,284
3682941668,3159984931,1658179058,1658179117,59,4269
3002935691,3595058485,1646142568,1646142712,144,63
3114284962,3384145610,1662594228,1662595084,856,3235
3898733147,3960961296,1667964094,1667964163,69,1670
3804522302,3357242882,1647787303,1647787862,559,1816
3249878217,3893740481,1663207283,1663207723,440,4062
3172892793,3944210313,1665688999,1665689585,586,3985
3592703675,3120137848,1644574293,1644575256,963,1163
3465210265,3652549780,1643348954,1643349805,851,3898
3033450382,3093375891,1660246729,1660246994,265,1373
3165458774,3919826243,1647049414,1647050368,954,4372
3070811410,3769915503,1665775580,1665775898,318,502
3906841101,3097904437,1665614079,1665614441,362,4096
3385219192,3524142498,1642015940,1642016212,272,3545
3247162592,3459527074,1648999152,1649000062,910,2674
3518355518,3713927120,1653653197,1653653516,319,2502
3230964050,3105480320,1665684616,1665685394,778,4441
3095333131,3741831176,1669628572,1669628786,214,4960
3805874853,3380696384,1652735998,1652736469,471,4677
3305158859,3295811429,1641217885,1641218393,508,3877
3521754155,3762647851,1647312671,1647312783,112,343
3436373952,3523975884,1669473827,1669474581,754,2239
3866149811,3445103158,1642322560,1642323045,485,2080
3476589918,3521161433,1643200150,1643200189,39,2716
3689046057,3405974548,1649800012,1649800230,218,744
3336804981,3806643858,1647255155,1647256155,1000,444
3606269059,3886234424,1664996369,1664997227,858,4188
3990035600,3320308745,1654166292,1654166520,228,4029
3859678554,3848782779,1641010473,1641010597,124,4798
3157182181,3347825186,1649083559,1649083966,407,4420
3398210046,3243453911,1656936931,1656937576,645,1786
3665495106,3571596928,1655885924,1655886611,687,2875
3292231379,3295551630,1652017349,1652017936,587,1277
3498939160,3023326498,1650896966,1650897783,817,2756
3304848971,3881359866,1666902589,1666903045,456,4929
3091512094,3573483626,1643051827,1643052672,845,1315
3366003225,3218648487,1650292297,1650292494,197,1401
3255645495,3807682635,1663776390,1663777107,717,4606
3690808087,3254382995,1642610583,1642611469,886,140
3035645252,3889500990,1669312736,1669313613,877,200
3188095252,3663369684,1652217358,1652217771,413,436
3853760497,3295901311,1664260920,1664261491,571,4947
3145481149,3141903145,1660996526,1660997153,627,1057
3160719969,3640857000,1661074249,1661075243,994,2966
3742035558,3753525572,1646352075,1646352491,416,3151
3999566386,3445566620,1663570365,1663571326,961,4670
3428219163,3918010934,1657945322,1657946196,874,4852
3885476616,3543468342,1667492134,1667493012,878,3013
3682983204,3343652320,1642766174,1642766505,331,969
3953331287,3232624994,1653861172,1653861599,427,3909
3759042509,3987759031,1650944110,1650944277,167,216
3593998718,3366281500,1652476941,1652477900,959,2456
3500857037,3292121861,1668273512,1668274482,970,4453
3127900270,3303839493,1664683151,1664683369,218,3040
3802408673,3455635388,1655399900,1655400261,361,4013
3653105700,3118982595,1657983720,1657984255,535,814
3665963364,3465918976,1643258544,1643259358,814,4386
3516397963,3625399362,1648815201,1648815368,167,4397
3992067867,3824878159,1648056463,1648056895,432,424
3191079784,3829401349,1655396109,1655396291,182,3428
3633894291,3329387991,1654824860,1654825033,173,409
3272278471,3582199586,1660527400,1660528399,999,3795
3806219953,3220148986,1662525336,1662525351,15,2302
3095696386,3479396223,1665042551,1665042632,81,3117
3090383244,3082435710,1644082061,1644082342,281,1858
3767067094,3701706771,1665117837,1665118510,673,1094
3263521770,3316391600,1661759990,1661760161,171,2809
3040081355,3760807983,1647241605,1647242338,733,1900
3564747113,3806570112,1655451053,1655451466,413,3837
3687018148,3618494549,1646052403,1646052526,123,4396
3795410707,3523288721,1653661399,1653661563,164,4563
3777268178,3092275438,1662212369,1662212683,314,1014
3865534310,3662614492,1641987502,1641988243,741,2198
3818852046,3848945008,1651806901,1651806952,51,4633
3511063813,3014476851,1644171387,1644171494,107,2426
3259701194,3934202987,1661331537,1661332312,775,2430
3001135064,3118772056,1666787724,1666788326,602,171
3243457754,3009280578,1658278960,1658279824,864,2179
3905490485,3369444242,1666245021,1666245435,414,3822
3932353832,3705480044,1653771141,1653771400,259,4885
3269280686,3828225969,1663889847,1663890722,875,998
3185501635,3787141974,1646851449,1646852367,918,589
3983031562,3676484650,1664640389,1664641096,707,1870
3119947879,3092359713,1658412252,1658412784,532,3472
3949769919,3459067849,1642571711,1642571893,182,3699
3622444593,3836207422,1667004730,1667005599,869,601
3972753920,3753239059,1666103120,1666104080,960,606
3809020062,3404310701,1667740838,1667740860,22,1813
3620372335,3802234543,1644551093,1644551426,333,2464
3748779709,3882801332,1652309050,1652309679,629,4709
3082685031,3400352438,1649062487,1649063407,920,4798
3959213070,3392930497,1644966693,1644967287,594,1733
3054782945,3705626123,1650057787,1650058764,977,3405
3640774485,3614990288,1668339923,1668340526,603,505
3489404275,3966676628,1643069793,1643069948,155,2883
3569384621,3611364647,1645732022,1645732159,137,2411
3451206820,3394381721,1654519183,1654520176,993,3698
3881282919,3957237203,1644070553,1644070600,47,1081
3739568400,3567849312,1668970132,1668970586,454,1926
3344980988,3682250841,1665239743,1665240300,557,2976
3619166336,3820393714,1642261153,1642262130,977,675
3671462717,3287606170,1658615504,1658616189,685,3
3642463196,3591967806,1663778384,1663779358,974,3689
3562072690,3892075017,1645861254,1645861394,140,2715
3600746869,3242142837,1662689738,1662690084,346,2033
3563072670,3827943115,1648203087,1648203789,702,583
3964696221,3511230991,1663685367,1663685767,400,1062
3684546109,3542587993,1654034967,1654035220,253,1951
3403709121,3940673451,1663432706,1663433523,817,428
3211466965,3835508048,1668405614,1668405810,196,4025
3540093034,3771630145,1648023638,1648024082,444,148
3239667517,3854280559,1644450432,1644451319,887,2552
3491597513,3511228863,1652167151,1652167892,741,667
3314414795,3873643737,1653278381,1653278592,211,4792
3761099807,3845400743,1653055496,1653055863,367,1052
3512604979,3348105306,1668391089,1668391481,392,1756
3310625694,3878070609,1664052014,1664052251,237,660
3510369413,3484325514,1658068528,1658069260,732,4525
3311478442,3436126254,1651617314,1651617421,107,2726
3654219328,3965002472,1664042420,1664043072,652,4269
3378503852,3630003596,1649687411,1649687760,349,877
3828658790,3909206170,1642388516,1642389134,618,2111
3482027174,3997613157,1650067451,1650067769,318,707
3899044360,3343380988,1646853673,1646854261,588,937
3694457792,3400214106,1655597855,1655598686,831,3509
3390651168,3577234458,1645122580,1645122746,166,2514
3136117539,3893712502,1656604228,1656604334,106,1658
3359581940,3065633895,1652813907,1652814181,274,1630
3998098785,3087537610,1659659860,1659660537,677,2689
3201800534,3939174179,1657471872,1657472113,241,99
3362919230,3477012844,1659697083,1659697844,761,630
3265967503,3729586118,1651810859,1651811066,207,3258
3522934119,3903518498,1664137927,1664138782,855,4876
3389484411,3183946847,1642041079,1642041316,237,2414
3239401859,3782242994,1667171651,1667172266,615,4837
3176113624,3318306220,1645648336,1645649048,712,125
3731103025,3746643161,1648215386,1648216058,672,458
3739207059,3064234099,1646999498,1647000080,582,4487
3960772301,3935392492,1655609660,1655610046,386,2774
3248846417,3644834635,1647240420,1647241220,800,1173
3925390388,3140938136,1646689264,1646690034,770,1480
3522745693,3336877656,1645462352,1645462414,62,1057
3561717300,3936379918,1648122223,1648122942,719,2939
3739140570,3682948467,1649613052,1649613278,226,678
3976493485,3415281014,1664284908,1664285037,129,76
3644097570,3512261070,1653970952,1653971351,399,3803
3261226766,3893560281,1644953241,1644954049,808,2397
3530236481,3490972327,1668905379,1668906051,672,820
3239837182,3575478865,1656629021,1656629803,782,712
3671283422,3012406141,1650186669,1650187328,659,2893
3558583699,3985086384,1643157388,1643157497,109,4528
3185775834,3776451407,1663550721,1663551000,279,4558
3473202755,3743790176,1662331911,1662332303,392,3325
3088717175,3315000420,1658330890,1658331415,525,4134
3603711064,3843899903,1649924759,1649925257,498,3433
3740827309,3100859071,1659261621,1659261669,48,1940
3561036328,3058678694,1643370339,1643370951,612,3654
3012325418,3667222479,1667892082,1667892699,617,1636
3984736106,3926324874,1663180439,1663180670,231,872
3341182197,3523103276,1649556475,1649556761,286,2720
3338711283,3585834551,1648443050,1648443655,605,4718
3736839763,3238178869,1662506417,1662506655,238,2871
3529429647,3520385244,1652627695,1652628152,457,3452
3883775083,3463529494,1654224934,1654225378,444,3469
3852744727,3184657906,1648536797,1648537567,770,1929
3689423482,3896657201,1649868155,1649869127,972,2650
3051602233,3280628704,1660721433,1660722240,807,723
3152813275,3428459649,1642327689,1642327771,82,676
3104419832,3286158012,1643118652,1643119548,896,3536
3748667048,3051638042,1646185697,1646185755,58,3814
3970415821,3481027169,1641422303,1641422928,625,2129
3420393195,3275653033,1664689211,1664689754,543,2122
3377970252,3641422471,1660309581,1660309916,335,320
3030805178,3478843761,1643928115,1643928288,173,194
3659866773,3135901778,1669177928,1669178581,653,1141
3234058540,3629431264,1646081265,1646081650,385,4104
3847265897,3550398460,1647387350,1647387383,33,1328
3890602094,3653804693,1663774493,1663775165,672,3608
3276034045,3996594779,1653562397,1653562768,371,2958
3482882129,3461590141,1651189158,1651189382,224,68
3294855295,3732753218,1648711774,1648712686,912,55
3234045230,3615880124,1661233176,1661233352,176,4771
3322112399,3540013644,1659157209,1659157297,88,1126
3506375977,3977779126,1645817691,1645818156,465,1293
3101654176,3616778911,1655686597,1655687503,906,3299
3461459538,3623670833,1668015725,1668016224,499,787
3948346216,3255141981,1651985112,1651985949,837,4819
3087091686,3302026278,1648419192,1648419940,748,4546
3451884362,3042752178,1668654293,1668655207,914,2045
3748825503,3067778363,1663189585,1663189953,368,2454
3120402401,3648729885,1651980270,1651980934,664,1636
3167007154,3006093915,1641344903,1641345560,657,2767
3443037446,3793342839,1651771773,1651771968,195,4316
3497543472,3919001600,1665451025,1665451978,953,3094
3977196913,3311695769,1666515173,1666516121,948,4729
3893409932,3724655858,1650648744,1650649148,404,3639
3076525546,3575525161,1641280467,1641281007,540,712
3888777347,3879031091,1669196077,1669196205,128,908
3950183084,3000491430,1649213147,1649214041,894,393
3015654313,3015259976,1642324180,1642324942,762,1716
3239688521,3782905286,1641833751,1641834218,467,684
3228367332,3341715008,1641744574,1641744827,253,1889
3445633427,3712932609,1655733154,1655734028,874,1439
3818984322,3442179640,1648294148,1648294290,142,2622
3455120004,3376700305,1656891092,1656891617,525,3069
3080507376,3339563491,1661068489,1661068577,88,1497
3923207979,3520804002,1656049422,1656049994,572,4805
3244473831,3298657658,1647706042,1647706975,933,396
3242780456,3657841625,1644516619,1644516715,96,1927
3268398070,3960576750,1646094243,1646094369,126,4459
3076549827,3185909266,1666749560,1666749687,127,1042
3004377443,3062877654,1654544921,1654545604,683,2042
3533771632,3766752775,1656091361,1656091738,377,76
3590591396,3853590826,1668422456,1668422919,463,199
3779087157,3658730971,1663643313,1663643484,171,1057
3400349535,3760750358,1651225145,1651225166,21,931
3108551457,3684758861,1643003591,1643003816,225,3183
3763716459,3037246258,1654100544,1654100924,380,537
3716399195,3503814821,1650125839,1650126106,267,2964
3732321144,3570938885,1649874481,1649874538,57,1586
3450846132,3550438726,1654244247,1654245039,792,4295
3132831971,3593067526,1646245416,1646245849,433,2339
3254323047,3585964946,1668310422,1668310727,305,1090
3266973111,3686832019,1667605712,1667606251,539,4400
3788501922,3250007992,1654657489,1654657599,110,2206
3514881380,3177504496,1668068104,1668068589,485,3258
3602837429,3387809206,1669489726,1669490110,384,2805
3463504012,3022635840,1646041828,1646041866,38,3838
3010132088,3386231347,1652469089,1652469128,39,68
3041656951,3222160468,1666971335,1666971820,485,3560
3757347899,3772400839,1647002510,1647002771,261,2152
3041887570,3238205831,1656986507,1656986631,124,757
3946207756,3825910894,1656281970,1656282548,578,2265
3302796355,3427921187,1652300269,1652300606,337,2719
3216349556,3301620193,1647231620,1647232556,936,3110
3840057933,3536877290,1664391630,1664391645,15,2613
3231261163,3122549115,1646336888,1646337521,633,3392
3170522543,3448195173,1658952632,1658953378,746,2124
3690549054,3458489015,1647691961,1647692484,523,4277
3424012430,3896352525,1653250923,1653251044,121,3422
3963201779,3860475014,1660026419,1660026522,103,2518
3197733249,3771720457,1657534895,1657535663,768,428
3281021234,3598838944,1657950413,1657950603,190,644
3768899009,3408297481,1662971651,1662972090,439,654
3937549351,3089917139,1654574122,1654574567,445,4880
3200058465,3302968730,1641649650,1641649756,106,2798
3630448144,3059950264,1652973778,1652974184,406,1755
3053485790,3680828026,1652392343,1652392523,180,3309
3831324631,3246480884,1641620851,1641621433,582,4037
3213971411,3511565609,1657628914,1657629780,866,3367
3181485158,3616392024,1642882361,1642882614,253,4031
3544593816,3944423255,1650108700,1650108866,166,588
3794223645,3289332538,1645753988,1645754781,793,3884
3999184910,3352981708,1653615213,1653616097,884,3946
3321966744,3614718661,1658318385,1658318870,485,2071
3340208379,3797937686,1667538398,1667538958,560,2060
3931737023,3446876527,1648633485,1648633494,9,1296
3310365643,3957729660,1641194448,1641195013,565,1063
3075857494,3215782392,1650063938,1650064822,884,1097
3844799818,3638009785,1646652875,1646653223,348,3321
3292927397,3752349832,1667708473,1667708725,252,180
3433908513,3809341577,1643061431,1643062181,750,1344
3951467007,3626410460,1655541242,1655541851,609,4122
3391304430,3149605585,1664121411,1664121995,584,324
3694174214,3681603871,1667596910,1667597549,639,2816
3158982885,3122204052,1666946011,1666946333,322,494
3034184466,3455579270,1642548519,1642548525,6,3488
3460399614,3270199573,1659990842,1659990995,153,4469
3889069696,3663097879,1667912887,1667913484,597,2660
3728564209,3534588149,1660646658,1660647125,467,39
3690249401,3586112343,1664757935,1664758259,324,3951
3691866695,3624428724,1652889511,1652890192,681,3566
3220540760,3966216378,1661655319,1661655984,665,1969
3506533867,3165225670,1657932617,1657933218,601,4797
3515328131,3743853988,1652414353,1652414703,350,4923
3025077561,3480202150,1660474186,1660474447,261,299
3879180360,3546604223,1659253488,1659253918,430,919
3677001596,3887673679,1657185492,1657186227,735,57
3983055987,3595032432,1647388777,1647389013,236,1514
3487446566,3467282016,1654958085,1654958496,411,967
3159026525,3396107181,1658815119,1658815459,340,437
3251378347,3604415225,1646786321,1646787152,831,730
3566248080,3104118322,1660153705,1660153825,120,1794
3579210286,3212086875,1662563076,1662563771,695,1243
3700052023,3962132805,1665301179,1665301755,576,4721
3893090036,3844433246,1651577288,1651577723,435,3434
3568588315,3563456690,1651593931,1651594496,565,1090
3132287915,3857753063,1646853861,1646854641,780,4574
3063935429,3731487147,1648602402,1648602929,527,4663
3512148074,3073055665,1666974811,1666975257,446,4571
3022927118,3218891949,1659448228,1659448285,57,3774
3380427795,3982755139,1664453251,1664454228,977,2366
3359574446,3868881059,1659793575,1659794109,534,2949
3344415546,3551453746,1666989307,1666990242,935,3195
3925111600,3182263263,1644892265,1644892767,502,4364
3411748754,3995566619,1649749481,1649750188,707,3681
3590130689,3935769530,1660168423,1660169100,677,4730
3892773491,3966702417,1643462790,1643462914,124,3301
3421282852,3791848227,1664105387,1664105757,370,1636
3279147056,3452663645,1664620999,1664621032,33,2495
3923453348,3707489961,1650811227,1650812010,783,3547
3645652393,3680504202,1651841284,1651841459,175,4309
3362967060,3592532994,1668900085,1668900437,352,79
3427749242,3277566135,1647538076,1647538990,914,1337
3804406026,3142551324,1652290498,1652291009,511,1199
3841615081,3298747854,1645249753,1645250635,882,1803
3123944988,3164498175,1652683015,1652683274,259,3320
3764756133,3344712770,1658818546,1658819319,773,4623
3855291324,3163528953,1668681797,1668682717,920,4326
3958995868,3260087940,1641004076,1641004242,166,2456
3507167628,3278152467,1666075928,1666076778,850,971
3679269839,3269722027,1651859973,1651860104,131,1945
3174439614,3351639441,1669572875,1669573438,563,1773
3867603519,3661762494,1651948738,1651948959,221,3271
3931328480,3248284033,1659288301,1659289227,926,3447
3084281734,3522580214,1659077266,1659077291,25,3906
3182727887,3727085519,1656042051,1656042251,200,4663
3677564955,3298650644,1642449272,1642449841,569,205
3719554403,3028053210,1658724725,1658725492,767,1867
3124038048,3322570959,1656054520,1656054964,444,1401
3328663753,3005591143,1652594026,1652594742,716,3659
3687044475,3355992950,1653283189,1653283398,209,3490
3207112874,3416956722,1667298955,1667299814,859,3309
3490606628,3709035670,1644202552,1644202836,284,1343
3146118913,3491511054,1669423022,1669423500,478,1380
3281113315,3975217506,1656612072,1656612178,106,3994
3017866019,3984905599,1654674787,1654675502,715,1842
3598541943,3719057683,1645886046,1645886542,496,249
3689907441,3308547399,1652234156,1652234214,58,1875
3063106351,3787711855,1650417990,1650418213,223,2988
3012652181,3102615716,1663323493,1663323601,108,4561
3232938555,3150059302,1647828732,1647829019,287,4317
3168256049,3204295844,1645533169,1645534128,959,3053
3006904920,3514697188,1668540165,1668540309,144,2635
3985613253,3376271363,1662884554,1662884911,357,4091
3303064398,3755099710,1650774691,1650775222,531,4568
3126322810,3043100765,1642313800,1642314799,999,3041
3890605394,3764300003,1669298379,1669299022,643,4234
3154896666,3470565015,1650197292,1650198123,831,4081
3432630268,3175869669,1651993376,1651994164,788,2950
3285895764,3786507688,1643893059,1643893808,749,1453
3942135880,3169076924,1651323137,1651324135,998,4153
3655676475,3190936506,1669158106,1669158801,695,802
3580651584,3546658780,1657220289,1657220861,572,552
3593981235,3768985009,1651369275,1651369778,503,3760
3652432049,3418998790,1643994085,1643994629,544,2475
3328501760,3644642996,1661254735,1661255257,522,2942
3279081924,3881698883,1642432669,1642432721,52,1072
3296759235,3341494597,1661692920,1661693610,690,1552
3570344123,3718194870,1662217784,1662218709,925,2981
3867737162,3403852043,1666608198,1666608740,542,1326
3076714600,3292788390,1649734015,1649734153,138,3435
3682741979,3443909371,1653894547,1653894811,264,1140
3056252953,3697853459,1663791991,1663792938,947,3690
3215943083,3905197928,1641859161,1641859251,90,3985
3076756468,3528856897,1651024541,1651025206,665,3397
3574010052,3978571895,1650698872,1650699731,859,2675
3096675344,3689907441,1655049721,1655050578,857,1682
3811517535,3278006830,1648936613,1648937058,445,553
3132584139,3866693826,1657797596,1657798210,614,4789
3363489594,3334150142,1652243430,1652244373,943,3902
3790163815,3798371731,1657993671,1657994026,355,1152
3109266344,3295744839,1661355953,1661356499,546,2134
3846622060,3666684891,1668669729,1668670419,690,2944
3000851960,3422896340,1657192822,1657193168,346,548
3374666293,3228908761,1661217644,1661217657,13,3344
3510395221,3437285661,1648454272,1648454337,65,4595
3885301104,3322180194,1642038767,1642039397,630,3558
3578433794,3518877473,1661556857,1661557758,901,3434
3789229089,3905082197,1644229492,1644229730,238,4894
3083759253,3554291748,1654943878,1654944149,271,1766
3133565900,3974590845,1651079464,1651080095,631,1643
3931685205,3188610173,1655592150,1655593074,924,3372
3335809340,3161964136,1657288932,1657289640,708,4080
3624192752,3285051744,1648339320,1648340245,925,294
3806298661,3006458946,1641580154,1641580499,345,2204
3560060021,3410190940,1665352769,1665353757,988,3774
3412826930,3486559307,1662281418,1662282119,701,1882
3881980832,3047401091,1643545933,1643546652,719,286
3386229744,3596596033,1655142894,1655143339,445,930
3091836055,3709036949,1653048452,1653048540,88,2029
3161617360,3900902595,1669367321,1669367811,490,2994
3348810259,3614808678,1642117349,1642118201,852,3641
3461444089,3788494088,1657983554,1657983778,224,756
3337766334,3037216069,1660935274,1660935862,588,3128
3261878368,3647526283,1650004682,1650005389,707,3069
3567967253,3001614917,1656163866,1656164368,502,3822
3482280768,3620741894,1646377647,1646377830,183,2050
3906745414,3866828628,1642111306,1642111650,344,3664
3730709044,3513612396,1647816757,1647817329,572,350
3567527464,3208318911,1657914061,1657914131,70,1818
3097250105,3360180325,1666222263,1666222283,20,4384
3049459760,3499221654,1662457865,1662457925,60,1714
3287180752,3692223872,1653872762,1653872880,118,3841
3646724312,3973793689,1652663584,1652664028,444,1651
3476534769,3007206217,1655354730,1655354920,190,4526
3272716230,3181811642,1652763171,1652763230,59,2026
3438145603,3819569587,1665809026,1665809501,475,4120
3408683393,3512307184,1646653788,1646654244,456,3899
3862672681,3527346945,1652629515,1652630505,990,295
3717014439,3207525322,1645305073,1645305322,249,996
3161485680,3315778566,1641681347,1641682227,880,938
3637416842,3796146265,1669200108,1669200726,618,373
3474664790,3488205264,1660063806,1660064717,911,3170
3193708698,3598019951,1658735944,1658736214,270,3229
3847267803,3173829994,1644745914,1644746517,603,4308
3798006008,3784497748,1641858970,1641859645,675,517
3914452123,3568572903,1667240048,1667240966,918,345
3357364345,3031365975,1642291975,1642292905,930,3696
3905772841,3971651360,1651923638,1651923716,78,23
3184076134,3663768328,1648860417,1648861151,734,2828
3626366981,3942959779,1643194424,1643194738,314,1455
3342734561,3371571578,1664985610,1664985820,210,4173
3698949568,3106968034,1661666050,1661666072,22,4098
3758070275,3841867063,1658026510,1658027349,839,3228
3875447402,3819257917,1643670602,1643670857,255,84
3729403470,3973219280,1667359816,1667359849,33,1860
3986954945,3556912865,1649642988,1649643534,546,2300
3999062965,3955501664,1650073641,1650074268,627,3461
3946207756,3903044870,1668631411,1668632186,775,1880
3844992831,3732813320,1663196521,1663196867,346,88
3067056047,3421870719,1654225859,1654226573,714,834
3987499821,3963490334,1653829737,1653830420,683,4966
3286012298,3443549451,1668027638,1668028047,409,977
3833982879,3140371772,1641949535,1641950096,561,3522
3421158224,3055354724,1641199669,1641200549,880,4119
3453682506,3452674096,1658805045,1658805927,882,1708
3807586008,3309826957,1660966754,1660967165,411,870
3246154434,3833735934,1653913724,1653913949,225,3270
3287754039,3080844968,1667142804,1667142832,28,1610
3143483760,3329011467,1663528949,1663529861,912,1768
3894127804,3259354905,1649321944,1649321999,55,3567
3622258461,3510516111,1660439783,1660440492,709,3686
3810959269,3742599098,1661498770,1661499719,949,3513
3243594971,3629351636,1655662607,1655662897,290,1630
3198693242,3695628693,1658264443,1658264555,112,2002
3684915389,3822079026,1659730642,1659730806,164,687
3872732002,3262600921,1649747609,1649748376,767,235
3217492413,3763089845,1659207439,1659207828,389,479
3357709123,3704633166,1665265976,1665266444,468,2340
3056801226,3071245611,1656452652,1656453100,448,438
3797756553,3664917871,1667933110,1667933728,618,844
3841987094,3324813285,1643194063,1643194630,567,3193
3748930674,3834937991,1654150245,1654151182,937,1412
3705287878,3679708806,1660370150,1660371012,862,4630
3351390061,3351792913,1650130180,1650131011,831,2961
3483976151,3413915595,1659224912,1659225074,162,3007
3862715964,3248020262,1659339194,1659340079,885,269
3541413326,3895059773,1645544465,1645544592,127,4969
3731178656,3089961214,1650716077,1650716407,330,1519
3749585605,3211801529,1663045032,1663045578,546,1078
3993536532,3007038783,1642820535,1642821323,788,740
3804007998,3810023824,1654566953,1654567427,474,368
3184063090,3060326626,1644616911,1644617823,912,949
3913589943,3545685446,1646154488,1646155391,903,2179
3886341692,3350428073,1651085935,1651086738,803,4883
3518121517,3431058353,1663925513,1663926258,745,2678
3429505202,3814283394,1660279427,1660280425,998,63
3412206662,3378900759,1662747114,1662747560,446,2123
3654498744,3273153077,1658089277,1658089412,135,1721
3144362652,3530920358,1655854462,1655854907,445,4704
3011624852,3226802726,1662286592,1662287262,670,579
3940153853,3533245251,1650287587,1650288581,994,4499
3921153293,3505910546,1668705430,1668706098,668,2123
3729059565,3775336064,1666463673,1666464030,357,1697
3676801394,3046852199,1668360430,1668360970,540,3827
3094172777,3935290612,1649283946,1649284243,297,1437
3215409241,3287420586,1649016895,1649016955,60,1216
3010169866,3341995600,1654695585,1654696421,836,4211
3849663027,3657685826,1647105355,1647105503,148,3124
3708208977,3104119133,1664254116,1664255006,890,4947
3265549049,3044133418,1646571621,1646572498,877,328
3915569668,3181282995,1655329773,1655330173,400,1912
3795957697,3594581181,1656388867,1656389097,230,175
3930997158,3083891399,1653666812,1653667131,319,1207
3006979470,3846880772,1659631957,1659632268,311,2348
3278425044,3440841047,1644318794,1644319696,902,1935
3313884175,3834795667,1652784219,1652784305,86,1388
3233711123,3902339223,1658305529,1658305786,257,914
3941009146,3638705126,1667097366,1667097828,462,3239
3833898017,3328903014,1644870676,1644871004,328,3463
3246369444,3439986682,1646131919,1646132313,394,1721
3355076067,3310229223,1644657635,1644657812,177,3773
3700176776,3922010803,1645356159,1645356412,253,1988
3687746348,3507046192,1644336706,1644337589,883,4692
3066789887,3608343385,1652013504,1652013692,188,3303
3310511453,3303363255,1661695327,1661696318,991,3325
3387771263,3305896883,1649108490,1649109282,792,4524
3347999275,3470943648,1648668345,1648669062,717,4318
3696601467,3665056412,1663365437,1663366418,981,53
3498195749,3359316190,1644019858,1644020783,925,4422
3412331717,3517804655,1649187730,1649188656,926,1722
3515305900,3864083764,1645687338,1645688169,831,2891
3906531247,3549193184,1656033002,1656033386,384,1853
3260763607,3871288419,1662931654,1662931765,111,1426
3059445620,3432853703,1642383538,1642384410,872,1188
3970972658,3623285414,1648943288,1648943604,316,598
3339989350,3563975495,1658592823,1658593489,666,4034
3115392785,3438237924,1642490581,1642490862,281,821
3058536421,3423787893,1643950348,1643950677,329,82
3383480758,3211256624,1663237046,1663237869,823,1815
3128551010,3857431830,1660535296,1660536013,717,3881
3081458909,3107610615,1644549465,1644549909,444,3611
3227418557,3744640443,1656728397,1656729102,705,2923
3993870878,3832345817,1666652480,1666653083,603,1219
3081671397,3496631722,1661610697,1661611290,593,390
3392182158,3371991948,1642233522,1642234039,517,710
3841763495,3483252866,1662044140,1662044822,682,4151
3678637674,3832787362,1656726194,1656727063,869,4886
3613679040,3133896811,1661368021,1661368545,524,2917
3417503914,3443731869,1649494081,1649494513,432,3896
3286721564,3789123077,1645607637,1645608180,543,1924
3213102041,3168524266,1664383293,1664383860,567,3146
3982538269,3297230803,1642333535,1642334357,822,4663
3859717699,3896005455,1668678241,1668678503,262,983
3232947580,3774646313,1652236676,1652237088,412,4257
3637362317,3248840374,1655555528,1655556348,820,2697
3478839876,3918991654,1668848423,1668849144,721,4007
3699760435,3277325442,1648351651,1648352154,503,1125
3202314072,3736454146,1653212636,1653213590,954,182
3980668420,3916522287,1658078300,1658078888,588,2360
3246617193,3245280405,1644219205,1644220163,958,4511
3986649666,3341701232,1663700275,1663700720,445,1987
3261123697,3344018384,1653801884,1653802194,310,3243
3106925449,3042352808,1651157798,1651158282,484,3427
3672907710,3720118896,1666573510,1666573704,194,3445
3656695256,3596285888,1646174317,1646175198,881,43
3012056504,3334487489,1649597959,1649598901,942,4250
3649462059,3614194501,1664050799,1664051448,649,1454
3897367919,3180339550,1665890484,1665890684,200,647
3884121642,3355007842,1667413116,1667413333,217,2389
3739192572,3322180194,1650974282,1650975129,847,3951
3742586419,3682336098,1656878150,1656878462,312,4043
3488947883,3213256400,1651165001,1651165577,576,34
3121227933,3006198418,1641248837,1641249361,524,1285
3028297728,3411845571,1667330402,1667331358,956,368
3858299484,3240911709,1648635037,1648635912,875,1047
3846940318,3676755920,1668618844,1668619357,513,936
3247104925,3702922659,1665685981,1665686447,466,2646
3304917851,3420592310,1659296097,1659297059,962,157
3939197323,3491729712,1653125055,1653125789,734,3747
3327554145,3888068085,1642013202,1642013376,174,2354
3130829475,3365153320,1665379095,1665379567,472,2536
3455120004,3999935517,1645056113,1645057111,998,451
3285015797,3726422258,1642872757,1642873134,377,1799
3116317101,3370493263,1666548850,1666549464,614,1468
3490308401,3678159088,1666349228,1666349543,315,94
3181744604,3863720267,1667262225,1667262566,341,525
3417525728,3568588315,1666233533,1666233635,102,1021
3750251546,3869169678,1641305011,1641305799,788,2040
3486941282,3308224991,1658792522,1658792859,337,3713
3699115801,3054595296,1654755804,1654755930,126,4929
3342913033,3292634561,1649693344,1649693998,654,695
3646609953,3043429912,1668774681,1668774984,303,252
3026167479,3742392718,1647164267,1647165003,736,52
3233142110,3331649070,1655087117,1655087792,675,4159
3032302141,3612025582,1655269464,1655270461,997,3887
3900368367,3072421468,1664292350,1664292932,582,1611
3012620442,3447465359,1666124993,1666125963,970,2377
3518389765,3127188808,1658665927,1658666537,610,4663
3944895433,3274385896,1662665994,1662666494,500,1896
3801697819,3768886945,1659750711,1659750760,49,1169
3925793426,3558067873,1648802586,1648803338,752,256
3163538089,3055852003,1660391019,1660391880,861,339
3235800523,3291753747,1657012070,1657012501,431,3728
3818462004,3374374607,1657679499,1657680292,793,3513
3057105527,3801227954,1669066868,1669067624,756,4339
3259525071,3019924777,1657325408,1657325888,480,1732
3398760049,3083652801,1656345163,1656345782,619,179
3235953058,3425572967,1647348465,1647349202,737,519
3583205106,3908612309,1648876108,1648876606,498,775
3307609847,3987887342,1664416422,1664417148,726,1411
3321559305,3006125560,1659295381,1659295609,228,1529
3304359114,3356674606,1664599123,1664599607,484,3843
3529755571,3072281877,1650761849,1650762783,934,3652
3864590882,3359253224,1655762997,1655763155,158,2576
3403636226,3825881728,1667533402,1667533471,69,1480
3081569500,3896941707,1666379622,1666380218,596,1311
3774322517,3252395026,1666086355,1666087014,659,4879
3826663976,3817362195,1649432500,1649432706,206,4492
3524279484,3115120814,1659035850,1659036213,363,3696
3843112310,3310294878,1656554858,1656555662,804,4843
3375755091,3262384835,1645736221,1645736744,523,742
3216392709,3318576328,1654889827,1654890364,537,2361
3455679052,3676664152,1663674762,1663675713,951,2315
3414653457,3534563128,1656799571,1656800518,947,1078
3230716375,3325872418,1659435413,1659436321,908,2460
3595866099,3049957208,1651667109,1651667830,721,1826
3168175802,3191889459,1645946015,1645946467,452,1618
3492725358,3932864243,1646684428,1646684963,535,2599
3298094313,3984905599,1644904925,1644905047,122,785
3960988896,3034379774,1643161372,1643162222,850,218
3097056919,3803060392,1653640696,1653641573,877,1909
3824139772,3960547410,1666653525,1666654452,927,1604
3549952509,3929727111,1646560043,1646560332,289,4758
3477659753,3363385741,1663352440,1663352849,409,2651
3278549222,3815238891,1642558622,1642559197,575,1022
3043904742,3759515342,1641820809,1641821376,567,3749
3150948768,3262970148,1641984146,1641985000,854,4124
3313364654,3668681850,1641852264,1641852626,362,1363
3661578043,3428056547,1661919472,1661919856,384,2187
3733151036,3631775842,1665444796,1665445743,947,1393
3321811578,3692819358,1661619314,1661620070,756,1965
3923933684,3701980639,1667649718,1667650331,613,2812
3844059983,3088707622,1641258375,1641258782,407,511
3395916172,3547932223,1653874143,1653874396,253,4535
3159017081,3645917259,1658050353,1658050837,484,2968
3098090501,3659302070,1666775399,1666775819,420,1238
3808083296,3684654490,1644191925,1644192746,821,789
3977191143,3831796670,1666259120,1666259207,87,3025
3886010192,3624527477,1665359495,1665359902,407,1670
3665112679,3634477170,1655513747,1655513760,13,3981
3680835756,3198825594,1643451888,1643452617,729,1992
3265166008,3519749448,1653863124,1653863803,679,2478
3140555946,3711734221,1644094707,1644095105,398,1502
3440839864,3616850389,1653228886,1653229744,858,1996
3123629137,3607023880,1658181861,1658182481,620,1099
3245564116,3113021053,1659318548,1659319106,558,2737
3998260183,3752060299,1649057121,1649057514,393,3816
3044165240,3309629496,1662080331,1662080902,571,4585
3080923726,3523033719,1647055531,1647055991,460,2303
3961022053,3322384415,1665176439,1665176550,111,1301
3662248281,3591722120,1641011901,1641012496,595,3489
3058606673,3392450500,1663211444,1663211664,220,1999
3052212958,3836255597,1641155463,1641155673,210,3681
3804856529,3136448507,1644320857,1644320876,19,2480
3380200821,3495428480,1649343992,1649344443,451,857
3601871808,3150824752,1660245811,1660245960,149,4454
3668475897,3125733639,1647609052,1647609278,226,4065
3156282862,3326255717,1646007631,1646007912,281,325
3990141858,3335214941,1656495515,1656495914,399,4143
3994033167,3069507267,1654416882,1654417401,519,624
3024717832,3124691296,1650616059,1650616783,724,389
3804221083,3297542148,1646257091,1646257839,748,1392
3769242006,3964811958,1662161481,1662161783,302,1209
3872547875,3709054095,1649068160,1649068851,691,1096
3262375194,3202334509,1661847782,1661848507,725,748
3795671009,3358130745,1666996694,1666997139,445,2135
3517354833,3089051368,1657614707,1657615303,596,2192
3097564365,3466359551,1667172596,1667173434,838,48
3593077404,3128444734,1656982823,1656983006,183,944
3530246128,3566492488,1648068588,1648068659,71,3307
3862092889,3540036965,1655869956,1655870336,380,445
3558522376,3097931736,1667263985,1667264647,662,4238
3482879683,3511052053,1659929573,1659929863,290,4016
3092346816,3028629526,1664294257,1664295179,922,1062
3852456307,3524598923,1668026872,1668027276,404,3246
3597448449,3437616922,1660600148,1660600273,125,1058
3469893342,3030439336,1653202107,1653202799,692,1962
3075846175,3501302083,1661764464,1661765447,983,1216
3131466468,3368876610,1661585145,1661585268,123,4523
3398599402,3623654182,1647501518,1647501899,381,2475
3572354115,3467430530,1659054444,1659054509,65,559
3753403821,3951472023,1647335494,1647335551,57,4655
3383406113,3110457429,1651278146,1651278564,418,3282
3785211904,3298389571,1648688360,1648688527,167,3365
3864548686,3655876954,1666254244,1666254800,556,1984
3288277250,3930904458,1665193445,1665193633,188,476
3915640220,3585439945,1665005644,1665006286,642,1168
3408720365,3468032416,1662221693,1662222253,560,965
3924174182,3507093997,1649400585,1649400838,253,2640
3734735939,3830610074,1652126946,1652127208,262,1809
3283769947,3257472539,1655258779,1655258833,54,4717
3115965208,3415309401,1667408478,1667408831,353,4532
3911804867,3995250922,1650904359,1650904833,474,874
3035845761,3572154724,1664790949,1664791604,655,1256
3927363786,3742235638,1653714260,1653714726,466,2571
3556613473,3287204650,1641422296,1641423013,717,116
3927999630,3017148905,1642386026,1642386352,326,3645
3328295105,3088799403,1668553057,1668553062,5,2340
3718886248,3730733112,1663532277,1663532284,7,3946
3221819576,3501508344,1661065477,1661066454,977,4343
3296896742,3210393970,1664108340,1664108846,506,65
3706596229,3209026597,1666756515,1666757391,876,3690
3404669089,3814466817,1645225293,1645226041,748,4969
3975915602,3731159007,1660807485,1660807595,110,2559
3526278218,3078874440,1663963492,1663963668,176,3372
3076909534,3217535514,1663824081,1663824431,350,3816
3923919919,3897503532,1643074256,1643075145,889,3226
3243231646,3943407736,1643235897,1643236068,171,85
3491388691,3293354866,1642939233,1642939852,619,91
3921765457,3879050257,1652604482,1652605441,959,3930
3900741316,3278347646,1646468433,1646469240,807,146
3598369876,3562627775,1642167284,1642167454,170,2794
3741784665,3567066865,1644916486,1644917091,605,3803
3417594126,3183298550,1646513380,1646514306,926,3754
3229458759,3300248893,1659602468,1659602889,421,4225
3182913117,3290247061,1645250670,1645251430,760,2351
3437503055,3733246420,1647973798,1647973822,24,2161
3579984950,3788741429,1650860036,1650860156,120,1865
3053164543,3847285711,1646245259,1646246131,872,2341
3826334538,3071671597,1644736058,1644736991,933,4314
3751870670,3233669383,1656411741,1656412668,927,770
3212086875,3458457402,1655777617,1655778488,871,4253
3700608129,3306291834,1657220502,1657221212,710,2826
3379284743,3281021234,1663907941,1663908601,660,2550
3838165533,3455577924,1653639294,1653640233,939,2744
3554613486,3340388478,1653478938,1653479037,99,3431
3394240750,3122513396,1655114904,1655115802,898,4118
3525517313,3212992811,1665304785,1665305710,925,4955
3718196479,3982215112,1648535771,1648536591,820,2306
3630159830,3546124426,1645029457,1645029895,438,164
3593241695,3841699580,1656432211,1656432900,689,1103
3940804440,3363734420,1663451100,1663451116,16,1119
3116387546,3411859419,1653251101,1653251450,349,1086
3277220823,3636528578,1650653916,1650654480,564,2572
3595108452,3287500565,1650438976,1650439302,326,2004
3198365899,3445282020,1661377480,1661377966,486,291
3049895369,3778852325,1649557406,1649557789,383,2467
3329782634,3791718003,1667147796,1667148060,264,3371
3471344403,3483243970,1665795912,1665796859,947,3330
3494943858,3959725335,1646684803,1646685335,532,1655
3654068352,3881783942,1658888989,1658889501,512,1914
3121030130,3699289404,1664627831,1664628430,599,388
3300899156,3302887936,1668178208,1668179168,960,3088
3515291652,3201459425,1667153207,1667153997,790,1276
3544980268,3266145889,1641767308,1641768016,708,4288
3108980378,3623104093,1650564037,1650564211,174,1160
3673867215,3814831923,1662919235,1662919896,661,360
3660944709,3961184711,1650132183,1650132681,498,1425
3221473509,3041318122,1656958083,1656958796,713,1145
3790140318,3512536127,1647241637,1647241885,248,4150
3898337502,3847263076,1645468339,1645468426,87,4118
3158402279,3950944897,1650525426,1650525472,46,1583
3461397765,3224533467,1668264183,1668264505,322,3637
3437954809,3268307912,1659675631,1659676221,590,2344
3336913143,3760709982,1658071302,1658072166,864,1205
3914202241,3424929491,1654604183,1654604685,502,4103
3884880578,3401670616,1661683200,1661683238,38,4382
3605402793,3028790651,1653425064,1653425754,690,4110
3178472833,3456340393,1667899646,1667900580,934,3243
3494792528,3079328530,1641156701,1641156799,98,524
3928530420,3868767951,1649096965,1649097433,468,3802
3457590400,3638729013,1643372114,1643372790,676,4365
3861404530,3705062677,1655909346,1655909855,509,3254
3650700879,3274319663,1666416048,1666416320,272,1674
3523846299,3086756601,1652080105,1652080539,434,2053
3573702827,3099552090,1641468479,1641469478,999,2551
3624008470,3902297623,1667277154,1667277598,444,822
3192093708,3777165286,1659621734,1659622135,401,192
3830871053,3789357801,1662715642,1662716174,532,3841
3024718132,3008095293,1647591215,1647591991,776,1324
3934691572,3789684144,1666674175,1666674648,473,68
3876546389,3254366640,1654131474,1654132178,704,441
3482421144,3345454316,1648090468,1648090544,76,539
3764024467,3857397414,1652311288,1652311850,562,1997
3989380879,3483661329,1656237359,1656238217,858,2056
3171051791,3433857583,1647462562,1647463536,974,3724
3558096866,3999193341,1652860201,1652861051,850,3694
3112192078,3212186718,1658342583,1658342882,299,304
3484765877,3044087580,1667960722,1667961169,447,2614
3576609810,3243787244,1652521415,1652521880,465,4422
3391117554,3222115541,1651471356,1651471757,401,258
3158893741,3127669504,1645869692,1645869703,11,1509
3214531172,3055858806,1658053529,1658053617,88,3838
3336749380,3573082753,1659908659,1659909103,444,1384
3856635577,3494583850,1665460061,1665460621,560,2201
3958007189,3764542778,1657335393,1657335464,71,3180
3539291415,3315337507,1658616139,1658616770,631,4083
3528715120,3859838229,1658995380,1658996005,625,3469
3049888019,3389462796,1668194575,1668195248,673,2346
3303081121,3109370787,1657505597,1657506423,826,3980
3291868938,3023378843,1665869191,1665869583,392,787
3387854414,3156414954,1649350857,1649351663,806,4555
3515919315,3756158439,1643829035,1643829627,592,4504
3987843285,3213047966,1644910286,1644910437,151,3617
3920853921,3783650154,1659828686,1659828886,200,3360
3270096754,3192903830,1644709019,1644709960,941,667
3231951291,3600522928,1655541808,1655542755,947,1954
3623387971,3515818354,1654020202,1654020899,697,1483
3579641527,3903005791,1654398906,1654399334,428,3511
3646259980,3866204680,1668929684,1668930407,723,2152
3337062559,3841541816,1646462815,1646462845,30,2764
3415665864,3076013752,1650537383,1650537939,556,1264
3164076745,3649026590,1644004020,1644004998,978,2817
3235835693,3809131917,1664261132,1664262013,881,4734
3216587090,3190159804,1658288992,1658289941,949,3366
3140863916,3655242176,1652629121,1652629511,390,4653
3524455133,3330594007,1666370980,1666371791,811,4800
3305204738,3940227870,1653790755,1653791321,566,194
3787287420,3682197526,1645935009,1645935572,563,15
3412331988,3731655933,1642240023,1642240033,10,2975
3169111186,3459251258,1668483008,1668483533,525,3054
3159984931,3954608232,1650427825,1650428429,604,716
3735265145,3773512145,1661337479,1661338295,816,2072
3985519240,3777170655,1654592968,1654593248,280,3536
3649179034,3999721622,1661955668,1661956652,984,996
3122282831,3123162902,1662465683,1662465927,244,2305
3583379807,3470958472,1664813874,1664814643,769,183
3545797814,3466436519,1660350464,1660351445,981,89
3780055878,3348050104,1662919809,1662919830,21,4771
3612962043,3791274256,1655536612,1655537181,569,4255
3288273992,3658449766,1655704212,1655704847,635,4698
3671686608,3500571461,1662143430,1662144244,814,3010
3494231563,3158842292,1667854930,1667855873,943,296
3207355394,3942661220,1659884584,1659885305,721,3242
3375724915,3162101266,1663121701,1663122482,781,626
3734477467,3854754598,1669241992,1669242675,683,4106
3527457803,3011947718,1661009970,1661010708,738,68
3613707396,3490000056,1655822927,1655823106,179,648
3459689711,3496184023,1650480949,1650481641,692,1016
3460360534,3418487092,1667591253,1667591743,490,135
3943526362,3329825401,1668106210,1668106614,404,720
3956182894,3934448114,1651367403,1651368240,837,2725
3570203897,3450344247,1655334911,1655335058,147,3238
3397965913,3076708403,1662050345,1662050766,421,1448
3700346465,3928455379,1660251845,1660252140,295,4185
3082435710,3282750995,1643848139,1643848784,645,2785
3958056173,3579599643,1650958787,1650959000,213,4216
3611660155,3268841138,1641678114,1641678648,534,3110
3904637386,3177696289,1643145204,1643146156,952,1103
3898318606,3442590720,1657890168,1657890191,23,4751
3336119604,3348707644,1656703321,1656703857,536,2007
3311939526,3442741796,1644545941,1644546814,873,4833
3972747202,3294733164,1660644629,1660645465,836,268
3652939515,3982615269,1654770391,1654770993,602,61
3619091527,3176850112,1650186429,1650186865,436,4393
3357954185,3458524563,1645320478,1645320870,392,3715
3421745452,3156952345,1653323096,1653323971,875,746
3561079655,3997969302,1663040744,1663041053,309,45
3403353426,3831339354,1658894583,1658894819,236,3980
3239688521,3318259948,1665280388,1665280493,105,2261
3037860417,3518021661,1652712639,1652713136,497,1758
3729447748,3851116391,1648831788,1648832541,753,4996
3881350961,3037659066,1655875635,1655876406,771,3664
3905002599,3065536642,1661535775,1661535846,71,2271
3214376328,3032664602,1661056086,1661056740,654,1541
3656613985,3774930710,1641496082,1641496386,304,2430
3667503920,3458155050,1649538286,1649539120,834,4843
3669289347,3567906712,1643935532,1643935939,407,3065
3113211168,3357885267,1659180863,1659181631,768,4691
3450715386,3311473302,1667817239,1667817578,339,2898
3429636189,3992711952,1669647504,1669648205,701,669
3245112740,3583118927,1643051943,1643052599,656,4531
3573932319,3366453099,1649086302,1649086799,497,3635
3687655705,3197172383,1661562807,1661563250,443,1806
3862161715,3872732002,1668225132,1668225685,553,3549
3420296233,3517711619,1668846062,1668846358,296,816
3274450649,3147901410,1649469588,1649470184,596,2686
3865027819,3388692454,1652806842,1652807014,172,3658
3837558143,3927345925,1649917808,1649918410,602,4944
3167406851,3698746562,1661418681,1661419493,812,2719
3422603509,3114617555,1647446045,1647446842,797,4305
3180612921,3370853759,1664799394,1664799563,169,3356
3680670564,3623285414,1641802824,1641803088,264,520
3280773520,3691900474,1666410525,1666410674,149,4607
3104363404,3422128299,1664491755,1664492664,909,1950
3742915490,3053657429,1664946968,1664947159,191,18
3558655328,3000717585,1652927511,1652928323,812,2778
3392702000,3309754050,1659192516,1659192874,358,247
3536119139,3032362321,1666833764,1666834709,945,3785
3113527621,3258277721,1657937712,1657938332,620,3019
3670194328,3367034026,1653861091,1653862034,943,4885
3315419960,3416638191,1651109416,1651110103,687,3341
3781815430,3017048786,1667200549,1667201268,719,4790
3553279078,3545762005,1664948731,1664949045,314,52
3489075700,3533194085,1662216783,1662217557,774,3747
3274375036,3211060153,1656519392,1656520298,906,3201
3212315753,3756709645,1649593121,1649593476,355,422
3794388796,3982931248,1647596998,1647597094,96,861
3451121991,3922208465,1652620961,1652621903,942,385
3748142678,3845950471,1661899918,1661900538,620,994
3936442799,3468297234,1659708537,1659708772,235,2322
3746131668,3554858659,1657392625,1657392759,134,4282
3248101574,3265717921,1644592796,1644593689,893,771
3924339082,3612134292,1662994564,1662995482,918,2483
3880842936,3673316854,1656905100,1656905344,244,3012
3667421119,3777854354,1645312421,1645312755,334,3915
3311473302,3864363231,1669337949,1669337951,2,4181
3217198457,3439170881,1647442966,1647443654,688,4437
3431934257,3072800133,1651289953,1651290033,80,4236
3596289255,3828430516,1654846347,1654846383,36,2491
3522098300,3506533867,1667646495,1667647392,897,990
3317881980,3756338983,1657222075,1657222413,338,317
3451047374,3730297248,1661340407,1661340839,432,4523
3832077585,3339214450,1644034798,1644035158,360,2929
3584462681,3841867063,1654659319,1654659889,570,3776
3317169529,3728729383,1644439366,1644439400,34,41
3027459414,3755309286,1660372939,1660373834,895,1752
3512322601,3554759753,1643097361,1643098139,778,2280
3900294173,3715746483,1656140270,1656141004,734,2982
3610164036,3740248269,1642703695,1642704641,946,3871
3590342169,3296341706,1654103153,1654103999,846,547
3162287487,3576211989,1663333876,1663334081,205,2139
3817681943,3668732944,1641208126,1641208462,336,2177
3365013743,3381348296,1643186287,1643186837,550,2961
3624019034,3738355579,1650383353,1650383501,148,3775
3382677341,3897930575,1668314455,1668314576,121,167
3691128293,3080232847,1659859724,1659859778,54,2177
3628341819,3130374655,1662579506,1662579989,483,1744
3047841471,3859599812,1660212249,1660212388,139,1777
3156994562,3798218833,1645819667,1645820158,491,3562
3651215580,3779106351,1647071092,1647071555,463,2842
3583224680,3207010847,1645248924,1645249288,364,2860
3891770739,3123921729,1641639195,1641640061,866,133
3602966399,3575961956,1659719016,1659719746,730,4280
3433767779,3349147793,1648393081,1648393186,105,3345
3037249427,3663294085,1659550308,1659550341,33,4410
3469226024,3631262057,1654651923,1654652263,340,4012
3875901590,3072280021,1652983414,1652984351,937,2977
3985638463,3027484168,1649704563,1649705040,477,2678
3791652653,3192349682,1661498382,1661499267,885,2482
3072621007,3130153094,1657854872,1657855392,520,3489
3078028495,3251950510,1667363352,1667363642,290,4254
3030115886,3406307892,1664521551,1664522432,881,2774
3647076057,3063261595,1656114302,1656114998,696,3136
3873101463,3151734468,1669164022,1669164814,792,2115
3632370283,3399739179,1653259328,1653259333,5,507
3266482719,3470972963,1641262309,1641262453,144,2156
3892002730,3442484821,1651484505,1651485382,877,4488
3702591220,3758384218,1659402429,1659402989,560,3376
3096675344,3610088458,1663706832,1663707451,619,1363
3081307566,3319783638,1664335491,1664336405,914,4576
3121229920,3942469200,1669422952,1669422966,14,2930
3487857237,3940132984,1665127884,1665128223,339,3127
3133986359,3309137214,1652812709,1652813202,493,2187
3498515557,3460149291,1649629610,1649630162,552,1840
3431082675,3113624539,1653101529,1653101844,315,928
3304018194,3580009892,1648174111,1648174161,50,2757
3986349337,3093725644,1644444622,1644445092,470,4278
3867099015,3794113212,1645954459,1645954540,81,2173
3633441129,3829532180,1645062541,1645063498,957,1393
3563378936,3534689545,1648148258,1648149003,745,1812
3091400464,3046663121,1661315068,1661315390,322,1479
3624004169,3301788169,1643488201,1643488748,547,2404
3525517313,3102682819,1646325873,1646325944,71,2758
3800118670,3461292482,1656325360,1656325982,622,4312
3501375084,3095379423,1655580462,1655580764,302,597
3307639339,3298711526,1643259456,1643259472,16,180
3301601707,3140847771,1658891826,1658892783,957,3690
3065991874,3389116581,1655580606,1655580640,34,2871
3572535707,3283159894,1660213810,1660214769,959,365
3062379895,3440239415,1664372536,1664372758,222,357
3759363811,3070916664,1657208158,1657209118,960,3097
3768370116,3285034286,1641357629,1641357826,197,388
3532121120,3047245029,1661911106,1661911273,167,2676
3232771105,3158496805,1667158904,1667159002,98,1442
3654442149,3732261659,1650010679,1650011084,405,614
3530761937,3712932609,1650680753,1650681365,612,4620
3973620915,3114041491,1647287903,1647288239,336,848
3717030090,3823475520,1666172288,1666172552,264,3824
3787287420,3967136117,1661026902,1661027715,813,2128
3044522541,3744329855,1644876317,1644876654,337,1641
3497945612,3849319208,1667910524,1667911366,842,2046
3918786744,3477933140,1641595815,1641596383,568,3368
3329695079,3229399386,1645601975,1645602608,633,4877
3792066141,3045887428,1652745142,1652745291,149,1076
3243418530,3317808639,1647626214,1647627151,937,646
3219769610,3328073158,1654156147,1654157044,897,4246
3742446194,3342580415,1663432810,1663433044,234,1766
3782620181,3444912644,1668743150,1668743621,471,4811
3745707884,3610628847,1644338676,1644339608,932,2640
3039876524,3075639192,1669075627,1669075697,70,1042
3875672213,3369678292,1665166652,1665167557,905,2918
3406078271,3739483899,1665926703,1665927048,345,974
3259312580,3532136171,1643215263,1643215446,183,4056
3477524552,3242285641,1649436806,1649437340,534,3940
3244134889,3933591325,1659031071,1659031117,46,2591
3426445341,3763417579,1644921297,1644921810,513,2510
3070949945,3675319138,1654401334,1654401406,72,2745
3797110650,3974236532,1652166664,1652167596,932,235
3327058421,3441127081,1660041730,1660041868,138,4983
3938274451,3416637295,1664918700,1664918888,188,1580
3592888732,3391431010,1665356202,1665356409,207,4692
3385005383,3426828958,1649097572,1649098397,825,2531
3994180257,3821636998,1666933189,1666933727,538,67
3149811767,3255221611,1662055340,1662056255,915,724
3835103798,3428895378,1658007430,1658008233,803,3817
3093511001,3259719933,1645730815,1645731455,640,3016
3087905808,3109029631,1653978747,1653978752,5,3591
3549682084,3301534233,1663217707,1663218083,376,2484
3227400709,3687752079,1649196989,1649197187,198,4204
3498582268,3377588991,1647228158,1647228452,294,1492
3246518714,3954382542,1657374674,1657375365,691,2597
3095217093,3553946462,1653436953,1653437510,557,737
3715098700,3347949028,1654327000,1654327073,73,2106
3223908305,3021476778,1666514909,1666514921,12,2390
3259525071,3493581981,1643122116,1643123083,967,794
3700674236,3687512804,1653479462,1653480364,902,2928
3815819988,3319285589,1662270221,1662270233,12,3114
3866395566,3203167041,1663590235,1663590357,122,639
3822588037,3004457077,1645278799,1645279046,247,279
3763438541,3892993100,1648090851,1648091515,664,3655
3627275715,3977234755,1669051338,1669051753,415,4186
3453209274,3179186480,1665154863,1665155803,940,2260
3920643349,3180068261,1653385370,1653385604,234,3893
3721898722,3983770416,1655342001,1655342021,20,2910
3316963265,3858295410,1667347674,1667348035,361,4797
3883578148,3765392856,1665450946,1665451666,720,3185
3892284006,3322901875,1657619422,1657619759,337,622
3991154781,3408887366,1654795759,1654796294,535,3166
3483036396,3198935015,1667512212,1667512398,186,2636
3250610354,3937696679,1654505193,1654505857,664,1283
3454769953,3105311876,1662600035,1662600795,760,992
3469784293,3710711710,1653029900,1653030876,976,3845
3432457658,3233368818,1641346374,1641347002,628,4473
3993299934,3233249655,1660098363,1660098480,117,2143
3039811023,3832754611,1657906604,1657906649,45,4283
3768097255,3579006732,1661812539,1661813034,495,3407
3698129694,3567897927,1659455448,1659456156,708,2358
3495693182,3169201016,1667139345,1667139411,66,4570
3389511498,3452971947,1652859748,1652860539,791,3283
3957917827,3007754463,1653570501,1653571243,742,1222
3646223465,3254281601,1660586727,1660587297,570,4279
3937636916,3007869198,1659393166,1659393671,505,2004
3977783984,3159579900,1657575801,1657576098,297,3433
3824664821,3307199794,1641403027,1641403407,380,1426
3904706749,3491447628,1668723790,1668724576,786,2391
3230231820,3862606667,1651324281,1651324633,352,4979
3459800082,3654943784,1668760183,1668761145,962,4950
3317845903,3291134691,1661927121,1661927363,242,3370
3159996840,3475493091,1642826558,1642826904,346,3981
3979849683,3498129976,1668994891,1668995487,596,1195
3220107235,3533944393,1649190926,1649191677,751,1241
3404162367,3232604658,1654728246,1654729169,923,4724
3483853932,3266220170,1652144893,1652145723,830,4706
3143604213,3390508518,1664473502,1664474344,842,4509
3153397953,3405567844,1662587905,1662588186,281,4722
3878967268,3635593334,1653790370,1653791177,807,2460
3043431461,3804700403,1665573046,1665573481,435,3845
3311492347,3230997979,1643599276,1643600041,765,1336
3886673636,3362919230,1658345849,1658346463,614,4296
3698875052,3725715850,1648039845,1648040590,745,2213
3204201429,3059547971,1665984803,1665985342,539,3126
3215664365,3134773554,1650565471,1650565924,453,1864
3943332462,3682987630,1649072272,1649072895,623,1379
3815780929,3333092023,1650823914,1650824704,790,4681
3734269457,3121255441,1645383072,1645383972,900,3019
3930272659,3884195929,1666109255,1666110226,971,739
3287166371,3635203618,1666976067,1666976786,719,3242
3192083418,3809535869,1664981770,1664982611,841,3191
3955004267,3857656221,1645327939,1645328381,442,3519
3092603169,3471406380,1661643794,1661644733,939,778
3182823072,3847296893,1664718912,1664719294,382,1436
3195820845,3059691578,1655600164,1655600964,800,2353
3724734181,3541363219,1669320439,1669320487,48,1252
3241206188,3932193440,1665526540,1665527354,814,1680
3405246134,3021805467,1663214103,1663214145,42,3864
3549041809,3812902838,1650453232,1650453886,654,658
3302972236,3065749540,1665639114,1665639483,369,2469
3082216682,3441136704,1648155903,1648155955,52,1004
3847739752,3491163230,1643253912,1643254735,823,2114
3837223271,3608963644,1661519481,1661519630,149,4595
3342528637,3798013764,1663475780,1663476407,627,4767
3477359236,3556312578,1655846152,1655846983,831,545
3674143138,3673177996,1668366372,1668366673,301,4854
3132872456,3985281367,1647609807,1647609816,9,1398
3418952887,3581184918,1648820337,1648821260,923,2811
3455006502,3002158076,1668196096,1668197025,929,542
3851931522,3000483404,1645365070,1645365637,567,2377
3921642677,3781391787,1652633867,1652634544,677,2493
3279182678,3539459234,1657917453,1657917593,140,4976
3484063237,3607333721,1660807553,1660807818,265,988
3573091788,3003631974,1643671155,1643671275,120,45
3086176077,3910873133,1669147153,1669147527,374,2088
3757636744,3267633982,1657611351,1657611782,431,4624
3597519343,3794271663,1662769151,1662769982,831,3713
3328124778,3744867731,1642245556,1642246088,532,582
3538600613,3234300096,1646123167,1646123273,106,1439
3123461133,3662291416,1656764079,1656764855,776,1660
3517084449,3403616054,1663021866,1663022022,156,1865
3135649855,3071880705,1653847299,1653847937,638,1436
3946911313,3298824234,1648184359,1648184526,167,4877
3714951641,3601564918,1658920946,1658921236,290,2921
3590130689,3403390178,1663232714,1663232992,278,1607
3531919315,3763811213,1664504332,1664505011,679,1485
3544120463,3880871266,1659318203,1659318722,519,306
3711493603,3985963473,1665235235,1665235756,521,3395
3874132873,3071574558,1642949017,1642949740,723,3165
3566196323,3640359709,1645132423,1645132645,222,4162
3823847976,3403790310,1651492305,1651492664,359,274
3426981799,3222075185,1654320315,1654321228,913,1871
3849663027,3682534054,1662537756,1662537847,91,1484
3148248314,3635522838,1643908392,1643908494,102,4476
3794719784,3332059596,1654899044,1654899897,853,245
3511052053,3974516442,1655635036,1655635523,487,524
3456571484,3252740524,1660423957,1660424097,140,3234
3395793231,3489185821,1652609622,1652609716,94,2888
3860729986,3753246982,1660202987,1660203528,541,4974
3161369332,3714912974,1646857681,1646858202,521,3738
3273382086,3950406942,1645004493,1645004995,502,1376
3909248832,3565279449,1650416516,1650417187,671,1579
3913129837,3324846721,1667649306,1667649952,646,3816
3195679636,3649032401,1654164968,1654165359,391,2755
3202357878,3900523833,1658078380,1658078800,420,3124
3160007420,3663367440,1661604350,1661605298,948,880
3751793406,3699974771,1643862307,1643862502,195,3098
3748777656,3265108999,1645062802,1645063712,910,4532
3821576085,3671835680,1667606042,1667606480,438,4418
3767327141,3282780091,1660001875,1660002694,819,3412
3530990016,3719975087,1642363166,1642364051,885,1489
3789750229,3653079861,1657206542,1657207447,905,4594
3176175824,3247756992,1658180945,1658181594,649,4825
3246964396,3819635770,1669028051,1669029010,959,1045
3900772351,3102019260,1663686871,1663687838,967,3375
3895715298,3715977283,1646434788,1646435220,432,2526
3493076481,3054991720,1650398272,1650398600,328,3049
3631855058,3156622773,1666291920,1666292918,998,2004
3292248649,3396142431,1644274845,1644275702,857,620
3962114590,3507068892,1650100511,1650100646,135,2139
3864150483,3495982104,1646158276,1646159246,970,337
3431953832,3089051368,1657089793,1657090230,437,3437
3183636990,3603711064,1650941454,1650942151,697,4260
3085312455,3923530161,1641034272,1641034854,582,2995
3644197617,3066707608,1641125560,1641125706,146,4378
3907289399,3659746200,1648064081,1648064870,789,3304
3357303820,3828989757,1649555601,1649555674,73,4544
3560971202,3333013613,1642171408,1642171512,104,4852
3898712042,3553933024,1657457582,1657457602,20,544
3038074473,3182036935,1645839314,1645839625,311,4385
3593035533,3022034902,1645654501,1645655468,967,838
3694317475,3991191829,1641918471,1641919045,574,2923
3032301031,3882432481,1646711357,1646712115,758,4299
3025183723,3974800301,1660546941,1660547070,129,2221
3242301149,3890404370,1650159533,1650159643,110,1108
3780601773,3281937877,1656997498,1656997901,403,3951
3325780470,3098319082,1656656852,1656657338,486,4949
3794719784,3616430699,1656594057,1656594761,704,939
3643937031,3541474507,1667438486,1667439075,589,485
3509548697,3996668871,1646923360,1646923955,595,1347
3043542462,3275103912,1664323070,1664323446,376,1980
3576573129,3852486278,1658798653,1658799463,810,2703
3120712318,3317667556,1668283968,1668284770,802,2503
3492598144,3258558149,1662157043,1662157869,826,1795
3778493177,3529904849,1664513355,1664513564,209,565
3764763734,3460263215,1653497730,1653498680,950,793
3924036863,3593035533,1666324786,1666325126,340,357
3440497186,3832230954,1659966073,1659966261,188,3978
3840502107,3408261256,1643499682,1643499900,218,2979
3239114961,3983939880,1664077900,1664078052,152,153
3820784219,3881728060,1647048980,1647049328,348,3506
3113808044,3713673027,1644640746,1644641330,584,436
3899983106,3652648431,1659679700,1659680155,455,199
3636844350,3335370530,1650309403,1650309593,190,3631
3033206914,3606373764,1642335217,1642335512,295,4002
3651642128,3222537916,1667250595,1667251193,598,1415
3186698482,3400118213,1655453710,1655454254,544,1456
3018384169,3221234304,1656117785,1656118382,597,1307
3653956898,3226104911,1660267553,1660268222,669,3466
3483832855,3211425956,1658113113,1658114055,942,4060
3191345787,3124411025,1656433419,1656433436,17,4264
3123499289,3513436728,1664705945,1664705992,47,2361
3457266955,3447124642,1649511956,1649512726,770,4597
3021942815,3989684052,1658635810,1658636144,334,4468
3006647556,3850717329,1645514217,1645515197,980,918
3869773694,3327886105,1648862908,1648863703,795,337
3246156481,3086476718,1647336058,1647336090,32,685
3173544680,3514180048,1646503096,1646503490,394,3649
3997878961,3976370770,1666466074,1666466260,186,171
3675498161,3449586221,1666171899,1666172279,380,2711
3434780307,3701021598,1647528532,1647529300,768,3499
3928477685,3526584468,1665470918,1665471528,610,3041
3437200082,3172182066,1664123563,1664123650,87,870
3325944808,3790242261,1646570944,1646571922,978,606
3940004420,3395817250,1662762800,1662763130,330,2871
3285709386,3282502103,1645275131,1645275253,122,4117
3744384844,3828721319,1659762447,1659762668,221,724
3385231214,3694550629,1655118282,1655118983,701,251
3753216495,3848576246,1654486314,1654486789,475,490
3380377899,3616616450,1644788968,1644789287,319,1731
3951472802,3873576155,1650530469,1650531282,813,2723
3458443920,3878460485,1645151721,1645152543,822,1652
3457340403,3282565168,1648928700,1648929608,908,1585
3457309797,3164493300,1667120916,1667121626,710,2143
3103361815,3535599168,1647249679,1647250011,332,925
3248774937,3898053019,1666914551,1666914701,150,1699
3265026255,3460229695,1660036387,1660036777,390,1761
3032512506,3763574338,1647829977,1647830795,818,3338
3297715512,3110449509,1656982098,1656983040,942,3352
3802720056,3078611033,1647760405,1647760718,313,4734
3882141615,3518272611,1654139527,1654139765,238,587
3179395532,3193993046,1655737104,1655737118,14,609
3641429509,3977636712,1659009796,1659009820,24,4597
3386093666,3751897224,1643384931,1643384973,42,81
3253314073,3605081824,1648575701,1648575985,284,872
3227988560,3450167472,1662438140,1662438489,349,3102
3902684992,3239677564,1669322739,1669323090,351,1900
3144928762,3190676238,1660598184,1660598194,10,1163
3436361253,3808893951,1664400025,1664400796,771,2492
3591685681,3126415811,1668580108,1668580585,477,4877
3682023498,3607668350,1641924201,1641924926,725,865
3735443135,3639439900,1668032549,1668032709,160,2436
3431308827,3109914409,1648346989,1648347103,114,4355
3906787585,3018391769,1658828587,1658829178,591,3853
3245817953,3957662533,1645994247,1645995006,759,1854
3798120181,3341786225,1650723935,1650724144,209,2687
3765031661,3100984383,1645883310,1645884237,927,1829
3864345053,3093852831,1668323590,1668323738,148,3081
3324220307,3486883625,1655041134,1655042046,912,3758
3008147087,3540582968,1667314466,1667314495,29,2978
3327106711,3759683106,1652972050,1652972703,653,589
3316838908,3705717245,1644523365,1644523958,593,3323
3578986033,3540692523,1652177946,1652178360,414,759
3889848166,3158942935,1666587726,1666588644,918,3922
3834887583,3602625341,1651229550,1651230424,874,4225
3758557922,3763871016,1653921846,1653922147,301,547
3709908394,3327754594,1661494202,1661495093,891,3521
3173279014,3338587313,1652289034,1652289542,508,1759
3779279718,3588848570,1655008025,1655008413,388,1941
3245982027,3725551705,1663737683,1663738178,495,4214
3347869306,3179470430,1651328747,1651329328,581,2788
3380741921,3443239547,1652404936,1652405015,79,1893
3208452458,3066707608,1661854009,1661854315,306,777
3716543337,3229743200,1646250981,1646251227,246,1561
3754618450,3352607679,1641452657,1641453163,506,4695
3737924822,3117602415,1655266453,1655267195,742,1663
3323226801,3593614392,1648904647,1648904852,205,1268
3795632696,3577190665,1647968707,1647968956,249,4466
3607445725,3664576806,1646487704,1646487835,131,1373
3874335263,3001535575,1649510732,1649511194,462,4579
3067096694,3883925275,1653683250,1653684130,880,3414
3521175065,3691978209,1662136352,1662136793,441,2172
3463342204,3586798509,1659106870,1659107318,448,2460
3130223696,3333885795,1666516680,1666516807,127,672
3853309616,3181557102,1666737754,1666738423,669,407
3307163184,3192183884,1643716900,1643717400,500,1853
3288296590,3115954491,1659933753,1659934682,929,4516
3380211592,3279971892,1643890783,1643891633,850,3201
3660148485,3177110015,1642278861,1642279215,354,186
3413289620,3235893435,1665857996,1665858785,789,1929
3020948969,3739664751,1668358582,1668358712,130,2467
3396885995,3351685662,1651848871,1651849765,894,1974
3470664542,3416419623,1668520442,1668521057,615,3828
3230373550,3530645819,1650816371,1650817237,866,1663
3328295105,3722074622,1646893576,1646893672,96,2685
3986049601,3516974390,1668051617,1668052189,572,1457
3987041389,3478416125,1644982281,1644982336,55,1620
3588946971,3758369884,1658165342,1658165554,212,4588
3789330379,3238763860,1665569900,1665570872,972,4599
3504235891,3997138387,1650990673,1650990817,144,3670
3998671234,3821857105,1649817974,1649818575,601,2659
3669148364,3220690458,1653462698,1653462765,67,2817
3307415243,3578323885,1648252284,1648252963,679,3831
3144930814,3718743830,1663337000,1663337563,563,1985
3279581175,3925474760,1667069476,1667070373,897,4320
3915554722,3864973359,1668594500,1668594913,413,3797
3811868120,3218566660,1661571060,1661571906,846,83
3316453875,3583081882,1646566048,1646566053,5,2522
3137184791,3683840886,1658598244,1658598660,416,4666
3702805586,3100845161,1657056109,1657057053,944,2698
3054780860,3195514763,1665328644,1665329281,637,4918
3192658875,3299496983,1668877027,1668877066,39,647
3355986608,3547409355,1649447693,1649448412,719,558
3522458445,3157936781,1669289694,1669289904,210,109
3780252333,3935517776,1661583612,1661584390,778,3948
3143365640,3778658385,1641974694,1641974833,139,3951
3786930870,3983835705,1641784227,1641784979,752,3652
3960672545,3837148105,1641332400,1641332804,404,536
3805535586,3172756197,1657685913,1657685949,36,4223
3136786623,3572784490,1661152343,1661152978,635,3295
3172392967,3143934451,1645505839,1645506072,233,3743
3284504979,3583127831,1665634093,1665634165,72,3094
3852093496,3217340824,1655662623,1655662991,368,1845
3232370032,3628013682,1645388375,1645389092,717,1349
3377265236,3365032493,1655211331,1655212330,999,862
3569117147,3411111247,1660575408,1660576189,781,406
3952662705,3112254084,1661575484,1661576290,806,196
3731312652,3647759415,1662671624,1662671659,35,1827
3697358064,3286200339,1642467254,1642467671,417,227
3397009815,3334967771,1660471287,1660471617,330,2522
3264905564,3770752067,1646151808,1646152193,385,1011
3768098058,3407594251,1653168232,1653168473,241,2341
3646931858,3733694800,1641747293,1641748085,792,657
3462583078,3644393968,1662413250,1662413863,613,3121
3078023149,3492518658,1659423593,1659424228,635,4511
3777285210,3535076484,1662250403,1662251151,748,211
3100887144,3402039576,1656226943,1656227236,293,4948
3268492003,3641467414,1657996130,1657996730,600,1986
3589579190,3556812007,1653435731,1653436585,854,3344
3346576986,3202669175,1659593635,1659594379,744,34
3511471767,3890904179,1654309782,1654310209,427,3800
3494211176,3948784998,1652998873,1652999649,776,788
3935978013,3579215002,1658319763,1658319910,147,3101
3655439456,3341588259,1658140103,1658140218,115,2616
3782606578,3287960505,1669041223,1669042017,794,4842
3108868282,3716314758,1646055414,1646055805,391,403
3761495691,3337413673,1641546523,1641546611,88,1159
3261700000,3578295072,1652663535,1652664482,947,3655
3699540673,3833658069,1668104671,1668105133,462,2036
3044488431,3266730560,1652640428,1652641126,698,102
3768464259,3000909555,1642607393,1642608000,607,3907
3525292755,3876000167,1668233617,1668234587,970,1770
3929467970,3072991251,1646548139,1646548945,806,1009
3052212958,3036502718,1653785240,1653785625,385,320
3733970031,3632684755,1642557200,1642557613,413,2626
3985676652,3247810974,1659744700,1659744921,221,2070
3090075274,3938810000,1654594597,1654594934,337,2403
3301531774,3543776760,1655416725,1655417122,397,3561
3585588283,3425900958,1656042376,1656043365,989,2284
3839290252,3839523914,1663627598,1663628408,810,3861
3011361017,3561434267,1666017698,1666018029,331,4315
3939265012,3361095086,1665227680,1665228261,581,4808
3738985986,3949777909,1645934674,1645935194,520,863
3873633824,3290188248,1643653574,1643653818,244,3207
3231586202,3402189791,1660123388,1660124120,732,4458
3987350388,3140027421,1644689741,1644689744,3,1279
3731567775,3254096332,1646173342,1646174161,819,1726
3489090007,3826422443,1646306694,1646307478,784,315
3336877656,3799000929,1655347507,1655348298,791,1916
3306518255,3606968171,1651936250,1651936825,575,1309
3354767052,3479573452,1662319380,1662320141,761,3144
3553615387,3773106508,1661902097,1661903008,911,1967
3221050728,3270821586,1664721461,1664721964,503,3150
3325861270,3701083129,1647038137,1647038987,850,4622
3665495106,3410368284,1660419722,1660420631,909,4714
3416358837,3994255882,1660601180,1660601720,540,4924
3665566300,3359190254,1650898225,1650898706,481,1593
3182984916,3523263971,1647400350,1647401314,964,4313
3205389603,3871878874,1652980058,1652980742,684,4185
3072150173,3423835989,1666417949,1666418351,402,755
3550550167,3471419082,1646859851,1646860652,801,691
3104142181,3498715093,1662969969,1662970687,718,2874
3838418377,3651070994,1663084723,1663085078,355,873
3468019709,3988227144,1643870330,1643870864,534,1650
3699211022,3295706603,1654981099,1654981359,260,4926
3250949456,3863032062,1667901488,1667901493,5,1809
3061209821,3904637386,1661048234,1661049107,873,1940
3002668091,3699566639,1653191459,1653192412,953,4244
3152512199,3172545922,1641933735,1641934139,404,4183
3254378854,3054887581,1641239662,1641240161,499,532
3284659001,3650459745,1654823041,1654823539,498,2920
3673776573,3910604688,1657676869,1657677587,718,3673
3182097576,3742494858,1647716193,1647716612,419,2725
3245089699,3372735598,1663037457,1663037809,352,4561
3374348591,3353123795,1641314679,1641315556,877,2654
3812494983,3618997870,1653753317,1653754212,895,2839
3980766306,3355406032,1663101558,1663101803,245,4799
3511372356,3685453275,1663200163,1663200645,482,452
3128724131,3707754007,1641213921,1641214604,683,2292
3063969611,3983075110,1657548570,1657548902,332,4047
3417706790,3170256815,1667317397,1667318023,626,1422
3164983885,3744699727,1652860674,1652861500,826,1572
3157513061,3957188445,1659658405,1659659012,607,3121
3982615894,3320614378,1653298416,1653298975,559,4933
3834882789,3761368817,1660917093,1660917393,300,3654
3001202457,3674461466,1661157683,1661157717,34,4223
3092549226,3333474570,1653697373,1653697792,419,2998
3386588988,3031791428,1665395771,1665396493,722,115
3811103515,3764310022,1648679590,1648680514,924,4899
3557964405,3818391079,1654904999,1654905914,915,295
3858106972,3364325846,1653321323,1653322141,818,155
3272969778,3126149229,1660088718,1660089216,498,3361
3832772998,3245280405,1664044611,1664045300,689,1193
3259891484,3710996050,1655524237,1655524572,335,0
3590995855,3954539308,1666335769,1666336304,535,4316
3983055987,3089481259,1647907796,1647908495,699,3668
3679185246,3951850013,1658360443,1658361411,968,606
3113377003,3744207930,1648879662,1648880091,429,992
3685659377,3841359109,1655027374,1655027393,19,2911
3022574741,3199097293,1664799340,1664799707,367,4889
3784023605,3453813486,1641022394,1641022877,483,2879
3483852437,3846691708,1647521947,1647522403,456,456
3267347155,3471607981,1643185995,1643186888,893,4899
3803925784,3259810616,1645200326,1645201320,994,1846
3520993977,3729846587,1666188005,1666188148,143,3455
3222871379,3311781554,1650541002,1650541051,49,472
3688991428,3378410267,1652529410,1652530368,958,1771
3219811159,3863720267,1654753322,1654754039,717,875
3299874686,3884493694,1668254601,1668254742,141,3791
3572049475,3525772009,1653547379,1653547726,347,631
3240805581,3974214543,1660326462,1660327319,857,4422
3641900197,3573161066,1655290901,1655291070,169,3798
3813095250,3978709981,1655955706,1655956587,881,267
3596675358,3280288760,1644864753,1644864976,223,582
3679735881,3352112914,1646287137,1646287427,290,3064
3083889166,3139852407,1661045051,1661045225,174,407
3871678293,3191099190,1645051307,1645051814,507,3566
3579414354,3998280301,1669393647,1669393691,44,4720
3523263489,3337376754,1644309427,1644310108,681,2506
3155597271,3579742124,1658870518,1658870803,285,1618
3090205105,3751551528,1645891891,1645892029,138,2378
3678850376,3452277548,1664432434,1664433386,952,4758
3172375931,3845967830,1653880077,1653880251,174,487
3152141780,3480289809,1652800506,1652801465,959,3911
3723752568,3386831090,1646798966,1646799210,244,536
3729925040,3724979390,1663138558,1663139131,573,3863
3190862699,3951645868,1656064349,1656064974,625,3577
3368089659,3545189181,1656288874,1656289264,390,4584
3166836538,3194273115,1669059805,1669060683,878,1246
3654189135,3594092599,1654352106,1654352988,882,1913
3253458646,3066584228,1641110441,1641110574,133,833
3293261818,3101950125,1665400949,1665401288,339,4126
3544850928,3945698362,1657809796,1657810361,565,994
3941242277,3818154918,1641426866,1641427337,471,4242
3983003781,3286815454,1648750133,1648750818,685,2779
3381615714,3474194116,1652156890,1652157406,516,314
3047252388,3658673321,1654716584,1654717248,664,887
3304156433,3189731304,1666407593,1666407818,225,3959
3723795915,3982367427,1663599658,1663600217,559,4558
3122824348,3939401256,1665031060,1665031444,384,4581
3879411742,3137357056,1658875006,1658875265,259,3055
3042993813,3874403613,1644900864,1644901338,474,3772
3605313145,3691902555,1647773749,1647774116,367,3918
3731792672,3261659814,1654779365,1654779852,487,3693
3516096501,3429993246,1668371518,1668371763,245,643
3242875109,3057137646,1654676026,1654676528,502,4583
3375720285,3557403611,1654489115,1654489204,89,281
3947973922,3788158847,1648916019,1648916530,511,3947
3392727881,3567344121,1652181937,1652182444,507,3325
3205866676,3211799890,1646135561,1646135783,222,953
3578396619,3108241354,1650644702,1650645239,537,3439
3034461504,3725594401,1647045427,1647045957,530,1389
3928830508,3244419119,1654044118,1654044747,629,1683
3525853209,3349553165,1650348508,1650349009,501,2802
3740893244,3333297441,1663281734,1663282127,393,1302
3600522928,3417388205,1664208257,1664208657,400,1230
3755124388,3486900702,1655932275,1655932714,439,2980
3008451888,3917766114,1651951149,1651951912,763,3946
3935100000,3286802455,1644509773,1644510306,533,2923
3470303198,3533953898,1650508989,1650509344,355,2916
3942591815,3157177265,1645597106,1645597299,193,3151
3468357041,3352383329,1660215396,1660215653,257,1333
3525023727,3810713632,1657950682,1657950694,12,4125
3560324858,3998740759,1662351120,1662351647,527,3355
3971357031,3533696928,1652574019,1652574101,82,2153
3047444463,3256165136,1659478111,1659478986,875,4064
3028086692,3848990757,1642147121,1642147192,71,1389
3707135546,3552337426,1661639103,1661639324,221,3980
3737664313,3330181753,1647218655,1647219618,963,953
3171730429,3840629545,1662421725,1662421755,30,277
3643606171,3965926135,1657307403,1657307587,184,2970
3749229092,3830820259,1648470794,1648471558,764,2196
3889710127,3077674758,1647966207,1647966394,187,4261
3361342305,3633347872,1647550376,1647550753,377,295
3577667632,3950386227,1664578214,1664578770,556,701
3257316109,3150664520,1642303844,1642304772,928,1075
3278007791,3388902192,1644211952,1644212718,766,2239
3495260733,3087219145,1666493749,1666494468,719,2974
3709005538,3223045846,1655739991,1655740230,239,4036
3039058579,3907447916,1648230321,1648230865,544,1746
3522396976,3404489357,1648982507,1648982890,383,2772
3527288467,3079066720,1666014585,1666015331,746,3276
3629579516,3811464710,1649905901,1649906532,631,4658
3313165415,3760564434,1651318426,1651318986,560,2826
3801486924,3707817063,1655525583,1655526470,887,4991
3268150296,3141323985,1641340850,1641341153,303,551
3219325496,3053963379,1663752826,1663752945,119,1878
3810996366,3396615373,1648907434,1648907548,114,2952
3899411851,3185842036,1653811180,1653811793,613,34
3656898356,3832976331,1665695687,1665696484,797,1989
3927630116,3478631035,1643678225,1643678632,407,2307
3860147179,3458067867,1645184833,1645185578,745,1088
3125937087,3467149118,1667535294,1667535947,653,659
3133935883,3288664051,1655716572,1655717300,728,536
3291420905,3735680047,1657987366,1657988282,916,3398
3134204981,3997648475,1645999278,1645999393,115,2965
3627295929,3048750918,1661683195,1661683944,749,3045
3910110073,3759706594,1663103151,1663104111,960,4112
3248774937,3850712309,1666021146,1666021302,156,1353
3612326551,3879926013,1648386160,1648386470,310,2055
3569329915,3302378240,1643323593,1643324420,827,3524
3210342846,3674476945,1655673640,1655674011,371,1049
3028279930,3073726824,1668679882,1668680724,842,1799
3484835175,3819675608,1668786340,1668787131,791,1704
3364649061,3262379802,1652501582,1652502254,672,1467
3832386976,3299677796,1642372753,1642373587,834,4905
3789470263,3939086702,1667071364,1667071881,517,3093
3003627736,3200786894,1668179235,1668179873,638,4758
3123629137,3456358495,1654396830,1654397334,504,1285
3798363461,3246766634,1641982899,1641983887,988,66
3172374997,3299092735,1641786611,1641787399,788,2800
3749164112,3351421163,1653964772,1653965415,643,932
3407241059,3515010346,1642498634,1642499195,561,233
3689545812,3239956593,1664979998,1664980644,646,581
3731487147,3079716795,1655079760,1655079813,53,1235
3945403945,3454073059,1648932298,1648932777,479,4362
3045272914,3709178047,1643678354,1643678619,265,89
3931941651,3721467884,1658750453,1658751375,922,2238
3294159130,3570672288,1659107661,1659108327,666,1177
3054824098,3759683106,1640994955,1640995891,936,220
3138225921,3762162463,1645235744,1645236401,657,2785
3648300268,3698015307,1663046743,1663047486,743,372
3217987652,3378749799,1663509544,1663510031,487,4274
3462445621,3893203125,1650507624,1650507910,286,3383
3928211930,3264361812,1667953194,1667953331,137,3015
3333946793,3040186994,1642202838,1642203613,775,4010
3913300010,3889667446,1656088875,1656089451,576,4775
3682259503,3738086298,1648243240,1648243676,436,4513
3901525860,3352672295,1651412133,1651412673,540,4670
3925237764,3911480291,1649961411,1649961575,164,2688
3615679189,3884834420,1657366206,1657366723,517,4842
3860801904,3632589963,1644591118,1644591534,416,3454
3728091304,3859659915,1643512782,1643513706,924,2674
3009804108,3973196966,1667372991,1667373206,215,1298
3895757513,3118107302,1664413390,1664414122,732,73
3903560907,3905000167,1661802243,1661802352,109,590
3942992427,3079853767,1649964787,1649965524,737,3906
3440841047,3655935413,1660132336,1660132896,560,4205
3919467244,3604597763,1641740812,1641741134,322,2710
3236065227,3229469814,1664241105,1664241725,620,1668
3167947616,3775336064,1660037748,1660038238,490,1934
3440648640,3791969064,1657447622,1657448453,831,1827
3273786621,3264233763,1652681308,1652682060,752,830
3444858019,3090075299,1643343345,1643343617,272,4927
3169676668,3507468547,1649570634,1649571384,750,4173
3796732656,3151224686,1648955825,1648956309,484,950
3792685874,3107968388,1642727410,1642728120,710,1652
3216001806,3876197774,1665240293,1665240673,380,4513
3660615421,3092375405,1661253251,1661253298,47,2243
3169781506,3173154194,1648732906,1648733529,623,2097
3084700913,3030805178,1660930939,1660931347,408,3758
3064786828,3479637025,1655501639,1655502428,789,2777
3633882171,3834706277,1641082756,1641083152,396,1633
3889327892,3364465926,1648618838,1648618953,115,4191
3298713345,3441709864,1641286976,1641287144,168,371
3476212102,3472956738,1642715761,1642716276,515,752
3461772870,3440368521,1657042637,1657042751,114,2233
3626997134,3714882747,1642888546,1642889380,834,1408
3907156467,3418424682,1647444756,1647444935,179,872
3699183984,3784711763,1648976447,1648977235,788,2079
3617192850,3564800106,1647954103,1647954961,858,1479
3346065197,3523415632,1658539762,1658540313,551,4567
3904504874,3693110899,1645167315,1645167912,597,2652
3679146462,3449260465,1644872323,1644873006,683,848
3806756789,3712984462,1653148535,1653149025,490,1595
3927258530,3921307467,1658656457,1658657419,962,394
3470771422,3089786160,1654933106,1654933800,694,2837
3444649999,3403268182,1641009254,1641010229,975,1531
3181108993,3124722941,1663989790,1663990327,537,2554
3057137646,3651045662,1668399314,1668399937,623,4413
3757428663,3263814161,1658680089,1658680730,641,4010
3949337003,3411208357,1658155218,1658155844,626,4260
3464884210,3442499352,1643519847,1643520256,409,3647
3544271733,3651093178,1659036723,1659037378,655,1665
3560600459,3691178072,1661188804,1661189615,811,4656
3140068795,3113383628,1660388187,1660389108,921,1498
3073175293,3252500470,1662202533,1662203269,736,2868
3301360368,3779952123,1641852530,1641853258,728,3461
3819955681,3874091171,1669189916,1669190009,93,1491
3142747866,3520794731,1657513366,1657514299,933,3396
3238278007,3297859696,1641446865,1641447608,743,1167
3625109340,3037860417,1661919379,1661919979,600,3202
3051343655,3569738383,1658834841,1658835488,647,4627
3460183796,3309259238,1666741057,1666741746,689,1229
3188031685,3303072499,1643807931,1643808649,718,1888
3666234493,3150568196,1650044721,1650044989,268,3442
3032723664,3605223000,1655256526,1655257017,491,554
3404455025,3265920114,1658012844,1658013112,268,4024
3980075898,3394539659,1645411877,1645412166,289,1670
3529830775,3067848538,1642237482,1642237608,126,1513
3734680109,3966431938,1657410823,1657411109,286,2436
3226595603,3243322418,1660985075,1660986038,963,1845
3198839781,3073829303,1642747139,1642747430,291,3905
3853257181,3870960943,1660401175,1660401196,21,1865
3098720426,3044288357,1661129977,1661130372,395,2968
3035849632,3957045547,1666108150,1666108631,481,4328
3059375125,3789684144,1665395116,1665396100,984,1183
3458403932,3234762663,1664527667,1664528221,554,187
3727538982,3483899359,1664633039,1664633991,952,2290
3749069705,3066748970,1661831791,1661831798,7,2912
3528684942,3071033839,1647157060,1647157236,176,4072
3049754622,3868486175,1656675834,1656676608,774,3866
3922549217,3962132805,1658832513,1658833274,761,3610
3327406726,3056687092,1648381459,1648382254,795,2533
3740960337,3857903424,1668850177,1668850693,516,4435
3735703468,3128101193,1658562035,1658562526,491,904
3304761193,3430551703,1652407085,1652407994,909,4960
3082991985,3927565021,1665140011,1665141011,1000,1486
3739500689,3763855343,1668076379,1668077105,726,4300
3211799890,3736036637,1659468292,1659468687,395,2338
3702504650,3401626656,1642879894,1642880295,401,2314
3548160456,3847751016,1657850946,1657851863,917,1176
3812367068,3289008377,1663449754,1663450188,434,1398
3493278232,3249731449,1651502683,1651503307,624,3043
3046276534,3607512667,1654885555,1654885967,412,4776
3843057742,3371102579,1643068050,1643068770,720,2470
3385214474,3804326442,1664603358,1664603434,76,4706
3206887703,3070093465,1652992073,1652992164,91,3603
3227418557,3908381104,1650465136,1650465519,383,645
3990092190,3884263158,1660149607,1660150539,932,4854
3162302689,3840366338,1650896115,1650896596,481,1820
3239875165,3850135156,1660864095,1660864298,203,3530
3283063461,3394369232,1645816683,1645816941,258,4358
3136466533,3007545594,1663829999,1663830610,611,362
3464473033,3923445402,1655395954,1655396131,177,3343
3775276802,3145071965,1667358069,1667358230,161,4521
3386770701,3377106989,1667419273,1667419912,639,3999
3075176874,3590026838,1659492843,1659493451,608,2275
3896804474,3809826531,1642069261,1642070115,854,4950
3863032062,3910959137,1651232365,1651232869,504,2154
3507010673,3950286783,1667351239,1667351684,445,2024
3208539074,3629598420,1664457859,1664457975,116,3589
3219886222,3156219009,1643368482,1643369034,552,4561
3869677821,3634626426,1658837078,1658837165,87,2798
3904797329,3550698426,1664337734,1664338430,696,700
3782071617,3945834923,1648683475,1648683590,115,394
3738322262,3811479670,1667615587,1667616156,569,4940
3514120076,3705906700,1657896390,1657897132,742,2593
3180957748,3908909021,1646051065,1646051717,652,2451
3556064132,3060580707,1654200339,1654201070,731,1300
3626784838,3602430050,1659203026,1659203823,797,820
3938546095,3943346495,1643727335,1643727789,454,113
3760211050,3356393089,1647206662,1647207589,927,149
3994418825,3682933555,1643025282,1643026119,837,4577
3141715322,3746643631,1661459392,1661459814,422,2663
3405762816,3865858935,1663748431,1663748940,509,4280
3152305812,3049246834,1653931476,1653931761,285,3694
3989786136,3922503600,1653320539,1653320595,56,3888
3837089971,3766678516,1654558185,1654558773,588,998
3093109284,3409182420,1662917212,1662917498,286,2779
3217151351,3203316365,1653961208,1653961302,94,1345
3343564370,3403811428,1661836946,1661837195,249,2825
3620278170,3751685030,1658412836,1658413709,873,30
3296677750,3683928614,1650667044,1650667559,515,1974
3931242410,3826334538,1654527718,1654527924,206,625
3042229072,3454777337,1656573041,1656573553,512,4497
3833356231,3061234559,1665416397,1665416614,217,1304
3594057466,3900016513,1656108063,1656108387,324,3461
3204201429,3982717965,1652024997,1652025073,76,1818
3884336829,3113624539,1655934001,1655934184,183,3286
3690990867,3710996050,1653980512,1653980624,112,1820
3785640310,3587796694,1661903044,1661903738,694,335
3818849972,3500123600,1646530793,1646531457,664,4100
3977710794,3970108553,1643484158,1643484397,239,1391
3088539200,3655979007,1644662068,1644662600,532,4445
3994351134,3455427379,1656013293,1656013450,157,2166
3712501951,3644899645,1661202699,1661203025,326,1855
3099968767,3805687615,1647049184,1647050132,948,2808
3187903812,3644617790,1652946750,1652947177,427,2829
3595214869,3608242916,1667411211,1667411299,88,557
3251747783,3669902429,1652386297,1652387249,952,4879
3420652063,3807867299,1642953040,1642953754,714,1515
3745140085,3150381618,1647217064,1647217883,819,796
3160799533,3293570427,1660625978,1660626544,566,4111
3249311996,3657803757,1656808696,1656809103,407,4938
3252685812,3243632935,1647201534,1647202521,987,2939
3069131483,3101185264,1643032396,1643033379,983,1303
3552943555,3954872663,1650969509,1650969644,135,2337
3870960943,3450526405,1656698230,1656699097,867,2411
3730950435,3937675485,1652515071,1652515159,88,3786
3525772009,3452027853,1641249209,1641249345,136,1338
3617228324,3977399866,1646897397,1646897878,481,1922
3685052000,3575961318,1649336876,1649337636,760,4088
3015137308,3433206027,1657689349,1657689508,159,1862
3543859239,3749465755,1658029115,1658029985,870,119
3162356711,3528767374,1646217841,1646217882,41,504
3956645940,3204958504,1660619359,1660620177,818,1495
3924015934,3165606716,1667911871,1667912659,788,4658
3471705146,3823880261,1653999070,1653999959,889,2092
3425350335,3546993278,1663418989,1663419552,563,728
3871880296,3658558987,1645567716,1645568168,452,2438
3387475625,3586312427,1660426884,1660427464,580,1781
3474666322,3752731301,1642747226,1642747688,462,1429
3528328300,3286606627,1655202734,1655203295,561,1340
3650279417,3049066932,1645806058,1645806211,153,751
3067931674,3659874694,1650313623,1650313872,249,1485
3892993100,3917514744,1647100533,1647100773,240,736
3840594002,3319502609,1665033805,1665034678,873,819
3978335381,3458763735,1657973268,1657973385,117,2096
3098192467,3857780342,1647610097,1647610702,605,324
3146075443,3115965208,1669463437,1669464041,604,3929
3769660801,3749834237,1664416965,1664417439,474,3991
3577375657,3923855100,1668792719,1668793074,355,1846
3369484999,3862606667,1661255386,1661255389,3,4258
3922986457,3795058397,1661204658,1661205062,404,3329
3299748797,3344435250,1644522914,1644522953,39,3946
3321877275,3349645522,1662479710,1662480694,984,4629
3967046941,3769258298,1657414285,1657414554,269,1213
3328295105,3990324116,1641704505,1641705162,657,78
3600042511,3035248387,1646743393,1646744285,892,785
3469309496,3655268941,1669074039,1669074931,892,3668
3697393318,3435103399,1645378865,1645379752,887,3604
3710795247,3141672088,1643431618,1643432310,692,1836
3679212300,3531402641,1655931382,1655931582,200,2953
3951474008,3589375482,1658175242,1658175960,718,1135
3414939886,3604569722,1656996393,1656996445,52,1919
3460087014,3369195144,1652199715,1652200340,625,2920
3146273170,3191311580,1657754467,1657754912,445,4351
3605134376,3181709488,1644158124,1644158623,499,1416
3225250076,3039833612,1642618642,1642619239,597,524
3585516560,3290979028,1664635481,1664636334,853,4519
3810260811,3929272637,1643979603,1643980166,563,656
3061262184,3840529717,1645447032,1645447200,168,3785
3076654957,3650354340,1661666983,1661667811,828,188
3564843816,3398790895,1661464933,1661465836,903,754
3419619789,3074805197,1668083095,1668083543,448,2286
3914717235,3516488536,1666073906,1666073998,92,3648
3247370583,3674812301,1650122553,1650122798,245,4946
3826277876,3931572006,1662644860,1662645091,231,1812
3231506205,3282580882,1650595726,1650596267,541,1032
3869841585,3896645235,1657018535,1657019468,933,4472
3136000720,3015194579,1642043977,1642044004,27,933
3056160782,3162692584,1658044553,1658045455,902,2398
3920601195,3724808630,1650606245,1650606935,690,4324
3498070462,3294246027,1664740016,1664740826,810,2557
3827572464,3140148088,1662063420,1662063518,98,2602
3655501856,3886442844,1665588051,1665588305,254,2270
3178364027,3550381908,1667215891,1667216353,462,4683
3203543079,3029633858,1660652919,1660653799,880,77
3789046953,3992187404,1668741320,1668742281,961,1832
3457839118,3117780009,1654147947,1654148332,385,1334
3881282919,3716129750,1645085258,1645085999,741,3522
3837128352,3739939549,1650540505,1650540834,329,2944
3924621942,3748096648,1650368981,1650369471,490,302
3099722300,3765955791,1661433094,1661433776,682,1498
3176727998,3702657628,1660907122,1660907934,812,3481
3978521503,3161240411,1660527787,1660527975,188,1372
3362847183,3912315635,1655422109,1655422545,436,694
3164930086,3668627772,1656249419,1656250184,765,2107
3265268738,3997033260,1650143609,1650144317,708,4543
3933602303,3366734651,1643626687,1643626713,26,4367
3434513115,3137867529,1664139584,1664140526,942,4035
3030000019,3930648290,1663942699,1663942742,43,2764
3247432426,3559663701,1647273127,1647273653,526,3522
3593425015,3968271265,1662403066,1662403391,325,4899
3243496269,3760993644,1655623212,1655623613,401,4438
3512915433,3997358345,1667260221,1667260504,283,3030
3806461202,3864876811,1665543707,1665544142,435,398
3719343681,3217012240,1667920709,1667920879,170,1025
3801278284,3298672241,1656316127,1656316788,661,4844
3041318122,3169330355,1653332731,1653332937,206,2998
3754548494,3534805530,1644716804,1644716932,128,2248
3764906509,3009601208,1657638077,1657638849,772,3598
3002167186,3453433487,1654729086,1654729880,794,3361
3865882366,3147233117,1666467652,1666467981,329,1736
3483899359,3931289039,1662256139,1662256490,351,2938
3097004923,3527876178,1644739059,1644739987,928,4423
3294816887,3240848301,1656017834,1656017909,75,2215
3030130764,3826415076,1649112835,1649113239,404,2743
3002317263,3760079966,1650958618,1650959321,703,4710
3735183692,3567688625,1649272869,1649273861,992,2670
3676886812,3567100647,1662976779,1662977138,359,1177
3486120143,3622462303,1652752170,1652752721,551,4629
3880705365,3361732891,1641800844,1641801072,228,2351
3106798007,3344712544,1642148277,1642148904,627,4027
3752244923,3411810176,1647818026,1647818366,340,1850
3765230332,3196225474,1666834442,1666834898,456,3919
3455733778,3691898465,1647995244,1647996166,922,3405
3080012981,3952883258,1666963877,1666964030,153,2244
3009801644,3537798135,1658837896,1658838516,620,1854
3296128827,3879829066,1659646407,1659646878,471,4434
3169093499,3026667827,1645553938,1645554503,565,3449
3525737735,3722697268,1663835118,1663835544,426,1645
3677727354,3821770869,1658666092,1658666422,330,1268
3553576677,3337675650,1654224218,1654224609,391,4712
3058331169,3559822642,1650306348,1650307260,912,1660
3605407857,3988667316,1666321790,1666322265,475,1658
3541072275,3366412160,1641705286,1641705725,439,4738
3525628725,3945152950,1654004689,1654004921,232,678
3519073105,3304431614,1647933640,1647933809,169,1416
3411602827,3554407842,1660759391,1660760125,734,3982
3704384384,3616543037,1665198679,1665199125,446,2837
3545002403,3311478442,1649042225,1649042893,668,2677
3775716975,3672769679,1666871570,1666872463,893,666
3897931103,3169896933,1647023552,1647024047,495,279
3858792568,3327966493,1663934980,1663935924,944,3219
3497945612,3333211299,1647241897,1647242709,812,2754
3534941269,3153328721,1648881992,1648882872,880,11
3805208985,3250247361,1662271696,1662271802,106,1872
3070543281,3903890113,1669648044,1669648202,158,373
3446125233,3599783654,1644634126,1644635048,922,319
3656796390,3977628761,1658973901,1658974556,655,1321
3354770915,3945116365,1653114845,1653115634,789,1309
3047466705,3453186186,1660503371,1660504188,817,2676
3397571880,3689082458,1655076140,1655076772,632,1984
3679267426,3205389603,1645731349,1645732105,756,1191
3581620062,3241416580,1667225069,1667225742,673,3066
3688180191,3943080912,1646916107,1646916789,682,4483
3871039126,3720557845,1645964737,1645965700,963,4999
3589912952,3174442659,1644437882,1644438465,583,2610
3906786908,3833712291,1665550664,1665551612,948,3948
3702763025,3636549059,1656357073,1656357299,226,3740
3088950355,3793973498,1662624085,1662624402,317,1628
3290536367,3351286291,1643334395,1643335260,865,4455
3386043760,3080869152,1667704362,1667704391,29,557
3808828209,3376114676,1656515935,1656516174,239,1639
3085143025,3558972241,1658653180,1658653429,249,3719
3061262184,3955558048,1666574144,1666574626,482,1989
3599348117,3625394978,1646889197,1646889846,649,3662
3630419787,3432564771,1651539294,1651539487,193,696
3138875199,3588511488,1662270285,1662270345,60,2783
3547934854,3085500838,1655267558,1655267950,392,4844
3071572593,3713128618,1656700094,1656700190,96,1470
3036812924,3758478772,1656459193,1656459548,355,4435
3310144002,3758436454,1656778861,1656779640,779,215
3311908597,3062963126,1662239815,1662239922,107,2943
3564361400,3537691560,1649405424,1649405594,170,3935
3358177618,3071371917,1657747538,1657748005,467,2331
3120837796,3995309554,1664243559,1664244301,742,3729
3756965968,3413488625,1651213649,1651213847,198,2294
3431801144,3217812771,1660017784,1660018611,827,1323
3739927577,3143744654,1660093107,1660093867,760,1188
3149893546,3234038622,1641051263,1641051638,375,4025
3303884430,3299865489,1652153008,1652153014,6,1338
3422523227,3351492053,1642332249,1642333165,916,2495
3927003981,3432232576,1649069023,1649070023,1000,3660
3873269408,3154770087,1655769320,1655770062,742,3249
3308032258,3051975657,1664231082,1664231296,214,2433
3559569966,3976125873,1665408112,1665408648,536,1964
3978590758,3180769204,1661888506,1661889130,624,543
3432190696,3322034003,1656375105,1656375311,206,3195
3597806288,3842467008,1656353119,1656353565,446,4962
3896022749,3805020695,1644271363,1644271586,223,4403
3283928785,3287852795,1645743398,1645743511,113,4903
3310674011,3665636619,1652557528,1652557911,383,375
3731934076,3945116365,1654215246,1654215353,107,2057
3213528740,3437446807,1657995400,1657996349,949,4789
3208654349,3576334448,1649706952,1649707451,499,119
3147108124,3543924550,1649469020,1649469723,703,4471
3577543152,3391705905,1645934411,1645935210,799,4906
3482346271,3375948097,1666154973,1666155161,188,2683
3227052694,3829655999,1661122192,1661122511,319,1573
3671713894,3520958168,1660381227,1660381856,629,4978
3837148105,3843383835,1668771045,1668771772,727,3100
3983554658,3006979470,1642299241,1642299580,339,4285
3651737889,3823790320,1641322151,1641322260,109,3748
3597548040,3011574793,1645844927,1645845721,794,3084
3892055211,3249834356,1641649520,1641649639,119,3681
3756224502,3833711937,1665216081,1665216090,9,1621
3573267883,3594566460,1662384797,1662384934,137,475
3993020100,3890294062,1643655651,1643655796,145,1883
3474654423,3296759235,1665511724,1665512167,443,2844
3712087007,3174702002,1654477065,1654477294,229,1136
3396738738,3045199387,1644687106,1644687866,760,2063
3751471974,3363372386,1655854334,1655855098,764,521
3461976533,3289284546,1652296486,1652296537,51,4932
3548262455,3996129028,1645946294,1645946483,189,3512
3961719475,3566869780,1664540621,1664540811,190,1051
3445775042,3931750533,1651453946,1651454726,780,767
3134621240,3970008160,1644944325,1644945087,762,929
3542163706,3545426065,1646212783,1646213279,496,226
3113256302,3337837214,1666556487,1666557436,949,3350
3214122462,3450180162,1662960994,1662961115,121,1667
3703761567,3572029888,1656613801,1656614209,408,109
3424655052,3614879605,1658991980,1658992137,157,3557
3029982023,3994278184,1649519991,1649520869,878,3886
3583032239,3181108993,1656186920,1656187524,604,436
3176837430,3294065153,1666859130,1666859826,696,3515
3481514024,3449639251,1653438432,1653439195,763,690
3098106620,3827217579,1665767117,1665767632,515,311
3027632462,3325330443,1667826029,1667826585,556,1263
3710029529,3508569024,1663954041,1663954886,845,2443
3854311352,3859680085,1659614395,1659614587,192,1872
3687617180,3821860334,1654417491,1654418241,750,3738
3277558839,3507953967,1643337549,1643338515,966,3329
3579694108,3265338560,1664999509,1665000318,809,300
3939572635,3824830394,1645271233,1645271415,182,4956
3370232057,3251056080,1644629171,1644629776,605,503
3288916752,3501503387,1663192388,1663192560,172,1940
3269754422,3803727171,1663908863,1663908869,6,1462
3576443116,3115284207,1642414828,1642414894,66,1649
3090776537,3246420786,1655559077,1655559319,242,299
3617830475,3787292579,1666523212,1666523560,348,4158
3703612930,3834121201,1666925822,1666926637,815,1241
3661316500,3955053030,1664779769,1664780653,884,3345
3683250499,3211116397,1666830122,1666830533,411,1625
3935307529,3208568672,1667614809,1667615255,446,2390
3653087777,3024618179,1650939302,1650940130,828,2050
3750655133,3348637372,1662855619,1662856385,766,2401
3338727021,3947337342,1646559049,1646559055,6,3910
3744617062,3557787223,1653038591,1653039141,550,1594
3625298494,3523482116,1663777023,1663777171,148,4740
3490784760,3437568419,1654895055,1654895617,562,1473
3185884376,3911013074,1646691873,1646692599,726,1818
3990964333,3805981202,1663730082,1663730722,640,1079
3207363877,3205963259,1669245902,1669246150,248,1836
3069158673,3624384103,1654183634,1654184216,582,776
3536796324,3557059956,1654137784,1654138674,890,77
3068009863,3576994439,1654851828,1654852167,339,259
3137696042,3741792199,1641214661,1641215561,900,4466
3584572419,3198145470,1643126739,1643126897,158,439
3443517533,3588553998,1664299370,1664299534,164,2079
3132733976,3211484426,1660217448,1660217572,124,4142
3510001650,3664742599,1661498686,1661498710,24,3674
3195330594,3132584139,1667766445,1667767371,926,1469
3760252389,3130147694,1664451177,1664451885,708,1333
3376363187,3361626983,1641738652,1641739502,850,94
3534187048,3257573930,1659421977,1659422449,472,3734
3436622737,3741136381,1652696374,1652696721,347,2635
3817678740,3980073735,1656373870,1656374686,816,1140
3130203702,3917750191,1657324900,1657325718,818,4047
3442238639,3266499299,1666804244,1666804713,469,2113
3653673347,3631592678,1647735165,1647736042,877,1250
3719759644,3951727236,1654403642,1654404170,528,4791
3367344342,3696530192,1650991182,1650991436,254,2119
3958858181,3317328980,1644093791,1644094341,550,270
3277778522,3030823021,1651412366,1651413194,828,2149
3714882747,3337710796,1668272159,1668272405,246,4719
3497273204,3959959879,1662041930,1662042304,374,3561
3338680040,3148477798,1645149763,1645150018,255,706
3323770066,3805370371,1664933877,1664934341,464,2132
3807374225,3002418018,1650252632,1650252793,161,473
3896291736,3296999452,1656647084,1656647603,519,456
3102851139,3867238983,1648429677,1648430538,861,2486
3048656059,3769488422,1652315384,1652315642,258,1866
3483634220,3132149630,1657477898,1657478698,800,2229
3270096754,3488667521,1642648596,1642649320,724,2688
3908069136,3467025820,1667316119,1667316446,327,4498
3551216867,3481674773,1668125245,1668126188,943,4744
3376295409,3483783055,1659590480,1659591101,621,4174
3058925951,3416245860,1654456111,1654456344,233,4499
3468073623,3179008307,1647797112,1647797831,719,4849
3209777635,3191473729,1653829637,1653830495,858,3455
3886506128,3189574947,1657777100,1657777919,819,4795
3833595212,3866664372,1648593795,1648593811,16,575
3720714754,3421220576,1653152045,1653152625,580,1168
3157193185,3826829347,1659102850,1659103237,387,1316
3148939104,3380607306,1647801290,1647802247,957,1246
3255655854,3257304331,1641378760,1641379161,401,3065
3174299777,3903634551,1668509902,1668510566,664,2855
3183342302,3087938789,1652425246,1652425785,539,500
3745665721,3194964062,1650025842,1650026117,275,1084
3155593728,3665195340,1663357780,1663358514,734,21
3624075107,3913589943,1669471604,1669472044,440,4787
3010771877,3705200384,1654529046,1654529392,346,2099
3013528629,3719066030,1660901272,1660901673,401,4353
3056533349,3006477984,1642559905,1642560537,632,448
3848097257,3229673754,1658225375,1658225993,618,2537
3484642526,3221648612,1645027279,1645028054,775,4258
3314116283,3516882671,1642897502,1642898364,862,3860
3689302027,3536735889,1666625440,1666626378,938,1618
3919001600,3022510352,1642595596,1642596115,519,2193
3621183361,3785328580,1664977723,1664978657,934,1341
3548173242,3891220861,1650363010,1650363052,42,1341
3529171082,3544586490,1663794274,1663794577,303,3137
3853803439,3081993083,1664981154,1664981219,65,2664
3314311163,3286904432,1649149213,1649149505,292,855
3981965953,3823002655,1668250793,1668251437,644,4695
3624243798,3429971208,1650559935,1650560908,973,1224
3973317582,3534988531,1666359776,1666360662,886,4552
3606062501,3467056943,1643800567,1643801409,842,3813
3680336662,3885997164,1665128870,1665129856,986,3385
3416514843,3902866122,1666576829,1666577799,970,4958
3728091304,3113841720,1656053651,1656054580,929,1799
3994283360,3204958504,1653160556,1653161212,656,3913
3282704170,3717987376,1668668143,1668668149,6,970
3512173171,3689977219,1650750702,1650751021,319,1410
3588519389,3188630843,1654839135,1654839920,785,4864
3261724438,3853920999,1669517941,1669518879,938,275
3829770307,3415470078,1655169077,1655169934,857,3766
3811988603,3600382125,1659577990,1659578437,447,787
3211986948,3913968845,1654341469,1654341993,524,1014
3594444436,3188347387,1655944033,1655944156,123,4193
3227712178,3045910362,1665048944,1665049757,813,3265
3388144628,3499181343,1644730899,1644731195,296,1256
3300212314,3118829397,1642573854,1642574576,722,3978
3557689058,3924613420,1667857954,1667858111,157,1967
3023276837,3786674268,1655637149,1655637368,219,1772
3833658069,3938080049,1658489657,1658490527,870,812
3626923997,3139903266,1644988172,1644988415,243,4851
3400594837,3930851684,1643293892,1643294213,321,4773
3736171851,3953770544,1649962090,1649962543,453,1935
3861379476,3799125659,1651201885,1651202377,492,3585
3879953258,3447155078,1663034886,1663034895,9,2727
3868571797,3195487259,1662091198,1662091271,73,870
3384069326,3070495003,1648636532,1648637394,862,3982
3629978781,3900842118,1641210275,1641210643,368,781
3855832440,3674154080,1652466281,1652466334,53,835
3041716209,3421909235,1661972403,1661973023,620,3482
3142801985,3337895863,1647375205,1647375272,67,1049
3746960590,3822373032,1642582145,1642582525,380,1368
3539068295,3693650646,1667523882,1667524660,778,134
3482977568,3944302958,1653314907,1653315050,143,4774
3647012238,3711716070,1661438286,1661438404,118,1700
3908540269,3928215472,1644959049,1644959850,801,3051
3060153004,3707576320,1642796733,1642797589,856,4496
3610489382,3596346736,1660788934,1660789057,123,3244
3534346523,3837721559,1666945893,1666946234,341,2256
3838580793,3247640142,1648161372,1648162228,856,2432
3975451059,3561360508,1645388751,1645388891,140,1704
3384584860,3593425015,1654084899,1654085080,181,912
3716388637,3120411431,1657204110,1657204374,264,3935
3483869780,3498362708,1663672124,1663672212,88,3514
3130161163,3123606429,1667842140,1667842346,206,4909
3023194425,3312989654,1656226086,1656226966,880,549
3504728983,3115234788,1642886927,1642887732,805,1272
3293520904,3758626223,1667934794,1667935224,430,2299
3179250488,3326146012,1660251980,1660252236,256,2307
3584662008,3347764329,1641798985,1641799505,520,4898
3574108639,3852782432,1643232880,1643233736,856,2221
3618533356,3110907341,1656816658,1656817366,708,2821
3690084844,3360978790,1656364064,1656364516,452,3481
3443900880,3043621366,1642485548,1642486492,944,2838
3227099427,3787237154,1661428379,1661429202,823,1278
3502097237,3284052197,1646659047,1646659775,728,1561
3187510263,3614129213,1654729389,1654729906,517,2133
3674196486,3450707838,1659302319,1659302622,303,1291
3157021586,3944773092,1651657296,1651657494,198,1250
3886904988,3595216666,1648105869,1648106697,828,3189
3130980798,3531686574,1653370484,1653370930,446,4335
3704329391,3169893213,1652736465,1652736786,321,3503
3550557006,3482574016,1662322259,1662322263,4,4827
3639262399,3927428178,1669416929,1669417684,755,1991
3396113104,3653473746,1668706229,1668706458,229,1869
3798006008,3485089467,1668629353,1668629975,622,1631
3760172092,3896506378,1644003142,1644003795,653,1896
3756191266,3950292877,1642331268,1642331968,700,1070
3432550927,3381698921,1661294480,1661295296,816,3693
3697681224,3533063112,1648401994,1648402061,67,956
3639307310,3902256415,1645420306,1645421269,963,3922
3590466989,3089478157,1654072282,1654072394,112,3688
3175997509,3691744800,1642267083,1642267917,834,4731
3624357141,3720984848,1655176413,1655176975,562,4297
3418082365,3117698804,1648516388,1648516889,501,3803
3545494011,3245089699,1643125028,1643125520,492,3466
3915251232,3090901098,1646907521,1646908069,548,2530
3744061502,3693392189,1668281169,1668281843,674,4097
3679069101,3873669838,1652393619,1652393886,267,1148
3920025579,3243829316,1646991512,1646991756,244,3590
3517943071,3163983753,1653914795,1653915431,636,945
3572181076,3548473763,1646093847,1646094202,355,4903
3870650449,3344889124,1644407947,1644408378,431,514
3583938191,3365580675,1659025593,1659026042,449,148
3462445832,3473692260,1645170778,1645171614,836,3862
3130524474,3661813334,1662762470,1662762773,303,1809
3269573119,3424999540,1651062921,1651063200,279,2984
3282903815,3328489888,1653386745,1653386881,136,4971
3641952467,3433916790,1655091688,1655092669,981,3678
3786773887,3800862345,1644936852,1644937434,582,2835
3855007166,3088447404,1668883666,1668884048,382,3461
3059246123,3334486009,1647981582,1647982500,918,1071
3083063492,3468966815,1647811796,1647812630,834,988
3272428771,3569604140,1649233484,1649234157,673,4070
3571134427,3344935719,1648310616,1648311394,778,134
3836486405,3153444262,1662704675,1662704870,195,4410
3664798944,3314454310,1648643635,1648644555,920,200
3708494703,3209111378,1647667560,1647668546,986,942
3711622931,3172523714,1663382790,1663382800,10,1279
3705903581,3225095496,1653211721,1653211825,104,2452
3225400711,3893090036,1644479082,1644479176,94,3289
3154236347,3903474922,1651445142,1651446027,885,716
3901989885,3846585208,1658131321,1658131954,633,2771
3669552685,3504669986,1664691755,1664692523,768,3157
3023232253,3191557776,1641522171,1641522673,502,3536
3864500602,3515711502,1655185205,1655185939,734,4804
3199911152,3015447136,1650680742,1650681663,921,4957
3953959585,3346576986,1665088792,1665089231,439,4441
3685836792,3029404993,1641967381,1641967472,91,2719
3697855693,3261902741,1667997477,1667998042,565,395
3571928139,3647229123,1658630185,1658630536,351,1820
3799611476,3694611359,1668896640,1668896797,157,2461
3774091953,3479185994,1663938187,1663938753,566,3072
3625530640,3229269075,1669557609,1669557613,4,1663
3905244333,3142801985,1652130902,1652131051,149,4047
3047910516,3015585863,1666099535,1666100003,468,4227
3706877672,3164885049,1663332033,1663332879,846,2475
3408816045,3479825199,1656341631,1656342013,382,1622
3418161434,3703531702,1667238997,1667239197,200,457
3931737023,3831324961,1644533088,1644534073,985,3826
3716089321,3600569888,1653502074,1653503042,968,4681
3586448694,3014168584,1655139842,1655140347,505,1559
3839155171,3092359713,1665539152,1665539753,601,3728
3135716912,3851660113,1667877560,1667878171,611,258
3732810834,3416133889,1648325814,1648326545,731,1887
3720708323,3817716275,1659876876,1659877106,230,281
3129444224,3616891593,1655958852,1655959088,236,2411
3565133661,3384962124,1644821864,1644821871,7,661
3644328681,3655591419,1657749517,1657749903,386,4761
3056859634,3658211616,1669214987,1669215745,758,4836
3181809341,3130200528,1660609282,1660609786,504,767
3395793231,3869013126,1649404516,1649404668,152,2090
3961827451,3515401993,1645481328,1645481691,363,1980
3514323850,3389785206,1646523684,1646523972,288,3911
3579669986,3833210479,1666681873,1666681873,0,2147
3896704615,3906520033,1644085170,1644085841,671,1466
3509950092,3558273812,1647470823,1647471333,510,367
3478104181,3627141607,1661438281,1661438955,674,236
3890605394,3048264258,1657579094,1657579359,265,1585
3795004385,3898638089,1660863482,1660864439,957,614
3319260929,3638972464,1667650796,1667651127,331,4016
3136448761,3735646888,1656797417,1656797946,529,3314
3285637279,3229830054,1651860050,1651860471,421,2837
3069973725,3889266008,1652114337,1652114895,558,1012
3660350089,3699830993,1661701968,1661702548,580,846
3766785352,3442102776,1647784886,1647784956,70,3068
3079325992,3431515472,1658892693,1658892777,84,3904
3336472642,3750508555,1657670147,1657670159,12,2059
3509548697,3624320834,1643190059,1643190308,249,1648
3717030900,3003890463,1669491281,1669492157,876,2207
3482879683,3806502782,1657967406,1657967542,136,752
3167826629,3698516086,1651312655,1651313563,908,3644
3958235055,3696970806,1660134779,1660135456,677,4373
3174741492,3613381963,1644147028,1644147951,923,477
3404034796,3198095870,1648540186,1648540549,363,4462
3480389608,3283063461,1664769361,1664769988,627,147
3112187496,3316348553,1646126676,1646127453,777,4969
3846683664,3299986981,1642878907,1642879123,216,1046
3940244190,3326860147,1661421728,1661422095,367,3671
3232972981,3565709240,1664469669,1664469765,96,1673
3294011321,3560976164,1645848110,1645848826,716,2917
3727385792,3916253942,1654166533,1654167198,665,3204
3445897031,3635215296,1660932567,1660933052,485,999
3734453484,3730849380,1649960354,1649960978,624,287
3278192179,3979558796,1668152678,1668152889,211,1605
3274996844,3319399711,1658679662,1658679846,184,983
3189948488,3153459747,1651501216,1651501983,767,1507
3437915655,3974792342,1664643929,1664644252,323,3608
3822571261,3656812218,1658241046,1658241849,803,43
3289789143,3394395416,1641264803,1641265362,559,4551
3577003803,3094412335,1656768622,1656768934,312,4847
3471108590,3812249636,1660543200,1660544105,905,2360
3975653147,3683918839,1656267358,1656267785,427,2774
3022029044,3157223314,1659681623,1659682267,644,962
3149462747,3446900783,1665328855,1665329165,310,4947
3302673366,3124215595,1663353023,1663353817,794,958
3532551212,3778466051,1655725283,1655726020,737,4913
3324641868,3836698550,1655188787,1655189205,418,354
3322027195,3239524836,1658250235,1658250479,244,3397
3058956055,3834669719,1648222327,1648223028,701,888
3157887294,3761523169,1669043721,1669043926,205,2254
3171226714,3542413106,1652302229,1652303131,902,3030
3230966393,3891961132,1666491058,1666491278,220,2022
3627252882,3706398656,1660881090,1660881393,303,3130
3334720658,3518389765,1668830421,1668831348,927,1075
3008704930,3688327636,1649010804,1649011167,363,2456
3462010138,3031364513,1663729530,1663730333,803,4271
3343650638,3328876116,1647171631,1647171869,238,701
3099149383,3223514692,1641763994,1641764234,240,3053
3598742066,3031527562,1651197284,1651197433,149,408
3938089861,3870543808,1649838953,1649839766,813,0
3839391728,3412019552,1646813998,1646814590,592,4392
3813161900,3105571423,1663641820,1663641896,76,1246
3266333164,3882755658,1656345441,1656345466,25,2797
3847033675,3650703496,1667074731,1667075331,600,4268
3288137310,3528413204,1660793088,1660793312,224,1272
3761323343,3730031376,1648601938,1648602722,784,4552
3304879925,3481318757,1649335057,1649335945,888,684
3873160681,3917268898,1648357700,1648358216,516,524
3177367374,3611202860,1650416921,1650417126,205,2790
3212004972,3568847984,1661227741,1661228332,591,3833
3751873715,3412148226,1667304280,1667304984,704,2504
3605058518,3566910777,1666121747,1666122740,993,4767
3795049435,3317881980,1661498515,1661499355,840,4652
3149728144,3727055848,1666600031,1666600794,763,1340
3551766528,3282159881,1651858164,1651858560,396,4411
3449298439,3135120617,1660514677,1660515626,949,1334
3460353546,3833554297,1645872788,1645872864,76,2014
3482421144,3407592947,1645648972,1645649494,522,2391
3822166752,3098043758,1642161747,1642162438,691,4173
3527957989,3208483015,1658148896,1658149409,513,2981
3101647691,3889008248,1646373501,1646374023,522,3634
3614915772,3942269345,1657011454,1657011646,192,4569
3718015386,3743723179,1646348604,1646349239,635,3206
3965946718,3026848668,1663262756,1663262995,239,3139
3921637693,3448418475,1655120161,1655120466,305,495
3407830193,3689184536,1645497865,1645498212,347,608
3601810802,3228847741,1645026234,1645026492,258,3751
3813763182,3702065366,1666433434,1666433550,116,2201
3018915015,3397580800,1645021695,1645021949,254,4969
3923530161,3921637693,1669373102,1669374090,988,1307
3909451623,3969214846,1648332971,1648333425,454,4004
3993625512,3839998185,1649385840,1649386504,664,1572
3822515848,3445638669,1659211347,1659212232,885,3660
3109266344,3163215914,1665144774,1665145616,842,324
3746257928,3289891768,1667768726,1667769114,388,4444
3670879665,3666669071,1655525851,1655526274,423,3768
3937700551,3983486918,1667428750,1667429719,969,669
3415529402,3183699805,1665396574,1665397120,546,4229
3189718123,3022823031,1643286959,1643286983,24,3740
3116757252,3118246741,1651085038,1651085992,954,1943
3770944132,3407841307,1663783363,1663783976,613,1005
3436477455,3228474490,1657999853,1658000464,611,3164
3699187266,3574175616,1645214819,1645214933,114,1807
3141366032,3103873495,1665112783,1665112930,147,543
3153560722,3564337174,1664375367,1664375482,115,272
3365566642,3862311405,1663987043,1663987540,497,985
3839302715,3068603771,1654591299,1654591994,695,904
3935027940,3956064752,1669495774,1669496097,323,620
3763855343,3205185852,1654912476,1654913034,558,2734
3146740347,3264540716,1655007808,1655008067,259,150
3653913882,3529921898,1641395321,1641396056,735,1458
3553340486,3074622432,1667158877,1667159607,730,2747
3118131246,3699878376,1650467183,1650467982,799,1228
3975903719,3866363396,1669110537,1669110857,320,1681
3163662638,3404805881,1661113831,1661114731,900,360
3676757290,3987311166,1653071415,1653071714,299,854
3381985243,3143389883,1646652713,1646652867,154,292
3806084332,3664334848,1645641364,1645642063,699,2014
3797844716,3051093820,1650372289,1650372307,18,2045
3102568581,3746769040,1649977258,1649977572,314,1481
3137720739,3908046355,1666344616,1666345007,391,653
3837318366,3349308679,1653591088,1653591319,231,2372
3225718901,3893867022,1654472220,1654472774,554,3670
3681011736,3237352996,1665591903,1665592859,956,255
3264207298,3365807062,1644474721,1644475408,687,3326
3554407842,3802854604,1656059468,1656060128,660,2862
3822021880,3886936379,1652018898,1652019147,249,393
3983075110,3207536126,1659603599,1659603780,181,2779
3047425409,3628056845,1645977474,1645978297,823,266
3134331205,3808320540,1664834204,1664834204,0,4934
3152986971,3636854884,1657469685,1657470337,652,275
3751924390,3832345817,1655815576,1655815974,398,3203
3190019122,3343972968,1652019565,1652019622,57,4072
3970012953,3256374119,1652370983,1652371673,690,1916
3781373662,3261906642,1667680359,1667680961,602,823
3099864412,3347527476,1651133634,1651134138,504,2513
3362559936,3871388949,1662847485,1662848238,753,113
3851537696,3156438198,1647100613,1647101366,753,4880
3199752534,3385485907,1640991881,1640991976,95,977
3560535530,3721364024,1641849754,1641849927,173,2360
3032069736,3051236292,1648345217,1648345314,97,1890
3191045705,3266473613,1653826333,1653826688,355,2830
3637633983,3678461220,1660442035,1660442649,614,4019
3211047343,3762380199,1644089406,1644089903,497,89
3350939153,3726495944,1652206355,1652206746,391,2804
3116064464,3304787972,1659532351,1659532678,327,856
3221235749,3528568896,1650337105,1650337397,292,191
3981283497,3419573489,1644130951,1644131169,218,3171
3250340562,3087169282,1645614457,1645615019,562,2046
3962738250,3804553581,1664621229,1664621554,325,4481
3427921187,3566591572,1662078172,1662079050,878,195
3173753718,3949183228,1646630720,1646631110,390,492
3745325076,3782475724,1663782342,1663782940,598,2917
3495950891,3993790765,1665340326,1665340364,38,1298
3692147274,3526519585,1662054697,1662054705,8,228
3106584371,3713244071,1647114194,1647115083,889,521
3625394714,3933713312,1659927067,1659927717,650,2695
3410853625,3513975463,1646443547,1646444083,536,1304
3097637288,3032029231,1669537778,1669538266,488,2934
3440609080,3443037446,1641934905,1641935109,204,3273
3967434355,3028644534,1646200954,1646200982,28,1390
3731777660,3624983327,1645736198,1645736777,579,363
3746453024,3409632414,1659427147,1659427325,178,3442
3643284229,3093183238,1653534574,1653535514,940,3723
3898193074,3796505288,1645010165,1645010229,64,556
3941449480,3914927153,1650671953,1650672160,207,3289
3779747469,3547034601,1651268459,1651268763,304,2898
3275031277,3664541721,1659069688,1659070579,891,944
3586106951,3374384192,1666030681,1666031175,494,3707
3513975463,3094028231,1650388165,1650389122,957,1284
3340674574,3005981941,1656408975,1656409024,49,4054
3436694076,3736310893,1666802279,1666802288,9,3087
3252190618,3682220928,1641217686,1641218511,825,2502
3188071926,3580648048,1643490532,1643491080,548,4346
3553804579,3836802375,1666674119,1666674795,676,1061
3627464495,3124166661,1644545442,1644545753,311,2314
3562275388,3193802162,1656162205,1656162750,545,2506
3694900357,3101656511,1654214684,1654215259,575,2721
3143222118,3692367180,1669556487,1669556785,298,2264
3468232456,3168498277,1643949250,1643949986,736,1144
3080528389,3760317597,1648866285,1648866896,611,4258
3905348940,3185787322,1655403359,1655403986,627,4297
3328039365,3119062423,1643315516,1643316090,574,3399
3667466452,3309728302,1658386804,1658387117,313,3124
3165858773,3097017801,1668590343,1668591329,986,3752
3978827181,3135428814,1658566441,1658566805,364,3821
3297595089,3476593651,1645870446,1645870950,504,2638
3898342164,3372950173,1661623428,1661623520,92,4165
3212091098,3134270325,1667618273,1667618643,370,2069
3832883366,3139472712,1641989270,1641989687,417,4382
3997783250,3051486352,1662057056,1662057805,749,1278
3594837053,3529239882,1664236178,1664236544,366,1616
3611214733,3291685773,1651062384,1651063255,871,2307
3708971753,3429408792,1662385289,1662386205,916,3864
3706544671,3962876806,1649501245,1649501771,526,1094
3266860296,3474675695,1642154464,1642154618,154,1215
3129172634,3265841935,1641840401,1641840627,226,246
3423119743,3292971253,1669352572,1669353253,681,1645
3731257784,3389191389,1665567572,1665567748,176,1589
3238514396,3566791204,1647347151,1647347906,755,2628
3455285530,3718410857,1643730754,1643731426,672,446
3948218140,3773989521,1646333977,1646334201,224,2740
3896318560,3160605672,1667591610,1667591641,31,1087
3879329985,3858696762,1660062267,1660062273,6,2825
3270091447,3067229848,1664499343,1664500291,948,1645
3275682421,3069066775,1658825261,1658825498,237,1115
3627141607,3576577064,1658527216,1658527983,767,3443
3608198695,3741904424,1659470143,1659470890,747,2832
3864771571,3612711613,1660765968,1660766829,861,2251
3214061490,3865893489,1646022830,1646023246,416,3634
3600754629,3501523812,1652236223,1652236558,335,1786
3194142506,3982033837,1665403419,1665404051,632,2159
3546215855,3377982483,1649082882,1649083328,446,3002
3267863999,3168175552,1643542173,1643542795,622,3418
3965621019,3057682738,1644661044,1644661197,153,2050
3074684598,3467856594,1669134561,1669134713,152,4116
3353236839,3071117722,1665413298,1665413788,490,4983
3642689879,3468878538,1655086331,1655087119,788,4415
3918597504,3281039884,1656387230,1656387582,352,4178
3471255750,3763624719,1646508383,1646508492,109,1674
3410516534,3487185520,1654509953,1654510497,544,2929
3455617892,3441092120,1648702358,1648702726,368,1887
3863120751,3612484253,1649261099,1649262097,998,3644
3487321846,3815931783,1661230595,1661231023,428,455
3167754003,3204658850,1656887703,1656888059,356,1684
3026991972,3808517932,1647462378,1647462504,126,494
3721842197,3985879350,1659830896,1659831404,508,1084
3808473482,3382531654,1658061446,1658061552,106,3073
3232771105,3666946352,1647289592,1647289668,76,4882
3313325482,3679146462,1658795720,1658796538,818,4780
3994003531,3670209843,1656751106,1656751866,760,1991
3752338737,3707667312,1658464331,1658465184,853,4469
3316079141,3755896048,1650187736,1650188411,675,1897
3427926634,3582363448,1650876721,1650876901,180,493
3568819340,3369145905,1658047596,1658047696,100,1195
3057567646,3239749749,1652154831,1652155049,218,4937
3649359242,3098882851,1660528419,1660528566,147,2211
3562494566,3707232201,1644809282,1644809919,637,630
3796817314,3000425895,1662730008,1662730303,295,2513
3035316092,3156952345,1660500454,1660500949,495,1079
3001987632,3473994401,1657491466,1657491648,182,578
3330333989,3717856400,1648261389,1648261795,406,1459
3208986811,3377112879,1648862559,1648862944,385,302
3235056522,3448378328,1668423737,1668424266,529,1364
3383005086,3672305192,1649596996,1649597041,45,315
3333062015,3046664521,1658523686,1658523853,167,1997
3651867591,3072991251,1663422999,1663423879,880,569
3645981321,3272188790,1646832872,1646833431,559,2577
3409764438,3528864048,1667835931,1667836148,217,3747
3037384044,3484055104,1665311930,1665312079,149,2993
3990492500,3483115957,1653699063,1653699540,477,3536
3155396907,3399919882,1662453034,1662453616,582,4191
3210551955,3432833702,1663743078,1663743889,811,4046
3176499595,3612955530,1648512263,1648512609,346,1688
3947514744,3920815124,1648630969,1648631508,539,1709
3772022021,3065493804,1664913792,1664913926,134,4951
3484333138,3552343946,1659000933,1659001578,645,2974
3023707326,3990591119,1654175854,1654176386,532,3648
3971440847,3868982571,1659429510,1659429980,470,4567
3894018225,3902246748,1641029411,1641030224,813,4408
3182601307,3167332592,1666345400,1666346129,729,1122
3930720670,3605976096,1655519805,1655520602,797,1290
3811317423,3544015951,1648338693,1648339187,494,2583
3448086796,3954651250,1667011582,1667011973,391,1928
3451403745,3520681576,1667881126,1667881837,711,2994
3844819556,3511054968,1648389711,1648389793,82,3293
3825705338,3398350656,1668001635,1668002375,740,2544
3865109372,3339535072,1653208811,1653209168,357,2687
3463001174,3525292109,1667857760,1667858460,700,1317
3786397059,3818408906,1650987109,1650987742,633,216
3027644891,3635278358,1646313353,1646313582,229,2970
3042826459,3932215923,1643691399,1643691408,9,4858
3679994810,3004382630,1642040309,1642041189,880,25
3169856520,3689142112,1657147168,1657147838,670,115
3785809120,3119769143,1657961624,1657962099,475,1287
3739615363,3227632573,1669458764,1669459686,922,3232
3104700409,3416927692,1661250700,1661251529,829,386
3851748560,3491005637,1643229788,1643230075,287,4773
3189908654,3235868528,1642504551,1642504699,148,102
3281399606,3379944165,1643528977,1643529880,903,3193
3136115850,3800523755,1644752776,1644753637,861,3319
3893645170,3945519398,1648166940,1648167213,273,21
3369734348,3218772944,1644497537,1644498286,749,4985
3023801336,3736775137,1652264520,1652264764,244,17
3207618376,3002864853,1653825988,1653826723,735,3203
3336375881,3958592047,1662961451,1662961878,427,256
3455174288,3815189955,1659498104,1659498263,159,720
3245221857,3092158561,1658926121,1658926788,667,4751
3246408680,3290280069,1653264648,1653265424,776,2795
3705903581,3893072624,1651029139,1651030037,898,3187
3498397597,3709799297,1651151968,1651152645,677,1972
3938809537,3921660768,1660379578,1660380048,470,591
3956078038,3636534190,1644466071,1644466085,14,131
3792893359,3325255768,1655528994,1655529705,711,688
3311412976,3009340237,1658856995,1658857803,808,1430
3211969986,3863488769,1643685669,1643686178,509,1265
3068854848,3160098434,1662874367,1662875059,692,2525
3454267372,3971852045,1662586970,1662587639,669,4806
3566561615,3430399509,1653758248,1653758288,40,1042
3772131165,3129661109,1643536809,1643537202,393,3790
3008062094,3381380929,1658183502,1658184085,583,4428
3168474890,3578978337,1648579669,1648580576,907,2620
3880295231,3527324031,1644376168,1644377163,995,1606
3772482190,3233250021,1659940805,1659941497,692,4445
3079935239,3585601266,1641646208,1641646747,539,1626
3159251471,3699419634,1669247670,1669248288,618,1454
3494020930,3046801852,1654989643,1654990391,748,508
3222550058,3942379966,1645957353,1645957620,267,4457
3662123609,3937134873,1667794157,1667794744,587,3251
3891130992,3850454852,1665731351,1665732116,765,3730
3423352344,3930770958,1664815902,1664816008,106,3634
3077747785,3542428544,1666879406,1666879827,421,519
3142784035,3400893470,1641382409,1641382973,564,3990
3737610969,3399957327,1661709355,1661709494,139,2434
3817390159,3895867203,1662103417,1662103897,480,2532
3526053594,3769280849,1663747602,1663748005,403,2992
3541393712,3485427979,1660462111,1660462886,775,2890
3845090243,3492288416,1657720320,1657720328,8,2543
3915440146,3848567584,1642147668,1642148205,537,3165
3313035858,3204331713,1668723068,1668723073,5,4436
3200251169,3506468500,1646711298,1646712236,938,2601
3165205364,3857638555,1663838288,1663839101,813,4185
3123585176,3902047645,1659240337,1659240848,511,475
3633882171,3971533799,1662624737,1662624961,224,1404
3034490097,3794667280,1648865330,1648865933,603,4918
3582803523,3601759176,1648436450,1648436947,497,2636
3067317220,3500958518,1668281271,1668281616,345,3365
3644966539,3593048207,1655139784,1655140541,757,164
3556328029,3159035074,1650241030,1650241233,203,4870
3802616658,3365956073,1657901577,1657901801,224,447
3014945488,3296843607,1657437818,1657438201,383,2102
3376071114,3278129796,1647660922,1647661360,438,1206
3759688638,3915141290,1654981614,1654982560,946,1335
3066827006,3291218910,1642341594,1642341997,403,557
3933015216,3629138419,1663973020,1663973809,789,1011
3894582826,3068325143,1654849761,1654850578,817,572
3921977884,3683946894,1656196303,1656196842,539,4268
3970145638,3029740278,1656931930,1656932255,325,158
3703011556,3249842457,1657977018,1657977690,672,123
3960279711,3785506042,1660413854,1660414323,469,4070
3279290990,3391902465,1642044356,1642045289,933,352
3982416724,3978158488,1645508577,1645509041,464,3342
3070921381,3405567844,1655546791,1655547034,243,1608
3744413061,3489791911,1645830584,1645831158,574,794
3916268196,3965418759,1657915213,1657915846,633,4897
3797838993,3068035036,1663050821,1663051725,904,1669
3392840370,3558885136,1666469341,1666469843,502,2555
3106920085,3557540641,1646155363,1646155796,433,3119
3587458772,3223762277,1661235185,1661235882,697,3476
3189554911,3745998228,1665326269,1665326990,721,3592
3820279045,3230220407,1660925471,1660925619,148,4534
3933412892,3644542908,1643823626,1643824296,670,4707
3532775220,3437166707,1662526957,1662527030,73,2376
3413123197,3529542689,1656506051,1656506588,537,1705
3669197763,3262240086,1658600263,1658600990,727,4070
3753332288,3653974751,1653543697,1653543815,118,335
3854454730,3359953655,1661094342,1661095120,778,4244
3937273361,3746187730,1659288724,1659289684,960,1263
3845407473,3260428974,1663401318,1663401581,263,3110
3525517313,3042808995,1652970008,1652970306,298,619
3454858265,3805248541,1664431689,1664432166,477,2617
3830970131,3201363044,1642505091,1642505194,103,3167
3281032419,3693935663,1662083778,1662084100,322,1208
3363177440,3982330066,1662989625,1662990474,849,431
3067932408,3426570121,1665994365,1665995136,771,3926
3640701420,3960674512,1643085162,1643086001,839,2883
3005268198,3566746281,1654350242,1654351153,911,4154
3390508518,3616690182,1644874889,1644875738,849,1343
3428485824,3963430537,1650836818,1650836954,136,4268
3770589124,3109099245,1654382732,1654383357,625,244
3446114272,3559005669,1648187065,1648187504,439,731
3769115324,3840391763,1662808097,1662808596,499,3280
3970498740,3281504996,1646604097,1646604716,619,3804
3982332184,3229964213,1664171137,1664172042,905,1091
3931283711,3529842281,1651982713,1651983453,740,3417
3258016838,3537555209,1667135105,1667136022,917,1367
3090504605,3776528902,1643434187,1643434300,113,3993
3049802828,3085087209,1650628203,1650628377,174,1575
3416644906,3214703004,1653068726,1653069064,338,4676
3922611646,3720314748,1649652737,1649652959,222,4211
3768831305,3136123883,1653683046,1653683755,709,916
3563572372,3132538993,1665585335,1665585563,228,817
3959680354,3525531803,1662014345,1662014623,278,2770
3170714864,3563956371,1660962900,1660963790,890,3529
3262375194,3806881202,1642838556,1642839553,997,2803
3006503652,3833908625,1658163792,1658163971,179,357
3324143065,3492801267,1646697542,1646698229,687,4670
3303834645,3933176634,1649426203,1649426377,174,1448
3799529255,3638050489,1660317511,1660317602,91,2474
3215004118,3393130148,1652897794,1652898330,536,1057
3892166450,3039463745,1662541051,1662541844,793,2738
3961358777,3643021608,1666330783,1666331727,944,2477
3405484211,3194938746,1657748324,1657749204,880,614
3866057487,3787211069,1665449765,1665450544,779,2010
3538884093,3784532435,1643831466,1643831489,23,2832
3865746137,3003604347,1653607320,1653607833,513,3393
3900402965,3248942783,1645244602,1645244683,81,4280
3601075626,3647918889,1665756556,1665757275,719,1337
3559129661,3350688125,1658103047,1658103052,5,1592
3373312164,3608232625,1643715492,1643716092,600,4744
3274621035,3143451935,1644105086,1644105978,892,3396
3831717475,3829082450,1661144408,1661144887,479,1249
3600700088,3087924540,1656426837,1656427752,915,4110
3713613865,3410901077,1647829292,1647829700,408,1963
3892548143,3983818040,1653861131,1653861935,804,4916
3230306961,3385174440,1667826327,1667826808,481,3543
3224865994,3739786648,1668144010,1668144341,331,853
3537764854,3385191092,1664491803,1664492575,772,1801
3592388903,3174907226,1642583919,1642584720,801,4535
3459240037,3936178206,1645789858,1645790805,947,451
3667615856,3796825326,1651889340,1651889394,54,4689
3486886359,3109252996,1651240693,1651240912,219,3116
3899662791,3946444946,1664260718,1664261000,282,3822
3093015116,3434333444,1663479463,1663479632,169,2627
3483083173,3981770478,1669415313,1669415875,562,2006
3099759300,3748627809,1665359360,1665359489,129,4178
3180466434,3199675895,1649617142,1649617532,390,3772
3512004863,3587306879,1642020104,1642020143,39,2049
3339029426,3058385244,1653487207,1653487770,563,1198
3706518804,3428530663,1647555620,1647556125,505,2101
3170050127,3674518206,1644295957,1644296356,399,4211
3426639545,3304503621,1662899862,1662900244,382,1656
3385343899,3421254013,1648815319,1648816220,901,4338
3760438521,3896941707,1652367768,1652368076,308,3849
3524142498,3953470774,1662020873,1662020996,123,589
3614306864,3816915806,1663922136,1663923106,970,340
3349691680,3945755061,1652224472,1652224578,106,2644
3523730272,3820250666,1666158649,1666159155,506,4408
3374563014,3451181628,1660293985,1660294500,515,2671
3060774682,3719040657,1661689857,1661690297,440,4214
3945589191,3928254518,1668872026,1668872662,636,3097
3289155448,3062192646,1645023444,1645023962,518,4057
3574558353,3299809367,1656918946,1656919182,236,2684
3839883538,3145423898,1648929244,1648929852,608,880
3158732733,3439103699,1662944004,1662944991,987,1676
3373043424,3449152431,1641200174,1641200811,637,952
3538974126,3995034428,1652216129,1652216568,439,428
3626021353,3514763577,1647598856,1647599293,437,4578
3688863729,3774555685,1659601231,1659601551,320,2884
3870603036,3312656909,1651398775,1651398907,132,341
3250894173,3505864912,1641666528,1641667338,810,2474
3095374220,3161980125,1667425057,1667425610,553,486
3673197755,3061946310,1667479271,1667480009,738,4519
3606062501,3261903615,1659266543,1659266889,346,1561
3111924311,3125167318,1645175985,1645176834,849,609
3460073623,3178356570,1650720600,1650721119,519,811
3372756577,3116804627,1660831915,1660832427,512,1295
3782482191,3718167512,1651803639,1651804010,371,4962
3193654816,3111240688,1655129012,1655129695,683,4982
3550381908,3177504496,1641668951,1641669240,289,3636
3254801439,3594222049,1668770785,1668771473,688,667
3121583649,3961338989,1661631910,1661632327,417,1217
3892707636,3636477922,1648284828,1648285760,932,597
3302805222,3681727565,1661776980,1661777121,141,2463
3753861410,3549401649,1666081520,1666082309,789,2909
3247725148,3030585836,1663780859,1663781788,929,2381
3451181628,3586689596,1665744835,1665745274,439,1176
3523137268,3539769416,1666603815,1666603982,167,4752
3650700879,3736372110,1656140189,1656140667,478,4482
3871278184,3795492389,1665667795,1665668243,448,112
3742613189,3248446740,1660342984,1660343543,559,473
3736099123,3451863122,1659923298,1659924116,818,3918
3770805601,3933791470,1649205264,1649205701,437,3667
3209974934,3795714254,1641631233,1641632222,989,4792
3606238002,3279647927,1643455960,1643456166,206,3830
3423813985,3549824090,1651871412,1651871660,248,3196
3789931978,3527028728,1650757934,1650758692,758,1399
3717193206,3743802761,1657654480,1657655422,942,1508
3607221629,3827062487,1665591674,1665592332,658,4827
3277740892,3631356045,1663139262,1663140116,854,2089
3320160905,3934782115,1648001264,1648001573,309,3607
3104743177,3131674308,1649385024,1649385135,111,4870
3115032059,3435553876,1659539334,1659540030,696,3371
3296163263,3325948875,1667248951,1667249768,817,4403
3259891484,3916799273,1646857620,1646857718,98,4748
3056427193,3854277505,1650794961,1650795511,550,2744
3549952509,3687964094,1647872553,1647873279,726,480
3371947160,3092906614,1665782604,1665783343,739,1649
3113407685,3790783791,1656610371,1656611011,640,4754
3791969064,3902159288,1665314124,1665314851,727,3308
3578131910,3476525331,1642209141,1642209557,416,600
3554419239,3309769648,1662578765,1662579426,661,4597
3284446573,3518701580,1659602678,1659602699,21,3323
3786696790,3402976616,1658734528,1658734892,364,2370
3424437298,3106791579,1653617970,1653618204,234,2348
3634189540,3508315114,1649858176,1649858999,823,4954
3658868883,3768294532,1668343319,1668343714,395,2169
3692342678,3697681224,1663413122,1663413854,732,2418
3414282410,3750583458,1651679105,1651679352,247,2327
3366217860,3004377361,1651451639,1651451902,263,4725
3560156156,3573485934,1656758554,1656759175,621,1638
3680336383,3791569279,1653789932,1653790194,262,4075
3839883538,3145433867,1658803783,1658804295,512,105
3210529203,3489798022,1652126965,1652127492,527,4348
3706103175,3774227570,1659774704,1659774704,0,351
3403229709,3556770688,1663004859,1663005393,534,4367
3106905495,3824682364,1648917984,1648918832,848,4273
3763473643,3202481479,1643013533,1643013729,196,2707
3615935023,3272631953,1660667652,1660667684,32,4826
3750106820,3797597100,1666219226,1666219300,74,2527
3486677299,3958098725,1655943207,1655943680,473,2012
3496508921,3998954294,1659793288,1659794211,923,1016
3239677564,3988840653,1647161325,1647162320,995,3142
3693232348,3547754244,1666208436,1666208759,323,385
3421861409,3014960150,1652320200,1652320593,393,2789
3146275192,3367204606,1651639164,1651640137,973,2620
3808373084,3294645674,1643790706,1643791470,764,3824
3825528642,3904933887,1667006981,1667007529,548,4997
3916119057,3571853591,1659444380,1659445087,707,1775
3316260418,3463473127,1668245065,1668245488,423,779
3759426276,3895457884,1667559616,1667560439,823,868
3249808945,3592944772,1641659450,1641660121,671,622
3368312860,3168607678,1666876743,1666876752,9,1074
3440870610,3976253460,1652567826,1652568366,540,4478
3068429822,3207951630,1669294764,1669295531,767,3683
3420152740,3324099846,1641986084,1641986173,89,4454
3410581452,3997571848,1660075876,1660076650,774,91
3995867192,3105376051,1661609127,1661610109,982,445
3604774553,3202480747,1649247812,1649248024,212,231
3209983393,3456065266,1661997260,1661997870,610,3419
3209395646,3148928478,1667505811,1667505836,25,1526
3902323763,3100901016,1656173216,1656173684,468,2953
3393547362,3476535788,1666135293,1666136064,771,4114
3890171937,3945889858,1643106332,1643107235,903,2496
3453894722,3237728143,1642389493,1642389907,414,4545
3423018118,3363851714,1656088292,1656089083,791,1914
3315576660,3955117415,1648441766,1648442257,491,444
3529830775,3471179178,1643275985,1643276411,426,2632
3826713742,3064935538,1656785586,1656786471,885,4681
3683657597,3209394165,1654529501,1654530178,677,4697
3161495384,3338830335,1641027932,1641028156,224,4775
3317377031,3949914960,1663034345,1663035329,984,195
3099831006,3639503456,1653569324,1653570129,805,675
3612790331,3981597068,1655032149,1655032188,39,2211
3264057783,3383029361,1641373503,1641373559,56,2153
3285413449,3167863114,1669246238,1669246328,90,3819
3384368615,3564501324,1651812207,1651812546,339,3499
3395431124,3458040811,1648313548,1648314460,912,831
3351174359,3061126636,1659050884,1659051316,432,42
3331160517,3054664158,1642902375,1642903174,799,1886
3031320674,3624951507,1664014967,1664015192,225,1351
3458607569,3308980747,1649141590,1649142554,964,3066
3713569202,3983497192,1647617148,1647618011,863,1617
3008341069,3942684335,1654766161,1654766225,64,4552
3284434615,3174223123,1647625766,1647626232,466,4302
3342897803,3268655753,1663451714,1663451826,112,2787
3370760537,3008878002,1664544891,1664545003,112,2655
3594878691,3534732001,1653196814,1653197461,647,2526
3221163865,3064713794,1664298266,1664299176,910,4266
3838418377,3358803552,1666027596,1666028065,469,316
3182903879,3938289684,1661715280,1661715693,413,4445
3890862552,3701036360,1650840271,1650840707,436,2456
3717100254,3337378232,1645725640,1645725796,156,2252
3881875397,3066689174,1644301773,1644302680,907,1628
3378004719,3033136152,1648292870,1648293693,823,4799
3305925735,3574416455,1655694796,1655695328,532,2293
3289155448,3558720290,1645894597,1645894655,58,2451
3552734555,3012015863,1660854478,1660855281,803,2895
3741008592,3624814056,1644062680,1644063308,628,3542
3132844383,3516638136,1646538338,1646538420,82,1154
3578480850,3085668488,1659558905,1659558914,9,3148
3259907283,3425459242,1658477097,1658477132,35,4749
3710495816,3850694871,1658239946,1658240545,599,1908
3248556841,3714699511,1645613890,1645614546,656,2233
3463473127,3169546804,1641474308,1641474943,635,3973
3823693447,3666813763,1643869592,1643869642,50,2434
3934311113,3675919830,1666962284,1666963019,735,3470
3601307197,3583113369,1663424246,1663425024,778,4792
3984146531,3407840216,1652746876,1652747238,362,667
3307307160,3859175330,1658858257,1658859092,835,3536
3194182925,3342805644,1651886343,1651887272,929,194
3922632168,3942160328,1641935133,1641935360,227,1370
3419190420,3677019177,1645013636,1645014336,700,1686
3580620827,3327623701,1664224201,1664224446,245,2472
3703039279,3296348139,1653023155,1653023995,840,919
3912112978,3346199197,1656185332,1656185985,653,589
3383995742,3907809901,1649622169,1649622391,222,2670
3665313523,3028972507,1666085786,1666086759,973,4042
3070202988,3058118826,1646104135,1646104715,580,4756
3805502980,3308933191,1648119645,1648119705,60,4359
3716690143,3039865830,1656427332,1656427482,150,1664
3705212131,3252395026,1661811459,1661811631,172,4706
3361430003,3221803598,1655257328,1655257977,649,2465
3078756663,3438107360,1642547553,1642547556,3,1554
3864081232,3436117552,1643120796,1643121134,338,239
3157887294,3735483414,1645259859,1645260507,648,3576
3574558353,3325283052,1657941824,1657942548,724,894
3220104340,3012872198,1650566654,1650566966,312,4410
3309377422,3657673765,1645996817,1645997133,316,3014
3823960157,3520746292,1661786781,1661787557,776,1506
3068086259,3298373578,1660871650,1660872090,440,3763
3834797844,3428826615,1668337421,1668337585,164,3538
3223135553,3313950701,1668203337,1668203673,336,3991
3926608819,3846614520,1662124480,1662125144,664,4027
3218591816,3429899673,1642254115,1642254370,255,1568
3882880549,3812785827,1651097585,1651097594,9,3488
3630074429,3203402124,1661792149,1661792423,274,2318
3711261517,3091303115,1654219388,1654219898,510,3914
3739639590,3379768231,1664873589,1664873771,182,527
3963541462,3022057351,1652072025,1652072867,842,213
3419091705,3986666611,1666306934,1666307457,523,4243
3573838856,3849232344,1668695816,1668696474,658,564
3693830202,3179993730,1661623678,1661624236,558,1756
3328948660,3059799236,1664813508,1664814436,928,1840
3921664762,3528861904,1653868761,1653868873,112,3160
3590738588,3734950557,1646950009,1646950073,64,4912
3398445572,3733651114,1656826528,1656827387,859,2293
3946951803,3599964098,1647994887,1647994941,54,2530
3862328080,3749718635,1642604361,1642604804,443,4544
3881359866,3339692279,1658961997,1658962926,929,3147
3920482976,3125522095,1650279060,1650279437,377,4391
3147451027,3275572865,1643206074,1643206663,589,2710
3339002281,3548162099,1651322076,1651322844,768,2482
3789521884,3631304178,1642786291,1642787104,813,2282
3403230100,3778476664,1662927041,1662927895,854,1332
3044917899,3257848054,1641509876,1641510357,481,3742
3932104393,3416431664,1645703531,1645703832,301,1851
3067278655,3425350335,1660377572,1660378318,746,2093
3027484168,3703341076,1661922822,1661922882,60,502
3526108397,3622060963,1647893103,1647893509,406,3300
3922156314,3261139957,1648195142,1648195423,281,3747
3067068691,3404108631,1647242576,1647242631,55,2962
3562622374,3596605318,1661080806,1661080901,95,3261
3159637510,3769123934,1658331308,1658332095,787,1914
3136587619,3359253224,1651620147,1651620494,347,4946
3930015232,3458489015,1658889872,1658890650,778,2191
3374204487,3647952306,1645786033,1645786338,305,4830
3069238623,3871901507,1654966827,1654967420,593,2104
3095217093,3257277310,1641321690,1641322411,721,2814
3066364120,3052426858,1656452958,1656453168,210,1371
3576698850,3378829448,1669467998,1669468892,894,589
3644400618,3209956253,1641043291,1641043318,27,985
3245740478,3913855716,1653992249,1653992316,67,313
3001264662,3184965837,1664138874,1664139650,776,4753
3156454180,3606868074,1646642325,1646643073,748,3088
3555818445,3591246342,1649131885,1649132079,194,445
3022966346,3250770482,1662512189,1662512849,660,429
3565649015,3405080876,1654595563,1654595825,262,2911
3574904070,3537565469,1659408545,1659409234,689,4425
3216149525,3060058277,1648064391,1648064417,26,4746
3352177845,3678539314,1665370350,1665370503,153,2068
3979877510,3024222100,1656411219,1656411572,353,2988
3545930278,3640268473,1648440123,1648441053,930,2220
3569667203,3119462567,1664190117,1664191010,893,1611
3590342169,3307184444,1651491704,1651492686,982,2609
3757163547,3496157930,1663488091,1663488747,656,4174
3910602881,3236663747,1659732119,1659732369,250,1158
3065193675,3905339971,1662587871,1662588676,805,1780
3594642945,3624983327,1655997399,1655997850,451,1868
3463312452,3889008248,1642006379,1642007192,813,2177
3793342029,3279211619,1654664988,1654664988,0,4942
3894702082,3277156943,1645793554,1645794195,641,3589
3742180938,3014119309,1642237025,1642237479,454,2386
3048530428,3555213398,1662781343,1662781352,9,1741
3687672991,3884227721,1666280092,1666280977,885,4807
3204188543,3913489416,1652494478,1652495160,682,456
3995566619,3218961303,1664801527,1664802213,686,4531
3198050541,3184900883,1654071173,1654071334,161,2549
3725047244,3302968730,1648978271,1648978493,222,854
3555112942,3980130945,1648908599,1648909075,476,3276
3300192709,3273509241,1646122228,1646122782,554,120
3013313541,3166469542,1655911669,1655911984,315,4277
3050554873,3674679595,1648261302,1648261593,291,664
3303092471,3143360984,1643464063,1643464519,456,2443
3792986474,3589006128,1665558272,1665558395,123,2642
3872955079,3727240226,1669591496,1669592398,902,1394
3251655028,3358020385,1662568328,1662568914,586,3161
3107797706,3144405871,1645053418,1645054205,787,680
3677704302,3358603970,1665302029,1665302750,721,920
3242780456,3326303809,1660039478,1660039928,450,81
3742055115,3889557676,1662598499,1662599009,510,4410
3260770199,3983986050,1660479050,1660479786,736,1822
3011796419,3038570974,1646905392,1646905753,361,1492
3887389589,3940313689,1652889512,1652890194,682,1004
3433202470,3662853396,1666008956,1666009939,983,2558
3938339792,3700872887,1660217901,1660218227,326,3380
3153262119,3339753764,1662812783,1662812820,37,56
3292876404,3739166263,1644889695,1644890392,697,2994
3024645793,3808695115,1662252164,1662252309,145,701
3108068105,3998134786,1661601132,1661601277,145,2757
3543859239,3518968510,1657235651,1657236119,468,3473
3422255474,3414617230,1643768099,1643768721,622,2276
3106149697,3490891019,1669400159,1669400507,348,2210
3188685309,3639748768,1662315182,1662315945,763,1203
3243425603,3180041787,1660726100,1660726380,280,869
3998845318,3608974687,1664840281,1664840649,368,1345
3609474562,3516870994,1647191581,1647192532,951,2577
3636692766,3670540118,1664767681,1664768316,635,2741
3543444530,3887765830,1658084766,1658085643,877,4008
3860204451,3076816861,1648398440,1648399348,908,2879
3716274706,3152841936,1652035915,1652036317,402,3776
3005871526,3051025992,1661019982,1661020667,685,4836
3022518090,3321296753,1651140781,1651141767,986,688
3668088235,3319043104,1662515325,1662515714,389,120
3506688489,3562976031,1649805150,1649805484,334,692
3060327523,3660278919,1659356053,1659356326,273,2853
3260428974,3291868938,1641522782,1641522972,190,544
3432101551,3786465086,1665943155,1665943920,765,442
3472997500,3918774259,1650753716,1650754468,752,2960
3862467569,3947675143,1641083498,1641083600,102,2659
3522458445,3812096190,1655380725,1655381223,498,909
3357050503,3470592332,1645655315,1645655568,253,595
3805702575,3233461100,1662946126,1662946476,350,1148
3590851484,3891594656,1662627182,1662627312,130,2313
3009162261,3958592047,1650036392,1650036518,126,3271
3266645542,3629496109,1653131777,1653131907,130,1841
3588455692,3751924390,1668812699,1668813306,607,353
3785000900,3086751535,1668968570,1668968854,284,324
3594489196,3610692120,1641244722,1641245712,990,4262
3904317752,3309728302,1664167987,1664168125,138,410
3521175065,3873205999,1641958830,1641959314,484,4872
3933763910,3479290090,1655229767,1655230093,326,3109
3524964146,3159371186,1664254604,1664254673,69,4624
3686049420,3834246146,1665696517,1665697067,550,549
3969367095,3416955929,1651285104,1651285893,789,3409
3438373107,3492264155,1665713631,1665714595,964,3149
3710122173,3547495444,1642547835,1642548090,255,3711
3177403462,3091473778,1643933792,1643934327,535,2088
3038565057,3996552096,1664824803,1664824889,86,4228
3223684210,3685091554,1652911260,1652911908,648,3692
3041995014,3374291957,1669348643,1669349035,392,1988
3003853057,3898710470,1669310887,1669310985,98,330
3508326681,3033980913,1649425105,1649426084,979,3821
3184714123,3068914734,1645533272,1645534043,771,873
3575439264,3233251245,1655179078,1655179426,348,3278
3082012385,3682256661,1646281843,1646281858,15,3199
3087033570,3876749117,1649522634,1649522835,201,3846
3109021667,3043848533,1641809668,1641810457,789,3888
3423685958,3501154881,1649723048,1649723849,801,4814
3139481750,3311966233,1651369798,1651369874,76,3802
3746917294,3119515735,1663477123,1663478076,953,163
3465683349,3278593974,1647026480,1647026699,219,2353
3313492434,3048252968,1654721666,1654722357,691,4445
3869468461,3075370598,1642129620,1642130427,807,1496
3861987870,3641241394,1663521605,1663522517,912,3935
3660148485,3731428560,1645749672,1645750370,698,968
3702034599,3596942439,1642677594,1642678314,720,2003
3332074714,3576485830,1661158417,1661159319,902,3155
3207911913,3662239693,1641815752,1641816254,502,1762
3817799189,3032879864,1668429417,1668429691,274,3605
3986894909,3355759586,1656325749,1656326394,645,752
3517373538,3067167415,1649459415,1649459887,472,470
3967695813,3302758348,1644024243,1644024417,174,1284
3902451664,3469262728,1668010924,1668011199,275,1739
3815848024,3746754395,1662469922,1662470130,208,688
3220631447,3436611894,1646836648,1646836858,210,2669
3532668082,3119488424,1645747209,1645747228,19,4014
3917122244,3114504150,1660342105,1660342231,126,2649
3371159671,3705929090,1668994098,1668994787,689,4036
3959332431,3255071405,1652531166,1652531187,21,2846
3205133286,3505655975,1651797857,1651798713,856,574
3733960381,3369718631,1644777400,1644778250,850,827
3534355494,3597233732,1668667270,1668667839,569,3828
3877364397,3978630470,1667925344,1667925730,386,3996
3297912191,3084184576,1660028939,1660029828,889,4367
3864474303,3291637327,1641456801,1641456992,191,4633
3024600265,3615507159,1643504198,1643504602,404,3474
3010211072,3375106273,1669204385,1669204867,482,209
3599464857,3186079712,1667712319,1667712781,462,3325
3335382409,3564840764,1655270246,1655270371,125,4846
3867188674,3022097016,1647114665,1647114869,204,901
3779915352,3629399579,1654256239,1654256566,327,2393
3904617763,3416602977,1666430418,1666431383,965,512
3593559597,3381674082,1666948404,1666948450,46,1039
3056890675,3644523975,1665045006,1665045460,454,896
3805057575,3761324535,1658140557,1658141256,699,1955
3583493390,3327679743,1666078716,1666079021,305,890
3952918170,3592665487,1668004120,1668004898,778,4466
3863259331,3754662934,1658085786,1658086053,267,585
3073513131,3539135765,1656126745,1656127151,406,4491
3159418837,3127817863,1667812967,1667813346,379,4578
3748788139,3869720468,1665045166,1665045429,263,4215
3761658645,3877063038,1657065444,1657066222,778,2278
3189447100,3685490364,1667222842,1667223626,784,2498
3125262253,3806959766,1647401051,1647401597,546,1694
3304636899,3521174421,1659475371,1659475604,233,1218
3796748032,3598939488,1648139569,1648139891,322,2886
3993625512,3277622205,1644294677,1644295129,452,277
3730494126,3995673587,1660077780,1660078367,587,2846
3388660915,3834416192,1657928451,1657928710,259,2537
3515662999,3927879787,1642163033,1642163869,836,794
3559315846,3210252285,1663317041,1663317949,908,365
3483770179,3560382683,1662983595,1662983818,223,1487
3666670383,3327104317,1656235039,1656235895,856,931
3009096580,3099831006,1645228357,1645228739,382,3449
3831783774,3107663749,1644532388,1644532877,489,4377
3544678585,3646032344,1654093281,1654093988,707,3999
3967223633,3483758071,1647952055,1647952677,622,2792
3171917029,3112324803,1662481814,1662482089,275,1165
3900075721,3758741931,1647229905,1647229990,85,860
3479110161,3890480429,1642609989,1642610977,988,472
3001875381,3867594832,1667067335,1667067988,653,2733
3134549910,3639706356,1644056772,1644057391,619,4160
3512443296,3155030748,1668692794,1668693312,518,2684
3978379646,3830200459,1663468013,1663468135,122,4264
3247474601,3880253543,1661662612,1661663241,629,723
3729112934,3225587296,1641907103,1641907172,69,1030
3453289500,3163119200,1657496538,1657497201,663,169
3511478188,3250610354,1658309898,1658310898,1000,2806
3538937875,3695836456,1657536366,1657536369,3,542
3395557239,3720933623,1661242603,1661243266,663,994
3768015110,3158769833,1667162630,1667163045,415,474
3608773837,3855889871,1644063335,1644063875,540,4975
3237615768,3509051943,1662427749,1662428310,561,2092
3068946112,3355679925,1653398271,1653398300,29,1578
3784434130,3576265715,1651583963,1651584429,466,1590
3316963265,3999344662,1650658090,1650658439,349,3049
3013296405,3592532994,1663205394,1663206210,816,239
3682023498,3432004429,1659803002,1659803876,874,3519
3969134067,3784287457,1642050903,1642051673,770,1924
3324301814,3741965821,1649158680,1649159240,560,3910
3007081562,3991453111,1653525901,1653525921,20,2400
3364460117,3996454327,1645489966,1645490926,960,1792
3651554622,3498823183,1643401086,1643401877,791,2493
3930997158,3497404414,1655440643,1655441462,819,4990
3082315324,3248458815,1656568023,1656568780,757,4198
3895757513,3370648285,1651875406,1651875975,569,912
3704153531,3409388792,1661414414,1661414746,332,1640
3602331835,3485419058,1649888554,1649889310,756,1531
3324050749,3852191812,1669314328,1669314788,460,1085
3058929507,3453650136,1665776207,1665776353,146,1664
3911509453,3714467121,1648550109,1648550187,78,3322
3146573211,3976603443,1653690084,1653690361,277,2995
3577412826,3043005301,1642872325,1642872688,363,3501
3616115890,3731730021,1647060263,1647061243,980,3654
3182999850,3882500908,1661469984,1661470257,273,3736
3369253028,3502353075,1642268540,1642269148,608,2166
3165682022,3662718615,1662445595,1662445611,16,1265
3025496482,3934974280,1658168890,1658169183,293,2076
3952463462,3242237268,1650293588,1650294163,575,876
3263898239,3509446048,1658178138,1658178484,346,2612
3489691357,3717283528,1656161163,1656161601,438,1964
3851525996,3293533440,1666858573,1666859187,614,4457
3975736359,3582872729,1652150522,1652151283,761,2736
3132011524,3167787721,1664610447,1664610720,273,4890
3430401550,3047917677,1644635054,1644635756,702,3755
3523380536,3655117934,1662410504,1662411031,527,4361
3283361248,3500361149,1645322555,1645322566,11,3965
3739390834,3211605348,1646572500,1646572631,131,4886
3325780470,3212873835,1658375532,1658375930,398,4194
3835954808,3780168944,1667322618,1667323424,806,237
3775336064,3412714271,1657110368,1657110720,352,4894
3772410857,3743392525,1648837267,1648837970,703,495
3559459027,3481609402,1666094480,1666094521,41,4193
3330637808,3166021110,1660754483,1660754851,368,3301
3180083218,3576562855,1657587808,1657588461,653,1557
3029494774,3559761316,1666192117,1666192420,303,3198
3996304076,3703242950,1654203164,1654203345,181,1276
3430813427,3510551355,1655362553,1655363147,594,4173
3844692156,3994418825,1665332277,1665332594,317,2741
3950360598,3251438610,1645741529,1645742242,713,3455
3831547968,3146376622,1669117831,1669117935,104,4864
3665118037,3700870631,1641047273,1641047587,314,3565
3599697455,3393330292,1657591656,1657591969,313,4297
3120252138,3207699969,1663089511,1663090188,677,403
3465063169,3482127724,1662136032,1662136605,573,3134
3193464514,3426137424,1666837191,1666837545,354,4669
3670092960,3488815731,1667194108,1667194342,234,4839
3850379965,3050480642,1666531976,1666532612,636,433
3329887472,3156764517,1648972679,1648973207,528,69
3203207483,3927852680,1641484552,1641484903,351,2955
3833741178,3254760138,1653055891,1653056784,893,1683
3513638658,3815218889,1667986302,1667986536,234,3063
3276104583,3142208537,1651857526,1651858081,555,4394
3728105217,3205616340,1648054205,1648055036,831,1992
3232013951,3461623917,1654001490,1654001917,427,3131
3368401038,3670731062,1642759941,1642760307,366,1622
3320505101,3306880566,1651506120,1651506336,216,1028
3503348403,3373591338,1666040432,1666041027,595,3907
3418927372,3490701046,1668758942,1668759116,174,2461
3524252322,3438164752,1641723252,1641723620,368,2503
3506837572,3113442014,1655796081,1655796664,583,476
3343187612,3994337545,1652831786,1652831820,34,581
3368885536,3976099840,1669414345,1669414367,22,3225
3135958497,3914230565,1663043413,1663044303,890,3332
3282852943,3124728136,1669106157,1669106373,216,219
3458200743,3703761567,1662046175,1662046871,696,4106
3765381682,3119058813,1644003093,1644003407,314,3707
3911162326,3390508518,1645352924,1645353080,156,1358
3045368263,3211464891,1661339649,1661339740,91,1938
3990829245,3432147003,1644750996,1644751276,280,3639
3029826793,3364848378,1662949435,1662950382,947,3751
3934884389,3297315850,1657593737,1657593742,5,4752
3430740317,3634305915,1652451614,1652451938,324,2467
3292563247,3582028139,1664116949,1664117566,617,1911
3313443935,3751369133,1660681752,1660681796,44,2472
3375062500,3315295546,1656136905,1656137359,454,2088
3181309165,3256943632,1646684802,1646684997,195,2523
3744494020,3657949457,1665215750,1665216168,418,3225
3231951291,3110912469,1667061850,1667062159,309,3377
3176966588,3245809384,1658548241,1658548303,62,3774
3042056046,3119958640,1657669760,1657670150,390,2888
3791974282,3564360679,1647815986,1647816657,671,3519
3839560979,3038068656,1662432941,1662433058,117,1549
3410875794,3009628306,1645544370,1645544632,262,3751
3664259042,3025800459,1642107262,1642108177,915,3699
3759985376,3346845439,1647126095,1647126981,886,3209
3211407387,3305288385,1661311207,1661311889,682,2491
3290216766,3951726712,1662830099,1662830250,151,1000
3029844565,3722479539,1663932373,1663932509,136,3994
3597070274,3110912469,1650040072,1650040158,86,4797
3594498461,3545549466,1664329854,1664329854,0,1984
3482983321,3746557976,1653904490,1653904793,303,2585
3595395118,3130952816,1642209959,1642210124,165,3188
3581631159,3427099076,1667549830,1667550794,964,4059
3120712318,3258087490,1657910249,1657910664,415,3747
3169856791,3930770958,1644154475,1644154673,198,4820
3223838615,3776137986,1651276298,1651276466,168,4344
3613120177,3013858895,1660848968,1660849845,877,678
3769520662,3391978797,1664083110,1664083410,300,1520
3904763792,3036946657,1665749252,1665749543,291,692
3417201944,3746838448,1664478438,1664478693,255,3844
3359039646,3936817211,1641713193,1641714048,855,641
3307706817,3370104438,1661232562,1661233309,747,2141
3798844955,3197690747,1660493344,1660494133,789,2622
3577417559,3490329886,1653998582,1653999355,773,1301
3202200736,3479032856,1650287644,1650288239,595,1956
3563832457,3595097091,1645530624,1645531471,847,666
3990591119,3323808299,1650842002,1650842720,718,464
3168408092,3471230514,1658429947,1658430612,665,2660
3905928643,3156761333,1644159824,1644160711,887,2990
3936392438,3467084647,1647833308,1647833901,593,1300
3157813949,3974733980,1659187954,1659188475,521,4909
3458986761,3256943632,1641533708,1641534425,717,3836
3226581664,3680293719,1641048121,1641048414,293,3770
3437393878,3809340472,1659021301,1659021595,294,4017
3439533891,3124619693,1657957811,1657957941,130,980
3462730071,3646363897,1667356110,1667356709,599,2784
3138061885,3289640506,1662511240,1662511608,368,2350
3584243459,3154110185,1645607593,1645608512,919,3651
3740702587,3530209050,1657172527,1657173455,928,1610
3414938861,3869177151,1654987625,1654988118,493,1958
3808656974,3884845578,1644087262,1644088199,937,3285
3121019768,3583279092,1646187932,1646188537,605,701
3963339664,3221583568,1649908447,1649909148,701,1905
3146697955,3422696739,1644113442,1644114395,953,2581
3881949194,3803087281,1643841126,1643841641,515,2663
3025646439,3187725941,1643944016,1643944891,875,982
3686994677,3858506016,1655632606,1655632864,258,4625
3527456400,3930494694,1664006087,1664006730,643,780
3349729358,3666974166,1663363265,1663363748,483,4807
3779737352,3741867692,1650623881,1650624511,630,1536
3826856893,3075016198,1644238881,1644239748,867,4662
3779480573,3456791752,1654152845,1654152925,80,3499
3149112589,3391072877,1641088734,1641089371,637,4183
3306226168,3444965116,1645902261,1645902697,436,312
3283583297,3933344892,1650235654,1650235698,44,4749
3843321731,3998845318,1653716444,1653716915,471,3773
3744324301,3558950862,1652607509,1652608368,859,4010
3884549884,3186698482,1651527766,1651528091,325,2706
3425158151,3858205625,1653510918,1653511438,520,880
3701992893,3876882650,1666871581,1666872221,640,1904
3507141084,3091099271,1669141006,1669141562,556,2883
3637236281,3052957092,1642633572,1642634146,574,2411
3428530663,3782350004,1647813947,1647814618,671,2981
3707291899,3882402855,1647512663,1647512842,179,4986
3251627617,3126926742,1647441753,1647441833,80,3783
3006464137,3582149432,1662732180,1662732797,617,3260
3237796226,3802248361,1660727054,1660727668,614,1232
3115388941,3265377075,1649377871,1649378238,367,4493
3285911205,3427293728,1657506442,1657507098,656,2913
3662340788,3955697285,1659880762,1659881066,304,183
3527896042,3261064102,1667744949,1667745774,825,3505
3785975200,3589744719,1658528547,1658529547,1000,3108
3932845335,3379302583,1660438976,1660439164,188,1542
3354330884,3124910327,1657915328,1657915672,344,2978
3035095839,3854362748,1652718759,1652719511,752,968
3093196535,3846260557,1642890514,1642890994,480,1561
3415344916,3685516210,1650977710,1650978002,292,1964
3626516654,3052967887,1661450712,1661451322,610,4900
3030494815,3796369795,1647766355,1647767174,819,694
3381286808,3601842431,1666490295,1666490317,22,4816
3512075866,3830075123,1652753192,1652754157,965,288
3455544038,3866564499,1664712147,1664712507,360,3091
3665903638,3100145353,1651923687,1651924480,793,2741
3071138997,3654978441,1666216610,1666216933,323,3230
3395733117,3136117539,1668155273,1668155431,158,2673
3355193168,3953698981,1645009941,1645010629,688,2249
3607866150,3198309713,1655287178,1655287808,630,1462
3133721853,3889281364,1647909265,1647909903,638,658
3539259688,3141436426,1647217212,1647217936,724,18
3586085014,3547817448,1665058752,1665058990,238,3277
3172153672,3862002481,1660072157,1660072981,824,3152
3311780043,3760256421,1645627700,1645627975,275,3441
3560308443,3923286530,1648450817,1648450995,178,2715
3942193885,3418937207,1665531544,1665532218,674,4910
3241124566,3882432481,1662680366,1662680923,557,4920
3510651643,3714613662,1651203271,1651203896,625,51
3729110224,3563197528,1656103738,1656104037,299,869
3799095387,3455638003,1654109626,1654109984,358,372
3709614767,3152347929,1660431216,1660431983,767,620
3423323991,3697431650,1660108429,1660109227,798,4108
3355620834,3229224129,1658737184,1658738065,881,3565
3183697115,3284697680,1644087811,1644088316,505,806
3622272348,3203585889,1665899666,1665900241,575,620
3159087811,3910547447,1652581050,1652581079,29,2863
3801695554,3387995930,1669374136,1669375046,910,2996
3574939751,3180683249,1647271127,1647271788,661,324
3984925254,3845600482,1656023363,1656023806,443,4282
3583614826,3687013089,1646152376,1646152686,310,2347
3518258444,3428425895,1646323347,1646324029,682,793
3144531954,3448090087,1654369623,1654369896,273,4175
3840053058,3500597917,1668804057,1668804231,174,2901
3806943617,3766453481,1657710789,1657711549,760,4079
3543477519,3654568977,1647642897,1647643241,344,73
3680002160,3354790550,1666355398,1666355595,197,3025
3651356682,3363950718,1649222698,1649223545,847,3655
3172957114,3987435544,1643471690,1643472402,712,2419
3796778603,3949723088,1654372633,1654372821,188,2917
3766065025,3076474193,1646583550,1646584423,873,2133
3534724334,3844564250,1653993141,1653993627,486,2797
3025135094,3083085758,1656498574,1656498896,322,4248
3392017818,3854349249,1651803418,1651803474,56,4076
3044464623,3840457571,1658619815,1658620720,905,2803
3024949982,3427293728,1648262983,1648263700,717,2651
3937159277,3286585890,1653234359,1653234777,418,202
3739494651,3278664256,1663468515,1663469400,885,1018
3218949193,3046116994,1663082902,1663083865,963,4269
3844623038,3648223270,1668052914,1668053149,235,924
3890829269,3347615949,1669168444,1669168524,80,55
3338789658,3309334151,1660239938,1660240179,241,3721
3179322547,3588522640,1660725316,1660726133,817,4981
3111353172,3242414556,1657681144,1657681236,92,1579
3086218901,3075881826,1648709188,1648709420,232,177
3537762288,3867472990,1669598263,1669598594,331,4226
3086958441,3775997640,1655986172,1655986930,758,4401
3089522516,3979584075,1661534258,1661535180,922,2187
3230964050,3076052154,1641424393,1641424908,515,4768
3748779709,3672171681,1652573471,1652574305,834,2624
3058090343,3660045155,1655573979,1655574410,431,2021
3905350184,3868150841,1653215907,1653216322,415,3737
3498941209,3999926592,1656517702,1656518349,647,4978
3562540731,3518764157,1665682171,1665682804,633,2172
3655649271,3512255018,1649790060,1649790833,773,3459
3638317149,3686036290,1654738368,1654738661,293,4684
3958466696,3381618779,1645345589,1645345779,190,3445
3876426793,3591018449,1657209341,1657210173,832,3800
3940003549,3128894985,1654734832,1654734867,35,157
3281806590,3831532530,1647633277,1647633997,720,2540
3971612225,3696607703,1645888467,1645888960,493,1333
3660615228,3706463258,1642665937,1642666496,559,2386
3845537601,3185182136,1654873695,1654874007,312,2422
3543015105,3589038733,1667122689,1667122713,24,2486
3895522449,3368021300,1664428646,1664429541,895,988
3629138419,3753371720,1650432030,1650432454,424,3327
3734097524,3873570945,1645395821,1645396772,951,427
3219693474,3542173401,1648363039,1648363594,555,4025
3816738134,3645751744,1667450775,1667451153,378,1701
3009630916,3223919527,1667914441,1667914628,187,848
3531976319,3289882203,1654442017,1654442271,254,2679
3371700363,3196119135,1655200190,1655201054,864,3281
3325069109,3612953849,1660424037,1660424885,848,1832
3286863658,3008619551,1662981171,1662981377,206,2889
3470468811,3687752079,1653123713,1653124366,653,3965
3868607437,3594092599,1668786712,1668787234,522,4830
3582102588,3972358729,1645714898,1645715199,301,4359
3284186334,3224865994,1650258559,1650259044,485,2443
3658719677,3908295096,1660605685,1660605801,116,1460
3886058248,3297761839,1649689534,1649690138,604,1656
3135034434,3154043129,1646299489,1646300261,772,2180
3614852517,3773422012,1652513380,1652514287,907,3291
3303626221,3433916951,1641814885,1641815503,618,744
3848307782,3804869282,1647019392,1647019690,298,2824
3214368821,3238273301,1644893501,1644893634,133,1738
3088455337,3041881723,1645809126,1645810071,945,1803
3101914645,3194874293,1659510819,1659511181,362,1664
3906406766,3753707897,1665365422,1665366187,765,1073
3903044870,3950124553,1667688006,1667688345,339,3067
3525531803,3018436457,1650198905,1650199723,818,3884
3601306677,3013957288,1652616519,1652616548,29,4398
3421865841,3595680524,1645148253,1645148349,96,2598
3118867561,3928258431,1667410182,1667410331,149,3180
3826118762,3736502645,1653884258,1653884665,407,2910
3954317188,3510310691,1655308651,1655309400,749,3250
3491589530,3513945447,1645149873,1645150178,305,1662
3154895171,3657157767,1647326900,1647326909,9,1901
3358759844,3328795890,1666592463,1666592714,251,240
3188827729,3744048373,1667882043,1667882643,600,145
3717856400,3119050322,1653133085,1653133756,671,1942
3665495106,3700218974,1648504372,1648504783,411,852
3412697233,3861057159,1660294175,1660295119,944,4267
3770294173,3056897798,1649535682,1649535752,70,4038
3249711165,3206415334,1660005211,1660006082,871,3116
3487580194,3909125333,1667842842,1667843246,404,2516
3437184394,3488226156,1647837552,1647838138,586,2027
3952410466,3544697389,1666983618,1666984475,857,3754
3432378318,3345212417,1652783678,1652783938,260,2884
3536348416,3170213854,1668501620,1668502117,497,3968
3343425566,3001584247,1642127989,1642128915,926,1529
3147286299,3133026545,1645500666,1645501381,715,4489
3303999082,3584336748,1643954880,1643955415,535,3470
3524878413,3403288883,1659132716,1659133462,746,2144
3258270972,3314436423,1659934021,1659934327,306,2688
3239376837,3321092331,1642823361,1642824092,731,1174
3294545592,3519619564,1665992845,1665993540,695,562
3346688388,3372340321,1645709381,1645710199,818,75
3157394547,3099257696,1644060923,1644061505,582,4712
3599648649,3400355896,1652995162,1652995836,674,1473
3617220389,3980818938,1649581288,1649582032,744,47
3809998825,3514240585,1661295991,1661296627,636,1278
3938876112,3494583850,1644322424,1644323142,718,1255
3238704346,3579571648,1669244142,1669244779,637,2516
3466070764,3890171937,1642001711,1642002176,465,1720
3818529757,3878460485,1660348693,1660348864,171,1738
3014112273,3563307036,1641302507,1641302704,197,1151
3920615333,3127029932,1643565113,1643565651,538,449
3855487717,3485626873,1641113721,1641114003,282,3184
3754543317,3350033581,1643893083,1643893349,266,4836
3562410566,3578815308,1645265127,1645265288,161,2179
3920275201,3284293161,1664889177,1664889584,407,4316
3153745256,3015943826,1656077365,1656077485,120,82
3161504163,3161911563,1664486654,1664487051,397,190
3696256574,3345273144,1666142811,1666142832,21,379
3322266919,3348029206,1665464544,1665465050,506,3777
3658672618,3912806464,1667921642,1667922471,829,677
3662206494,3169896933,1653219630,1653220313,683,4205
3112742379,3279824238,1657788022,1657788477,455,3190
3081807070,3982539950,1646249495,1646250308,813,1242
3993998325,3382533826,1667476900,1667477014,114,4472
3778395177,3309079538,1660250173,1660250289,116,888
3859906503,3362340268,1651647576,1651647646,70,350
3431007763,3230964050,1659811549,1659812291,742,3356
3942884390,3415421236,1665374398,1665374819,421,4246
3261229792,3015893173,1656671448,1656671833,385,2524
3546802903,3214274673,1663578370,1663578732,362,3634
3032892434,3884935488,1651627351,1651628247,896,3347
3440705304,3937417405,1643041632,1643042221,589,176
3863017186,3457075278,1644027229,1644027409,180,3985
3170915517,3234300096,1655947146,1655948062,916,3575
3083273970,3528455225,1659407055,1659407900,845,931
3160161903,3564360679,1651699035,1651699842,807,52
3721589964,3118074522,1653854340,1653855282,942,2671
3906121924,3041187084,1643156642,1643156939,297,3247
3366403546,3452450729,1645062700,1645063355,655,1388
3163953494,3983013844,1665815487,1665816064,577,2760
3782584910,3395949860,1662436002,1662436257,255,1800
3064649461,3430524956,1642636792,1642636842,50,4100
3814874198,3683657597,1648054673,1648054754,81,4884
3379862531,3508316451,1665400677,1665400839,162,3858
3891568375,3900842118,1644994882,1644995147,265,3939
3090859502,3753351767,1661667135,1661668091,956,2251
3054657652,3544337421,1660956091,1660956876,785,4480
3829021015,3734381703,1657896809,1657897046,237,1040
3764542778,3009518850,1661547528,1661547787,259,4444
3530150108,3828529104,1653784009,1653784630,621,2122
3415246126,3918685178,1648736919,1648737548,629,417
3326235234,3674453292,1645960150,1645960232,82,4437
3028069288,3395906145,1653419127,1653419954,827,3328
3751362399,3493988000,1643920770,1643920891,121,2007
3284591585,3578576228,1655710305,1655710324,19,1497
3118074522,3566427501,1646285665,1646285791,126,1025
3504609300,3685248983,1652442488,1652443278,790,1651
3110102787,3783578995,1662432427,1662432766,339,1544
3363614984,3143246827,1658434231,1658434297,66,2031
3126552961,3762003864,1646176059,1646176737,678,4327
3647798967,3275789502,1646430808,1646431354,546,4453
3205666501,3755604870,1664722182,1664722586,404,2798
3109725920,3940722123,1656733685,1656733721,36,2584
3470848488,3343801248,1647954523,1647954931,408,1725
3671224661,3101360100,1647741142,1647741391,249,3212
3081408701,3025844324,1668343454,1668343592,138,1373
3349134554,3469300745,1667170416,1667171412,996,4657
3311859019,3864924202,1668897578,1668897979,401,3562
3470565015,3336399212,1649263246,1649264082,836,1844
3518501000,3631994192,1653695027,1653695660,633,4890
3109916295,3789583569,1661755321,1661755410,89,3563
3005201731,3594386436,1661205678,1661206158,480,1306
3122290782,3215327072,1652004090,1652004359,269,2480
3569116250,3843627804,1657778493,1657779426,933,2590
3039926404,3124513062,1665173199,1665174192,993,1687
3131589749,3843662567,1641754360,1641754465,105,4618
3942433890,3915321256,1664059371,1664060201,830,2341
3120187216,3490217730,1655614888,1655614897,9,4256
3479000879,3112324803,1661439957,1661440480,523,3952
3579996740,3360445386,1652005193,1652005232,39,2549
3482523131,3435294863,1656234669,1656234770,101,2705
3645403752,3755279829,1645434611,1645435572,961,4664
3443326949,3390318735,1645776319,1645777201,882,2900
3137449297,3203014470,1646200172,1646200592,420,3582
3909016846,3641371334,1652446949,1652447521,572,1180
3880542409,3166409046,1643485607,1643486489,882,3699
3549724235,3570962078,1653667290,1653668062,772,3372
3917154611,3833739945,1668376089,1668376449,360,1836
3750110680,3458787486,1654855680,1654856363,683,3081
3248155521,3588237235,1648471843,1648472272,429,4597
3996633276,3416702759,1650091844,1650091884,40,3307
3842395735,3803594010,1665029249,1665030176,927,2779
3597733218,3558680785,1659671047,1659671204,157,3936
3750878999,3525864415,1658907315,1658908259,944,4151
3382937901,3596411327,1648210769,1648211128,359,2848
3415827580,3355007842,1644527099,1644527894,795,1842
3367521530,3489859607,1664207076,1664207988,912,3767
3890912322,3452577383,1668340315,1668340456,141,1706
3918906787,3652013055,1660027461,1660028314,853,4878
3596194666,3500684905,1646350527,1646350698,171,2407
3857711734,3840442360,1646663501,1646664080,579,2221
3806432290,3518408145,1652254197,1652254610,413,3960
3105371445,3545313140,1668382692,1668382913,221,4993
3347596592,3926577525,1649317332,1649317723,391,1647
3153187497,3238013479,1655156463,1655156607,144,3912
3266256202,3580139606,1663973757,1663974462,705,1773
3687617180,3919188307,1662013227,1662013731,504,4374
3624144694,3326331416,1667726589,1667726797,208,514
3945146977,3537830978,1656077602,1656078116,514,2330
3188517290,3364909387,1660050382,1660051154,772,657
3483901228,3673059843,1655804199,1655804397,198,756
3647229123,3957016627,1650571602,1650572313,711,3730
3278286854,3199251955,1657340319,1657340341,22,1320
3049859653,3568650732,1660810218,1660810961,743,2673
3070702621,3763571247,1647162184,1647163138,954,4895
3665081713,3552420268,1652620692,1652620872,180,3765
3893317083,3479568039,1647428182,1647428566,384,2280
3829755669,3731078151,1663347044,1663347504,460,2645
3220631447,3499669498,1647059640,1647060030,390,4431
3690775493,3978381334,1648805551,1648806363,812,4729
3898621913,3046653832,1661542801,1661543014,213,2969
3713501481,3712087007,1655193253,1655193958,705,172
3188849494,3920349365,1656991300,1656992179,879,902
3057256122,3102390819,1659937600,1659938193,593,780
3433857583,3606159811,1645476123,1645476556,433,2763
3737727140,3877847314,1660543524,1660544101,577,2257
3394601545,3468904347,1658101800,1658102128,328,1466
3079853767,3058536421,1651222367,1651222640,273,1985
3135865836,3821032005,1650024714,1650025189,475,2408
3753995974,3885394491,1656946190,1656946867,677,303
3410257892,3350855198,1653340466,1653340801,335,190
3119515735,3570250085,1653726547,1653727015,468,4639
3594613893,3631636637,1655984724,1655984831,107,4005
3873463101,3232327765,1641711202,1641711425,223,1937
3804856529,3427622757,1663852223,1663852412,189,1491
3720186346,3418952887,1665507925,1665507932,7,1807
3684671323,3207198958,1653798465,1653798612,147,368
3478835851,3582544167,1641944380,1641944731,351,4522
3796735236,3897188052,1641434993,1641435840,847,436
3959536143,3551117931,1644911614,1644912495,881,203
3468120384,3340811697,1657582735,1657582771,36,390
3803937320,3627295929,1652529200,1652529223,23,37
3626910330,3412576373,1643192852,1643193526,674,1856
3307193641,3867603519,1663716953,1663717748,795,2599
3579300475,3158760741,1649012476,1649012493,17,1554
3658014715,3702140878,1645894732,1645895603,871,1050
3225685095,3279358208,1649639694,1649639932,238,205
3953404062,3460427877,1648007450,1648008179,729,2571
3855526340,3316052393,1645799016,1645799186,170,4091
3652194548,3437954809,1663320620,1663321086,466,940
3664695400,3974199559,1660382440,1660383048,608,2833
3698654702,3626994050,1660904974,1660905619,645,2363
3495696044,3450144262,1657538475,1657539386,911,4220
3371544175,3511052053,1653594231,1653595056,825,3682
3322272098,3221974543,1656056609,1656056963,354,786
3878184235,3737127990,1669140900,1669141505,605,2309
3447620729,3263898239,1657690017,1657690578,561,3759
3674085963,3491731430,1654139239,1654139909,670,803
3410958030,3666126927,1651835495,1651836188,693,1277
3606868074,3664075858,1656834036,1656834866,830,4594
3065891114,3355968526,1669090179,1669091152,973,719
3548772360,3220553840,1659022985,1659023740,755,79
3712997204,3239268820,1653828051,1653828198,147,1023
3054165640,3610122717,1659288590,1659289510,920,3057
3015164995,3412389316,1651009376,1651010294,918,2485
3427605566,3212186718,1648444538,1648444722,184,1950
3045573086,3180274459,1669125688,1669126561,873,1774
3561163861,3358714218,1659551221,1659551516,295,3828
3145225134,3835033149,1649236595,1649236905,310,3799
3822736369,3726554411,1664302573,1664303128,555,1037
3632115325,3005427224,1662532299,1662532880,581,3527
3122382277,3477473336,1654837442,1654837618,176,1636
3275203126,3978478606,1666245402,1666245950,548,2424
3273633257,3164605965,1661702153,1661703150,997,746
3621455230,3153459747,1657983895,1657984717,822,2190
3739026771,3736501839,1665691490,1665692438,948,4112
3508771868,3686205944,1656204615,1656205137,522,3851
3875697481,3089690159,1651560074,1651560900,826,356
3040810714,3224365881,1666833354,1666833747,393,4344
3873385590,3485003669,1658536445,1658536786,341,1419
3001894068,3436689056,1645802406,1645802883,477,1719
3255442075,3770863240,1659871079,1659871663,584,4686
3951409441,3510574576,1648095764,1648096301,537,1549
3854113094,3486201761,1668749365,1668750358,993,572
3084717784,3850352893,1641258554,1641259495,941,770
3085087209,3297346228,1655670425,1655670499,74,161
3345876216,3856105698,1662657014,1662657202,188,4433
3822640712,3055645032,1660937294,1660937688,394,205
3691034414,3362084646,1649214297,1649214378,81,768
3048931520,3888044420,1641809679,1641810086,407,1172
3128162604,3001151269,1648017286,1648018055,769,2015
3683448814,3274293764,1641502734,1641503292,558,4260
3874716380,3640974983,1643980304,1643980947,643,1054
3386949131,3337855736,1649024073,1649024712,639,660
3180177997,3147925446,1651632549,1651633120,571,4449
3547136024,3357519791,1647071465,1647071636,171,4515
3054503308,3513578786,1643061356,1643061624,268,839
3249775636,3074622432,1660678293,1660679076,783,1834
3412966919,3980633797,1655580652,1655580975,323,2279
3671192130,3856521401,1657487549,1657487780,231,2717
3235713319,3997913146,1648234237,1648234757,520,1683
3094129298,3810996366,1654094077,1654094186,109,2586
3469429907,3483810851,1646119424,1646120400,976,3802
3292681934,3648374272,1656593446,1656593943,497,160
3208115371,3985815671,1650242227,1650243189,962,404
3299772269,3914486550,1658488347,1658488920,573,2098
3491161436,3486031111,1657327270,1657327549,279,2249
3688355686,3267321275,1655749311,1655749890,579,2665
3687679466,3882752750,1665960649,1665961228,579,4168
3121633485,3134227961,1668025824,1668026005,181,1012
3018753397,3490677714,1660845458,1660845568,110,4489
3716089321,3612438442,1648700656,1648701640,984,1249
3753331286,3177309949,1654498253,1654498831,578,4350
3013449946,3798665934,1666727429,1666727806,377,385
3553055873,3283489971,1653957649,1653958527,878,1940
3432238853,3768134302,1650963929,1650964390,461,563
3587744034,3401875185,1667233610,1667234208,598,3349
3401072403,3954500971,1668619466,1668619853,387,2472
3290868681,3103738301,1646666444,1646667223,779,4129
3283040150,3807128740,1663564003,1663564068,65,1333
3131137692,3989490665,1657749531,1657750489,958,1894
3653126892,3482215098,1662399434,1662399822,388,712
3360673247,3250993592,1648135755,1648136727,972,4347
3252570744,3857571843,1650549566,1650549600,34,3538
3818266622,3675553981,1641024133,1641024779,646,137
3496403215,3151428738,1661850163,1661850672,509,3325
3968320854,3295883879,1662959450,1662959864,414,971
3370937154,3273558099,1646199996,1646200737,741,410
3462847628,3755193968,1652258063,1652258725,662,4774
3497868167,3401845035,1669036976,1669037930,954,2857
3691561963,3448422733,1653805284,1653806118,834,3016
3228530653,3389409107,1659859105,1659859614,509,3660
3951630883,3190228745,1643063205,1643063886,681,1490
3647395983,3127265615,1653886619,1653887401,782,4041
3064135514,3429055460,1643649794,1643650415,621,2261
3435232405,3514438436,1641405723,1641405882,159,4073
3343195064,3551811858,1666637030,1666637704,674,2223
3212611211,3770688057,1666011067,1666011497,430,3050
3179979988,3873739979,1654757351,1654758182,831,3708
3203660453,3325558038,1645584959,1645585843,884,3461
3643899530,3035539563,1647384064,1647384183,119,1784
3599897060,3772863393,1653630982,1653631621,639,1286
3899090390,3202800151,1648685372,1648685525,153,3003
3966892258,3750194755,1663195857,1663196815,958,542
3669552685,3594449619,1657722504,1657722754,250,1911
3962893261,3960131212,1665694142,1665694754,612,1211
3662156305,3693890159,1662186385,1662186761,376,1503
3360453034,3879306435,1649417897,1649418503,606,1479
3558726263,3990141858,1663484276,1663485105,829,4129
3741711701,3564062569,1651146869,1651147112,243,1274
3169588705,3030102081,1666502028,1666502787,759,2494
3584171562,3869212677,1666034157,1666034178,21,84
3041454333,3984094073,1646351509,1646351985,476,4288
3239749749,3429388849,1669299304,1669299338,34,2496
3256335209,3907878796,1655994207,1655994565,358,387
3406387477,3461715693,1669314002,1669314909,907,3578
3996083261,3394605181,1645637589,1645638402,813,1654
3788494088,3913352000,1643996301,1643997051,750,4398
3261229792,3630698467,1660391337,1660391578,241,913
3426989011,3687500348,1658991919,1658992495,576,3272
3590874457,3041497740,1657584126,1657584563,437,3608
3571262340,3557631657,1662386066,1662386903,837,2581
3165618394,3267401919,1661831729,1661831768,39,2524
3076102803,3102568581,1648072749,1648073262,513,4913
3288358386,3444074900,1668015359,1668016197,838,2675
3450180162,3802143476,1641697859,1641697896,37,2905
3570512915,3321728284,1668702754,1668702787,33,4967
3526197898,3590875442,1669215266,1669215270,4,4624
3535427328,3959253682,1649442017,1649442911,894,4212
3628128923,3693775456,1641806409,1641806530,121,3154
3146368380,3228306217,1666077468,1666078129,661,3327
3448494729,3441293730,1649557650,1649558635,985,4875
3769242006,3438210184,1664390535,1664391523,988,1623
3151869114,3478977175,1653500468,1653501421,953,2719
3935396168,3967001309,1663844511,1663844693,182,3288
3020971987,3748194006,1665639443,1665640206,763,3468
3882266039,3623961794,1656780614,1656781127,513,3681
3512255018,3486559307,1662033262,1662033707,445,2400
3922402835,3919288728,1655096706,1655097118,412,3729
3206258780,3424556983,1655215493,1655215968,475,754
3925355678,3173515675,1651382807,1651383669,862,3529
3656904993,3667736542,1665229093,1665229860,767,1744
3081222629,3721973528,1669524297,1669524846,549,4936
3289453517,3520095153,1661749993,1661750511,518,2547
3154592098,3061517680,1665676508,1665677005,497,1891
3897679298,3323992767,1668997305,1668997732,427,1988
3280440628,3159211919,1669264664,1669264846,182,2397
3897433820,3365198403,1667665205,1667665742,537,526
3191471957,3989736596,1665052869,1665053568,699,3299
3614173809,3647887183,1646864236,1646864532,296,4134
3543016647,3717997119,1642680456,1642681197,741,1733
3074917972,3110240014,1663037919,1663038606,687,143
3402309368,3678921313,1654131708,1654131958,250,382
3489404436,3055119556,1655390834,1655391214,380,2400
3662853334,3157971136,1654672573,1654672795,222,1772
3072387166,3397851274,1659459633,1659459991,358,82
3940003689,3622689209,1648478172,1648478766,594,2271
3742656172,3402432079,1669493494,1669494181,687,856
3130512417,3838112762,1658035542,1658036437,895,452
3255719187,3963790496,1642740899,1642741352,453,774
3453428807,3527805871,1662357378,1662357657,279,4955
3644226258,3430482988,1659394505,1659395285,780,931
3526846877,3906703890,1669030534,1669030693,159,205
3157977512,3127783430,1644535380,1644535838,458,1585
3897589090,3376007907,1664853563,1664854313,750,2434
3547656396,3640103583,1658779873,1658780640,767,2937
3433684573,3955762172,1665555227,1665555527,300,834
3636056020,3599464857,1646241521,1646241760,239,377
3131818992,3664009501,1656270617,1656270943,326,549
3015585863,3976050201,1646568996,1646569698,702,727
3735550215,3525531803,1658512336,1658512836,500,3046
3796283708,3723976221,1663690355,1663690747,392,1353
3577444955,3181818097,1641154306,1641154590,284,1138
3706649155,3227092330,1646482447,1646483279,832,2588
3324278032,3608313040,1668338172,1668338560,388,2194
3557059956,3073120463,1659589614,1659590281,667,3465
3119769143,3795499696,1663159406,1663160351,945,583
3167935196,3878377321,1658755381,1658756243,862,382
3239677564,3408415543,1647463401,1647464001,600,1960
3228241347,3854357220,1663396817,1663396925,108,918
3375055812,3790345404,1645857419,1645858340,921,3676
3982930785,3682990329,1663830920,1663831236,316,4059
3108470688,3979196188,1667097919,1667098831,912,3337
3052212958,3134861234,1654579543,1654580309,766,1074
3212379891,3805738907,1648937652,1648938104,452,1392
3673146707,3741867310,1662310326,1662310851,525,2429
3488447152,3853747685,1665127870,1665128172,302,2708
3609339161,3214854107,1662969424,1662969813,389,2221
3221368321,3699656372,1643446985,1643447292,307,1860
3372967124,3467501613,1663947534,1663947697,163,4162
3381888996,3764017896,1643776920,1643777398,478,4150
3294853517,3037800513,1655819200,1655819335,135,4129
3959628805,3951537889,1649263801,1649264325,524,1097
3606420693,3636612831,1655460698,1655461539,841,1183
3272163202,3909326097,1652947464,1652948277,813,1667
3567242296,3627618227,1650472600,1650472768,168,3709
3080990637,3610015036,1658463202,1658464004,802,1367
3576878079,3315522456,1659086811,1659087509,698,1391
3320135940,3464617010,1651107541,1651108363,822,2195
3199283247,3061603202,1657095406,1657096202,796,2032
3013210484,3671994834,1645892249,1645892686,437,2630
3303155586,3802215994,1645695957,1645696522,565,4018
3941319937,3604569722,1657113424,1657113867,443,528
3741725584,3390095424,1663956988,1663957821,833,4564
3694439940,3718382298,1661449261,1661450252,991,1443
3928038224,3868689531,1656979474,1656980356,882,2936
3487507813,3901177742,1648167527,1648167994,467,802
3634708364,3421264808,1665279582,1665280498,916,4912
3856989985,3755708981,1649135981,1649136474,493,4169
3659746200,3164828782,1668375803,1668376021,218,637
3271924040,3292914775,1641665000,1641665675,675,1450
3167873048,3143421884,1647426808,1647426927,119,494
3349122048,3788357467,1642915981,1642916130,149,1940
3446311437,3194439418,1647730094,1647730971,877,4785
3703017048,3978204820,1667762603,1667763078,475,2186
3750878999,3927879787,1652395065,1652395961,896,190
3731046670,3758623851,1664705091,1664705964,873,2848
3203526246,3685091554,1666714714,1666714994,280,4919
3027459414,3670023014,1668008844,1668009217,373,2618
3265151799,3249088089,1665980615,1665981554,939,409
3780228538,3182074201,1660402211,1660402997,786,1992
3296856196,3968056721,1664922288,1664922485,197,2619
3986011180,3079053296,1646823261,1646823483,222,3764
3081898891,3958465922,1656829734,1656830643,909,1290
3282308191,3158751763,1644600477,1644600520,43,2570
3805763041,3034226755,1658402954,1658403506,552,3691
3113853036,3771167612,1656562736,1656563031,295,2308
3811722516,3432564581,1663924663,1663925172,509,4649
3656321527,3615949276,1642105658,1642105748,90,4598
3248587033,3082502963,1659757506,1659758177,671,3584
3960203057,3795124794,1664015516,1664016431,915,1762
3404143075,3883185696,1667920519,1667921468,949,2372
3209791324,3569224571,1661771879,1661772000,121,1957
3753525572,3165434598,1644112283,1644112907,624,1155
3566103162,3644659115,1665631741,1665632669,928,2888
3952031971,3315486720,1642820965,1642821110,145,4854
3389582126,3288396034,1642529143,1642529207,64,3973
3939809175,3799834639,1650098802,1650098956,154,1840
3259496395,3019902323,1663520068,1663520153,85,3889
3197135118,3953564227,1666937680,1666938449,769,3065
3981442896,3829801573,1668792658,1668793433,775,2785
3200851177,3435966315,1663086163,1663086565,402,1372
3382514690,3223609360,1644344764,1644345183,419,2808
3213165707,3037876770,1668387667,1668388378,711,66
3158985452,3772556550,1655065660,1655066627,967,2381
3691448772,3643754161,1641016383,1641016660,277,3842
3083082321,3048980559,1654318054,1654318856,802,3466
3774789096,3876885016,1661432829,1661433131,302,4048
3029354569,3441280860,1666657366,1666657938,572,1894
3619738927,3143103441,1662385752,1662385939,187,3613
3149112589,3074857020,1667764305,1667764632,327,427
3024391050,3808983231,1644814113,1644814766,653,3224
3039085606,3572744681,1668828462,1668828750,288,1250
3428808686,3128347497,1661922901,1661923677,776,2344
3815087064,3641977633,1662473992,1662474370,378,2680
3832258074,3563665177,1663152189,1663152213,24,4296
3544816819,3761341669,1659552521,1659553395,874,1193
3822969250,3522542856,1654264225,1654265204,979,2520
3877143568,3302990672,1663369482,1663370103,621,4256
3237365942,3642583189,1668735233,1668735404,171,1935
3289946250,3349729358,1655752615,1655752786,171,1810
3242785550,3306738678,1656956694,1656957261,567,847
3631773555,3400179895,1653322265,1653323247,982,3555
3409074013,3957407948,1645564671,1645565566,895,2603
3832063092,3578550306,1649362015,1649362077,62,2335
3983146709,3458103347,1654431720,1654432061,341,2010
3853703601,3436097211,1648944719,1648945622,903,1555
3090403833,3272497119,1653525814,1653526404,590,1133
3985810750,3152444337,1646705961,1646706315,354,3956
3359900802,3982564767,1642974498,1642974569,71,4907
3351565044,3843452386,1661863050,1661863797,747,254
3404835762,3268826956,1662783554,1662783787,233,302
3857417594,3181709488,1655152286,1655152689,403,1857
3178250316,3562877418,1648072779,1648073385,606,4723
3027135914,3818582657,1645433039,1645433371,332,3845
3259197624,3028764365,1667660926,1667661136,210,4308
3562072690,3820279045,1667903318,1667903708,390,1622
3452623685,3021704476,1647650181,1647650929,748,514
3420670951,3133634763,1666349052,1666349260,208,2063
3570026119,3702623043,1666997329,1666997347,18,4176
3503780340,3764793756,1651523163,1651523631,468,2046
3159770609,3732610366,1649465268,1649465303,35,535
3907060670,3281698373,1641038882,1641039504,622,969
3507075084,3073100079,1648706795,1648706983,188,3814
3829583571,3575853091,1643811945,1643812231,286,879
3862874931,3521830013,1663588255,1663588640,385,3334
3959213070,3606154668,1643781966,1643782325,359,4629
3368244124,3661540931,1664684217,1664684872,655,3525
3247830000,3057584676,1663716677,1663717063,386,4428
3022290861,3143749366,1653920764,1653920769,5,3394
3640570106,3022866656,1667933500,1667934415,915,1655
3066867477,3221027866,1664225263,1664225839,576,1085
3807362369,3717185476,1641951920,1641952735,815,1666
3249682500,3712911244,1662332136,1662332269,133,1750
3339621481,3794825950,1651312535,1651312830,295,1345
3026995360,3120322009,1666878957,1666879556,599,477
3406980090,3478813303,1650186413,1650187035,622,4496
3541459228,3470283071,1661136706,1661137671,965,4306
3570106594,3567238118,1648688333,1648688416,83,229
3103447628,3501652393,1643648245,1643649024,779,2532
3644389920,3138720489,1645240395,1645241138,743,2181
3142235714,3165306333,1660456492,1660457334,842,4681
3857458964,3720556330,1657324282,1657324606,324,3755
3884328269,3714346870,1663831584,1663831835,251,308
3356720371,3396107181,1660820273,1660821070,797,4785
3057962595,3719317354,1646774547,1646774584,37,2068
3525308379,3834043625,1645207001,1645207618,617,1317
3002411098,3364745953,1651789788,1651790708,920,1414
3222384629,3006690897,1651943854,1651944227,373,3839
3964786163,3468167078,1656992158,1656992873,715,4606
3549089999,3338446249,1650408421,1650408493,72,3754
3652013055,3893489239,1654472171,1654472501,330,2075
3250610354,3406835421,1654575586,1654575962,376,4969
3363357001,3361159327,1652241372,1652241617,245,3062
3861708513,3631620647,1653826387,1653827238,851,238
3921452338,3193410636,1642315223,1642315618,395,4847
3049460470,3830657216,1648248611,1648249463,852,3327
3896645235,3304786155,1655446751,1655447692,941,4334
3129474254,3966333390,1658004137,1658004155,18,2097
3685711288,3809096630,1662082793,1662083790,997,2710
3462730071,3907845718,1643986462,1643987018,556,3706
3150251610,3368826152,1665418049,1665418355,306,4703
3683190297,3633816908,1651299317,1651299579,262,1870
3342513221,3437720811,1647263206,1647263468,262,2147
3217714371,3953575477,1644818292,1644818535,243,2118
3791996246,3945403945,1654460008,1654460335,327,4953
3042361659,3601380679,1666972029,1666972154,125,4842
3448411750,3969473373,1662630413,1662630901,488,4627
3085487833,3466881157,1662614686,1662615264,578,2959
3193317149,3923286530,1645712740,1645713168,428,4914
3074977548,3465060637,1653213520,1653213660,140,3643
3849557099,3886857712,1647323663,1647324114,451,3125
3138411588,3477288860,1660606952,1660607330,378,978
3495610642,3402308867,1661631558,1661632074,516,589
3453400938,3184624522,1654186549,1654187041,492,1732
3451094990,3400313512,1652998586,1652999580,994,3824
3479274089,3331138638,1641790994,1641791176,182,4413
3963291660,3573957301,1663959543,1663960509,966,1182
3451876412,3552496460,1663182114,1663182526,412,3477
3182823072,3477668372,1651658652,1651658866,214,4848
3908069136,3591674450,1658688931,1658689714,783,2932
3271129868,3107879346,1644377503,1644377964,461,1656
3549581486,3697875865,1657990831,1657991043,212,3316
3888326158,3407136622,1643341807,1643342126,319,4959
3085519704,3038403419,1642438583,1642439262,679,2264
3031972224,3582120512,1662601222,1662602186,964,255
3233127065,3767099948,1665260255,1665260892,637,3218
3722479539,3006268935,1647138881,1647139634,753,4491
3826182685,3537594368,1662663167,1662663501,334,3614
3664616157,3492157656,1669382091,1669382804,713,1853
3953014866,3173631062,1665142879,1665143178,299,3497
3499875495,3023311749,1647686265,1647686323,58,4264
3956829565,3000909555,1657701222,1657701444,222,4188
3780643078,3585842719,1654058193,1654058235,42,2268
3998662451,3745766807,1647260450,1647260695,245,3445
3287266530,3305734250,1648587481,1648587628,147,2215
3204106232,3324820820,1650048275,1650048374,99,4001
3293570427,3844224568,1657447249,1657447555,306,1592
3727538982,3325114816,1652137627,1652138056,429,1510
3895094001,3881140069,1656811452,1656811710,258,587
3646595761,3940242888,1642457978,1642458722,744,4463
3653151965,3487459881,1641950512,1641951305,793,1143
3891568375,3772243678,1646933301,1646934002,701,3279
3098024100,3964316710,1661119129,1661120083,954,606
3399050528,3846216432,1641913914,1641914420,506,4942
3263729106,3345623091,1659720564,1659721354,790,1611
3000632565,3438844424,1642546458,1642546957,499,1053
3578433794,3963239108,1652439136,1652439231,95,2326
3317157856,3473463885,1660440746,1660441244,498,791
3321349662,3733431988,1656933472,1656933535,63,2257
3176543755,3865525149,1661167080,1661167459,379,486
3548788244,3913855716,1649768539,1649768598,59,4949
3305829143,3005707205,1659188945,1659189723,778,4145
3615358050,3025754212,1641370592,1641370718,126,4276
3090445643,3817376348,1650289180,1650289243,63,632
3219682507,3927882623,1669014428,1669014969,541,580
3564613346,3258256883,1668509190,1668510074,884,1336
3162624163,3050480642,1647385344,1647385965,621,1553
3625114221,3079328786,1665659348,1665659966,618,390
3877929989,3246084487,1666497676,1666497738,62,1353
3692794345,3939387580,1667242668,1667243287,619,2132
3387627787,3163847043,1654137179,1654137970,791,1158
3610088458,3018355863,1655527701,1655528397,696,2870
3557240712,3277777472,1660863504,1660863831,327,806
3033741995,3344601820,1662636793,1662637675,882,3787
3240949992,3570994350,1641456414,1641456533,119,4450
3028696508,3937623660,1666275402,1666275738,336,2153
3850479896,3132745039,1668053469,1668054450,981,4729
3863501021,3660370691,1656336425,1656337256,831,3987
3735493295,3494659532,1663290559,1663290885,326,3097
3612985150,3204310723,1645093731,1645094422,691,570
3157527916,3437954809,1651701724,1651702013,289,507
3973170824,3045758916,1642511478,1642512439,961,616
3249711165,3741053653,1642608687,1642609136,449,2794
3415006904,3068694033,1644421731,1644422665,934,847
3151224686,3349475434,1641233866,1641234575,709,4468
3105715174,3804553710,1647081466,1647081905,439,1721
3848330885,3705283800,1668750221,1668750833,612,136
3436869571,3598659567,1664168061,1664168636,575,1682
3776614547,3751993579,1656533701,1656533736,35,4373
3994751675,3918661128,1648324593,1648325458,865,1246
3013979797,3909810189,1651495495,1651495734,239,4971
3052535588,3092399660,1654830769,1654831001,232,707
3622972030,3195796549,1658093378,1658093572,194,1632
3825355814,3733589302,1653076840,1653077677,837,4783
3416691403,3645511957,1645171585,1645172184,599,1892
3666300236,3563468400,1655447980,1655448187,207,1771
3843377868,3304879925,1668300443,1668301424,981,2723
3302760686,3120252138,1642667471,1642668141,670,4273
3815414116,3454710504,1660584409,1660584887,478,1688
3604932275,3237730103,1666787687,1666788460,773,4346
3704785676,3789114789,1642173056,1642173280,224,4215
3726431349,3236309931,1649377797,1649378674,877,4255
3642487632,3733679376,1646139684,1646139990,306,677
3099847274,3210229197,1643887576,1643887802,226,2088
3522168051,3260482271,1668217324,1668217981,657,738
3657346156,3127925822,1657665548,1657666229,681,4770
3521476062,3127606218,1664416916,1664417082,166,1276
3596416826,3619933722,1661767804,1661768582,778,3854
3982538269,3658587151,1660851268,1660851444,176,1214
3407226881,3189980262,1660030688,1660031001,313,4013
3933642303,3405384223,1665293101,1665293308,207,700
3844979161,3235403376,1656800542,1656800952,410,873
3687026058,3567024017,1644866011,1644866981,970,1173
3184566032,3869687389,1664657619,1664658541,922,1813
3498763046,3889423257,1666273347,1666274065,718,2941
3656546194,3767615377,1664110051,1664110249,198,3010
3960988896,3006177082,1667519641,1667519993,352,3223
3405222026,3598876076,1666764186,1666764657,471,2842
3660470032,3206935607,1652266364,1652267240,876,3874
3553949731,3191073448,1665989536,1665989950,414,3122
3805392687,3559569966,1646328346,1646328461,115,2118
3495218118,3062575373,1654658548,1654658779,231,2354
3034974660,3444173743,1645809991,1645810529,538,966
3053361229,3229596131,1653888942,1653889011,69,4806
3077461557,3764300003,1646143334,1646143788,454,3496
3951059975,3824091105,1641084882,1641085224,342,1571
3205554100,3360911125,1652836647,1652837369,722,3464
3132630543,3346674837,1657794869,1657795682,813,4416
3007674068,3713671167,1657826619,1657827614,995,2271
3578216368,3541018031,1645276602,1645277239,637,20
3767356566,3863245279,1650935918,1650936577,659,3734
3485799387,3747008094,1654048306,1654048727,421,2960
3939945084,3657685826,1668989212,1668989345,133,3289
3148398988,3374859720,1660512774,1660513689,915,2648
3156511404,3743679678,1654998050,1654998821,771,2530
3069196624,3938230129,1648279286,1648279390,104,669
3256413913,3136834252,1667546038,1667546967,929,558
3015913076,3038946560,1662613667,1662613793,126,4750
3237004130,3365441872,1652276399,1652276486,87,598
3146587340,3114431179,1663787554,1663788374,820,2735
3275477497,3040716652,1646591257,1646591373,116,3159
3415345259,3786016617,1643379364,1643379439,75,1970
3256987006,3089055122,1652029578,1652030445,867,2605
3730671580,3302346802,1645027399,1645028149,750,2708
3748840405,3415973609,1643488658,1643489521,863,846
3943480012,3072280021,1658179073,1658180049,976,441
3594314220,3244569555,1643591275,1643591773,498,442
3464677702,3778600613,1659503544,1659504138,594,4765
3892075017,3821770869,1654088669,1654089173,504,3799
3173122334,3642192913,1656553959,1656554879,920,1544
3287305932,3155211610,1660981076,1660981605,529,4272
3229313775,3550798768,1669341589,1669341908,319,1673
3167684361,3561575823,1666868840,1666869045,205,9
3451341334,3278599582,1654877450,1654878236,786,2197
3586523738,3722419570,1648327657,1648328406,749,4709
3960928527,3408813757,1650567318,1650568204,886,4883
3548064993,3477544203,1666460077,1666460740,663,1850
3011001698,3910020717,1643851222,1643851591,369,1818
3555231467,3453150875,1664320452,1664321447,995,1157
3997305004,3325873829,1645400847,1645401056,209,1132
3547754244,3575961956,1662879874,1662880558,684,2224
3013324841,3029612972,1641263643,1641264281,638,371
3304004448,3469723216,1658504740,1658505320,580,4293
3845294830,3155519389,1649209425,1649210086,661,4147
3163166040,3741976329,1666009286,1666010011,725,4213
3421551822,3532335682,1642896541,1642896681,140,2864
3582447802,3676082852,1663581552,1663581893,341,706
3094621683,3800593132,1665439817,1665440399,582,4219
3027858077,3318427160,1664904794,1664905022,228,684
3741795462,3494211176,1660744315,1660744732,417,4214
3879236693,3774222380,1661781112,1661781660,548,1836
3946374157,3426724477,1669040651,1669040680,29,1218
3574108639,3146103424,1664658009,1664658760,751,587
3664812118,3663708429,1649637134,1649637469,335,2964
3475421003,3798560972,1650993672,1650993831,159,3980
3311813357,3067041350,1663011087,1663011438,351,3110
3256027130,3571980538,1646869137,1646869523,386,3
3198007406,3756709645,1655796391,1655797185,794,4918
3147680546,3508831844,1644493938,1644494299,361,1348
3726049720,3906040289,1651993476,1651994090,614,3067
3928536229,3299595872,1663284000,1663284785,785,830
3101964309,3637483074,1642695473,1642696001,528,1287
3974032779,3107563135,1659882835,1659883659,824,1590
3400865473,3816671012,1654177780,1654178524,744,3829
3928191607,3487470445,1662154883,1662155440,557,4450
3115189870,3370315564,1647450948,1647451740,792,123
3885750519,3795771777,1665999485,1666000218,733,530
3674947498,3932594890,1661250457,1661250598,141,386
3328579885,3153967825,1661313702,1661314018,316,3741
3523997346,3358814608,1661097979,1661098088,109,410
3960119106,3231984689,1651018690,1651019594,904,564
3235728200,3479754856,1660589842,1660589952,110,897
3028940760,3528330555,1664274740,1664275717,977,4313
3335545550,3792675607,1662485560,1662485621,61,4364
3557691554,3188735490,1655133573,1655134406,833,4500
3864083764,3469713333,1659560611,1659561330,719,1806
3299595291,3412050361,1646004730,1646005303,573,4467
3706877672,3269797871,1656490880,1656491279,399,4317
3622266919,3712260848,1648175549,1648175615,66,1926
3167122248,3275600764,1658068916,1658068991,75,4818
3692202742,3435577321,1651753817,1651754508,691,3843
3130237907,3688646015,1663786576,1663787466,890,2143
3804674797,3406156468,1662296419,1662296819,400,880
3162787953,3784349432,1657702307,1657702915,608,4945
3166579014,3622890772,1645255445,1645255861,416,739
3321966744,3276501293,1660153338,1660154234,896,3409
3040951046,3994852591,1642832063,1642832409,346,2101
3370409233,3688280367,1646043706,1646044379,673,2737
3467821726,3536253176,1652187113,1652187800,687,3445
3232434060,3828989757,1655884098,1655885080,982,1493
3655509128,3404332368,1650847226,1650847872,646,807
3915471682,3976780004,1654728453,1654729179,726,4510
3030160375,3715563938,1663946515,1663946846,331,3348
3707576987,3549039083,1648683812,1648684274,462,2918
3625340784,3547854244,1651879227,1651879249,22,1846
3305796860,3133215056,1657415800,1657416117,317,2192
3685245143,3827457343,1657348258,1657348743,485,1270
3520934960,3008460932,1656341348,1656342152,804,4431
3590468838,3700211607,1651067045,1651067117,72,1872
3444270563,3396570498,1642260167,1642260269,102,2428
3594164019,3273647006,1666434358,1666434742,384,2452
3634790390,3084130944,1665566264,1665566433,169,3696
3349445535,3974195397,1665739429,1665740046,617,1080
3757549754,3223335128,1669618958,1669619811,853,979
3888657041,3144653137,1663581662,1663582079,417,3635
3299735839,3105303596,1652551061,1652551471,410,3271
3415691597,3939118767,1665797197,1665798050,853,4204
3835906887,3831921618,1642516760,1642516936,176,1529
3920442486,3495421511,1651380055,1651380724,669,3734
3184245104,3245113027,1665656104,1665656832,728,3619
3001281166,3099329679,1655805669,1655806400,731,3310
3471230514,3831589758,1644432364,1644433195,831,2881
3358688468,3420636570,1652781700,1652782119,419,2578
3414969978,3033194267,1658742107,1658742487,380,4875
3690101429,3035984430,1651023763,1651024502,739,3551
3451503035,3171591142,1661064184,1661064323,139,4996
3189356576,3949769919,1652854371,1652854965,594,3889
3674018406,3323240049,1655776630,1655777147,517,4778
3260743059,3876609164,1648591352,1648592058,706,2069
3756655047,3464407339,1659047032,1659048001,969,1350
3867929248,3386193656,1660360379,1660360769,390,2165
3325885842,3918636764,1662644866,1662645607,741,4647
3378008595,3697881708,1653810777,1653811119,342,406
3377491485,3507441027,1664538903,1664539130,227,4577
3405822355,3063549647,1652528085,1652528414,329,4943
3682683513,3525821402,1641879304,1641879532,228,1857
3058887092,3140864878,1646252186,1646253158,972,2584
3417318408,3672824069,1661333049,1661333964,915,2560
3523616222,3716441199,1652210907,1652211694,787,294
3593627399,3579007394,1648208308,1648208699,391,4749
3754533780,3663181225,1651840286,1651840302,16,1704
3586488604,3587045957,1641783376,1641783732,356,4220
3610353862,3451457368,1668716357,1668716590,233,4363
3460073623,3542920510,1669224251,1669224504,253,2671
3897258642,3901433341,1658485112,1658486055,943,208
3578104871,3623714073,1649096401,1649097286,885,4278
3119585692,3479568039,1655469591,1655470177,586,4626
3004621011,3424456956,1661198105,1661198222,117,1507
3134854082,3665233526,1660721140,1660721693,553,2267
3864234353,3874586291,1663444107,1663444687,580,2180
3222108326,3983092680,1656316557,1656317214,657,2337
3329488573,3882582916,1653114530,1653115097,567,4110
3709787199,3430636797,1665944082,1665944238,156,4411
3466278208,3373674680,1653721341,1653722265,924,1229
3307171259,3792079094,1641353435,1641353694,259,2718
3858054969,3631282962,1648729420,1648730102,682,4422
3229307627,3451198793,1657242530,1657243310,780,3809
3770342638,3849842060,1654560172,1654560547,375,4310
3243481450,3151499804,1660275983,1660276450,467,251
3766447229,3501776587,1667031923,1667032132,209,3388
3799165772,3905111751,1661758892,1661758894,2,3553
3637002840,3724260668,1662291937,1662292646,709,2703
3807521802,3556840977,1649757358,1649757964,606,4039
3630934919,3569923227,1649950936,1649951503,567,2344
3805336803,3058484178,1668874912,1668875101,189,222
3716530888,3492157656,1641129669,1641129834,165,3967
3286772610,3314493119,1664269217,1664270027,810,784
3612201785,3603641613,1645922784,1645923006,222,4389
3096518766,3414617230,1660646687,1660647477,790,2934
3743563742,3100437960,1665463738,1665464294,556,4594
3113624539,3070710283,1650949671,1650950531,860,940
3650194953,3665594503,1642391862,1642392798,936,826
3904708545,3649489520,1667832967,1667833330,363,1247
3722647299,3758822955,1660290290,1660290304,14,4081
3441064552,3115962561,1645871403,1645871625,222,2330
3705403093,3481398354,1647048911,1647049841,930,2767
3601231511,3434144661,1662398715,1662398717,2,1892
3780988438,3763845997,1655381039,1655381837,798,2992
3103086905,3753447832,1668823875,1668824645,770,2928
3300861909,3984904310,1669224458,1669224727,269,4963
3478634745,3542552248,1649873713,1649874355,642,1692
3531636085,3437683644,1657473215,1657474156,941,3232
3227872870,3815712441,1654604758,1654605077,319,298
3539825453,3983860211,1643679513,1643680230,717,1656
3781019129,3332360596,1655087042,1655087243,201,1519
3078960477,3603686273,1659364760,1659365303,543,2844
3754382212,3218409581,1647964881,1647965087,206,1514
3719445442,3318128737,1664827975,1664828390,415,4754
3270899445,3358768372,1648343911,1648344384,473,1030
3804839992,3219859379,1647159562,1647160442,880,927
3955288411,3786646443,1641392295,1641392708,413,934
3979916853,3159333416,1652874316,1652874453,137,1977
3508048718,3183348114,1665302344,1665303148,804,1933
3907038406,3362307305,1662159884,1662160836,952,4894
3752587398,3194114250,1655766900,1655767758,858,353
3793130075,3259126889,1646600837,1646601293,456,2525
3587655658,3293501044,1659407823,1659408095,272,86
3708720330,3051653252,1646690090,1646690339,249,4597
3088160759,3712053215,1655295193,1655295869,676,1634
3976711161,3181478066,1661973154,1661973209,55,3397
3373823571,3274293764,1652027246,1652027315,69,1525
3124210215,3304761193,1663721240,1663721474,234,1842
3438725911,3144691925,1646749683,1646750120,437,2962
3829271896,3209822324,1657692853,1657692870,17,3485
3684570507,3969757740,1641118961,1641119595,634,3281
3890250786,3000466091,1665994512,1665995042,530,3530
3086491974,3181524427,1665966389,1665967340,951,438
3898530809,3169080417,1650863886,1650864384,498,744
3085043567,3695606718,1668433340,1668433837,497,3478
3589622707,3640227872,1643978882,1643979157,275,219
3434301181,3757153646,1657422266,1657423093,827,2104
3639395208,3034245521,1657783057,1657783961,904,3952
3518093961,3487477799,1660894545,1660895045,500,716
3154122927,3256193335,1650478477,1650478724,247,456
3902051240,3212862420,1663711661,1663711885,224,3629
3579407013,3385924645,1652217675,1652217967,292,2941
3141165742,3237384994,1646181715,1646181765,50,992
3624320834,3134184057,1655762414,1655762945,531,401
3723957804,3799193099,1651265817,1651266190,373,4586
3444002068,3016440117,1644376660,1644376817,157,3102
3777400341,3249311996,1654955279,1654956033,754,4836
3674395386,3800468193,1652242023,1652242482,459,3336
3947111009,3843123412,1666559894,1666560018,124,1842
3614112407,3173840185,1665209434,1665209576,142,2994
3869460012,3996393217,1661887502,1661887738,236,4417
3229365569,3367938316,1655348456,1655348508,52,4795
3014169047,3769514098,1644483664,1644484095,431,4736
3096990685,3626436402,1643432656,1643433023,367,2223
3937675485,3922957717,1652277119,1652277356,237,3726
3279581175,3861425523,1654515414,1654515656,242,2522
3967035409,3926494612,1649853726,1649854129,403,1254
3149017889,3242145671,1657966826,1657967818,992,2901
3139137541,3884680011,1648907814,1648908789,975,78
3142917709,3783474111,1668155386,1668155789,403,3763
3830230852,3439437368,1651644955,1651645155,200,1715
3163038968,3023890441,1658049245,1658050015,770,1602
3727471904,3281193984,1667277640,1667277761,121,381
3700302766,3908115443,1643566123,1643567077,954,799
3052887785,3711455979,1665928960,1665929230,270,3569
3298672901,3696050364,1654726765,1654727085,320,535
3037528119,3266361335,1655552966,1655553329,363,4271
3721675234,3789148988,1646195402,1646195427,25,318
3116059596,3250936682,1658994607,1658995432,825,3765
3661598733,3680210506,1646605755,1646606309,554,536
3558098918,3576114135,1665556796,1665556817,21,3613
3016305352,3115399800,1667416962,1667417136,174,209
3581745023,3737667425,1644370963,1644371001,38,4337
3110871974,3731915703,1642958458,1642959258,800,1936
3257713517,3362990145,1663217709,1663218439,730,1389
3205582688,3629171853,1666251660,1666251981,321,3352
3645652393,3964332696,1667162570,1667163530,960,1537
3145228006,3791777733,1653488322,1653489207,885,990
3974032779,3264192866,1645272099,1645272507,408,415
3868832594,3660467333,1662217243,1662217322,79,4500
3921794871,3869582306,1646142710,1646143323,613,640
3031972224,3089664547,1664656711,1664656772,61,2386
3396838906,3419551703,1656058881,1656059557,676,4183
3669041146,3503399099,1657341966,1657342852,886,96
3004070467,3068552328,1648483845,1648484598,753,3287
3269031421,3013268639,1643162801,1643163650,849,48
3056989792,3542768718,1655760686,1655760937,251,1943
3470973028,3655501856,1647097594,1647098308,714,1377
3268546401,3296233546,1650336880,1650337714,834,1803
3831471475,3132287704,1661879023,1661879112,89,3315
3808156122,3467400377,1641479168,1641479787,619,4737
3072636222,3755185317,1644982253,1644983042,789,289
3139131718,3993865702,1665796882,1665797554,672,3705
3925100694,3303300212,1666379113,1666379299,186,3668
3755739008,3500418925,1650443235,1650444153,918,1109
3062200676,3914343214,1646242790,1646243108,318,3030
3133603332,3832838291,1650412503,1650412619,116,2953
3520433266,3575869325,1662158101,1662159004,903,3813
3168046647,3824459018,1654658531,1654658946,415,2946
3826071267,3479032856,1652338459,1652339061,602,2482
3045712707,3435359960,1657805270,1657805364,94,1483
3989577234,3998790559,1654365651,1654366639,988,3922
3820173961,3523482116,1650914162,1650914756,594,2256
3795995271,3290242375,1653430580,1653431401,821,2448
3915644488,3141344047,1653891410,1653891778,368,3810
3505149123,3609341315,1657560159,1657560924,765,3027
3220540760,3530084701,1652488730,1652489101,371,702
3502587721,3573856005,1650872119,1650872489,370,1067
3720640308,3100984383,1665906200,1665907170,970,1492
3251094045,3501580752,1655560779,1655560820,41,229
3298713345,3934052872,1669043556,1669044081,525,479
3904596331,3448626886,1656925915,1656926422,507,4756
3786913909,3485513545,1643627079,1643627909,830,2252
3834228596,3964577579,1668859688,1668860448,760,1472
3373621844,3817098387,1663232094,1663233082,988,1108
3537353030,3752353137,1643717487,1643717848,361,3414
3156436374,3088198118,1653724710,1653725557,847,1999
3668882389,3774582486,1652712112,1652712274,162,203
3183991941,3739707377,1660759503,1660760438,935,4997
3923374904,3675934821,1658213268,1658213345,77,4356
3925507867,3462445621,1649962771,1649963027,256,4993
3242364137,3756721457,1641156330,1641156655,325,3280
3970111684,3022915099,1661032956,1661033626,670,318
3682256661,3549809409,1651970713,1651971074,361,461
3307214197,3327577973,1651710613,1651710884,271,680
3744469350,3812430410,1641597754,1641598739,985,880
3389191389,3486831670,1657183257,1657183411,154,1621
3941154715,3877697314,1656216428,1656217157,729,740
3029046769,3174646127,1656501051,1656501121,70,3779
3256699344,3811138448,1643594282,1643594320,38,1674
3258179845,3300078579,1662190787,1662190795,8,1619
3530556973,3306589407,1660824874,1660825522,648,2341
3251622689,3798336320,1648530852,1648531702,850,1515
3269805400,3947575135,1655195027,1655195576,549,4182
3376107213,3764877193,1649003329,1649004090,761,4868
3521242633,3591599102,1658765260,1658765831,571,4811
3350762252,3983801015,1644608868,1644609372,504,2135
3266566393,3774901762,1654055750,1654056606,856,1443
3174572520,3861274127,1658532835,1658533791,956,3762
3560501171,3097178237,1652728278,1652728595,317,782
3353040371,3180064226,1663048176,1663048425,249,3416
3961022053,3602024735,1668193177,1668193961,784,2513
3656774579,3463464777,1658324457,1658324753,296,1486
3325936440,3166654608,1644210136,1644210631,495,1878
3451181628,3934143084,1653542034,1653542119,85,1186
3766311093,3061645026,1657363042,1657363719,677,4729
3630229483,3695994175,1656802666,1656803061,395,3822
3048906458,3006735448,1651566736,1651567482,746,133
3121046391,3860500916,1650208879,1650208964,85,1497
3946199242,3795372299,1655159202,1655159547,345,517
3642044760,3621590144,1665526069,1665526280,211,4543
3140787887,3682786206,1660307081,1660307425,344,2666
3158522370,3811756616,1669651295,1669651815,520,4960
3129324723,3966060582,1657771902,1657772053,151,3841
3603352934,3202106656,1667251737,1667251766,29,672
3452027853,3069752367,1645978336,1645978770,434,2702
3666611965,3751551528,1660213273,1660214052,779,2506
3273035597,3597861443,1666695353,1666695960,607,1139
3743853988,3104624922,1648748628,1648749566,938,295
3577667632,3537446399,1654649892,1654650499,607,4842
3331564514,3733589302,1656540549,1656541257,708,2881
3420203571,3715246227,1664759848,1664760750,902,549
3710080711,3287889003,1652981061,1652981539,478,3612
3075299536,3121275280,1668584034,1668584985,951,3328
3169111186,3725142994,1647970343,1647971103,760,626
3999566386,3743616761,1660981717,1660981989,272,1988
3835281390,3695461334,1662866081,1662866935,854,3583
3485473475,3398745321,1660232678,1660232860,182,4254
3442918047,3497631575,1651214864,1651215197,333,985
3020924194,3589234970,1651504948,1651505706,758,3251
3023927707,3822999572,1652091659,1652092118,459,4348
3835955446,3704445454,1651358369,1651358842,473,4797
3464876402,3705121957,1663143786,1663144278,492,1541
3330853381,3509095056,1649021494,1649022407,913,957
3645557254,3792869195,1653354587,1653355131,544,639
3304653702,3995469697,1658999712,1659000386,674,408
3384042064,3924843262,1650588650,1650589065,415,1473
3432702173,3157633838,1648288505,1648289455,950,4398
3054139858,3927882623,1659906529,1659906637,108,2784
3219758413,3977310763,1655702640,1655702853,213,1248
3777551989,3340304126,1661619246,1661620114,868,544
3485981972,3451210573,1662567251,1662567591,340,1538
3475794661,3089478157,1660222543,1660223187,644,4605
3122604105,3138554285,1651165345,1651166222,877,870
3820938407,3016701161,1649402697,1649403060,363,333
3174765221,3519621335,1669214000,1669214222,222,3439
3343380988,3810424359,1655548550,1655549482,932,2829
3331408438,3257020012,1645070468,1645070956,488,904
3217027880,3589584496,1653248525,1653248845,320,4601
3564311215,3452159912,1653706759,1653706842,83,4496
3657298309,3219289512,1644398270,1644398879,609,1071
3868369421,3135143432,1644208989,1644209831,842,2793
3493657340,3440209668,1658647671,1658648157,486,1878
3360719832,3797135946,1655581682,1655582337,655,1105
3783706344,3147636346,1653359402,1653360190,788,3927
3198438012,3832509101,1648629298,1648630132,834,2359
3969214846,3858113203,1667974332,1667975286,954,1499
3571085325,3852454165,1663125305,1663125644,339,2231
3018057988,3905700548,1660117499,1660118069,570,470
3101042755,3670092960,1652578417,1652579336,919,914
3566746281,3828315089,1657580506,1657580518,12,1578
3951396407,3938339792,1657614194,1657614318,124,728
3399739179,3148888999,1661129318,1661129552,234,1509
3029982023,3200803006,1655931392,1655932264,872,415
3894972781,3400449545,1667531242,1667531728,486,3140
3081485481,3176854871,1644448161,1644449151,990,294
3448454218,3952984315,1649983482,1649984477,995,2162
3893884212,3935033863,1643056465,1643056542,77,3855
3045949359,3229743602,1651428212,1651428274,62,1006
3248882161,3470463404,1666093115,1666093848,733,1419
3624436666,3284859113,1665104498,1665105469,971,2951
3804700403,3946788446,1655783148,1655783729,581,183
3735738032,3235494798,1667878670,1667879351,681,1022
3895191620,3623938506,1642950129,1642950409,280,162
3682091291,3028253067,1649525620,1649525963,343,4496
3877097043,3634620997,1660186676,1660186927,251,1867
3017756332,3298058527,1668105385,1668105910,525,4434
3880021589,3547921740,1643215676,1643215832,156,138
3103613999,3431205111,1645245620,1645245880,260,4290
3018015322,3244338570,1668407834,1668408270,436,2032
3569154740,3370585881,1646837094,1646837907,813,580
3789499934,3206101438,1658008750,1658009660,910,2070
3072794518,3821618690,1657859489,1657860090,601,1269
3717817512,3053960288,1645600149,1645600323,174,3897
3128911827,3837384636,1664419062,1664419923,861,2426
3040268426,3429191830,1659363165,1659363232,67,2383
3834433545,3862356874,1642834925,1642835533,608,4883
3488133396,3927827230,1647415392,1647415552,160,2217
3818794189,3728275576,1664133557,1664133809,252,3932
3781093579,3609670208,1655865308,1655865765,457,4919
3760534370,3230060859,1648879800,1648880735,935,2442
3392700867,3526202812,1656172365,1656173121,756,3066
3925935255,3668000175,1668619940,1668620373,433,2422
3362331195,3237379307,1661634766,1661635278,512,1562
3124725498,3520766994,1661837210,1661838085,875,574
3776882007,3507139912,1649369242,1649369873,631,212
3075004677,3753108295,1657614583,1657614606,23,1254
3225596339,3161539431,1663391722,1663392112,390,2873
3180207484,3465613118,1641127748,1641128156,408,4064
3684654490,3023103623,1657640781,1657641166,385,4380
3792380301,3242984353,1653873447,1653873620,173,846
3506564573,3320375253,1652337356,1652337572,216,4468
3490064976,3813868982,1662382964,1662383928,964,2319
3595991149,3490843299,1667009660,1667009697,37,638
3168557541,3984214409,1643565802,1643566429,627,4419
3770900770,3787503378,1658016652,1658016770,118,1905
3843057742,3543206543,1665558768,1665558994,226,4218
3718224305,3657259409,1656901294,1656901911,617,3850
3498732092,3084190701,1664100393,1664101157,764,385
3394225476,3729562452,1651299440,1651299462,22,3363
3119082518,3936803076,1662668521,1662668698,177,638
3506564431,3455211064,1647215421,1647215594,173,1581
3915949634,3455003689,1658627763,1658627936,173,3634
3011980316,3398623266,1647514668,1647515438,770,2524
3192903830,3892284006,1658896019,1658896554,535,4341
3599034080,3515818354,1644138118,1644138300,182,1284
3214937300,3027011528,1656552961,1656553421,460,403
3189120195,3619980652,1652659521,1652660456,935,1480
3107852441,3152611120,1661120713,1661121105,392,4818
3951242530,3410244374,1665981183,1665981870,687,3632
3620372335,3364787893,1663816609,1663816968,359,1876
3738169758,3735021777,1645302016,1645302498,482,3499
3389888818,3396182036,1663968913,1663969554,641,2108
3997007533,3467490740,1658781310,1658782300,990,2710
3464837841,3547030246,1651857583,1651858272,689,3843
3925069838,3857956629,1658998681,1658999533,852,1035
3420652063,3986216930,1660015869,1660016539,670,107
3168227012,3736890518,1653023674,1653024165,491,334
3180519342,3725087263,1648553662,1648554506,844,3445
3894623525,3521391257,1655321511,1655321955,444,60
3378749799,3106761433,1652494981,1652495770,789,2013
3637362317,3539580186,1661660116,1661660622,506,1077
3464801295,3714708565,1661098405,1661099399,994,4573
3225008837,3612683047,1654969538,1654969549,11,2749
3325567485,3751776429,1642303514,1642303826,312,1957
3313865497,3020218020,1643699585,1643699767,182,951
3126000108,3432223016,1667662830,1667663457,627,3843
3224507904,3407840216,1647794336,1647794991,655,2885
3923760273,3247148423,1647430476,1647430604,128,4559
3966067431,3623482717,1651527235,1651527296,61,3009
3173216625,3168395096,1649158170,1649158484,314,1064
3539945227,3538411696,1664229191,1664230123,932,2783
3870450838,3101835051,1651573261,1651573507,246,2545
3357321487,3708484784,1647020224,1647021127,903,1118
3256745557,3133320347,1641338565,1641339453,888,442
3930998966,3924689859,1658102773,1658103440,667,2076
3643357251,3736652902,1647210343,1647211049,706,2366
3246731281,3684604765,1651683766,1651684407,641,2824
3267601005,3548766058,1650311550,1650311731,181,4208
3508823569,3962291845,1649627878,1649628301,423,2431
3430399509,3723482427,1642869076,1642870028,952,963
3508295048,3246963365,1643470616,1643470857,241,464
3302021985,3453658077,1662811829,1662812766,937,47
3295334042,3038541174,1643470809,1643470838,29,4762
3621955882,3437425834,1662810834,1662811834,1000,2112
3704099013,3440786471,1663979105,1663979736,631,1845
3158948173,3948853378,1658136964,1658136981,17,4680
3646389725,3967118245,1653389485,1653389751,266,4592
3232938586,3888388864,1663379780,1663379856,76,1432
3012538830,3861480749,1645845926,1645846370,444,4836
3379738344,3846126631,1645424937,1645425091,154,3309
3819455181,3020438562,1665311707,1665312154,447,4305
3014201663,3998364265,1657363990,1657364758,768,1042
3091567405,3334871200,1643898918,1643899039,121,2107
3183129796,3437120825,1664153738,1664154252,514,1782
3110833290,3486680000,1654741366,1654741897,531,57
3008538279,3782084036,1645069466,1645069839,373,2761
3363883305,3445610875,1643790338,1643791297,959,2416
3525430029,3011642169,1649587694,1649588198,504,3172
3922894090,3540084045,1643016651,1643016877,226,532
3070030659,3545471039,1641067814,1641067865,51,3705
3030102457,3639835134,1661244533,1661244907,374,3435
3797011172,3121172441,1665829851,1665830377,526,3983
3341465704,3377014331,1664211061,1664211681,620,3552
3317249010,3724935392,1641178311,1641178569,258,1462
3874259985,3275572865,1653284819,1653285799,980,1126
3431801213,3933172107,1659933795,1659934622,827,1107
3421713340,3918906787,1665151875,1665151954,79,4454
3491726201,3865430117,1661912231,1661912777,546,1560
3666615118,3965815507,1648363364,1648363554,190,1219
3404007762,3395215660,1643948696,1643949101,405,449
3976008709,3152452400,1643758749,1643759679,930,4023
3410892927,3918886743,1647820054,1647820969,915,1827
3897372471,3044129033,1646749122,1646749413,291,3014
3440609080,3564237524,1653003636,1653004464,828,100
3525879275,3712713663,1663186932,1663187296,364,560
3945533122,3861626004,1659038957,1659039769,812,4336
3598597744,3763435877,1662926974,1662927637,663,4876
3610753752,3240690111,1643985265,1643985329,64,3639
3198856509,3531781633,1649594867,1649595570,703,2483
3860152904,3899567738,1652002251,1652002915,664,1143
3123028458,3124174400,1651080663,1651081357,694,4009
3411678134,3018753397,1665560202,1665560984,782,3299
3962413967,3103257010,1661053872,1661054869,997,2566
3838591617,3597996766,1663291966,1663292420,454,2781
3213047524,3970319091,1647309436,1647309567,131,71
3911235615,3894638224,1657742710,1657742817,107,470
3874778355,3903639499,1662414470,1662415042,572,4727
3875668227,3725048767,1667190897,1667191468,571,2380
3470218094,3583886755,1644683668,1644684482,814,4938
3728784233,3977196913,1655967034,1655967908,874,1832
3058419958,3993894617,1649656339,1649656782,443,4881
3905329623,3204277119,1650495456,1650496397,941,810
3165478948,3808828209,1651989042,1651989736,694,160
3140893803,3379043675,1658833354,1658834351,997,1229
3105521202,3011926398,1664454624,1664455415,791,1844
3712702469,3045180104,1652443582,1652444068,486,2059
3727060407,3072150173,1644968190,1644968191,1,2553
3634426403,3896384712,1654705690,1654705875,185,1314
3053016127,3052918846,1659863851,1659864573,722,1588
3401536119,3510855684,1651513185,1651514112,927,501
3155714778,3924943768,1664365692,1664366358,666,3978
3059755662,3813849154,1660657000,1660657837,837,2234
3837224236,3894448170,1642439678,1642440248,570,1331
3439895950,3950814316,1650131367,1650131889,522,4655
3729808963,3454576693,1667596442,1667597143,701,51
3585939410,3043904742,1664434770,1664435071,301,2569
3261903736,3572999482,1658650349,1658650399,50,2497
3172182066,3007564381,1662979847,1662980255,408,2449
3410076350,3894410608,1664066413,1664067258,845,850
3970656723,3236867637,1653657577,1653657990,413,2941
3010406221,3549743348,1651000982,1651001511,529,4987
3978521503,3848307782,1642132809,1642133673,864,2222
3041493993,3606704725,1658457769,1658458022,253,4114
3994162151,3270663410,1656670975,1656671945,970,1987
3741421862,3833432021,1668128143,1668128779,636,1050
3983173561,3950170742,1641246262,1641246708,446,911
3485699927,3422646363,1651810658,1651810994,336,160
3717540701,3924623753,1661249244,1661249341,97,3506
3806836757,3360336681,1654809453,1654810046,593,450
3543594540,3430200724,1665982172,1665982782,610,319
3453057702,3813136137,1655142569,1655142826,257,92
3228745110,3824260332,1650113732,1650113990,258,2226
3472097273,3156611505,1655964827,1655965483,656,1857
3924639385,3182347864,1657178080,1657178271,191,4971
3176062061,3975403236,1667451781,1667451927,146,2467
3618363400,3283021963,1660987197,1660987718,521,4596
3930077210,3251095803,1648356908,1648357147,239,4510
3842060272,3061908351,1668520445,1668521430,985,3546
3622718722,3835076954,1646724815,1646725164,349,4438
3463721906,3221985331,1665044210,1665044385,175,2536
3797534818,3053629412,1647196773,1647197297,524,4179
3867543599,3155088583,1660287324,1660287370,46,826
3577766435,3524521839,1641761778,1641762660,882,4216
3133556368,3089854334,1643951722,1643952207,485,3651
3986615008,3580231918,1652240692,1652241041,349,4356
3923991350,3181768595,1656556658,1656557647,989,1204
3815749710,3683869082,1650800477,1650801287,810,3832
3150044907,3411395716,1647574793,1647575013,220,4449
3648644127,3279449161,1655398701,1655399326,625,1229
3928530420,3631119400,1657917078,1657917982,904,3631
3046109583,3680760442,1668219056,1668219940,884,4587
3214516255,3523886004,1652294224,1652294682,458,4660
3473775133,3902287471,1660440192,1660440908,716,2872
3448946764,3223150135,1662106347,1662106743,396,2193
3379020408,3194252833,1653584045,1653584429,384,3857
3757752521,3135634236,1646931747,1646932696,949,3952
3055852003,3616671277,1652629322,1652629422,100,4672
3992191014,3160999793,1660539166,1660539773,607,2867
3360408220,3105776288,1661473978,1661474221,243,3636
3864673913,3459692630,1653906176,1653906380,204,3198
3953742105,3536869292,1653096774,1653097054,280,2431
3882484338,3012111672,1656470289,1656470958,669,4947
3681997640,3048707031,1660111109,1660111343,234,4852
3492171703,3384327884,1660899861,1660900083,222,3243
3002810995,3627659504,1658069600,1658070092,492,4095
3041995014,3391978797,1649374820,1649375624,804,907
3569116250,3981929957,1661143264,1661144165,901,2127
3281408444,3236051845,1657250343,1657251155,812,479
3388661207,3824607987,1659456129,1659457119,990,3890
3876277245,3988651887,1657065984,1657066614,630,2293
3891290479,3411924900,1665980118,1665980681,563,2237
3445453908,3483073491,1656481443,1656482310,867,3142
3742818812,3484401614,1646252716,1646252727,11,461
3202119402,3535661845,1649653640,1649653946,306,1508
3493741649,3560203997,1647394743,1647394845,102,4624
3107852441,3087219145,1667905780,1667906153,373,1422
3779496330,3868573410,1650863672,1650864511,839,3915
3190243200,3632716737,1653447581,1653448179,598,1477
3835948529,3905752419,1650227510,1650227694,184,3762
3391072014,3641871648,1651344035,1651344119,84,846
3600795688,3010847998,1649441769,1649442150,381,1965
3092962883,3943835186,1647068824,1647068832,8,4173
3389369287,3256451589,1667975101,1667975937,836,3813
3645744896,3126543051,1656499780,1656500448,668,843
3410504083,3901899817,1658626612,1658627424,812,3319
3663931413,3938229409,1657556382,1657556701,319,4248
3107201408,3444518677,1655553430,1655553612,182,2773
3482515141,3191319951,1645800450,1645801065,615,492
3855162691,3737924822,1656964728,1656965435,707,758
3603156983,3575219759,1664230784,1664230992,208,2897
3188323214,3179755138,1661933580,1661933685,105,3806
3479741331,3508446379,1668045504,1668045810,306,4728
3025430437,3877026725,1649345883,1649345943,60,3256
3202859403,3027858077,1643744595,1643745455,860,4802
3869317983,3379047843,1654120717,1654121686,969,4355
3738632434,3161022966,1664945742,1664946198,456,2381
3153745256,3980670851,1647386484,1647386678,194,3279
3711591217,3241946052,1660326027,1660326154,127,4167
3472436734,3883336854,1647808676,1647808768,92,2503
3637116280,3416497485,1653545422,1653546417,995,4387
3676839502,3460393822,1669103690,1669103840,150,3111
3820487291,3541636898,1668077887,1668078584,697,4581
3151224686,3474816057,1646688954,1646689303,349,2273
3350088291,3485187051,1648519031,1648519483,452,1139
3379479656,3142397637,1669350054,1669350644,590,1779
3074175715,3878925520,1663920005,1663920670,665,1705
3541765842,3778168719,1656629312,1656629670,358,1837
3036318154,3367037869,1646129771,1646129837,66,2526
3844357792,3481027169,1664161387,1664161811,424,644
3060299761,3559281202,1665853175,1665853913,738,4099
3407831261,3073820304,1642783676,1642783876,200,4368
3842678089,3663164198,1648032093,1648033008,915,117
3883320490,3908909021,1666049360,1666049499,139,578
3565646617,3026997034,1644710690,1644710729,39,4433
3169662624,3336341591,1651970650,1651971108,458,296
3233071806,3362809911,1650391557,1650391802,245,3698
3032000672,3683952553,1642006184,1642006673,489,3052
3632332308,3276789451,1645676464,1645677135,671,1363
3200897668,3035999049,1654489150,1654489931,781,2957
3694743429,3772615212,1658580836,1658581500,664,3925
3911588813,3309171876,1651845295,1651845588,293,2853
3746023865,3318968924,1668828115,1668828486,371,4642
3429224552,3631622174,1645193835,1645194226,391,4978
3953614749,3968157955,1658300830,1658301094,264,2019
3658830091,3658194021,1657375904,1657376005,101,3728
3223543273,3159116432,1658649745,1658650522,777,3505
3251556226,3647813019,1649081943,1649082380,437,1453
3925935062,3406899653,1654515844,1654516083,239,4494
3234229602,3693153834,1642589921,1642590615,694,1016
3290949672,3493078632,1656403172,1656404063,891,1199
3699547044,3528750246,1643331043,1643331372,329,4453
3224434359,3585144374,1660498617,1660499257,640,4026
3290265844,3406146241,1642793747,1642793766,19,1983
3088747469,3042101441,1654873126,1654873434,308,1802
3481144193,3049482106,1661224442,1661225240,798,1563
3087974156,3703537726,1653112227,1653112797,570,132
3904317752,3675260879,1654288008,1654288122,114,1404
3814392247,3445427214,1669223903,1669224450,547,4942
3175743071,3145702411,1648478453,1648478673,220,3918
3475250189,3213038180,1663924729,1663925357,628,4939
3905563657,3319038946,1650575319,1650575413,94,4687
3121043458,3111589399,1647628756,1647629639,883,1622
3156611505,3931670865,1669416290,1669417074,784,1566
3545362498,3427547559,1654936640,1654936722,82,647
3923949823,3956455518,1669662370,1669663340,970,3374
3872421127,3154754431,1669018517,1669019504,987,341
3543390598,3959574866,1659719380,1659719681,301,1788
3677267631,3839448828,1641079761,1641080063,302,2725
3612789709,3381533898,1665126487,1665127223,736,3769
3890261863,3685857995,1658251835,1658252275,440,3582
3498221393,3922936360,1651685381,1651685829,448,825
3295275970,3458981372,1667239487,1667240110,623,1015
3812205967,3155469219,1641174237,1641174420,183,2282
3956493134,3585758692,1668742199,1668742245,46,339
3927984989,3044322792,1659451472,1659451771,299,2694
3353954003,3885617330,1649699388,1649700354,966,4634
3786612758,3025050612,1659367703,1659367749,46,4593
3576123170,3015671287,1654054037,1654054261,224,1888
3844623038,3560648766,1655684609,1655684824,215,1283
3287089445,3582873447,1658989049,1658989901,852,2643
3103603936,3138036751,1667870545,1667871317,772,4956
3221979922,3550698426,1663071377,1663072136,759,3177
3368786957,3330547321,1655145131,1655145249,118,50
3298389571,3198670286,1657844315,1657845178,863,2453
3760907597,3048093798,1641275765,1641275980,215,3812
3867048506,3115593104,1654752368,1654752384,16,2868
3853813922,3949468373,1647452241,1647452352,111,3554
3965400779,3841878095,1659684319,1659685089,770,1115
3972085049,3661969622,1644460548,1644461438,890,617
3829876496,3037552284,1654749210,1654749341,131,4801
3495607904,3193375375,1645947034,1645947955,921,1922
3829819638,3522227067,1646383079,1646383610,531,4321
3975712439,3872770276,1647632125,1647632791,666,1764
3593915988,3273870303,1668016097,1668016884,787,1074
3432108685,3791220112,1643567791,1643568418,627,1482
3829983569,3534428800,1657253121,1657253164,43,4894
3385111003,3755232343,1659100038,1659100214,176,1412
3753254259,3698715131,1659252297,1659252596,299,4399
3068810493,3652586277,1664751267,1664751768,501,2590
3097820673,3452908172,1644474189,1644474514,325,2131
3464094259,3954500971,1669511326,1669511584,258,4352
3872475655,3119688751,1643381489,1643382146,657,820
3651197020,3888735330,1644235470,1644236191,721,472
3894666723,3384151655,1666465591,1666465913,322,2144
3685248983,3972027204,1662624752,1662625294,542,3141
3047906170,3371335947,1664916422,1664917066,644,4490
3667421119,3169893213,1662207528,1662207903,375,3762
3782980818,3163319660,1654178865,1654179632,767,4973
3651642128,3720275481,1644348025,1644348419,394,431
3949850819,3813336855,1659947610,1659948337,727,3480
3922768084,3642747934,1659471528,1659471780,252,3405
3225744048,3838794054,1660867584,1660867993,409,1322
3550947118,3130584731,1664452136,1664452719,583,691
3373732894,3778392581,1656176905,1656177345,440,4526
3390808669,3624294564,1645592901,1645593261,360,3640
3924863006,3376302670,1657116924,1657117468,544,2034
3653347859,3249204623,1658042307,1658042523,216,1364
3402338342,3580086371,1657740485,1657740491,6,3733
3258451504,3379122804,1650783432,1650784017,585,3019
3269192801,3476770767,1662428079,1662428607,528,1965
3194623673,3520585021,1669377253,1669377287,34,4017
3474403141,3501172852,1642371256,1642371463,207,18
3009092732,3903379554,1643079117,1643079980,863,3683
3269016229,3751538416,1668500774,1668501526,752,1850
3718280032,3528921898,1662288861,1662289073,212,4914
3773283615,3993841688,1655612082,1655612097,15,2399
3889532010,3552898806,1653412276,1653412354,78,4298
3032597144,3810321608,1648737695,1648738240,545,1273
3596960936,3741690017,1644160430,1644161211,781,1042
3914048338,3507021831,1656410773,1656410938,165,4507
3325427279,3306558972,1646936994,1646937118,124,2883
3024722909,3304130601,1642214297,1642214637,340,2181
3886904988,3504052354,1646777382,1646778113,731,3097
3033612154,3163447921,1644196811,1644196862,51,4367
3661832484,3502430116,1664134280,1664134284,4,973
3427503965,3551754439,1645074600,1645074887,287,3847
3968960831,3149811767,1645052836,1645053125,289,2033
3939276293,3698654702,1651203255,1651203857,602,4086
3370879565,3281408444,1649142988,1649143830,842,3735
3706649155,3362918729,1659813973,1659814436,463,2474
3639790922,3176570711,1645623844,1645624798,954,3547
3841121138,3365978893,1646360255,1646360482,227,3121
3091070732,3958214103,1642213747,1642214586,839,2956
3618897463,3155891558,1661961047,1661961864,817,1132
3497073562,3210798445,1667149913,1667150494,581,108
3579416113,3203014376,1645947512,1645947985,473,204
3856712110,3744584880,1649408305,1649409061,756,4343
3068640271,3093117900,1647136245,1647137161,916,4577
3956090742,3287174301,1651056952,1651056968,16,4921
3155434505,3007980330,1665072832,1665073114,282,3513
3640408568,3899998283,1650957411,1650957646,235,3600
3048670780,3283939118,1647427479,1647427547,68,2163
3854127450,3443982399,1662422529,1662423179,650,2500
3358462506,3313973797,1663135631,1663136343,712,2689
3308104550,3562072690,1647135851,1647136001,150,4292
3448052494,3553767578,1641458827,1641459290,463,699
3386328164,3167841890,1655568849,1655568857,8,4326
3368025670,3793542905,1652682837,1652683799,962,725
3668575620,3390141524,1660379476,1660379481,5,3149
3077492318,3280915879,1650104950,1650105361,411,1331
3489754743,3526584468,1667669756,1667670208,452,4157
3816614606,3715721393,1666941645,1666942406,761,2581
3922490543,3868359332,1660083159,1660083889,730,113
3229865554,3118047899,1660930107,1660930703,596,1437
3656090401,3847762680,1647990389,1647990787,398,2349
3365616455,3777713578,1656175273,1656175932,659,3072
3412854664,3798512562,1664036578,1664037399,821,760
3923779015,3681744757,1666749652,1666749992,340,225
3635099057,3207298990,1643552866,1643553677,811,1354
3714957018,3260904928,1646081554,1646082520,966,2437
3671192130,3172367634,1665486415,1665487308,893,2721
3839290252,3930038530,1647994742,1647995055,313,2387
3143434346,3242394470,1660766135,1660766570,435,1895
3759241712,3568823239,1648994790,1648995453,663,872
3068247893,3507021831,1642625065,1642625519,454,1477
3150392865,3488929976,1646662085,1646662953,868,3581
3756137594,3418236661,1660743998,1660744007,9,1253
3789961910,3421418134,1654020221,1654020653,432,1612
3874549392,3874073217,1657973319,1657973874,555,3696
3524193951,3070307821,1648850931,1648851606,675,4484
3815621431,3024712798,1650922978,1650923587,609,4050
3407993073,3396564340,1662245920,1662246595,675,246
3862170700,3097542740,1644505207,1644506185,978,2072
3898379095,3220196774,1667438398,1667438996,598,1531
3002853414,3285515771,1658939870,1658940298,428,434
3766727007,3969334261,1664907692,1664908501,809,2406
3564886171,3539805961,1649101849,1649102183,334,1780
3980670851,3651718863,1669034719,1669035240,521,1112
3617595336,3373704663,1654952948,1654953015,67,319
3657246130,3773211747,1656352788,1656352794,6,2555
3611333661,3142457780,1643205969,1643206446,477,3036
3013973784,3142152925,1652742278,1652742400,122,1012
3757054903,3742841337,1655063004,1655063364,360,1676
3216860946,3599464857,1660889095,1660889393,298,2858
3011081042,3584984077,1649967522,1649968358,836,539
3100058401,3599695681,1666691177,1666691995,818,4870
3644772682,3488326890,1666900535,1666901248,713,1353
3072805217,3177341328,1656707493,1656707634,141,2501
3517771907,3501225372,1643792189,1643792548,359,2090
3987976841,3819486210,1664112181,1664112912,731,2798
3617697894,3093674476,1652032161,1652033042,881,2587
3716351233,3671192130,1648845231,1648846190,959,3340
3433425518,3493644301,1641781055,1641781409,354,4119
3518327158,3018999927,1642915993,1642916519,526,3464
3670304392,3179137210,1657491935,1657492822,887,4214
3126499099,3565313308,1661484839,1661484908,69,3752
3538702163,3385191092,1658973444,1658973666,222,3969
3526478799,3295434208,1651123648,1651124562,914,2730
3640157432,3203740729,1646890190,1646890492,302,762
3847452415,3856189374,1654730962,1654730979,17,4573
3498767266,3078480300,1658073260,1658074021,761,377
3302028039,3591673770,1651301120,1651301430,310,4366
3106271056,3260369431,1643519762,1643520324,562,1084
3302502861,3936945702,1647060600,1647061500,900,2539
3794888671,3151754241,1669637986,1669638283,297,3690
3591626397,3490217593,1649932001,1649932737,736,2747
3071672679,3317529255,1661616972,1661617169,197,1915
3961033659,3864973359,1667273638,1667274086,448,3222
3758233571,3773809205,1657942130,1657942758,628,2555
3446035059,3715988636,1651941573,1651941804,231,4453
3357158210,3389997018,1655629366,1655629658,292,2372
3773934983,3024960152,1645297726,1645298523,797,315
3516882671,3926422243,1662903098,1662903326,228,4986
3403327086,3652542985,1656374511,1656374830,319,1993
3874875675,3909835317,1653907200,1653907703,503,301
3253064787,3510529244,1648057771,1648058248,477,4714
3102633902,3318301464,1652063936,1652064722,786,4713
3309818110,3883234057,1646188208,1646188307,99,2962
3248363112,3289211217,1664123862,1664124111,249,4731
3074633497,3779182702,1651025595,1651025807,212,1814
3660556401,3594461115,1645917802,1645918611,809,2786
3832754611,3478807075,1655491194,1655491996,802,2572
3204532384,3109267078,1653063870,1653064670,800,2466
3341510239,3758420719,1664362485,1664363484,999,2682
3017756332,3181780519,1668930305,1668930337,32,4009
3489455627,3630119090,1651769341,1651770205,864,2556
3954106844,3205026260,1661381412,1661381840,428,3104
3000597190,3482134667,1641326141,1641327141,1000,2868
3810625404,3023932100,1662645143,1662645491,348,2972
3442895723,3045691347,1647885716,1647886609,893,1301
3665662562,3907603997,1647018679,1647019253,574,2471
3101289764,3911162326,1661296531,1661297459,928,3459
3378325492,3606139954,1650392759,1650393150,391,4297
3942811741,3027734528,1662632553,1662633416,863,2625
3031261958,3792662360,1656166332,1656166428,96,2496
3906128412,3702606713,1653625096,1653625589,493,4063
3419190420,3799155870,1650594483,1650594843,360,1663
3927913845,3396395328,1658548263,1658548449,186,1475
3289063822,3983839649,1667851260,1667851558,298,3107
3492691701,3932988011,1654818614,1654818776,162,618
3528346011,3616616450,1652325409,1652326029,620,679
3389959762,3028089969,1662331918,1662332551,633,4361
3401545620,3919954883,1651321987,1651322507,520,3279
3398927661,3613581272,1665385146,1665385687,541,386
3134755805,3841165511,1651064413,1651064434,21,974
3588688900,3599729367,1652567289,1652567718,429,2159
3089854334,3173240010,1642732246,1642732834,588,20
3746863006,3625023801,1651297133,1651297737,604,2617
3971089516,3757774602,1649847295,1649847513,218,550
3704314360,3599095978,1661312168,1661312192,24,1339
3918529968,3691910265,1648586490,1648586712,222,2101
3229673754,3901549129,1642429533,1642430173,640,2101
3195835017,3559285579,1652487967,1652488528,561,4238
3388887968,3369837585,1646275171,1646276064,893,3821
3745505807,3477206652,1668166035,1668166131,96,3022
3447542018,3998858332,1641194214,1641194684,470,491
3801235113,3487559945,1648717838,1648717910,72,1511
3914637156,3741947092,1660332038,1660332256,218,3044
3255501414,3087410489,1646232415,1646233292,877,3107
3939258547,3676408628,1653489742,1653489857,115,2420
3028488037,3804535082,1662342743,1662343682,939,667
3696389285,3685698637,1645896517,1645897397,880,1687
3305428004,3489002186,1660424334,1660425229,895,1891
3697874948,3114946810,1666386800,1666386809,9,4992
3126472874,3858763091,1665417862,1665418073,211,3594
3381044497,3134621240,1646393094,1646393761,667,319
3406040142,3232491291,1653383847,1653384359,512,521
3866848895,3136216319,1646724624,1646724733,109,828
3385111003,3639492350,1669431037,1669431564,527,215
3318095420,3820102546,1662612133,1662613097,964,2995
3612573355,3416128875,1654140287,1654140596,309,2292
3662608273,3504001864,1658929207,1658929760,553,4527
3222832081,3424195260,1647531205,1647532069,864,4982
3185914561,3492725119,1646313858,1646313898,40,4353
3493974787,3002918072,1663852543,1663853328,785,2462
3397849462,3739904710,1660219232,1660220152,920,1192
3663675434,3003047109,1660459197,1660459349,152,3169
3841324221,3179646316,1665717260,1665717487,227,1402
3004743222,3963784432,1665055789,1665056503,714,3578
3542752085,3726977702,1662212674,1662213256,582,1299
3289062482,3033427999,1656052140,1656053088,948,1334
3500860813,3180157948,1648433620,1648433683,63,2913
3813408197,3331845465,1664299944,1664300631,687,1328
3448139268,3578679511,1656167309,1656167393,84,2927
3154233220,3561801327,1647071575,1647072496,921,4228
3089823570,3639721073,1647810337,1647811066,729,4720
3357613361,3384584860,1667593605,1667594379,774,929
3540253447,3366105522,1646632177,1646632691,514,1713
3852362831,3056995350,1654424785,1654425152,367,803
3642487632,3700677506,1645326066,1645326446,380,4665
3411673417,3365837349,1644259826,1644259913,87,1826
3777055634,3402345379,1644750807,1644751240,433,2271
3048093798,3240034252,1659615805,1659616798,993,1299
3578297161,3215277133,1664360508,1664361309,801,1805
3578134850,3661032606,1660677107,1660677371,264,3918
3831243125,3569613825,1656564884,1656565713,829,4786
3513454344,3823128771,1642529926,1642530067,141,627
3054416076,3023613743,1651990672,1651990790,118,1929
3323707801,3188849494,1658186717,1658186837,120,19
3219720519,3231931230,1649933261,1649933339,78,3205
3807421467,3969460191,1642291965,1642292770,805,398
3607516706,3988440344,1647867771,1647868056,285,3474
3221260804,3706259793,1657778424,1657779314,890,370
3219860087,3172412276,1664971786,1664972103,317,1893
3047094142,3472597795,1669057199,1669057287,88,2421
3191590925,3590972360,1655446861,1655447585,724,1609
3507944199,3776384999,1646015761,1646016270,509,420
3388856770,3343883342,1649761975,1649762651,676,639
3893254150,3112733010,1666303084,1666303756,672,1862
3883923620,3636112235,1659759296,1659759827,531,4700
3638298292,3835059973,1642359142,1642359786,644,367
3428498825,3823914978,1668945110,1668946051,941,3200
3828970830,3142763458,1641796233,1641796736,503,497
3266030403,3476128432,1641350299,1641350720,421,4257
3808637613,3488226156,1659220337,1659221190,853,722
3309497755,3594222049,1647364664,1647365374,710,1967
3055243618,3663783887,1657535121,1657535571,450,3023
3845665720,3642966017,1642091411,1642091823,412,1108
3373792043,3746960590,1657062164,1657062405,241,2471
3099086842,3372967124,1652677383,1652677793,410,4433
3422212191,3643918723,1664509360,1664509648,288,2641
3158165366,3573215967,1653532887,1653533845,958,955
3465660779,3258811030,1656394538,1656394616,78,758
3915066274,3405578222,1646678465,1646678854,389,647
3949997516,3348611893,1645734230,1645734723,493,1683
3124576556,3948588157,1664525730,1664525827,97,2576
3559611897,3508097014,1666413943,1666414088,145,1873
3070718273,3172651732,1655384439,1655384485,46,1802
3731178656,3733722909,1667749867,1667750038,171,2890
3887450275,3179187377,1644782449,1644783432,983,1544
3674295339,3091387210,1650291628,1650292609,981,188
3378118734,3579061852,1650759446,1650760331,885,2795
3403937107,3505316147,1650935331,1650935415,84,2824
3730709044,3344974414,1664219857,1664220565,708,332
3955726765,3395325057,1668011697,1668011703,6,4199
3577444955,3445851208,1658955448,1658956085,637,3412
3197233544,3823935301,1655395509,1655395647,138,4021
3219859379,3642660081,1667424371,1667425029,658,3505
3548568847,3481057054,1663810804,1663811427,623,4117
3847762680,3851858540,1667838888,1667839040,152,2560
3841993448,3691128293,1660021344,1660021383,39,997
3941677671,3102419317,1644691711,1644691736,25,3419
3483287241,3250499861,1667596313,1667597227,914,3918
3204351113,3635629334,1656731387,1656731941,554,2172
3050727687,3794544498,1656492569,1656493276,707,1505
3063698377,3852085365,1652570349,1652571119,770,3400
3163534245,3626784838,1652931028,1652931232,204,4310
3759254304,3390736355,1643009449,1643009872,423,2489
3883252330,3057402484,1663343696,1663344221,525,4939
3620444484,3548635788,1650554700,1650555607,907,4328
3163447740,3481515367,1665581345,1665581749,404,2052
3889682498,3418084658,1643642732,1643642996,264,2039
3460254023,3123072290,1660239674,1660239894,220,3126
3041459313,3659313974,1656302134,1656302717,583,4426
3087366442,3215891388,1645134124,1645134650,526,431
3413571032,3367081863,1657974728,1657975538,810,1080
3877541644,3372657881,1663506632,1663507533,901,3792
3731012745,3335175989,1667649140,1667649673,533,3463
3368132116,3476141628,1645228685,1645229511,826,2242
3114298247,3719933274,1653471908,1653472246,338,3489
3743067322,3978369295,1655243354,1655243710,356,39
3010232074,3841288480,1659040395,1659040493,98,2623
3253978181,3649719817,1652280044,1652280880,836,2432
3682683513,3673146707,1645692478,1645693143,665,2207
3914717235,3924056689,1651289833,1651290300,467,1838
3573466975,3134854082,1641487869,1641488857,988,4018
3158268429,3748628564,1642982751,1642983332,581,4799
3397838316,3521226292,1649976304,1649976574,270,3206
3416133889,3610206541,1653403350,1653403517,167,4623
3182002412,3536191542,1641179185,1641179405,220,1673
3351768859,3674464047,1664448204,1664448256,52,1963
3282444495,3511370718,1642094739,1642095723,984,3681
3206534466,3252526521,1643880528,1643881061,533,3671
3633324647,3989447218,1659567651,1659568435,784,4818
3851121386,3951277109,1657460292,1657461268,976,2775
3505453370,3161240411,1649892788,1649893039,251,2816
3037727864,3145216282,1667520253,1667520868,615,2180
3753246982,3300159293,1648690854,1648691060,206,440
3975623986,3643606171,1668949716,1668950200,484,4771
3117489238,3113929144,1652944374,1652945170,796,4691
3315632505,3473703218,1658178288,1658178698,410,526
3712817281,3188116127,1641585374,1641586012,638,2308
3559723273,3152242739,1664419922,1664419934,12,1218
3553165476,3646468846,1655453073,1655453543,470,4625
3250713905,3409242403,1658999649,1659000543,894,623
3119980612,3595093830,1650465206,1650465339,133,2145
3280681943,3475942573,1661612134,1661612740,606,724
3239334862,3204799060,1664996127,1664996318,191,1861
3313522360,3410138975,1653275558,1653275740,182,1342
3707039253,3654767264,1667195850,1667196354,504,1587
3333901007,3230997979,1658993100,1658993859,759,1630
3882569161,3390684476,1645983263,1645983922,659,1850
3533426089,3685314247,1650177129,1650178070,941,802
3152326493,3054461380,1661481327,1661482123,796,1253
3756220499,3420152740,1645868641,1645869230,589,3880
3686337045,3720265769,1648394826,1648395786,960,1872
3319015093,3718555715,1662453672,1662453705,33,631
3292595397,3829667343,1643563381,1643563611,230,3479
3538130018,3798856477,1645237523,1645238480,957,1811
3515099297,3532212141,1663722012,1663722821,809,2618
3939308165,3600447523,1649719859,1649720031,172,3786
3356734843,3587024232,1653458893,1653459544,651,4515
3940244190,3948117478,1665026082,1665026120,38,3783
3747153762,3716210239,1641178611,1641179202,591,13
3821444988,3229981527,1651279476,1651279857,381,1777
3125907037,3137784775,1661663501,1661664223,722,4500
3481667877,3374747968,1669675938,1669676594,656,2454
3944840398,3213437762,1646504563,1646505133,570,527
3696240948,3204080206,1644876941,1644877650,709,4612
3400594837,3835392769,1653193805,1653194219,414,4824
3226754944,3913843257,1665859171,1665859336,165,4122
3607796902,3271511091,1650894932,1650895408,476,153
3259248419,3728990183,1649653533,1649654353,820,920
3273274449,3852097223,1648277956,1648278629,673,2228
3867197134,3244975470,1647994197,1647994473,276,3325
3946447889,3977957690,1665450093,1665450318,225,4629
3814011503,3259719933,1655568406,1655569048,642,2996
3465358454,3052297876,1666165321,1666165385,64,4881
3682694656,3697784923,1652637007,1652637424,417,837
3027247611,3572535707,1644324520,1644325030,510,3498
3536796324,3554143233,1660373430,1660374264,834,1545
3153719338,3450635567,1656869270,1656870245,975,796
3245910204,3690619292,1661820547,1661821520,973,1993
3449217539,3948346216,1644967512,1644968324,812,752
3449325882,3264623441,1647286229,1647286909,680,3866
3749960227,3562011326,1668561366,1668562290,924,3305
3060502848,3148467735,1643330444,1643330971,527,1942
3476088139,3327283172,1648339449,1648339771,322,1532
3121465589,3291308675,1647255849,1647256717,868,39
3881391844,3354281398,1667076928,1667076989,61,3743
3993248480,3608198695,1668029869,1668030051,182,3767
3298976830,3854318155,1656894054,1656894790,736,3856
3286953111,3504570073,1653876983,1653877859,876,569
3933642303,3332404351,1666971933,1666972101,168,3235
3135226114,3954232848,1666331773,1666332701,928,2206
3656475058,3269034746,1667548278,1667548286,8,3021
3904012515,3850536341,1652452665,1652453660,995,1547
3148851834,3714113422,1645078810,1645079308,498,2189
3994199553,3909571198,1668282809,1668282988,179,12
3644917662,3845504662,1662053039,1662054029,990,2169
3998811665,3815105195,1642432220,1642433045,825,4389
3688991941,3460476670,1641465506,1641466312,806,687
3128724131,3450554095,1641826630,1641827022,392,3778
3691313972,3846011900,1646313536,1646313653,117,3424
3569940241,3196348219,1641043072,1641043948,876,3123
3078835319,3341604313,1649462828,1649463515,687,4745
3574089711,3930660639,1660903367,1660904159,792,2407
3641422471,3524756955,1655817347,1655818049,702,2267
3088610204,3188110287,1664440072,1664440814,742,4549
3063265006,3067890517,1661114203,1661115109,906,3664
3837558143,3501085774,1669612968,1669613691,723,2599
3036782454,3324087315,1669228310,1669228492,182,2449
3174855015,3605402793,1657311914,1657312238,324,2759
3653792563,3363960581,1666412568,1666413161,593,2728
3614194501,3485393728,1651220986,1651221141,155,698
3056500759,3854352618,1660534567,1660534713,146,1958
3191924624,3294065153,1667920006,1667920887,881,2048
3246408680,3618146499,1664660436,1664661184,748,887
3631316695,3213694515,1653943921,1653944154,233,3525
3751795478,3557756432,1664410945,1664411195,250,4063
3269362547,3456396664,1655878265,1655878780,515,2818
3105766096,3192382331,1650971009,1650971203,194,1128
3350702593,3552786792,1653044562,1653044933,371,660
3426443090,3752274795,1659232059,1659232960,901,98
3100714009,3070197986,1656921005,1656921310,305,823
3705745640,3866276289,1659480334,1659480715,381,4640
3257360139,3884139433,1669229162,1669229238,76,2780
3348244594,3688861183,1668111255,1668112036,781,1838
3047947969,3764567553,1667510864,1667511236,372,2030
3732036582,3514318527,1646950715,1646950764,49,3136
3372967124,3394288364,1660582828,1660583527,699,3886
3015549459,3082105928,1643421595,1643422143,548,3811
3094648547,3614582300,1642992787,1642993756,969,2942
3920561907,3960371688,1646298909,1646299443,534,4314
3062151258,3629022069,1668832366,1668832585,219,1432
3154834631,3197912191,1664156656,1664157286,630,594
3651529566,3125021256,1658165723,1658166611,888,3853
3714104315,3627228313,1648868753,1648869362,609,3537
3733596818,3353901227,1652644192,1652644771,579,2914
3213047524,3472516855,1664710546,1664711028,482,2329
3149462747,3635760637,1641711147,1641711496,349,2298
3496056460,3391034483,1651398267,1651398521,254,1232
3380563917,3315082183,1653123071,1653123304,233,2383
3667243497,3151874564,1657314767,1657315246,479,4860
3130304796,3656350321,1665210934,1665211762,828,2201
3390629319,3512916510,1650188418,1650188891,473,1381
3438210172,3892953381,1664563843,1664564358,515,4720
3322814787,3353833603,1661572484,1661573047,563,397
3783161509,3738639047,1657349492,1657350247,755,3506
3901961286,3607014173,1658027897,1658028572,675,1973
3161488036,3278774233,1662582278,1662582491,213,481
3891983196,3846728280,1644320012,1644320712,700,1676
3146719250,3551155490,1646438458,1646439075,617,1610
3178875661,3388048068,1668054640,1668054721,81,4826
3461444089,3073385360,1650324169,1650324194,25,562
3248893374,3598761948,1666446787,1666446901,114,908
3205557604,3967962635,1651221158,1651221877,719,191
3248739716,3390911887,1668650543,1668650754,211,546
3763089845,3919109316,1656688038,1656688518,480,3436
3399809676,3631978249,1658999536,1659000447,911,3125
3965226283,3326688851,1645059430,1645060043,613,1254
3579818342,3665357438,1641248602,1641248758,156,3851
3334233967,3808768934,1660867434,1660867912,478,4
3306254664,3832578522,1656164658,1656165043,385,3627
3738485370,3770917606,1648884076,1648884912,836,1894
3739568400,3604125810,1661293430,1661293922,492,245
3153471336,3231772750,1644359726,1644360242,516,4768
3283110613,3316734764,1663644426,1663644693,267,2382
3290682353,3853124401,1659623565,1659623726,161,2979
3789959617,3374562931,1657868945,1657869589,644,909
3305637967,3500429839,1658003634,1658004028,394,3873
3919776917,3811678193,1645220073,1645220618,545,748
3432630268,3337951654,1654130277,1654131272,995,2032
3946217781,3271096048,1645014360,1645015231,871,4665
3744048373,3813269373,1667788850,1667789416,566,1987
3706075960,3960488778,1665039027,1665039212,185,3255
3520433266,3203278013,1645542823,1645542941,118,3253
3088203172,3275203126,1649793060,1649793086,26,1270
3711874050,3707530712,1642921322,1642922151,829,3272
3809173608,3173099487,1647541482,1647542442,960,3836
3453449250,3772241112,1664354359,1664354744,385,3109
3445152992,3340428394,1666929294,1666929949,655,2506
3602701170,3121958814,1660748935,1660749125,190,1709
3875750919,3865751565,1649307306,1649308093,787,2366
3161968899,3422667843,1662639699,1662639750,51,4030
3065597043,3638628352,1668132691,1668132916,225,2305
3058237555,3546914292,1646262552,1646263088,536,908
