calling_number,called_number,start_date,end_date,duration,cell_site
3575715668,3909281743,1656193684,1656194520,836,1257
3195534254,3599869347,1649747953,1649748463,510,1115
3277577090,3675481622,1652469528,1652470244,716,957
3636879699,3129594470,1668315899,1668316299,400,1147
3097457183,3272428764,1650272945,1650273248,303,2076
3339312980,3866431229,1645259621,1645259735,114,2259
3143679923,3560053389,1649785688,1649786526,838,527
3970970054,3003728684,1643276173,1643276326,153,2269
3089574886,3180062640,1642560099,1642560898,799,817
3095124554,3044854518,1667230189,1667230644,455,631
3813632607,3508398331,1646529795,1646530583,788,1807
3993994586,3076307729,1661435417,1661435724,307,1793
3272912522,3160071792,1662956569,1662957318,749,1002
3365829981,3603096470,1649450485,1649451481,996,1426
3773488272,3999390272,1663295504,1663295679,175,220
3218686367,3432059238,1657205611,1657205948,337,2343
3097982496,3002829154,1643584551,1643585369,818,369
3382133724,3948074176,1641877275,1641878213,938,2261
3658477943,3038529026,1644694456,1644694785,329,1072
3034147055,3282275875,1659004182,1659004674,492,2243
3985418000,3605195406,1668278041,1668278777,736,771
3720248207,3637518238,1650099875,1650100514,639,22
3923907099,3714535860,1648016503,1648017374,871,1518
3305480485,3568097363,1665711385,1665711787,402,1313
3695478448,3937728696,1667867903,1667868340,437,2320
3106732056,3471085694,1657564363,1657564928,565,2096
3913288832,3165208023,1665068755,1665069176,421,2226
3166206557,3962062858,1667688086,1667688432,346,2388
3748492935,3724455974,1657732589,1657733164,575,1322
3985326073,3620616287,1664223116,1664223708,592,1195
3571428723,3774816472,1651658688,1651658759,71,2277
3423640116,3259625938,1657305925,1657306575,650,379
3628729475,3075288965,1662368060,1662368853,793,945
3913608544,3791460437,1649624795,1649624950,155,1855
3571477883,3107982351,1656798178,1656798684,506,2314
3460687455,3170158934,1654521705,1654522111,406,2444
3903560788,3964637208,1649992732,1649993078,346,2007
3303986609,3632155506,1666093657,1666093864,207,1344
3547072063,3179891006,1661037974,1661038025,51,216
3744829701,3597661669,1668339338,1668339425,87,915
3760817382,3098538909,1653141463,1653142261,798,1249
3133647753,3748556962,1646090938,1646091761,823,282
3887409378,3739406554,1646170945,1646171311,366,2187
3566824993,3745248673,1653229899,1653230121,222,151
3121651540,3197466224,1661333898,1661334859,961,2498
3421772590,3884100790,1669130332,1669130710,378,2361
3844560489,3586128295,1649046580,1649047559,979,1685
3847237978,3566818588,1643790115,1643790580,465,1327
3713520914,3670622586,1642923433,1642923623,190,997
3876097800,3175295329,1656540025,1656540521,496,1900
3777846262,3434182192,1663595122,1663595602,480,1966
3939948508,3175298013,1660285567,1660285650,83,2115
3329190028,3862583365,1654759902,1654760194,292,1351
3326881805,3533497399,1669427907,1669428200,293,403
3452843457,3149135097,1663422927,1663423161,234,1450
3391206046,3037844343,1650110294,1650111221,927,2263
3840659531,3428299424,1662579600,1662580421,821,248
3627385112,3486061006,1669508111,1669508648,537,2406
3526315797,3349724698,1667251851,1667251857,6,1256
3561573044,3876867156,1652802780,1652803556,776,788
3641493201,3652177742,1645355986,1645356520,534,1392
3104459009,3182982515,1647563069,1647563101,32,314
3876696308,3188162412,1649678845,1649679216,371,861
3813632607,3439120258,1663905688,1663906348,660,1928
3004100055,3604954681,1661791800,1661792659,859,1348
3038630181,3682922389,1667672556,1667673427,871,2312
3528288695,3368987950,1642035768,1642036340,572,1736
3749327438,3563972468,1667240894,1667241496,602,2286
3761307187,3426666423,1659729760,1659730629,869,980
3216912897,3774164657,1655458782,1655459007,225,1595
3678404361,3486832676,1645225521,1645226097,576,1960
3358241145,3190972776,1669703936,1669704684,748,1564
3102820806,3393911160,1657859318,1657859839,521,2092
3469507401,3636960130,1642963511,1642964026,515,1513
3228366627,3034643506,1664575126,1664575625,499,2424
3530157274,3719884534,1664581394,1664581418,24,1010
3046640828,3948577391,1641067748,1641068725,977,2221
3877902487,3984818292,1663031592,1663032172,580,724
3414901923,3800312034,1641871477,1641871568,91,1510
3147792323,3901902653,1662688249,1662689210,961,136
3465238210,3587508502,1643175386,1643176114,728,2119
3751022139,3354330082,1660445949,1660445978,29,807
3378522829,3641752896,1653278302,1653278452,150,101
3057090135,3992708211,1664250413,1664250901,488,1366
3315583401,3904546701,1658606566,1658607517,951,1906
3445031830,3758708262,1644778758,1644779235,477,1962
3749211785,3726788021,1656861286,1656861708,422,1729
3533898881,3720941666,1648874900,1648875875,975,403
3218136112,3938505582,1646414318,1646415316,998,657
3442209140,3911588238,1667371708,1667372577,869,1225
3937758732,3734621671,1668885866,1668886445,579,2421
3611657912,3792253761,1657301864,1657302231,367,1111
3050370620,3773196864,1651802673,1651803117,444,1847
3697822889,3866158221,1650157175,1650157180,5,1190
3905969199,3735946925,1655884130,1655884883,753,273
3993798870,3440598942,1645250856,1645250899,43,1728
3650563043,3645850762,1648378720,1648379491,771,308
3784594026,3443161524,1652734979,1652735161,182,1359
3647398701,3248324593,1663819740,1663820576,836,2137
3877205464,3546192493,1665320379,1665321060,681,1918
3043604048,3911439857,1649716001,1649716438,437,948
3928361511,3279538648,1652873839,1652874199,360,1349
3086894794,3698633384,1668976867,1668977549,682,2106
3047922240,3911632634,1667714703,1667715107,404,495
3258577325,3340427847,1653442714,1653443141,427,27
3325735696,3497045946,1645399713,1645400216,503,377
3750765878,3567491118,1666358881,1666359294,413,251
3616794499,3257203631,1667863888,1667864839,951,2474
3990037235,3243883781,1659115245,1659115699,454,357
3984050382,3288490513,1650726769,1650727627,858,54
3014438377,3741929805,1641154898,1641155351,453,92
3720381616,3342215329,1645345446,1645346327,881,1558
3438130685,3318227153,1646483861,1646484740,879,1205
3854859043,3984533628,1648370107,1648370442,335,228
3334743610,3168871510,1657766569,1657767218,649,1201
3211945942,3133030435,1653484483,1653485419,936,836
3232304638,3357692565,1658929998,1658930512,514,2312
3590627159,3933558253,1647806181,1647806985,804,2305
3546290525,3708309303,1641682920,1641683492,572,702
3696448766,3081589831,1666992742,1666993160,418,1709
3108998670,3621452884,1661614080,1661614218,138,26
3424476490,3530278315,1651520445,1651520637,192,2309
3369913868,3728506494,1661723510,1661723844,334,354
3667028828,3956191936,1654391149,1654391700,551,2265
3631660076,3016283694,1645885300,1645885914,614,1973
3826573375,3577990920,1664325268,1664326048,780,1064
3927952722,3523394395,1657958609,1657959300,691,2003
3445743049,3958375464,1644935679,1644936554,875,538
3678541527,3559863065,1667677232,1667677394,162,909
3771111014,3370120843,1655011529,1655011904,375,1764
3866541862,3988337484,1658700745,1658700885,140,1369
3731588710,3667528236,1663544320,1663545217,897,2408
3633479779,3273219526,1646764209,1646764240,31,72
3055402951,3745289284,1655964391,1655964665,274,532
3032465570,3790829012,1665417819,1665418454,635,628
3691317999,3120419076,1665596767,1665597081,314,1559
3502554871,3968635893,1650030514,1650031422,908,1231
3592520398,3365381632,1659091088,1659091117,29,1427
3295262122,3220424979,1643274359,1643275133,774,167
3423306122,3907004279,1644199319,1644200213,894,2096
3608071362,3293865251,1641177679,1641178064,385,1450
3432722823,3585553252,1662713714,1662713857,143,2376
3257690557,3236819846,1644578979,1644579256,277,1634
3645537857,3441206388,1641277719,1641278313,594,2322
3382526428,3520758396,1660300007,1660300212,205,1946
3280558341,3315544584,1654816687,1654817219,532,1045
3041809783,3721136961,1659923207,1659923945,738,1605
3862371205,3461938856,1649753750,1649754211,461,1425
3657115450,3964636806,1656778085,1656778488,403,658
3216550436,3840962989,1651388756,1651389433,677,2077
3962773297,3594795944,1656163737,1656164127,390,2417
3190417421,3233932115,1662489801,1662490515,714,2438
3501786397,3442967650,1668249107,1668249773,666,210
3732840219,3563972468,1647030404,1647030871,467,1773
3765472006,3480314503,1654328029,1654328405,376,2238
3307775998,3135119423,1649096658,1649097033,375,2268
3697822889,3288016190,1658039200,1658039785,585,1975
3081028310,3657101592,1648451062,1648451948,886,1690
3347397074,3697822889,1657099860,1657100208,348,1606
3377781677,3039198774,1662641176,1662641615,439,2342
3017883382,3543668840,1669430185,1669430990,805,1365
3543257848,3915336029,1644443786,1644443818,32,2178
3199117399,3492103801,1644640213,1644640717,504,1679
3571173934,3678149544,1662031194,1662032012,818,136
3325962611,3359541123,1652377582,1652377988,406,810
3021968850,3321105707,1644127471,1644127525,54,2328
3914275771,3676132016,1654813357,1654814043,686,1961
3073332785,3604435641,1648246945,1648247448,503,161
3565128218,3984348951,1658208003,1658208193,190,1169
3914427859,3664381582,1664500658,1664501366,708,1597
3865299110,3611763388,1663822912,1663823035,123,202
3318654389,3305299292,1660957912,1660957936,24,253
3465382952,3536903033,1647292952,1647293667,715,225
3380313835,3401611149,1652089444,1652090176,732,1515
3474402148,3747046698,1641687489,1641688026,537,832
3548670552,3676690161,1642481970,1642482277,307,2446
3962695354,3937758732,1656663695,1656664393,698,1785
3532675680,3834174227,1657677941,1657678434,493,1978
3828322397,3704568536,1653161419,1653161430,11,338
3237841242,3063478155,1651931510,1651931559,49,1544
3832703867,3150485567,1654739864,1654740436,572,843
3404008086,3956491451,1665490139,1665490471,332,1541
3501568597,3434090231,1663488631,1663489455,824,1429
3471376255,3773505782,1650516092,1650516132,40,1118
3280046501,3708337100,1655695675,1655696477,802,1351
3866582723,3913071555,1643463242,1643463994,752,633
3933752482,3169486525,1667932294,1667932922,628,2376
3613021322,3370120843,1643905677,1643906260,583,2336
3722199706,3876687977,1661835182,1661835777,595,340
3173969437,3504641910,1661979425,1661979491,66,1095
3704604706,3095503795,1658811955,1658812774,819,767
3902777743,3659701814,1660362236,1660362280,44,1789
3267089074,3587833146,1664280749,1664281543,794,2319
3935022176,3502947486,1657126495,1657126547,52,1183
3188936143,3915686266,1659680616,1659681177,561,1461
3549703546,3690350377,1664495222,1664495477,255,2383
3989206811,3388726341,1645598798,1645599361,563,2385
3232835207,3810320285,1649433307,1649433581,274,1583
3788785252,3577530061,1645165900,1645166783,883,54
3120490643,3651535646,1649995285,1649995879,594,1404
3086273441,3785721693,1659624248,1659624455,207,339
3926612159,3832438123,1665162064,1665162321,257,403
3622950232,3309405529,1652366598,1652367379,781,319
3918383192,3572018229,1667889939,1667890453,514,2406
3734754514,3750123961,1665772158,1665772750,592,517
3469471892,3034643506,1654466230,1654466835,605,1956
3347152834,3997050001,1662643737,1662643995,258,1706
3985239597,3643412582,1661990452,1661991180,728,2465
3139604406,3339025394,1641149926,1641149993,67,1911
3560043638,3166754795,1649078246,1649078421,175,2135
3624911947,3672560021,1657139233,1657139440,207,1202
3836331716,3625772064,1648436290,1648437156,866,1397
3975096180,3152176779,1656415294,1656415351,57,1726
3584309667,3617453316,1664771320,1664771654,334,2029
3687919265,3151323388,1646072959,1646073840,881,1208
3819770312,3235476099,1645151532,1645152163,631,2447
3247590827,3707778731,1657567288,1657567691,403,1922
3476566118,3695360424,1646569094,1646569972,878,493
3796587240,3947369111,1641831848,1641831986,138,2137
3709665583,3182752768,1660069067,1660069307,240,1310
3801410751,3885026939,1650561529,1650562520,991,245
3348735740,3990343743,1649735270,1649735899,629,78
3726520685,3555272427,1666404384,1666405121,737,1212
3618101679,3287082352,1662334324,1662334628,304,312
3678152024,3590384867,1644579198,1644579783,585,2095
3226220903,3357034260,1650899734,1650900597,863,2475
3986631065,3461630480,1649657561,1649658426,865,2190
3187291408,3909309427,1647557126,1647557631,505,1345
3452219424,3956878212,1661087005,1661087113,108,2466
3603786519,3334237477,1652176328,1652176385,57,609
3034288673,3773488272,1662141818,1662142179,361,256
3402019498,3667414511,1645274434,1645275099,665,2332
3758849561,3610480358,1661694558,1661695027,469,1874
3451299629,3148256129,1667844155,1667844227,72,2048
3925690262,3938505582,1644530571,1644530702,131,340
3965137487,3023576817,1654598184,1654598910,726,1770
3832703867,3307306078,1659145159,1659146149,990,1804
3465406980,3312661854,1667005183,1667005359,176,2049
3126995401,3161774382,1666639197,1666639344,147,1500
3266127117,3297684978,1644499534,1644500277,743,189
3110395191,3272563093,1659763630,1659763711,81,622
3922341165,3575784654,1649936721,1649937036,315,1369
3314240169,3884551317,1668888745,1668889407,662,604
3473505436,3230248695,1664349443,1664350195,752,1137
3582168015,3310512172,1644835926,1644836048,122,2033
3197739962,3607580736,1656527461,1656527957,496,1017
3579404607,3900843323,1646896602,1646897564,962,663
3132594209,3879322451,1646039694,1646040268,574,56
3401611149,3274452346,1661251303,1661251610,307,53
3735801716,3804189322,1656985332,1656985792,460,239
3010368174,3480905975,1645349736,1645350201,465,2481
3863676573,3142313032,1655173780,1655174738,958,2357
3520825972,3416521015,1660488839,1660489297,458,1534
3976147939,3645868952,1654243388,1654243641,253,1366
3125911793,3057300178,1641029040,1641029931,891,279
3201276259,3531357820,1646654183,1646654793,610,558
3558492617,3788034142,1649258452,1649258775,323,896
3504641910,3202424407,1643551120,1643551490,370,202
3195274844,3462412055,1654939323,1654939889,566,2372
3591724433,3047388698,1658314136,1658314678,542,745
3603965318,3917984429,1658231833,1658231844,11,1179
3564444579,3858911279,1667782471,1667782687,216,1415
3502432342,3048077825,1666423375,1666423823,448,791
3180600647,3858876644,1666349345,1666350328,983,324
3533954093,3113516667,1667666490,1667666809,319,2481
3753998489,3177915558,1656935203,1656936071,868,1444
3525192232,3625611440,1659067089,1659067326,237,1982
3595560993,3505417530,1657324946,1657325123,177,47
3609310097,3815462032,1648786826,1648787366,540,223
3500948971,3737153063,1661752635,1661753578,943,1846
3866582723,3573969593,1652532053,1652532198,145,1710
3897421758,3730337290,1652236458,1652236637,179,1969
3995288261,3792708367,1668270855,1668271033,178,1899
3935601127,3483254795,1646222465,1646223013,548,1570
3708896596,3034325039,1659543142,1659543470,328,614
3830866959,3236308141,1643230008,1643230476,468,1756
3721870717,3515367610,1660223059,1660223644,585,1499
3429887771,3104050460,1647535287,1647536266,979,2492
3752176146,3118518203,1662708390,1662708665,275,2041
3387264235,3094759406,1653256257,1653256784,527,1741
3251106195,3626457002,1663589942,1663590628,686,1802
3022082086,3794251958,1662705442,1662705914,472,447
3773789419,3127783768,1641917938,1641918403,465,505
3660998516,3102251970,1665279237,1665280205,968,772
3766914780,3729553337,1645171673,1645171732,59,225
3277298737,3233507128,1659420817,1659420850,33,798
3347942747,3263239497,1646107219,1646107738,519,845
3182643672,3022283384,1669331738,1669332339,601,1105
3405155234,3849379963,1643110738,1643110840,102,871
3453143238,3686144397,1656504285,1656504990,705,1144
3961140276,3888260346,1667968351,1667968936,585,2246
3551810435,3273752842,1659898430,1659899282,852,1918
3313079052,3549033213,1641862220,1641862788,568,53
3633111737,3247551122,1669031222,1669032158,936,2239
3993332175,3640508439,1650370174,1650370491,317,146
3152555864,3186787984,1666619495,1666619541,46,2075
3178981589,3870779720,1664571457,1664571950,493,2242
3776027879,3599795440,1669368719,1669369570,851,317
3084940745,3133805973,1662212119,1662212838,719,533
3923259150,3045925838,1653385483,1653386300,817,1932
3916290714,3458815526,1653286082,1653286534,452,927
3793117012,3862939959,1660362687,1660363082,395,1213
3620236387,3896960517,1654789843,1654790382,539,1125
3439364410,3962658092,1658513448,1658513588,140,1705
3393712145,3892023630,1645986639,1645986901,262,1148
3744002702,3447077543,1643288717,1643289077,360,1655
3102760949,3244946730,1647168901,1647169449,548,122
3371767777,3928727074,1652719872,1652719965,93,1331
3397052856,3863665550,1649605143,1649605767,624,697
3034470773,3022283384,1647636597,1647637210,613,2230
3011567148,3670154961,1667430163,1667430828,665,373
3336525489,3671869525,1641969333,1641969939,606,1930
3240435560,3674335911,1641540073,1641540991,918,941
3691879230,3677300151,1661109162,1661109430,268,1972
3271409183,3947174877,1663572581,1663572946,365,694
3509582460,3022283384,1657123133,1657123371,238,2153
3579486534,3343543154,1658083411,1658083922,511,273
3271479070,3241210215,1652973236,1652973813,577,1450
3113760926,3593487418,1667923906,1667924632,726,1963
3870463011,3154288650,1666461394,1666461716,322,2246
3991390314,3097457183,1663198300,1663198620,320,2411
3959504618,3710786724,1641898616,1641899055,439,1143
3424553049,3618941109,1649303659,1649303930,271,144
3228110844,3465229825,1651092532,1651093107,575,439
3673549679,3660513601,1644892025,1644892640,615,615
3569686431,3957803611,1669152976,1669153935,959,1
3202161567,3115669693,1668742606,1668743555,949,369
3868936645,3837157118,1657000321,1657001138,817,1377
3658513045,3149191705,1651018363,1651018451,88,1958
3479778946,3766818968,1669213477,1669213576,99,2261
3062486954,3053166522,1654368377,1654368432,55,1507
3363279084,3297434061,1657329863,1657329983,120,394
3418635865,3179855785,1660955159,1660955623,464,1885
3823161778,3364600039,1655588455,1655589234,779,1946
3345650412,3066546417,1654161853,1654162190,337,1204
3707578213,3013814400,1642277258,1642277990,732,796
3809312897,3398735443,1669554021,1669554298,277,1537
3548511640,3831542177,1656226485,1656226670,185,1840
3606643671,3505196729,1666436862,1666436872,10,599
3017715856,3093178960,1643983421,1643983828,407,200
3287901684,3675093452,1642066157,1642066612,455,1548
3201213219,3848860153,1641643365,1641643384,19,366
3565805050,3046043182,1649533537,1649534342,805,1094
3130561868,3613801852,1661478959,1661479050,91,1952
3340837702,3013073909,1648911658,1648912075,417,1008
3467810757,3006738164,1667357311,1667358231,920,2312
3065434950,3021289375,1666865920,1666866605,685,10
3185977048,3316398180,1643155882,1643156493,611,916
3442477300,3547672806,1664526958,1664527581,623,652
3626505512,3817252660,1663118477,1663118605,128,701
3295385873,3469600523,1650137820,1650138464,644,2473
3293237543,3427127427,1656736351,1656737296,945,1853
3335709869,3819812955,1649074043,1649074221,178,2490
3595270507,3396524452,1642859494,1642859666,172,25
3227246451,3329498574,1652078149,1652078697,548,977
3103625074,3126778118,1644347232,1644348010,778,1272
3835202206,3898494020,1646685642,1646685656,14,863
3833683293,3661747291,1661068072,1661069027,955,2426
3748492935,3988337484,1649595158,1649595663,505,2051
3424476490,3320381981,1652765510,1652765753,243,2418
3833572466,3236522609,1660213657,1660214175,518,1291
3948180125,3054927562,1650436092,1650436891,799,1818
3181578884,3100113266,1660143896,1660143938,42,2023
3710756423,3236325866,1650847289,1650847757,468,854
3676592387,3533954093,1654851580,1654852526,946,144
3674349184,3857687791,1659022933,1659023144,211,155
3964637208,3966056341,1668279779,1668279916,137,1018
3697028552,3509568211,1666426790,1666426815,25,478
3273258651,3828530052,1664041949,1664042690,741,1908
3136810446,3013862518,1653781079,1653781749,670,1223
3882978452,3085429140,1664629807,1664630345,538,1069
3890054358,3858225831,1641874243,1641874786,543,1770
3991673197,3296531648,1643912708,1643913573,865,1138
3846628868,3474081200,1656767248,1656768078,830,2123
3283037458,3598576303,1650571955,1650572031,76,32
3615137704,3167737446,1668998648,1668998992,344,1048
3455537522,3733440098,1649986881,1649987786,905,583
3003972844,3188680599,1656162109,1656162831,722,1430
3061979919,3776398060,1641311260,1641311292,32,357
3053005521,3927646653,1649554452,1649554677,225,1268
3508133844,3488962022,1655648486,1655648629,143,413
3564198089,3906772132,1648419537,1648419587,50,972
3876696308,3632155506,1658249580,1658249703,123,2386
3646151081,3310953839,1669299344,1669299767,423,1646
3125911793,3836855857,1642842427,1642843248,821,1251
3581083030,3065482463,1647392107,1647392177,70,1871
3388628484,3985418000,1650225971,1650226053,82,2487
3645560004,3521160717,1653672517,1653672720,203,575
3306439333,3450102071,1664333576,1664334132,556,1655
3784123884,3769944434,1657537365,1657537563,198,249
3020729502,3351361711,1659697490,1659698174,684,2419
3160515169,3763093748,1645418707,1645419149,442,299
3292365668,3951692395,1663851927,1663852175,248,1812
3345410681,3491272857,1660051924,1660052855,931,1834
3334298803,3907635993,1650342193,1650342318,125,38
3292667822,3590259850,1643069792,1643070042,250,2380
3123815439,3912111332,1641909942,1641910436,494,1122
3958050741,3981019442,1654780185,1654780582,397,91
3435252882,3730337290,1648908701,1648909145,444,1061
3109465057,3099976032,1645958118,1645958582,464,1403
3548670552,3261866390,1651981234,1651981732,498,2362
3070676307,3933460964,1658314721,1658315286,565,1215
3127940283,3649442188,1655765505,1655766153,648,713
3581449963,3154551351,1658646002,1658646769,767,1736
3103404280,3234861737,1647830634,1647831599,965,1517
3703943697,3061982327,1667775119,1667775578,459,455
3385007362,3632284739,1645791503,1645792182,679,2
3968682824,3301994647,1652527771,1652528207,436,142
3564599618,3794447092,1662021476,1662022308,832,2345
3362148197,3785432995,1669420506,1669421260,754,1842
3730533080,3714259747,1648060570,1648061302,732,2266
3057837723,3297949666,1668661169,1668661649,480,2380
3457191473,3259071830,1658884657,1658885221,564,1536
3312203382,3013681789,1664451270,1664451368,98,46
3382983805,3381900638,1646194691,1646195153,462,2138
3344787204,3429101401,1653224307,1653224479,172,992
3678505160,3262377052,1650045029,1650045825,796,2094
3221850819,3719744431,1664809584,1664810376,792,1969
3936360658,3319422840,1667342083,1667342719,636,1258
3061556470,3127403665,1649843783,1649844268,485,1160
3498441448,3772749656,1653806751,1653807264,513,2402
3563738755,3718684083,1647713552,1647713954,402,2245
3212707122,3568965374,1665764150,1665765004,854,61
3412673526,3241425701,1660744440,1660745266,826,411
3691062084,3927886349,1642429362,1642430339,977,1794
3019204329,3499091436,1648487372,1648487652,280,343
3148549210,3379285136,1665235429,1665235671,242,610
3176818286,3239575265,1665095118,1665096019,901,1133
3570335491,3511569871,1641082752,1641083410,658,505
3224128562,3697028347,1643970658,1643971450,792,2495
3178090646,3139198469,1660897669,1660898289,620,2158
3587633750,3618095446,1669572131,1669572971,840,2195
3331439996,3079038995,1652007407,1652008333,926,1583
3776419392,3552494506,1660733176,1660733563,387,334
3017484255,3908312889,1648480718,1648481337,619,1806
3892023630,3779236518,1650404594,1650405464,870,1813
3306669471,3791315348,1663529904,1663529962,58,2151
3544353013,3138755786,1652696858,1652697754,896,72
3234064099,3043256301,1645480466,1645481463,997,647
3887002610,3893828389,1641029803,1641030439,636,1417
3780117215,3823942349,1661040711,1661041355,644,1487
3281397783,3936135558,1654501315,1654501751,436,158
3264339209,3334483625,1645477088,1645477222,134,1315
3254496907,3833333678,1647256303,1647256932,629,448
3801579775,3980971387,1643238303,1643238356,53,1063
3992817916,3575766470,1664832263,1664832807,544,1255
3507363672,3000165786,1655373156,1655373822,666,2194
3437983939,3540799664,1646355033,1646355730,697,67
3932161358,3734621671,1649207243,1649207596,353,653
3963787394,3278843111,1665075608,1665076046,438,106
3902437090,3549549632,1661081539,1661082528,989,1155
3968297784,3188384391,1660490684,1660491469,785,2054
3154991935,3268745445,1655358911,1655359689,778,2157
3218869856,3805314214,1651116849,1651117238,389,1931
3500948971,3735081666,1667123169,1667124088,919,458
3021126829,3592561930,1664843845,1664844609,764,63
3039255124,3185611253,1644303474,1644303507,33,231
3453884967,3739719526,1654370351,1654371202,851,2485
3625034951,3336494171,1658498479,1658498552,73,1512
3911960681,3499272388,1651601498,1651602250,752,145
3830303170,3682793223,1649608387,1649608714,327,2191
3992909356,3016283694,1649429577,1649430233,656,2265
3434010912,3259625938,1669206084,1669206460,376,2052
3325360523,3457341479,1641261853,1641262598,745,2291
3878695242,3020285623,1650600593,1650600605,12,1604
3137350861,3672693214,1664438999,1664439406,407,2418
3598645736,3040521946,1654329681,1654330213,532,1234
3676868183,3963793916,1649058088,1649058970,882,1434
3986885276,3948310967,1652739944,1652739987,43,1301
3896594746,3085412399,1657188335,1657188352,17,1905
3418338710,3227584428,1650111998,1650112989,991,1124
3175929512,3096695477,1642942785,1642943020,235,982
3612878721,3625611440,1666390450,1666391426,976,260
3166521010,3019204329,1657746435,1657747002,567,1008
3881578299,3095661205,1663124262,1663124282,20,1516
3942273552,3692345317,1659724819,1659725513,694,1456
3336494171,3879967963,1657763599,1657764051,452,296
3797295915,3777820691,1654419436,1654419931,495,1806
3117749198,3566534974,1663305535,1663306420,885,948
3502316165,3512353520,1641686958,1641687494,536,1919
3284433811,3903108572,1659157756,1659158726,970,289
3375279811,3128133737,1645515485,1645516409,924,1327
3682993605,3862918742,1664515166,1664515783,617,814
3269629374,3398257086,1663132708,1663132749,41,744
3195504067,3125314664,1641964632,1641965005,373,2034
3786924052,3335275571,1668878066,1668878231,165,1028
3096274177,3977139394,1643581125,1643581205,80,2133
3890117007,3952552328,1653518852,1653519556,704,595
3448952875,3389926670,1663615749,1663616454,705,616
3085931016,3218136112,1656358295,1656358723,428,179
3895542691,3010767150,1655907941,1655908776,835,375
3743934334,3462280366,1658099917,1658100571,654,1599
3929312426,3934125569,1669309962,1669310095,133,2345
3142923526,3339611423,1657745563,1657746323,760,1178
3933742178,3086653619,1641457604,1641458052,448,1284
3098161767,3664242822,1641950940,1641951087,147,2182
3179855785,3344787204,1660940242,1660941091,849,280
3269865212,3764175850,1658967914,1658968099,185,1321
3151554851,3477692188,1655698316,1655698522,206,2071
3066531358,3569600936,1644414777,1644415368,591,72
3318717113,3911439857,1645782601,1645783227,626,1877
3061366261,3442087752,1662610449,1662610705,256,358
3488151008,3166274990,1652322265,1652322403,138,2498
3869495480,3202460554,1651066992,1651067395,403,2239
3147210428,3422703729,1659659767,1659660280,513,1715
3280491285,3249705811,1652793896,1652794555,659,434
3582060994,3993332175,1656769377,1656769446,69,1762
3825036404,3558139345,1652563765,1652564178,413,1034
3332797032,3155294057,1668695485,1668695774,289,1941
3962722941,3404934353,1668727541,1668727587,46,872
3361870766,3749756110,1669205256,1669205984,728,1294
3167737446,3089471552,1662032326,1662032414,88,1191
3743569811,3156538951,1666321007,1666321030,23,345
3197466224,3892800106,1663851760,1663852352,592,2261
3772980352,3426433476,1660745032,1660745066,34,529
3456435173,3790157838,1652594019,1652594125,106,1383
3404317985,3292172583,1654821127,1654821381,254,1602
3237245622,3985491144,1658479460,1658480162,702,1178
3688910009,3104793032,1656537659,1656537692,33,194
3092800496,3526491245,1652978633,1652979485,852,1860
3354233805,3029016525,1665655374,1665655844,470,575
3132802864,3912916652,1644487149,1644487789,640,696
3391262941,3223463387,1665891488,1665891552,64,850
3546859493,3129955835,1643146187,1643146624,437,1172
3832072924,3500097822,1644718058,1644718738,680,1439
3572164547,3289437738,1659036324,1659036601,277,565
3041652512,3372471333,1655704446,1655705225,779,2384
3173535458,3277550058,1655658006,1655658228,222,2060
3533290388,3776939860,1643321962,1643322146,184,1093
3819541125,3344143432,1666183338,1666184000,662,336
3045691620,3081701001,1645002301,1645002834,533,1583
3098342545,3159525512,1647697867,1647698692,825,268
3252843201,3819172879,1668792152,1668792433,281,2400
3284838720,3248892530,1648359751,1648360655,904,12
3328373210,3617340911,1666729778,1666730736,958,1266
3984533628,3004951157,1665136944,1665137254,310,1604
3941689381,3832995595,1653842186,1653842315,129,1357
3640756400,3074795505,1641789333,1641789420,87,7
3760972512,3197176680,1659525475,1659525960,485,2187
3447926518,3690657404,1642743299,1642744277,978,1078
3474376744,3536931244,1653447662,1653448111,449,372
3850546468,3173108957,1651184753,1651185318,565,504
3172502658,3838774657,1663140220,1663140942,722,906
3340337106,3755513433,1669247073,1669247909,836,833
3264831577,3328471090,1657818767,1657819679,912,49
3583591867,3273289104,1653122500,1653123389,889,1315
3517149250,3422106507,1646126950,1646127323,373,1452
3408240731,3990109853,1659733625,1659733827,202,2404
3515161257,3185611253,1656425662,1656426237,575,694
3515941468,3875748779,1659435604,1659436046,442,2453
3673810421,3399479391,1647464842,1647465450,608,1582
3691032308,3205601088,1657356421,1657357416,995,1036
3540550798,3565083183,1652106261,1652106326,65,1223
3949713678,3364893066,1641915929,1641916456,527,1301
3710888381,3064701445,1647873155,1647873225,70,318
3821864560,3109959336,1658592612,1658592922,310,1864
3759737476,3005854023,1657163567,1657164242,675,1034
3178490239,3949771162,1667359896,1667359976,80,1381
3292812509,3720475877,1645364042,1645364867,825,2229
3812239613,3961973688,1662939969,1662940657,688,780
3745712275,3389812297,1647230334,1647230704,370,1857
3664898256,3880290667,1663177626,1663178624,998,161
3412989654,3452067391,1659525502,1659525587,85,1775
3020446596,3412675211,1669553743,1669554530,787,264
3298038439,3073762858,1658511859,1658512093,234,1115
3028267408,3042446262,1647826351,1647826937,586,1881
3663985085,3287078889,1652739208,1652740011,803,1012
3878695242,3409804938,1662682028,1662682859,831,925
3058951367,3729820423,1657551384,1657552059,675,1647
3089962675,3290710394,1653742242,1653742339,97,2201
3506187447,3579921083,1642908383,1642909351,968,704
3098538909,3969046292,1658039696,1658039978,282,780
3129860388,3611763388,1668682383,1668682987,604,54
3067220098,3805888209,1649017733,1649018635,902,1810
3733619028,3644128961,1644396618,1644396774,156,1232
3034919553,3795508879,1661501662,1661501863,201,1332
3634010080,3651571335,1668650524,1668650958,434,288
3324394622,3972677516,1668453576,1668453955,379,497
3101137807,3437109709,1665024615,1665024977,362,343
3642314622,3973853235,1659592197,1659593167,970,1341
3318594125,3804458349,1660251786,1660252441,655,55
3907872554,3826573375,1647241122,1647241175,53,11
3247590827,3308071201,1643095981,1643096918,937,1646
3991859515,3649442188,1669064638,1669065118,480,2211
3798509385,3912511626,1668748672,1668748689,17,260
3524109178,3505196729,1665333300,1665333874,574,2165
3196079047,3320179826,1646966784,1646967126,342,1703
3777684793,3819380768,1657719967,1657720463,496,84
3249145163,3773488272,1657410797,1657411179,382,1986
3277577090,3837366084,1663184361,1663184563,202,1072
3602829591,3001794280,1647604672,1647605303,631,1277
3329496705,3288016190,1650026398,1650027290,892,1360
3267107046,3403786938,1661070868,1661071622,754,586
3188126815,3727794902,1661608017,1661608420,403,2171
3771788181,3766186320,1643788163,1643788478,315,2118
3096710771,3855013110,1651212766,1651213716,950,779
3907700603,3932613929,1664541197,1664541618,421,1823
3067403592,3084882941,1645498210,1645499035,825,1037
3914427859,3084783158,1652474441,1652475054,613,126
3819770312,3302700303,1656591387,1656592242,855,193
3256807270,3905744284,1642585459,1642585896,437,596
3007308564,3155320608,1665324321,1665324767,446,1969
3924865492,3174499556,1652792543,1652793008,465,2251
3254181971,3404785260,1651874130,1651875059,929,431
3860446106,3197300293,1649597140,1649597485,345,435
3284892894,3345543859,1664286783,1664287606,823,2259
3594269515,3388515499,1645966623,1645966739,116,1943
3865387894,3582138072,1664404386,1664404401,15,177
3143689256,3821180393,1656095688,1656096401,713,2325
3867126446,3364661787,1648326716,1648327702,986,279
3450074680,3187779586,1650020561,1650020847,286,167
3588376802,3949620827,1648949314,1648950255,941,2110
3672274616,3185745995,1659234683,1659235344,661,35
3555966791,3614741796,1647357380,1647357709,329,2098
3328544337,3834160941,1656767606,1656767738,132,993
3567520646,3577798894,1666644957,1666645053,96,568
3987510303,3405155234,1665976631,1665976924,293,321
3909002163,3324069408,1668253355,1668253691,336,2449
3815779833,3801579775,1644404970,1644405818,848,2217
3654527501,3742145726,1657169589,1657170420,831,1171
3777820691,3268216928,1653478243,1653478251,8,1129
3962746969,3579093901,1654086773,1654087123,350,2427
3058837915,3203734562,1649242130,1649242850,720,1626
3414370730,3524942512,1661003931,1661004322,391,679
3524480094,3181578884,1652018866,1652019280,414,602
3125717667,3273701051,1665618864,1665618885,21,1131
3348234563,3763093748,1649622644,1649623551,907,1348
3718710270,3256873642,1651369659,1651370625,966,2437
3457108498,3331426472,1649359018,1649359681,663,1733
3737504606,3975663862,1648515859,1648516476,617,928
3975380491,3101460702,1656231328,1656231833,505,1836
3899117968,3436578278,1656674974,1656675057,83,1530
3087709771,3749529134,1645613354,1645613687,333,465
3090090794,3599604382,1659172573,1659173436,863,418
3130181848,3253827804,1646092767,1646093168,401,1582
3728924033,3192193744,1648825536,1648825674,138,76
3637944484,3782730026,1644383764,1644383961,197,2336
3012892515,3020446596,1668813963,1668814818,855,275
3984215552,3904825547,1645936898,1645937710,812,544
3784808734,3808415962,1642746568,1642747448,880,1009
3481090623,3165536332,1648388549,1648388923,374,112
3613188168,3068129646,1651289976,1651290804,828,1870
3162836777,3776398060,1642779550,1642779926,376,1145
3936029875,3706560099,1651297276,1651297923,647,840
3342929537,3940520472,1654558427,1654558883,456,743
3095170532,3828890005,1663783616,1663783626,10,1285
3445647826,3169496287,1644892069,1644892624,555,993
3353722089,3598522904,1659910174,1659910332,158,517
3524480094,3750192699,1660697573,1660697707,134,18
3088562105,3371002443,1649216558,1649216759,201,2394
3171214894,3239575265,1652526428,1652527154,726,2147
3951354982,3167058279,1655435684,1655436089,405,889
3992571464,3158029379,1641059424,1641059823,399,2102
3504911583,3285243887,1647521193,1647521809,616,208
3941528766,3445689630,1665737168,1665737699,531,1271
3089126812,3647480411,1652346844,1652347702,858,2066
3029578425,3801736024,1660110203,1660111172,969,366
3881002245,3959504618,1654982353,1654983119,766,1494
3949445116,3924969388,1656555806,1656556305,499,21
3915344164,3141392063,1660079600,1660079835,235,2416
3572325072,3952620083,1656781268,1656781658,390,2014
3524315738,3299840986,1654128567,1654129489,922,341
3782266220,3175979112,1660814924,1660815066,142,1958
3456602518,3714259747,1659106403,1659107228,825,798
3556000533,3243840165,1643142194,1643142854,660,624
3483354291,3289684726,1663205557,1663205993,436,818
3333095694,3259071830,1653208838,1653208856,18,2188
3998200859,3508340066,1658723856,1658724513,657,970
3098083694,3595499905,1653705976,1653706800,824,879
3279069375,3351786927,1646467713,1646468655,942,1959
3517260537,3659326501,1648073189,1648073842,653,1332
3727131221,3562116841,1669610180,1669610878,698,1529
3500097822,3481293963,1651173262,1651173309,47,920
3794926978,3678778706,1663373689,1663374425,736,1272
3698706740,3773196864,1650504453,1650504611,158,1388
3674059710,3932530423,1651693850,1651694667,817,400
3549209951,3749529134,1652169179,1652169551,372,980
3818823702,3656878544,1656028154,1656028880,726,1899
3609601814,3855754332,1654659919,1654660519,600,313
3805653360,3066956305,1657695012,1657695092,80,1409
3883537438,3895332326,1669585898,1669586507,609,2136
3778575442,3682922389,1641404823,1641405010,187,812
3595612540,3100239217,1650713926,1650714792,866,532
3569401888,3968143962,1657129194,1657129962,768,847
3962031345,3159950284,1654107731,1654108671,940,1602
3817057878,3903112291,1666707944,1666708209,265,1599
3310542239,3971934050,1652191328,1652191659,331,782
3344713569,3633498077,1650740809,1650741379,570,507
3845256746,3962138330,1654118588,1654119276,688,728
3075313832,3471221302,1665323671,1665324037,366,242
3802592493,3749208805,1662073486,1662074184,698,2216
3562472924,3099559880,1661268954,1661269125,171,1084
3841459327,3607385542,1657748948,1657749019,71,1382
3195451932,3361652898,1644131292,1644132019,727,1365
3257118282,3420298161,1650897805,1650898242,437,585
3985620157,3257865090,1662881796,1662882150,354,2344
3084940745,3254991122,1669296646,1669297625,979,2353
3356302136,3072276713,1666356404,1666356406,2,2327
3639695113,3208346862,1645350254,1645350764,510,1099
3322663101,3162284444,1668423143,1668423683,540,1205
3178529360,3526239660,1644996201,1644997075,874,598
3433237569,3325334543,1655998494,1655998656,162,1467
3310935085,3214817416,1652747784,1652747959,175,638
3356690610,3835922991,1659550095,1659550117,22,1344
3288788264,3671355250,1665399460,1665400143,683,1440
3959872101,3982268438,1666673381,1666673409,28,1238
3152860718,3400121766,1645279182,1645279388,206,930
3846060378,3427225872,1645639428,1645639819,391,484
3502599631,3356028416,1649253252,1649253981,729,1649
3988546259,3127549843,1656386036,1656386903,867,1652
3179891006,3553467860,1665546768,1665547489,721,1425
3348278635,3922766043,1657699664,1657700278,614,121
3587497382,3650675743,1646509060,1646509123,63,592
3596483616,3804748811,1665027960,1665028947,987,406
3664898256,3987813210,1664217051,1664217688,637,1299
3536443756,3347434027,1654353531,1654353959,428,2218
3107982351,3411181030,1669136963,1669137079,116,1681
3707199669,3439905167,1662809968,1662810112,144,930
3784646522,3486606390,1655460907,1655461686,779,842
3316485303,3073540574,1661382207,1661382303,96,2239
3665599335,3750949753,1658573845,1658574835,990,2461
3836089663,3745248673,1660978725,1660979180,455,86
3565001530,3173322239,1641114544,1641114615,71,2045
3447257561,3699183333,1661442620,1661443530,910,564
3251948771,3986081370,1665111060,1665111648,588,1532
3638233110,3054573274,1667350918,1667351632,714,1879
3097834756,3456080836,1654648182,1654648670,488,552
3511593307,3849701361,1669091943,1669092658,715,2000
3566936390,3160071792,1649714268,1649715057,789,1284
3647951580,3499281518,1645325060,1645325589,529,205
3023772977,3776027879,1662333168,1662333681,513,1431
3581026789,3608843912,1663498210,1663499032,822,204
3898641431,3809059026,1660681661,1660681891,230,2194
3601562567,3667028828,1644493235,1644493703,468,517
3682028611,3203904444,1653646122,1653647039,917,1922
3242235161,3411128747,1655119259,1655119630,371,2148
3960494982,3133655192,1658354858,1658354908,50,2366
3902501623,3124476593,1669637955,1669638183,228,77
3377528840,3506307976,1669600997,1669601858,861,2301
3973226891,3245723038,1663435651,1663436550,899,2144
3318227153,3292368988,1653290660,1653290681,21,1497
3398116898,3911588238,1666414307,1666415271,964,790
3893671286,3088587729,1662234553,1662234948,395,2030
3948695100,3871509767,1661539872,1661540391,519,2019
3784808734,3021769525,1650762816,1650762917,101,563
3269653223,3090090794,1668537624,1668538105,481,2133
3416230781,3443190053,1646963478,1646964324,846,1906
3576411084,3658260972,1657064912,1657065152,240,1412
3533740602,3576317139,1667683022,1667683914,892,544
3418007140,3351906355,1659777482,1659778367,885,1528
3145961063,3794524447,1654814394,1654814532,138,1029
3507431231,3620236387,1642228422,1642228865,443,604
3850392190,3820885067,1662458999,1662459384,385,336
3246321113,3112419355,1644097646,1644097780,134,1431
3620748135,3543668840,1669082110,1669082767,657,714
3955064333,3212218759,1643572022,1643572982,960,202
3138001926,3434575449,1644931663,1644932172,509,726
3660548799,3892848585,1643314790,1643315431,641,453
3767409219,3597251704,1659107991,1659108075,84,730
3893671286,3092564684,1667690311,1667690705,394,1038
3348198228,3414857456,1665890205,1665890893,688,1616
3488551185,3002415281,1664256549,1664256808,259,2377
3953655387,3189038779,1663694586,1663695528,942,677
3319037937,3277284318,1658390525,1658390808,283,1924
3024268753,3371785046,1648846141,1648846796,655,1675
3621379912,3622596133,1661569967,1661570671,704,62
3677001111,3783119155,1649735293,1649735697,404,1025
3860745004,3945397961,1648455240,1648456195,955,2348
3104050460,3059858458,1649714227,1649714837,610,874
3001794280,3389497658,1641006059,1641006765,706,1830
3716137932,3408396410,1644066647,1644067604,957,1656
3695545980,3569557301,1660023914,1660024148,234,1915
3569552798,3333764188,1656003006,1656003400,394,965
3585989542,3871321308,1659656930,1659657021,91,2195
3168983812,3034288673,1655069281,1655070075,794,1784
3788819111,3678541527,1651811244,1651812138,894,1192
3194796707,3280818938,1652600296,1652601194,898,566
3353500391,3711847265,1646404264,1646405213,949,2269
3734565675,3635988688,1643035556,1643036206,650,781
3887519119,3529681535,1658254714,1658255361,647,1495
3857460953,3832995595,1644624941,1644625837,896,576
3176818286,3839967647,1651611757,1651612343,586,1579
3300159475,3141196312,1652025655,1652026599,944,1354
3280630861,3986885276,1649536627,1649536976,349,401
3967972556,3684926586,1651127505,1651127855,350,1689
3993923271,3447077543,1653669316,1653670005,689,1692
3640613606,3733486808,1647306810,1647306966,156,1020
3989208740,3779998740,1653729716,1653730232,516,2328
3705996677,3564026629,1666551572,1666552413,841,1574
3676893681,3390532209,1644699123,1644699794,671,1809
3365381632,3151896132,1665074436,1665074696,260,1632
3563343479,3335709869,1647405656,1647405895,239,1117
3372271387,3558370114,1663119361,1663120146,785,1319
3569478966,3804329236,1643701061,1643701594,533,1325
3339312980,3920669948,1658909760,1658910668,908,1690
3897712112,3217060058,1647169920,1647170309,389,530
3733486808,3168084964,1649577188,1649577548,360,1817
3386918140,3295262122,1665445020,1665445989,969,141
3626118668,3755473771,1658127637,1658128053,416,1683
3478921948,3313426081,1642014133,1642014744,611,1295
3080735392,3078231218,1655839092,1655839764,672,778
3795817960,3303698845,1662793758,1662794597,839,1840
3307067721,3356034290,1643350982,1643351541,559,1639
3393606099,3239020709,1652183145,1652183323,178,706
3194871172,3756722426,1657832325,1657833302,977,44
3125911793,3362647814,1648896944,1648897663,719,907
3701979416,3409804938,1655532453,1655532930,477,2364
3686424169,3699258770,1664068561,1664069484,923,617
3356728242,3683507812,1644938933,1644938999,66,1420
3518322544,3020729502,1661864929,1661865502,573,67
3878810894,3587633750,1648917795,1648918408,613,1781
3324998923,3591264259,1652747780,1652747801,21,943
3461508348,3112314644,1651336282,1651336787,505,1725
3802040767,3405955824,1646289211,1646289646,435,1621
3204175740,3400121632,1655888949,1655889461,512,322
3409352040,3765660727,1665464445,1665464450,5,2337
3935383578,3798223043,1656760014,1656761001,987,2408
3168818004,3730270448,1648708733,1648708861,128,1785
3327873529,3280648157,1669503762,1669504116,354,1532
3679617161,3878512967,1666712601,1666712953,352,2171
3364855872,3697322167,1646205169,1646205584,415,978
3353295219,3277978979,1653205013,1653205903,890,1996
3127412666,3817960208,1660120029,1660120546,517,741
3309305862,3096740365,1649529924,1649530087,163,1608
3148549210,3688076815,1661700745,1661700885,140,743
3721136961,3683793217,1646564249,1646565073,824,1454
3108342285,3743687544,1661281708,1661282090,382,1965
3758323845,3259880338,1658092982,1658093634,652,1300
3094562402,3125717667,1644699784,1644699856,72,2497
3906216789,3647994845,1649463182,1649463589,407,1563
3761775611,3197352308,1642604147,1642604448,301,1124
3760142759,3158988425,1658534780,1658535574,794,167
3323783108,3874664424,1642744363,1642745248,885,575
3616218859,3749811473,1659468009,1659468117,108,1462
3543257848,3575512492,1661610336,1661610412,76,2466
3379598529,3865511945,1662105122,1662105716,594,1330
3060674509,3851864688,1664429225,1664429451,226,617
3339459948,3281445213,1654658565,1654659321,756,1414
3930794939,3213169891,1661373850,1661374129,279,708
3052889118,3673948643,1659250095,1659250234,139,1976
3698898645,3675418278,1657207505,1657208339,834,1977
3315583401,3940067834,1658495550,1658495595,45,1111
3674005769,3559267449,1650847262,1650847446,184,191
3664337365,3322287315,1645065804,1645066016,212,2326
3388628484,3434182192,1668868825,1668868953,128,1395
3922358932,3194070207,1651489089,1651490047,958,1427
3947174877,3402354750,1660430666,1660431338,672,1771
3288834634,3342685325,1659365284,1659365799,515,2185
3408978529,3389773271,1642695266,1642695787,521,143
3208220195,3449993526,1656307707,1656308426,719,75
3220577762,3486907422,1652909212,1652909832,620,248
3621726953,3535575355,1645403717,1645403994,277,1289
3878808489,3916776869,1652510275,1652511183,908,162
3349433488,3856160688,1643636250,1643636581,331,1246
3993994586,3050271924,1661801896,1661802860,964,22
3546799061,3585919417,1654919213,1654920154,941,1950
3835976086,3318717113,1655019430,1655019845,415,2066
3390431277,3553048423,1659531013,1659531340,327,1792
3432954312,3881942272,1648409826,1648410270,444,984
3482483232,3158291556,1667613864,1667614276,412,2155
3070117232,3623802234,1664786871,1664787502,631,504
3310499607,3428142421,1647763748,1647764197,449,424
3195504067,3936179181,1652085634,1652085927,293,312
3331604266,3749811473,1668190016,1668190410,394,2141
3960450011,3559696066,1650373983,1650374737,754,691
3424453686,3227310314,1651563196,1651563295,99,31
3265181921,3195274844,1644441612,1644441830,218,976
3429010148,3621938271,1659210001,1659210990,989,1572
3032779815,3022594569,1642375714,1642376482,768,1478
3480905975,3829209875,1665544101,1665544458,357,2027
3425002636,3498770747,1669311643,1669311690,47,1137
3801579775,3953118937,1651790185,1651790937,752,1817
3778625091,3413898378,1665480514,1665481486,972,1218
3274752508,3862102577,1652528502,1652528505,3,1665
3264281080,3385196866,1650263863,1650264097,234,1500
3825462888,3925344243,1667055289,1667055935,646,1471
3327857419,3341897848,1656181628,1656181733,105,2153
3444809495,3929988329,1662092575,1662092689,114,1683
3094414065,3081188307,1665727932,1665728682,750,1525
3243018622,3094291821,1660888665,1660888820,155,2091
3691834770,3180051747,1645721117,1645721912,795,41
3059858458,3833722302,1654322022,1654322385,363,642
3276576100,3208243335,1667270609,1667271333,724,456
3107541952,3485526833,1656734289,1656735105,816,571
3026935493,3469812263,1662480238,1662480569,331,2377
3786724835,3095430228,1663633011,1663633133,122,1997
3427127427,3912916652,1657594518,1657594926,408,470
3702932977,3977872515,1660577081,1660577284,203,1761
3014993252,3085412399,1665717696,1665718179,483,1354
3195534254,3360158658,1663661944,1663662205,261,1329
3865847882,3417143667,1659441846,1659442652,806,713
3022401876,3236132865,1641499001,1641499977,976,1791
3121336226,3404330776,1644439913,1644440583,670,772
3080287966,3652029135,1647323741,1647323858,117,443
3031249180,3378814600,1654551697,1654552474,777,1211
3078628091,3641493201,1656999892,1657000717,825,1109
3777835723,3930474522,1660404551,1660405270,719,1425
3143741876,3205472801,1658106764,1658107404,640,1737
3811318665,3947461796,1648165065,1648165668,603,930
3744386868,3152988371,1666242360,1666242543,183,1367
3341248102,3058927575,1642380688,1642381488,800,1288
3293201387,3163708045,1656861652,1656861855,203,2176
3473852885,3227970299,1665754626,1665754880,254,532
3970917362,3242785599,1645462400,1645462824,424,2113
3039255124,3252981510,1654224979,1654225625,646,2061
3975462879,3481293963,1657923741,1657924680,939,1583
3190417421,3480375415,1645587465,1645587665,200,1254
3576317139,3884256882,1652557379,1652558354,975,178
3145045320,3523829341,1644652844,1644653085,241,1339
3048504189,3574460900,1641649809,1641649881,72,1008
3112356239,3988976739,1646513415,1646513969,554,479
3409332035,3247948931,1645578834,1645579194,360,2347
3768013956,3461938856,1644632402,1644632967,565,1776
3206106614,3236325866,1654716105,1654716315,210,1058
3081213963,3884551317,1667952485,1667952656,171,1402
3020526331,3892686083,1663933273,1663933360,87,118
3145772897,3522211010,1644078401,1644078611,210,2343
3284443787,3114627858,1668337053,1668338018,965,1435
3787465946,3066990756,1658413513,1658414301,788,563
3108288045,3231517158,1662249442,1662249640,198,847
3307033178,3204412545,1650625611,1650626047,436,669
3662526382,3004951157,1666782470,1666783016,546,1053
3675353745,3576411084,1644728397,1644728883,486,1138
3284630826,3635938446,1666369126,1666369821,695,1493
3547758342,3306515955,1649839837,1649840804,967,2091
3586524207,3884067849,1665085080,1665085378,298,0
3128805218,3112270906,1651468900,1651469259,359,1813
3868630067,3333543321,1646215110,1646215594,484,308
3580310329,3911588238,1662990740,1662990782,42,1736
3746050591,3833046871,1660446105,1660446230,125,2155
3894844173,3655923753,1641172800,1641173320,520,892
3756473550,3882603510,1658378616,1658379312,696,181
3550677109,3980841914,1664056090,1664056752,662,2212
3687307113,3322663101,1665538677,1665539546,869,1931
3831426674,3938973292,1643424504,1643424715,211,2236
3524466015,3030286864,1661945343,1661945558,215,2237
3359722926,3419430775,1663887389,1663888118,729,2455
3603786519,3666338218,1642786280,1642787046,766,2296
3080325374,3192193744,1657923825,1657924026,201,1
3798708209,3080325374,1658273954,1658274750,796,437
3537592483,3174712961,1655610727,1655611649,922,1514
3787714854,3370889279,1645983528,1645984431,903,340
3306910493,3829729960,1662213340,1662214117,777,1288
3641460659,3046707177,1668420866,1668421171,305,1973
3525751984,3554753273,1646592419,1646592945,526,1787
3222254600,3141196312,1655276809,1655277460,651,657
3289330422,3935210171,1669438519,1669439031,512,1626
3630750697,3443131930,1646477627,1646478461,834,1412
3979352608,3156683897,1666969818,1666970152,334,2440
3866215730,3173809486,1645375126,1645375855,729,2069
3251808759,3479401102,1666441593,1666442410,817,487
3802823421,3321391869,1669700190,1669700491,301,2492
3359296227,3378791519,1649698176,1649698282,106,2137
3636528701,3095661205,1649212902,1649213505,603,746
3083791573,3903709933,1661593679,1661593797,118,329
3303719777,3577651077,1665238818,1665238874,56,659
3947092814,3607354151,1658257782,1658258267,485,851
3558312644,3275649997,1656274540,1656274759,219,2238
3823682564,3688776786,1654192322,1654192514,192,1260
3710189327,3492103801,1659769894,1659770380,486,1374
3835922991,3109500957,1657184315,1657184452,137,543
3905744284,3343059553,1647419159,1647419412,253,519
3984570592,3973666003,1664780515,1664781165,650,1693
3341890542,3938370016,1641497982,1641498396,414,1800
3962695354,3059151355,1658542317,1658542869,552,1859
3551884757,3328854884,1652776550,1652777383,833,490
3520106918,3920028342,1649605376,1649605883,507,1034
3112739600,3748627476,1657540724,1657540922,198,995
3579486534,3261527870,1647304722,1647305214,492,1408
3456660113,3154553765,1641596880,1641597278,398,572
3950146840,3802325069,1648739873,1648740184,311,707
3664242822,3830303170,1647488095,1647488941,846,1163
3309196902,3125314664,1663832109,1663832442,333,1060
3005200951,3939973483,1657899890,1657900172,282,894
3300015174,3612778107,1649175453,1649175792,339,1543
3696856656,3917601622,1654562912,1654563760,848,1275
3210078490,3828485006,1665449207,1665449850,643,1500
3063674428,3334743610,1647829495,1647830199,704,146
3453227348,3103740757,1656950169,1656950436,267,2047
3637457925,3369330833,1652473349,1652474109,760,615
3539303536,3714105777,1665223474,1665223611,137,2151
3935383578,3170985187,1656464098,1656464896,798,1663
3667414511,3428142421,1653519540,1653519619,79,371
3973666003,3658271419,1651940138,1651940877,739,1618
3826433692,3518246885,1669473394,1669474274,880,1383
3839454838,3827891957,1656131634,1656132204,570,1942
3688133320,3154553765,1663565178,1663565287,109,2115
3790648941,3526747987,1663434327,1663434935,608,1465
3008283469,3770561730,1660713855,1660713962,107,1223
3352751731,3258102756,1655568282,1655568406,124,2330
3074044425,3629942160,1661855199,1661856100,901,804
3065548516,3523631626,1650191472,1650192412,940,2286
3410513846,3292812509,1653103384,1653104157,773,2252
3956055955,3318466045,1641626231,1641626264,33,1384
3073966897,3256859026,1642199923,1642200635,712,129
3103228367,3834826280,1649874619,1649874681,62,1743
3100572176,3217583205,1652416374,1652417127,753,455
3859976372,3229881750,1643280410,1643281323,913,1328
3370779634,3653577731,1641529916,1641530321,405,2482
3697118662,3614399988,1660079375,1660079454,79,1082
3637408266,3347854994,1652631595,1652632595,1000,1324
3716246985,3814278185,1653556565,1653557383,818,697
3130993420,3454554705,1660831823,1660832747,924,748
3721751204,3795494127,1651063087,1651063808,721,1245
3167494570,3898229065,1669136832,1669137069,237,2392
3514152633,3918552618,1653193554,1653193661,107,2220
3909281743,3679141266,1645367742,1645367902,160,2328
3137441705,3307730398,1662224709,1662225669,960,1998
3617545187,3976156173,1667028810,1667029506,696,1723
3492034029,3121391240,1644536517,1644537366,849,748
3126940487,3468654589,1643905759,1643906393,634,620
3402349073,3898403925,1663627199,1663627434,235,1173
3615387566,3951751770,1660270645,1660271133,488,1380
3052889118,3444174394,1641217521,1641217862,341,1662
3985243519,3282425868,1641073431,1641074345,914,863
3757044916,3656092578,1654197985,1654198151,166,1582
3467211844,3895274115,1663494462,1663494762,300,821
3680703930,3211047702,1650479807,1650480196,389,580
3974481828,3560020610,1644709962,1644710824,862,1430
3363279084,3899890592,1648026883,1648027492,609,1314
3438130685,3010161936,1662029871,1662030278,407,512
3471376255,3940310287,1651712815,1651713363,548,292
3181032246,3266498789,1660913707,1660913738,31,3
3924865492,3679045431,1651988944,1651989245,301,1292
3185985712,3323783108,1653248281,1653248869,588,214
3199117399,3518864357,1641143890,1641144247,357,2041
3046080865,3355184225,1657910415,1657911131,716,105
3358968691,3379829698,1653315569,1653315992,423,103
3193344217,3532307372,1659752511,1659752813,302,1468
3324394622,3434182192,1666934361,1666934746,385,1288
3739453348,3675418278,1645277435,1645278050,615,2478
3757499622,3023576817,1669436309,1669436769,460,1091
3178732875,3041792624,1644702352,1644702824,472,1484
3557556781,3346288809,1641444202,1641445059,857,453
3152795421,3167557703,1641646159,1641646706,547,1243
3933450798,3855734814,1645647424,1645647565,141,68
3795508879,3037786726,1660425148,1660426090,942,1880
3016871175,3898229065,1646604099,1646604961,862,251
3546006441,3521160717,1665915312,1665915598,286,1315
3292797747,3506971803,1655659565,1655659776,211,1887
3185985712,3249071020,1659673560,1659673879,319,697
3364600825,3931677547,1669178951,1669179734,783,1130
3928852706,3662455665,1664836441,1664837343,902,1461
3502947486,3439462043,1646893049,1646893627,578,1100
3030286864,3161234904,1665419063,1665419763,700,1876
3430102174,3356302136,1659636696,1659637042,346,763
3204735172,3129283198,1662042602,1662043235,633,1491
3945086462,3252070101,1666252713,1666252768,55,964
3343741687,3201142543,1658098366,1658098774,408,602
3494179125,3049447132,1656117098,1656117344,246,2290
3877638741,3531256735,1647952949,1647953139,190,1099
3368387959,3567491118,1669110608,1669111230,622,2230
3504446959,3869355507,1654008597,1654009117,520,72
3486814228,3478219461,1656119886,1656120753,867,128
3851982179,3819380768,1651010421,1651010745,324,1580
3906236028,3747889498,1660228525,1660228878,353,1783
3948515015,3310512172,1663182636,1663182865,229,823
3008417861,3433439185,1647456326,1647456627,301,2126
3053134032,3772762015,1658982148,1658982374,226,2080
3784495839,3141198072,1646668502,1646669034,532,1399
3124415148,3263328793,1666656829,1666656893,64,98
3734035375,3608297293,1648794713,1648795258,545,1548
3272250396,3745420516,1656334591,1656335457,866,1295
3710708040,3185360566,1661081354,1661082337,983,2336
3832786192,3162641272,1651647118,1651648013,895,281
3001480546,3508718004,1650976504,1650976560,56,1641
3270919620,3932002704,1650393847,1650393896,49,866
3104870555,3676132016,1655232555,1655233000,445,1815
3571719140,3123166182,1666915507,1666916400,893,2400
3903550568,3556823098,1661038226,1661038927,701,91
3168434098,3157821920,1651118075,1651118270,195,1302
3511192827,3436578278,1661123032,1661123320,288,2270
3145961063,3369913868,1663202080,1663202118,38,56
3236819846,3632763218,1642327349,1642327511,162,1606
3532926054,3313079052,1653207022,1653207508,486,2393
3800460824,3576411084,1654556859,1654557152,293,2047
3569525429,3570423127,1668447425,1668448077,652,555
3261255394,3408529019,1660091603,1660092587,984,700
3792253761,3711442352,1654284338,1654285103,765,666
3583918364,3556000533,1651377505,1651377560,55,1200
3184720975,3379935974,1660773133,1660773723,590,1495
3010819705,3409050239,1646186644,1646187635,991,1194
3369330833,3058064037,1662470634,1662471066,432,1527
3495919793,3990520153,1646153837,1646154365,528,398
3512720372,3524131973,1656503601,1656503988,387,105
3426899836,3263372197,1666655931,1666656485,554,766
3035476619,3867868879,1651566004,1651566084,80,478
3848860153,3629090721,1659535974,1659536475,501,641
3485644295,3232667530,1663503560,1663503619,59,1278
3088553332,3461630480,1644200271,1644200274,3,1259
3944398168,3686249771,1668260901,1668261300,399,914
3360342048,3854184537,1644926825,1644927359,534,1245
3069318012,3355798436,1642193791,1642193863,72,1154
3054188296,3679846649,1652791120,1652791266,146,560
3477522732,3855013110,1660959075,1660959812,737,1167
3609804397,3321818923,1641044564,1641044703,139,2007
3736871918,3024554792,1643320457,1643320748,291,2475
3677001111,3275301708,1666039248,1666039632,384,338
3465433147,3641493201,1647735456,1647735846,390,58
3153851884,3713455058,1650035366,1650036072,706,1068
3236325866,3983536056,1653032398,1653032745,347,484
3174639274,3683246538,1643052048,1643052665,617,101
3823206701,3072911780,1661330265,1661330953,688,1729
3913645530,3176608983,1667541823,1667542569,746,2351
3614430693,3194871172,1660987955,1660988473,518,1043
3474259908,3098179768,1649304522,1649304536,14,598
3972441567,3198731476,1652253713,1652253890,177,586
3334030228,3952283751,1656651867,1656652615,748,1430
3568676955,3059447105,1646887707,1646888338,631,2079
3656092578,3744726408,1646973756,1646973825,69,1069
3736483863,3204935260,1641294916,1641295069,153,1572
3019854226,3719503327,1647919954,1647920502,548,254
3648257100,3988337484,1641641605,1641642139,534,120
3790549304,3813290629,1668345981,1668346303,322,577
3530495336,3311303975,1668085511,1668085744,233,657
3547358965,3690349378,1650916653,1650917449,796,1208
3447257561,3199315199,1663375785,1663376758,973,453
3370267721,3170924487,1659567526,1659567928,402,1797
3791460437,3481811999,1667491412,1667492339,927,2136
3367915131,3776027879,1668782730,1668783499,769,1159
3973666003,3773789419,1655100683,1655101588,905,1862
3443360830,3886521997,1647394312,1647395262,950,469
3691474413,3079219552,1655401295,1655401855,560,476
3285030317,3811337280,1653018059,1653019048,989,1193
3586025172,3993923271,1657136997,1657137916,919,1197
3570335491,3927666827,1662460847,1662461585,738,1865
3156189187,3978987003,1643045400,1643046340,940,305
3098820434,3120505983,1643190076,1643190554,478,2261
3183165788,3763093748,1644191685,1644192228,543,886
3266681677,3560020610,1652455083,1652455718,635,359
3081396297,3834401696,1667868051,1667868323,272,968
3515138485,3806167216,1665552866,1665553139,273,462
3509999399,3847237978,1667622481,1667622887,406,68
3388004574,3755085868,1643412044,1643412534,490,930
3060989519,3568676955,1664481297,1664481863,566,2421
3581570568,3049141347,1666345149,1666345851,702,1461
3804257503,3817073865,1650483993,1650484711,718,2257
3750160040,3083791573,1665871344,1665871835,491,1023
3492909923,3356728242,1648531421,1648532129,708,1527
3068723030,3719503327,1666387305,1666387693,388,1967
3000275416,3735943539,1641243937,1641244362,425,1568
3413334821,3059075236,1668706688,1668706872,184,156
3237697952,3957115705,1650906368,1650906505,137,1202
3853448159,3261913628,1650856440,1650857030,590,1543
3120208739,3343177837,1669076622,1669077522,900,1264
3952107057,3309922968,1664433108,1664433274,166,1634
3741929805,3913905115,1652413158,1652414010,852,815
3206106614,3182502852,1652791613,1652791868,255,1223
3048388831,3296478783,1653087456,1653088142,686,2470
3460687455,3574240169,1665470571,1665471281,710,2219
3240588695,3501786397,1652260941,1652260953,12,1087
3673950693,3700412611,1663969679,1663970666,987,788
3404563689,3275810322,1656902583,1656902621,38,1010
3890026377,3268670465,1650077143,1650077343,200,918
3271919876,3634885711,1641878815,1641879314,499,915
3975864053,3064574238,1660373010,1660373613,603,224
3166274990,3003022656,1662027677,1662028038,361,2329
3486208738,3168329235,1653206245,1653207085,840,2150
3285243887,3880835949,1655680893,1655681354,461,130
3215342018,3313608055,1664171947,1664172675,728,1741
3928930330,3795609815,1660314230,1660314682,452,1987
3106465076,3379259059,1652214219,1652214536,317,1652
3520699413,3401134518,1647875374,1647875468,94,851
3375359100,3094852425,1667683752,1667683846,94,506
3273219526,3946614568,1651865617,1651865973,356,101
3758577708,3272663489,1661988245,1661988961,716,2395
3960816300,3216550436,1655847421,1655847425,4,2298
3824083602,3089844622,1648160926,1648161147,221,1270
3641682706,3299362427,1641431496,1641431967,471,1584
3534715157,3267360802,1654049560,1654050366,806,1719
3596567072,3833342718,1655443843,1655443928,85,718
3279773317,3066426534,1642965305,1642965726,421,826
3424790413,3361670451,1649185953,1649186396,443,1516
3670579691,3524282034,1655809653,1655810613,960,2092
3557215676,3967747142,1652923121,1652924022,901,1305
3438130685,3619660501,1647281149,1647281156,7,39
3105679045,3347679085,1657699147,1657699895,748,1341
3094940809,3024651290,1660626027,1660626742,715,340
3100716894,3760304580,1667866419,1667866667,248,546
3970049421,3569686431,1647629087,1647629135,48,1036
3993504996,3987979637,1642478019,1642478248,229,479
3701726268,3504457520,1655768876,1655769568,692,944
3504911583,3552282443,1658523549,1658524169,620,1101
3772762015,3198319752,1641200368,1641200486,118,2028
3918602291,3609310097,1661552758,1661553283,525,546
3686826205,3830303170,1657202766,1657203509,743,1570
3412673526,3485995293,1654278417,1654278910,493,995
3708101315,3281803406,1666162267,1666162588,321,1305
3651535646,3157212376,1666800595,1666801224,629,1361
3650041115,3249554278,1651354744,1651355640,896,481
3154139372,3109941959,1659010458,1659011090,632,46
3686968293,3228518080,1668997204,1668997781,577,189
3034216304,3431595099,1663382566,1663383564,998,1598
3855537172,3026701207,1646137171,1646137897,726,305
3126778118,3762422234,1662306129,1662306838,709,508
3026293367,3755228064,1656980070,1656980520,450,1117
3408048729,3035992910,1657178456,1657179174,718,1196
3816690173,3761147252,1658574796,1658575082,286,97
3753985186,3396406579,1652218168,1652219122,954,2199
3471376255,3234141140,1664634097,1664634912,815,16
3029578425,3316287541,1660350575,1660351219,644,191
3596932196,3525978019,1660361435,1660362288,853,94
3749702246,3703534908,1667393071,1667393724,653,2383
3983158937,3098934820,1665922983,1665923715,732,479
3447555067,3432942151,1661723246,1661724246,1000,2362
3599104606,3845363108,1642406016,1642406941,925,158
3824227701,3749327438,1664273930,1664274919,989,339
3673549679,3746155501,1668179023,1668179624,601,1862
3805921576,3650902153,1661909801,1661910591,790,173
3630448266,3489453670,1654346944,1654347212,268,1728
3287210562,3186207758,1649846080,1649846429,349,451
3707406950,3925754107,1664191866,1664192237,371,1648
3577276558,3149818961,1641822723,1641823020,297,944
3657340310,3884959127,1642268863,1642269800,937,1969
3611685224,3194142427,1648770073,1648770993,920,1550
3735946925,3627886263,1658227651,1658228195,544,192
3714026701,3573826666,1653742792,1653743457,665,433
3199255829,3102672864,1641680379,1641681206,827,983
3437983939,3039198774,1652848592,1652848678,86,1732
3554741157,3958507300,1659756158,1659757113,955,306
3491272857,3534910343,1650004991,1650005022,31,1767
3072911780,3935740815,1661328513,1661328594,81,512
3266620552,3902329320,1657610905,1657611430,525,1986
3845818528,3884256882,1657206540,1657207335,795,1443
3919439752,3821312248,1668120780,1668121713,933,929
3966770982,3736885329,1653676953,1653677012,59,2238
3578002057,3981331110,1648283279,1648283701,422,1093
3232342525,3987979637,1647662336,1647663265,929,1157
3633239646,3058750967,1645178683,1645178839,156,1979
3594254200,3286078112,1661312218,1661312906,688,372
3880290667,3813666053,1660662660,1660662909,249,439
3051863550,3344143432,1652954853,1652955202,349,475
3168535205,3981191978,1669245036,1669245135,99,763
3701196344,3394695318,1656249916,1656250271,355,2464
3177370273,3407746149,1650157839,1650158364,525,877
3730920499,3782708820,1662284281,1662284677,396,301
3591088164,3882030333,1642244010,1642244918,908,631
3003195362,3939244771,1665004313,1665005086,773,651
3046006152,3520341683,1648321154,1648321681,527,576
3775146250,3007308564,1653132475,1653132582,107,342
3492034029,3141635102,1653545244,1653545459,215,1628
3917684798,3184539687,1656516741,1656517235,494,1713
3483254795,3945611603,1648587840,1648588526,686,1202
3821120962,3419783275,1649388550,1649388576,26,1016
3597251704,3077143208,1654001653,1654002560,907,1465
3131131112,3903015279,1654813287,1654813974,687,1970
3568097363,3321391869,1656787979,1656788165,186,1938
3480115115,3010767150,1642983683,1642983789,106,2444
3048409719,3821998886,1641340474,1641340574,100,1659
3163395401,3431000503,1666264839,1666265453,614,1239
3160544934,3718731864,1662046328,1662047194,866,348
3841459327,3767868249,1648670874,1648670887,13,1829
3059858458,3217719618,1651711013,1651711711,698,1448
3244763805,3585218766,1648706541,1648706956,415,1103
3125436993,3953796727,1644128429,1644129382,953,1394
3711048943,3532063469,1666325397,1666325981,584,2433
3300456889,3014354609,1657791011,1657792004,993,1631
3807440065,3176653619,1652822514,1652823202,688,630
3776398060,3191462400,1665559100,1665559690,590,2211
3866681013,3006507589,1643264925,1643265711,786,1518
3538823780,3869991101,1664485029,1664485612,583,1858
3716977635,3340464785,1656602331,1656602465,134,837
3208106743,3575457804,1647377379,1647377504,125,266
3187644022,3494179125,1653224993,1653225080,87,311
3405955824,3075088680,1654907017,1654907074,57,803
3445743049,3178090646,1658115096,1658116060,964,1991
3646433612,3779459643,1667751253,1667751431,178,933
3473728186,3853256957,1658834585,1658834734,149,1789
3276232281,3176941664,1655768112,1655768918,806,498
3327253070,3526798607,1665218702,1665218749,47,11
3527067891,3728224229,1656928512,1656929241,729,1411
3377847710,3557835284,1657163606,1657164455,849,1453
3405799068,3806251232,1652913164,1652913568,404,563
3866268396,3592043925,1644321371,1644321772,401,384
3993637202,3729389785,1667959526,1667959923,397,1115
3251948771,3526439962,1646892773,1646893156,383,499
3574957979,3290481654,1644225653,1644226286,633,567
3064701445,3726892870,1653049023,1653049551,528,1678
3526747987,3128514837,1668280838,1668280881,43,2332
3192375486,3976147939,1644791908,1644792356,448,281
3031827531,3878059612,1658224257,1658224473,216,2416
3920261171,3183165788,1657959788,1657960263,475,1038
3640949933,3488551185,1658212742,1658212955,213,551
3012323943,3284269721,1649035769,1649036584,815,1260
3984274810,3640745969,1656180877,1656181688,811,1474
3051863550,3304589206,1668076762,1668077538,776,1129
3768846820,3749702246,1642044565,1642044960,395,1168
3026727334,3342190885,1647365292,1647365952,660,2036
3158834421,3965563922,1662164655,1662165051,396,1631
3369356299,3123781164,1665140831,1665141277,446,758
3252790120,3396453607,1643495673,1643495904,231,1909
3324003851,3290800332,1662475620,1662475771,151,1132
3309869716,3003872692,1656310650,1656311331,681,2444
3374007172,3763453899,1656087086,1656087378,292,2325
3257492375,3476283460,1651081701,1651082152,451,981
3562579840,3888438556,1646882319,1646883286,967,1609
3949133704,3635988688,1657177372,1657177829,457,1073
3707476548,3832703867,1648740783,1648741004,221,454
3355078629,3002727939,1666651156,1666652028,872,1797
3241444105,3172310061,1649601184,1649602056,872,2168
3179405209,3273243249,1649076513,1649077497,984,1162
3249252169,3222375785,1649153988,1649154275,287,776
3316625530,3566936390,1650638372,1650638640,268,118
3003195362,3620725243,1660973633,1660974536,903,233
3428889808,3407409307,1659307526,1659307899,373,338
3295020761,3301093931,1650143303,1650144227,924,2325
3942862085,3537943189,1642788816,1642789085,269,1246
3714322007,3299389436,1656673125,1656673208,83,111
3467401235,3004160380,1660084733,1660084799,66,942
3140486428,3787298788,1650234976,1650235273,297,1668
3549122378,3828761401,1663733291,1663734110,819,1120
3762533949,3234030791,1657150592,1657151588,996,2098
3863676573,3152200344,1668637465,1668637582,117,1141
3102332016,3934326645,1658834357,1658834992,635,722
3604755020,3774945806,1653813670,1653814520,850,2473
3705752007,3570906118,1652881909,1652882160,251,1389
3749811473,3001794280,1655778416,1655779114,698,1889
3096076350,3428501033,1660004817,1660005481,664,2371
3080287966,3243883781,1667884114,1667884371,257,1817
3072834944,3024447668,1668548296,1668549222,926,2177
3471744546,3445095607,1649819919,1649820333,414,1098
3352595765,3899301205,1669450393,1669451176,783,2395
3351802314,3661135703,1659290328,1659290409,81,922
3875892624,3094414065,1649115189,1649116147,958,1059
3328024680,3343177837,1644109314,1644109751,437,190
3894115655,3615359439,1665721470,1665722371,901,359
3768984387,3640756400,1665292037,1665292336,299,1937
3455537522,3281907019,1647592082,1647593076,994,922
3252843201,3873002836,1668894817,1668895502,685,1813
3242897248,3861652282,1660980124,1660980496,372,1797
3254496907,3776128581,1669532715,1669533414,699,2280
3015956370,3689464410,1666419271,1666420032,761,2045
3167557703,3744147238,1665904794,1665904816,22,1116
3277521554,3904546701,1644303197,1644303831,634,38
3763385597,3255751346,1666815675,1666816582,907,2495
3657753711,3567906153,1645520810,1645521236,426,1859
3808022912,3183740417,1669364638,1669365218,580,659
3835864517,3348198228,1653546100,1653546171,71,1571
3118128782,3866222795,1649106668,1649107002,334,1815
3827431944,3721340009,1663472993,1663473425,432,1453
3533403208,3528278695,1661113529,1661114133,604,1265
3329154834,3982916950,1648252055,1648252245,190,1668
3185977048,3599327423,1645708543,1645709423,880,1361
3890852478,3066750826,1649874268,1649875161,893,2408
3025611145,3952889735,1657234742,1657235317,575,700
3612973191,3697692313,1651728208,1651728720,512,426
3010713914,3884256882,1645016993,1645017380,387,2081
3366262960,3057756725,1653798359,1653798893,534,391
3450502369,3104870555,1648927218,1648927722,504,958
3140064319,3059848821,1666806389,1666806770,381,1912
3900101700,3604236901,1648034511,1648035417,906,191
3622478840,3359278409,1655831587,1655832071,484,2125
3771588829,3457468984,1666743792,1666744203,411,131
3835355277,3959093613,1656390425,1656390546,121,2413
3029149493,3910427189,1650899998,1650900192,194,483
3437983939,3329154834,1660259517,1660259721,204,2370
3737086539,3396146110,1643770111,1643770583,472,1652
3170158934,3760535935,1654189107,1654189313,206,2010
3102332016,3653850140,1642168932,1642169283,351,8
3409823179,3061299464,1652530523,1652530569,46,2402
3009169806,3109234948,1665740353,1665740986,633,495
3664273227,3281597338,1648588656,1648589382,726,318
3972052329,3133427035,1665813686,1665814281,595,790
3452258976,3595984663,1665892880,1665893276,396,862
3215257603,3454276568,1646286106,1646286553,447,1664
3205153391,3345413125,1666051263,1666051802,539,1936
3547749057,3160242179,1662259968,1662260902,934,1907
3260571568,3992571464,1646444804,1646445797,993,1971
3852253700,3404317985,1651432991,1651433441,450,983
3370867881,3298879351,1655080135,1655081081,946,669
3605587138,3170325894,1667918968,1667919659,691,470
3563407459,3308028752,1659886448,1659886453,5,2370
3537787770,3585553252,1646943757,1646944488,731,613
3720240255,3451771672,1657162511,1657163105,594,1190
3139935588,3746969288,1650352121,1650352489,368,2305
3888312656,3911849911,1643367513,1643367821,308,2373
3710851755,3900588986,1647622118,1647622707,589,1200
3636879699,3825900664,1665875063,1665875409,346,324
3584925664,3364600039,1649779582,1649780533,951,1610
3222749852,3526747987,1648565971,1648566870,899,1534
3098276544,3743569811,1641893942,1641894721,779,2079
3103417672,3778381574,1646001368,1646001683,315,1333
3205282165,3412673526,1663312467,1663313121,654,587
3021968850,3159669419,1665490312,1665491187,875,1715
3737420070,3783051630,1654888371,1654888447,76,1574
3957051129,3817668840,1669423561,1669424442,881,1428
3330749303,3145220460,1650838506,1650838739,233,1934
3843347515,3968635893,1658727556,1658728516,960,1777
3657391976,3150817357,1648433046,1648433473,427,35
3680139573,3327873529,1643447034,1643447085,51,1157
3651271289,3569051470,1658523537,1658523609,72,2048
3482933937,3797930164,1656024708,1656025320,612,574
3898012654,3707947874,1654128162,1654128666,504,425
3702983168,3614064639,1658668606,1658669462,856,1719
3490942401,3861717658,1666307310,1666308111,801,558
3765617850,3413810353,1648275466,1648275717,251,459
3064574238,3707552735,1652330675,1652331222,547,394
3098290557,3110639083,1662663065,1662663446,381,2231
3284443787,3560043638,1649306666,1649307254,588,1443
3688776786,3671154785,1656285202,1656285280,78,2440
3502554871,3320488617,1652538699,1652538891,192,1052
3039962870,3547923552,1660943542,1660944022,480,793
3476558133,3339611423,1668465748,1668466337,589,764
3148589566,3234851871,1650456008,1650456265,257,2089
3958710935,3585553252,1668548296,1668548667,371,445
3968682824,3774806676,1656274831,1656275367,536,1246
3468654589,3677001111,1644575915,1644576383,468,1074
3547072063,3999788546,1655564075,1655564890,815,642
3709518724,3085799189,1658209277,1658209722,445,1528
3352986307,3314583046,1644678397,1644678543,146,773
3929305160,3841170833,1642313331,1642313496,165,668
3630744377,3488001885,1665710552,1665711498,946,2452
3017715856,3251854206,1644859646,1644860370,724,1874
3565803867,3829347049,1650856318,1650856907,589,1477
3114764410,3363097423,1662102189,1662102488,299,1145
3825995272,3241392393,1664032187,1664032450,263,1114
3890161181,3116584028,1667856754,1667856831,77,625
3517449502,3967425379,1652015594,1652015783,189,990
3984570592,3802816973,1650802465,1650803182,717,1490
3355910238,3377774902,1662697352,1662697986,634,1733
3168820334,3034470773,1647861424,1647861820,396,938
3842560828,3272428764,1658438024,1658438164,140,1324
3065482463,3188680599,1651998211,1651998554,343,868
3878698797,3935978133,1649024303,1649024476,173,1353
3793086361,3083182515,1669162100,1669162495,395,1991
3719124928,3420298161,1662706675,1662707537,862,2162
3589984222,3462483679,1659565926,1659565966,40,863
3624139591,3731828976,1650424506,1650425354,848,574
3903978752,3369040211,1666583922,1666584384,462,1323
3817667121,3928930330,1664101617,1664101953,336,2257
3605308632,3732840219,1649716418,1649717097,679,2126
3081213963,3645560004,1653985530,1653986097,567,846
3531842620,3598665921,1667838447,1667838512,65,164
3472052544,3287714636,1669563334,1669564241,907,543
3579921083,3865950417,1656667850,1656668591,741,1575
3209544947,3500264647,1645392286,1645392610,324,1479
3532450192,3053991932,1667838822,1667839651,829,894
3942134694,3177651100,1649635218,1649635250,32,1906
3633830454,3750765878,1662005357,1662005507,150,921
3220750989,3786724835,1661614155,1661614270,115,1656
3904183865,3953655387,1647273695,1647274137,442,1280
3079516653,3413056504,1656844138,1656845094,956,362
3133601374,3191414403,1657383177,1657384143,966,698
3713116694,3283947136,1665318230,1665319177,947,2441
3260246509,3051863550,1656142121,1656143013,892,458
3619309272,3542688397,1646111875,1646112575,700,2442
3793298032,3885235661,1641014401,1641014431,30,386
3835621921,3170924487,1642505712,1642506296,584,521
3474088124,3370263528,1645094317,1645094666,349,2394
3201446016,3561113748,1660919987,1660920079,92,379
3744829701,3926426459,1643291852,1643291873,21,1105
3809059026,3951158399,1653240486,1653240781,295,1805
3025223556,3013484024,1647913972,1647914737,765,934
3414258502,3059491889,1652973704,1652974435,731,1166
3292365668,3119869652,1664858123,1664858912,789,1741
3985734621,3614741796,1656298748,1656299224,476,1274
3127549843,3359078190,1643570801,1643571476,675,309
3912106632,3642314622,1662044449,1662044847,398,1080
3254083367,3330749303,1661981424,1661981799,375,38
3907705988,3052396813,1658218152,1658218570,418,1626
3992817916,3591724433,1664091041,1664091750,709,763
3074619364,3107199564,1654115329,1654115441,112,1703
3900911220,3219656369,1663767520,1663767791,271,911
3828530052,3949445116,1668499048,1668499194,146,526
3200468398,3616712503,1655292364,1655292766,402,837
3866260144,3841170833,1654186612,1654186967,355,182
3553096192,3372334548,1656907716,1656908580,864,1982
3269283315,3833722302,1652307323,1652307707,384,55
3907705988,3651753987,1661302905,1661303563,658,602
3053026624,3929887239,1660760025,1660760832,807,2375
3922341165,3281397783,1669192409,1669192835,426,1763
3948743692,3371767777,1644277602,1644277611,9,607
3291780380,3259260257,1650159692,1650160273,581,1834
3729820423,3583591867,1652748868,1652749254,386,1672
3092564684,3735943539,1656084313,1656084939,626,2364
3595049641,3016508907,1653709940,1653710767,827,1550
3526630913,3855769157,1652162678,1652162780,102,851
3928727074,3309053474,1662253998,1662254518,520,161
3272555962,3285331142,1666309579,1666309766,187,1061
3919196366,3535325513,1641391991,1641392987,996,1845
3935601127,3258854274,1652823692,1652823740,48,824
3557643641,3215342018,1643766767,1643767709,942,526
3837447685,3257732454,1655262732,1655263573,841,1365
3730920499,3821391381,1666744309,1666744760,451,345
3691834770,3711059561,1645659811,1645660365,554,1579
3537915144,3615387566,1668716435,1668717354,919,1530
3664267954,3254866960,1664171022,1664171590,568,1903
3784698616,3590259850,1665524243,1665525049,806,1893
3164702890,3029807207,1642878114,1642878583,469,437
3763385597,3637944484,1652058123,1652058328,205,2312
3466459383,3256231811,1654437590,1654438389,799,2059
3594471575,3414669089,1652723067,1652723904,837,2238
3775948778,3829729960,1664521370,1664521631,261,1768
3444313610,3004160380,1647169386,1647169919,533,2470
3118406319,3017712081,1663366690,1663367384,694,987
3997167780,3239620599,1647390165,1647391047,882,1093
3668441547,3081028310,1662092913,1662093278,365,1089
3721226798,3714698686,1667669141,1667669279,138,682
3353388722,3556033785,1661647227,1661648178,951,1860
3657101592,3415888174,1664510086,1664510806,720,1378
3344077337,3822187489,1649545988,1649546312,324,1656
3936659399,3115367011,1650889676,1650889681,5,1090
3165492854,3838250910,1655666979,1655667193,214,2389
3992708211,3039176873,1655092337,1655092541,204,63
3816536444,3617340911,1648552377,1648553337,960,871
3941903445,3804329236,1643954065,1643954297,232,238
3980501547,3344177563,1643837847,1643838822,975,459
3311382844,3814045699,1656409103,1656409773,670,1470
3145669202,3856080546,1651848292,1651849268,976,2402
3832336338,3045570288,1667073096,1667073327,231,980
3057725565,3449504551,1645478850,1645479102,252,686
3716977635,3346254669,1650884130,1650884400,270,1810
3618380884,3038832798,1657905385,1657905462,77,1791
3364390232,3528418687,1652081599,1652081786,187,381
3949002357,3096746005,1642779099,1642779568,469,1596
3636528701,3774991953,1648514756,1648515136,380,1481
3558539337,3845801721,1665583138,1665583520,382,224
3088465843,3526218972,1667661325,1667662155,830,703
3407460146,3705943924,1665800661,1665801465,804,1775
3740090157,3002876565,1666603385,1666604004,619,1865
3943622737,3151896132,1659224748,1659225547,799,1612
3469471892,3581570568,1654500232,1654500393,161,1757
3446946900,3572594221,1650845108,1650845663,555,1984
3325735696,3242752835,1658661707,1658662575,868,2222
3999180921,3023576817,1643341259,1643341611,352,1203
3242235161,3911632634,1650399234,1650400018,784,411
3775665997,3851864688,1641485024,1641485146,122,1511
3824545323,3917240832,1654942877,1654943173,296,403
3656656446,3317241023,1650822313,1650822477,164,2398
3776429592,3048896097,1660447406,1660447641,235,938
3130899709,3821594953,1642908019,1642908057,38,2088
3486606390,3986311619,1657033956,1657034686,730,705
3998763119,3444005080,1661429741,1661430571,830,562
3404904674,3354233805,1665625654,1665625828,174,425
3505270174,3793032912,1656881152,1656881615,463,1104
3480642253,3975379893,1641740480,1641741067,587,2292
3539510682,3185985712,1668115438,1668115925,487,2325
3410513846,3706605056,1642798327,1642798840,513,1918
3265571367,3540799664,1646490165,1646490684,519,1544
3075288965,3059848821,1643686608,1643687576,968,1785
3017504746,3570906118,1669476992,1669477302,310,873
3809059026,3668625909,1651399289,1651399891,602,1869
3852818295,3558139345,1641490747,1641491676,929,1988
3707940691,3124941982,1641630776,1641631377,601,945
3767409219,3240588695,1648206431,1648207211,780,468
3845511281,3381769309,1666606539,1666606992,453,2499
3747363730,3934773931,1659641002,1659641327,325,265
3764492400,3317241023,1651743591,1651744307,716,713
3087123320,3666338218,1656653587,1656653971,384,2009
3369049258,3253059691,1652548625,1652549192,567,830
3840533238,3719929552,1658801591,1658802505,914,2447
3269357443,3759986276,1659992608,1659993015,407,1372
3332797032,3501308694,1667435219,1667435873,654,1834
3032800454,3139455252,1649003236,1649003343,107,15
3136798128,3600901232,1660742058,1660742583,525,2169
3060121211,3677965553,1648231043,1648231601,558,1525
3029956642,3067229796,1663833060,1663833504,444,2452
3836565798,3242622170,1654246507,1654247461,954,1329
3705733070,3276341369,1649616456,1649617355,899,1365
3575715668,3011686027,1654132658,1654132991,333,1271
3668552386,3114277786,1649040658,1649041614,956,1611
3131131112,3136200575,1653951669,1653952303,634,1466
3228366627,3367685887,1665805042,1665805246,204,385
3112070783,3806015172,1669175546,1669175988,442,1097
3498707377,3804094924,1644499386,1644500096,710,2227
3010649870,3718823049,1644470223,1644470545,322,1987
3800271865,3903108572,1652035451,1652035627,176,2331
3531842620,3271278790,1649384204,1649385030,826,1739
3264753140,3987510303,1654662155,1654662167,12,226
3068129646,3790783685,1658018870,1658019542,672,711
3188126815,3968337751,1646759455,1646760309,854,697
3510323514,3973440480,1647156664,1647157511,847,2251
3029758309,3537138552,1657376824,1657377310,486,1417
3210078490,3285333536,1649968845,1649969134,289,1192
3828555703,3904881288,1645102817,1645103437,620,388
3958539607,3933450798,1666197074,1666197614,540,410
3828503026,3252843201,1645421947,1645422081,134,1598
3618441418,3419422052,1645671170,1645671717,547,2486
3137803904,3816995343,1647174720,1647175675,955,1871
3640587334,3494746675,1665336489,1665336489,0,1211
3887791096,3947704522,1665842359,1665843287,928,2155
3604852600,3460504628,1652271163,1652271396,233,1060
3565083183,3610930903,1647261274,1647261529,255,1633
3984818292,3882438892,1664466862,1664467398,536,1373
3315283904,3652513122,1655442413,1655442993,580,1286
3492773808,3917240832,1662605025,1662605540,515,63
3290794282,3632911091,1643939465,1643939551,86,536
3693925345,3691032308,1650279506,1650279601,95,2413
3337601088,3392121294,1665867170,1665868141,971,2389
3611025093,3870359885,1666974945,1666975545,600,207
3501729913,3545658442,1650119334,1650120008,674,1066
3402880726,3829149174,1642662686,1642663361,675,2105
3209332658,3976453338,1668050977,1668051607,630,2186
3360051725,3788785252,1668551038,1668551393,355,2367
3136174856,3957803611,1666046274,1666046793,519,1302
3797930164,3804657904,1647662626,1647662992,366,2413
3560043638,3214558994,1644186479,1644186670,191,696
3562547940,3093024844,1658230300,1658230998,698,2297
3046043182,3974318707,1662815056,1662815853,797,1105
3334102064,3845256746,1657525583,1657526035,452,1562
3046351455,3220432369,1657385534,1657385584,50,860
3309767670,3781368357,1645268368,1645269165,797,648
3563750578,3418364050,1665812340,1665812933,593,1163
3350872529,3766345791,1659662735,1659663713,978,2337
3458493864,3776954666,1663005602,1663005674,72,1340
3269622220,3269573550,1647097217,1647097806,589,164
3099976032,3045879019,1668974303,1668975266,963,2472
3147336288,3982736205,1660065962,1660066938,976,1832
3604759141,3192375486,1648576282,1648577230,948,2004
3885162740,3934141269,1656211875,1656212491,616,306
3264081641,3165807050,1652913307,1652914212,905,136
3981210682,3333347852,1649695126,1649695297,171,2481
3727020814,3506971803,1641732752,1641733228,476,796
3461630480,3938773149,1660443626,1660444353,727,16
3053005521,3329751201,1659942943,1659943135,192,461
3425548171,3084730908,1660700484,1660700580,96,86
3475779347,3285303154,1645762335,1645762375,40,287
3628956600,3614179985,1658541634,1658542029,395,1991
3546605941,3309767670,1647474768,1647474954,186,1622
3075519908,3131131112,1651968071,1651968900,829,1862
3292298549,3348802129,1642701819,1642702281,462,14
3763455710,3958449916,1663610250,1663610466,216,1630
3325944344,3108998670,1648375406,1648375957,551,1944
3099934862,3506937925,1662923872,1662923947,75,2331
3103740757,3401138486,1655492013,1655492887,874,1071
3870485916,3425804563,1650976401,1650977265,864,2125
3975504102,3291175188,1668484294,1668485156,862,1625
3552958954,3952889735,1667652493,1667653363,870,189
3534224607,3003872692,1662584507,1662585190,683,1935
3462483679,3485459472,1661028506,1661028806,300,1108
3565700391,3190064020,1657645968,1657646454,486,2365
3449504551,3604757184,1653250855,1653251240,385,1139
3690586350,3048386186,1653023328,1653024258,930,957
3633111737,3688790539,1641728728,1641729684,956,1906
3010713914,3205359825,1669522623,1669522714,91,141
3009365802,3753483202,1654196246,1654196789,543,1658
3966130885,3758849561,1651185894,1651186462,568,1762
3931789231,3386490201,1641577307,1641577720,413,2046
3042461816,3313687025,1667362653,1667362718,65,1200
3028311577,3400114442,1666702688,1666703494,806,2279
3062261092,3765472006,1645754312,1645754869,557,859
3153541916,3654381548,1651860778,1651860804,26,138
3201479561,3916261675,1658776366,1658776614,248,1319
3636001595,3717406689,1644912699,1644913519,820,846
3049592624,3839200168,1664844063,1664844991,928,1552
3414277030,3716246985,1652730663,1652731292,629,1107
3091062283,3022707615,1642283865,1642283970,105,1970
3319782337,3704871253,1669038489,1669039268,779,2133
3464330947,3678197665,1662284816,1662285711,895,1213
3894431064,3673731636,1660632189,1660632958,769,1731
3442779071,3223290764,1659054369,1659054691,322,2098
3758849561,3431595099,1660213411,1660214217,806,281
3392569339,3440778681,1647769114,1647769276,162,2098
3640613606,3085429140,1654748809,1654749583,774,486
3493424957,3292636621,1655408706,1655409096,390,1424
3432186900,3786194675,1651212650,1651213197,547,2478
3271182009,3249261763,1662468371,1662468656,285,69
3697322167,3187644022,1649847274,1649847517,243,2298
3378168172,3178235505,1668367533,1668368348,815,562
3206549691,3371026826,1653263454,1653263464,10,640
3248452729,3480308437,1655584815,1655585786,971,239
3280399460,3543872563,1643453672,1643454406,734,1553
3115177011,3748061416,1649146260,1649146602,342,1066
3264148498,3972195042,1645057343,1645057592,249,2214
3821299576,3595738872,1662466699,1662467629,930,1617
3181074947,3662409391,1666180559,1666181171,612,597
3916456426,3813690540,1653287579,1653288218,639,995
3344337283,3835621921,1663855091,1663856014,923,1675
3035946381,3689680251,1660521884,1660522256,372,1004
3171734482,3470482542,1642193285,1642194083,798,688
3130561868,3290481654,1666862922,1666863087,165,128
3397940369,3120419076,1667770974,1667771452,478,2148
3057837723,3797259426,1641992031,1641993031,1000,1215
3608071362,3897222406,1668645352,1668645847,495,1666
3421772590,3048388831,1660465220,1660465407,187,676
3414857456,3884256882,1641589119,1641589757,638,1314
3099976032,3864930473,1654852988,1654853761,773,1843
3741494242,3707867178,1660084258,1660084881,623,2100
3816309635,3771111014,1645680663,1645680940,277,1953
3142869544,3415917688,1644509017,1644510017,1000,783
3083182515,3863697907,1668765183,1668765567,384,2464
3328699609,3801956152,1661932388,1661932550,162,1853
3168084964,3117262222,1661877741,1661877817,76,312
3311329069,3133767042,1662854394,1662855294,900,1767
3888703674,3918602291,1661784783,1661785606,823,897
3713129998,3216550436,1647877518,1647877747,229,1315
3232160942,3360051725,1666855056,1666855896,840,1975
3641618845,3827851972,1658620473,1658621135,662,1453
3818823702,3710318693,1650119629,1650119812,183,1275
3085093321,3889126069,1647864818,1647865799,981,2041
3868701805,3734311859,1645996863,1645997242,379,2189
3351610798,3685505113,1645530502,1645530715,213,1380
3618397647,3187523092,1664556397,1664557335,938,359
3963334554,3228565452,1644910300,1644910815,515,2363
3001794280,3814572709,1654693339,1654693890,551,2313
3573252143,3200933791,1650851318,1650851487,169,1310
3994651874,3866534454,1651761282,1651762141,859,523
3787920743,3356154602,1661675270,1661675880,610,1413
3427127427,3469783180,1662048141,1662048463,322,1888
3523394395,3403389913,1653281774,1653282365,591,317
3091817310,3605706184,1660536793,1660537674,881,543
3592043925,3377086230,1667719011,1667719280,269,1425
3622259711,3310882037,1660876233,1660876748,515,1741
3992817916,3883864322,1650526486,1650526562,76,118
3713129998,3641682706,1642001702,1642001726,24,2279
3098083694,3938679223,1642122533,1642123413,880,1654
3265364405,3857460953,1663331043,1663331072,29,921
3818467247,3764173171,1661722243,1661723176,933,1180
3658461707,3176941664,1662894328,1662895213,885,237
3710189327,3910846571,1647146660,1647147641,981,240
3607385542,3040528605,1647342327,1647342995,668,1239
3904445895,3085136451,1641942110,1641942908,798,892
3504893701,3732796331,1643331501,1643331832,331,1298
3378814600,3797237179,1663852626,1663853037,411,92
3977078930,3208464348,1663956848,1663957191,343,1006
3593487418,3339415879,1641176210,1641177043,833,1675
3364059276,3462743550,1667983455,1667983877,422,1828
3148366567,3624060457,1662921596,1662921611,15,105
3120208739,3661976391,1663176585,1663176632,47,1374
3740090157,3292667822,1661992862,1661993141,279,1715
3280648157,3154991935,1644604435,1644604998,563,1625
3134793811,3954988798,1662198703,1662198876,173,998
3066639403,3159562411,1645298897,1645299289,392,439
3747363730,3984467207,1664811834,1664812326,492,1303
3072985971,3370701718,1657305870,1657306026,156,1255
3252421501,3628583147,1651768812,1651769131,319,1030
3934199220,3359901981,1662095162,1662095573,411,275
3622485921,3521112560,1652756751,1652756770,19,2379
3041563987,3407909365,1650564028,1650564321,293,932
3703943697,3223459561,1667372750,1667373075,325,32
3823288349,3391056146,1664580406,1664580740,334,2069
3185373368,3399235044,1662212155,1662213143,988,1694
3023448006,3061840033,1656199021,1656199553,532,1589
3753391012,3651753987,1664473061,1664473126,65,101
3720475877,3423593448,1647403529,1647404332,803,704
3870349696,3600472145,1653762466,1653763313,847,2253
3518864357,3940310287,1654931668,1654932033,365,415
3716461226,3785813162,1665919331,1665920245,914,660
3759409777,3494990710,1663559568,1663560276,708,653
3518607253,3454554705,1668047706,1668048392,686,302
3859164696,3393156673,1647730198,1647730946,748,1110
3175498635,3565083183,1643616585,1643616982,397,1635
3691925367,3806520351,1647666833,1647667193,360,2327
3813632607,3975504102,1668749466,1668750365,899,246
3153750267,3497990894,1642721245,1642721673,428,1354
3019773309,3137829230,1663819067,1663819594,527,2305
3870778205,3866532806,1652112066,1652112950,884,1754
3464625158,3248395971,1664697294,1664698043,749,1674
3255115511,3531345844,1643983004,1643983152,148,815
3527291464,3218780941,1647461800,1647462351,551,671
3687925631,3959783422,1653996166,1653996909,743,1924
3540735539,3655981198,1645147978,1645148121,143,113
3768984387,3786480807,1655449221,1655450172,951,1273
3810320285,3294478149,1650619702,1650620578,876,1077
3757507821,3832275392,1663628953,1663629793,840,2491
3759867623,3801358344,1647763007,1647763556,549,1585
3296419150,3578974875,1645549703,1645550268,565,1866
3286696325,3435252882,1657793996,1657794057,61,58
3796065026,3520341683,1653559450,1653559672,222,570
3749756110,3930124385,1648986245,1648986369,124,1950
3437122732,3749208805,1642123520,1642124219,699,241
3782708820,3607385542,1643476308,1643476866,558,1976
3881378306,3588936901,1669752500,1669752979,479,1243
3749379310,3692368068,1652244492,1652245461,969,376
3620522583,3887108152,1665484281,1665485166,885,15
3274208430,3599299457,1651329723,1651330201,478,1452
3915206176,3936360658,1666186837,1666187772,935,318
3395307809,3666148943,1655657007,1655657268,261,1629
3419465829,3204359619,1641656376,1641656884,508,2278
3379935974,3655135775,1648125896,1648126593,697,726
3125717667,3677001111,1660554698,1660554778,80,805
3654922401,3547429967,1643860938,1643861738,800,41
3416076001,3070795112,1661420923,1661421248,325,996
3190778281,3802790977,1645534990,1645535864,874,345
3791406454,3852184769,1665923548,1665924061,513,388
3307636200,3029149493,1644411238,1644411444,206,1160
3648975076,3784495839,1654498432,1654499122,690,2208
3957577990,3828761401,1655030412,1655030634,222,2492
3025014828,3643939596,1644605235,1644606064,829,2241
3836762535,3211047702,1652273415,1652273481,66,984
3964738114,3460047535,1669707800,1669708613,813,580
3089574886,3699625300,1659235060,1659235689,629,923
3956194935,3724157579,1654180021,1654180089,68,754
3072734804,3120081486,1658246462,1658246526,64,2310
3915637706,3512631937,1645051059,1645051298,239,2443
3084531614,3791315348,1653020060,1653020871,811,2364
3296895937,3889967886,1668196436,1668196930,494,2058
3346986628,3425490548,1645842017,1645842971,954,128
3645768666,3120949338,1661207803,1661208230,427,2391
3472458500,3062486954,1648645112,1648645149,37,308
3556456137,3898403925,1663559062,1663559412,350,748
3714719241,3011981503,1642451098,1642451616,518,1161
3523394395,3605308632,1642177669,1642178142,473,965
3205383513,3075288965,1667320135,1667320198,63,1161
3474808421,3207757416,1656210138,1656210943,805,378
3661372760,3180534430,1665398132,1665398766,634,1640
3489273340,3777846262,1657256446,1657256571,125,1865
3556823098,3074886612,1656641898,1656642570,672,711
3948074176,3722859316,1652265809,1652266555,746,151
3275494433,3216582576,1642938391,1642938767,376,1558
3655498745,3209462413,1650318534,1650319424,890,643
3057837723,3791055136,1646013604,1646013950,346,943
3464983756,3937728696,1659164979,1659165358,379,320
3389472671,3060718787,1660019815,1660020728,913,2099
3831380073,3526630913,1645795949,1645796947,998,827
3067539427,3429445014,1653996118,1653996588,470,1346
3854859043,3506345760,1655437711,1655437982,271,2125
3735943539,3451299629,1659188571,1659189465,894,1259
3490435539,3172305265,1656589090,1656589654,564,1643
3502947486,3112389617,1652259148,1652260000,852,1576
3524109178,3389812297,1658298408,1658299404,996,1503
3692345317,3446699030,1661772414,1661772789,375,1881
3778147762,3749379449,1664510033,1664510958,925,5
3777872237,3129641154,1647276348,1647277048,700,746
3247787797,3465229825,1669286229,1669286503,274,244
3637518238,3733143454,1642913122,1642914005,883,1507
3832252723,3901736828,1645990391,1645990452,61,12
3929305160,3358156140,1664362287,1664363065,778,2041
3745960708,3302113605,1656272383,1656272447,64,734
3767581542,3766914780,1654019522,1654019901,379,799
3912916652,3576862500,1650925216,1650925233,17,1497
3961903747,3142101976,1654674527,1654674878,351,1300
3176818286,3156962564,1647126549,1647126660,111,1679
3772337054,3627385112,1650687693,1650687721,28,1393
3538823780,3049869003,1641436399,1641436556,157,890
3389448374,3620939715,1646459047,1646459867,820,417
3431354119,3286065477,1659221296,1659222045,749,1783
3501520918,3150551034,1664360782,1664361649,867,1836
3351216955,3225989431,1641941953,1641942046,93,2119
3616218859,3471221302,1660725107,1660725199,92,1020
3506384176,3832072924,1646042001,1646042530,529,164
3377911201,3546290525,1660381856,1660382341,485,478
3886736668,3364911803,1646818166,1646818182,16,1018
3514894244,3161805415,1657974874,1657975174,300,2256
3557734825,3070984953,1667165832,1667166826,994,2006
3988466264,3547483148,1664210805,1664211721,916,773
3877299439,3135579253,1642259118,1642259224,106,1632
3890492731,3203153576,1653419728,1653420359,631,2360
3605492251,3039198774,1647604467,1647605422,955,273
3200468398,3858459394,1653650660,1653651239,579,623
3942862085,3072734804,1659246463,1659247361,898,1801
3337673105,3589972665,1666280864,1666281389,525,76
3512100935,3339385127,1657014815,1657015153,338,2464
3421505883,3776148003,1664949634,1664949990,356,1596
3393606099,3602891052,1647201796,1647202769,973,1981
3345543859,3529898997,1647231044,1647231075,31,132
3196934109,3928572443,1663074912,1663075013,101,2100
3158503756,3815774397,1667015917,1667016114,197,789
3284269721,3445689630,1642589437,1642589752,315,924
3049592624,3094277549,1659480416,1659481022,606,2159
3801107936,3359541123,1650669552,1650669883,331,2097
3375585327,3906309759,1642916151,1642916553,402,1469
3070984953,3996319604,1657344742,1657344941,199,2429
3921451192,3882603510,1666418263,1666418677,414,1619
3989741708,3084030782,1652086272,1652086305,33,624
3626015702,3139376524,1654370905,1654371659,754,393
3425613329,3552305242,1658807816,1658807986,170,390
3886780901,3424897066,1661969707,1661970066,359,1840
3962784099,3336494171,1644071085,1644071443,358,1093
3674729672,3228737899,1658398017,1658398698,681,103
3450502369,3518583464,1649236172,1649236282,110,2199
3518717396,3284269721,1653378333,1653378526,193,2495
3214969929,3605278552,1643735736,1643736372,636,404
3745737102,3669744444,1669589544,1669589997,453,2331
3101460702,3636948225,1647214662,1647215269,607,2089
3064522150,3957216784,1667185854,1667186055,201,2441
3223159718,3094852425,1661816519,1661817462,943,555
3988957478,3811472324,1666645191,1666645200,9,433
3435224460,3752176146,1643524174,1643525075,901,1051
3398124878,3911960681,1641748164,1641748173,9,408
3211401798,3410613004,1655495235,1655495556,321,1162
3641185549,3958507465,1655774390,1655775038,648,2446
3475352970,3224960669,1660234544,1660234917,373,1999
3442330693,3286555687,1647704551,1647704689,138,1859
3741134467,3887337385,1652533721,1652533999,278,181
3556648442,3931854815,1652099116,1652099430,314,1421
3924167113,3421671936,1667926485,1667927439,954,2475
3780368492,3341890542,1659080862,1659081661,799,2336
3859976372,3957689713,1659614055,1659614683,628,264
3515367610,3649036884,1648629227,1648629838,611,1192
3262711330,3955776304,1647741828,1647742779,951,401
3304559201,3852810875,1665975305,1665975602,297,118
3500735220,3265181921,1643093097,1643093470,373,1706
3047372637,3392121294,1668492472,1668492658,186,1987
3149143223,3215502915,1655274643,1655275292,649,1923
3153552268,3601590462,1646499977,1646500357,380,54
3828555703,3831951487,1660556105,1660556355,250,652
3787590278,3660551283,1655958604,1655959455,851,1628
3332721407,3634885711,1659341332,1659341479,147,996
3295518987,3654922401,1646394264,1646394399,135,2137
3796255141,3774724683,1659075137,1659075175,38,2141
3555560595,3153541916,1650750340,1650750663,323,557
3232209052,3706797905,1644507533,1644508048,515,177
3759909818,3110121278,1662032087,1662032515,428,1256
3184720975,3455537522,1642765029,1642765949,920,974
3901360663,3271278790,1654475993,1654476187,194,1563
3958920817,3651571335,1667585972,1667586868,896,68
3055050795,3628927796,1664774246,1664775203,957,1648
3996319604,3638822670,1651269260,1651269517,257,110
3819235768,3066639403,1650613144,1650613291,147,635
3056501932,3686594925,1652713450,1652714122,672,1843
3446481380,3466282430,1644482170,1644482977,807,1756
3164355501,3073924620,1669205078,1669205944,866,135
3452564658,3506273643,1648748037,1648748404,367,1931
3788018778,3828531030,1651314717,1651314754,37,476
3239418137,3569443529,1656340828,1656340837,9,921
3306439333,3248733503,1654206077,1654207050,973,1430
3469879706,3452258976,1648466489,1648467189,700,275
3813690540,3320488617,1650072978,1650073216,238,229
3914888679,3232667530,1662898876,1662899481,605,1894
3830541998,3502316165,1660871153,1660871285,132,1277
3895855296,3397052856,1657019728,1657019787,59,587
3592043925,3481090623,1641354215,1641354326,111,1627
3309869716,3011863548,1655138085,1655138246,161,1775
3896239645,3779611783,1665025803,1665026598,795,819
3338812942,3395670756,1661269866,1661270563,697,58
3057314040,3665075758,1655435366,1655436199,833,1791
3378162995,3131548243,1642828488,1642829303,815,1286
3467810757,3997810649,1646435668,1646436520,852,2087
3419751912,3173108957,1650268471,1650268579,108,383
3417248496,3216810372,1652563547,1652563964,417,1599
3508143883,3909281743,1660185555,1660185651,96,796
3012593677,3915817603,1649721032,1649721591,559,1593
3328993418,3721541321,1655097687,1655097850,163,1285
3005700539,3605412707,1645251576,1645252265,689,189
3322226292,3508311968,1648331037,1648331466,429,9
3804145408,3390431277,1644252571,1644253408,837,1275
3045925816,3332797032,1668024993,1668025190,197,993
3692772256,3110395191,1645120748,1645121235,487,71
3534182480,3871321308,1662017358,1662017735,377,888
3737772457,3952316985,1646321000,1646321578,578,1969
3346012606,3140407144,1658354771,1658355271,500,991
3804773972,3398840886,1657111887,1657112099,212,997
3713520914,3417049317,1648626414,1648626488,74,1114
3837877764,3063520189,1660322251,1660323211,960,643
3336551797,3723438987,1653080599,1653081311,712,310
3820302319,3261463305,1649352100,1649352466,366,1146
3232469999,3477770827,1659464971,1659465008,37,1585
3548609816,3112270906,1647331281,1647331597,316,728
3255751346,3725042810,1646221681,1646221810,129,2488
3620700244,3906216789,1647117523,1647117880,357,98
3835842311,3785586097,1654108886,1654109087,201,871
3483254795,3404908537,1644392028,1644392057,29,1087
3598645736,3976970303,1644280583,1644281406,823,2436
3493226566,3411495833,1665094181,1665094540,359,87
3050434345,3998850502,1648396581,1648396583,2,621
3544365476,3361422449,1665699782,1665700210,428,2179
3269726483,3991340294,1642337988,1642338639,651,1116
3270935026,3958375464,1647531981,1647532304,323,1834
3868701805,3984818292,1656037627,1656037816,189,116
3042360618,3436975295,1660387879,1660388729,850,105
3286555687,3278827891,1651572173,1651572747,574,548
3224800126,3941512307,1650352176,1650353053,877,234
3128613298,3611062566,1660914869,1660915580,711,2388
3569743064,3469583371,1660997537,1660998044,507,1442
3580594125,3312124839,1651921280,1651921381,101,2237
3143741876,3603399306,1652293073,1652293918,845,2266
3467383586,3132584801,1667804507,1667804623,116,1379
3417143667,3496470143,1661446885,1661446939,54,908
3382840804,3355195985,1648587737,1648588479,742,805
3976223971,3047629830,1667267996,1667268331,335,2375
3316625530,3215819425,1659301765,1659301918,153,93
3823650698,3215443177,1666464503,1666464890,387,1333
3436636953,3730845439,1656263041,1656263575,534,884
3155320608,3615666134,1660056088,1660056161,73,1261
3234064099,3277810331,1645121513,1645121561,48,1036
3014275222,3946409673,1663157807,1663158155,348,602
3134337442,3686320266,1659756145,1659756150,5,766
3460504628,3172305265,1667798216,1667798658,442,167
3814577253,3300479839,1667989928,1667990852,924,23
3173969437,3813690540,1645808305,1645808949,644,1565
3699293407,3089613411,1649334504,1649335049,545,2495
3071971535,3041386590,1667515386,1667515709,323,355
3742012582,3696243779,1656678048,1656678983,935,1169
3909168020,3863080370,1648140238,1648140558,320,1945
3935022176,3631568439,1646853465,1646853471,6,842
3320488617,3016508907,1665843673,1665843775,102,1476
3556819852,3572594221,1642126290,1642126293,3,2380
3903321481,3592887882,1641149994,1641150391,397,1932
3195813968,3544353013,1650474062,1650474923,861,2114
3273752842,3369356299,1665201277,1665202108,831,1481
3795299092,3634041831,1666142953,1666143856,903,595
3230775095,3066360181,1643238641,1643239393,752,1884
3800201060,3766966794,1645635426,1645636082,656,188
3463540687,3748085058,1669369602,1669370333,731,243
3517556603,3911632634,1656415710,1656416534,824,2493
3771528397,3804478597,1651627100,1651627746,646,615
3973264936,3540799664,1663606068,1663606921,853,1883
3605278552,3371818930,1659958512,1659959101,589,984
3783119155,3885162740,1654381355,1654381581,226,9
3631703207,3456239535,1653817793,1653818489,696,254
3359601528,3500264647,1668017802,1668018156,354,258
3861263764,3269914132,1648379205,1648379638,433,1431
3956836647,3141963631,1648299764,1648300393,629,1351
3066531358,3298857826,1650447432,1650448366,934,178
3009801123,3715231431,1644884200,1644884459,259,2113
3258399411,3297314002,1669294368,1669294890,522,1935
3873840731,3377473764,1669088397,1669089118,721,754
3856985099,3127940283,1668620331,1668620741,410,2304
3498740809,3678340379,1641292540,1641292934,394,1481
3085311533,3898391169,1641069669,1641070396,727,587
3924865492,3623736661,1668328337,1668329322,985,2135
3744726408,3491356699,1649555501,1649555876,375,394
3687689210,3083182515,1661602545,1661603517,972,1607
3532021354,3959504618,1649477785,1649478555,770,1580
3999788546,3587727278,1668487376,1668488094,718,1428
3513169935,3051776472,1661405720,1661406021,301,1623
3974804920,3706027798,1659204673,1659205023,350,1100
3813511439,3109234948,1665344452,1665344561,109,2316
3815774397,3413319616,1646800829,1646801477,648,875
3630448266,3074837048,1648085627,1648086548,921,1378
3566874478,3124147703,1663056765,1663057165,400,2063
3463669049,3153831709,1644508415,1644509401,986,314
3124222667,3516624109,1668488122,1668488840,718,2439
3492376573,3925754107,1668383804,1668384172,368,1889
3574205549,3481811999,1666802098,1666802990,892,268
3434833146,3515161257,1653208781,1653209269,488,1627
3611100286,3010531134,1661903724,1661904690,966,57
3764298989,3643615690,1664172575,1664173134,559,488
3557087358,3655498745,1669470377,1669470619,242,1537
3566919425,3671699977,1644400717,1644401354,637,763
3362836351,3562243381,1661278308,1661278765,457,2048
3891027417,3065530519,1667810693,1667810821,128,2093
3650199111,3935822380,1658868729,1658868925,196,940
3263033338,3246900158,1649255069,1649255631,562,473
3349433488,3788018778,1656080134,1656080951,817,2437
3557791528,3980841914,1663758581,1663758869,288,1267
3071850041,3478921948,1650691757,1650692518,761,1857
3335462055,3004964162,1651070580,1651071421,841,2245
3137412000,3023431340,1660940971,1660941805,834,744
3952552328,3563738755,1663062134,1663062668,534,486
3292739128,3177427428,1662117407,1662117548,141,374
3298993308,3531574623,1666565264,1666566023,759,796
3708809295,3567520646,1657992234,1657992562,328,2384
3255776587,3295806447,1642388194,1642388386,192,2
3958710935,3019631963,1666620015,1666620721,706,1092
3165700370,3254030842,1649731061,1649731121,60,1528
3584139105,3926612159,1653170999,1653171530,531,500
3637981738,3132611388,1658954687,1658954828,141,892
3592561930,3707578213,1653031247,1653031554,307,2097
3982916950,3128248749,1661286518,1661286709,191,893
3683460040,3561573044,1657994367,1657994627,260,1323
3452275962,3182982515,1643744806,1643745034,228,870
3851327758,3029263333,1643160256,1643160972,716,1713
3708654413,3045587450,1657494837,1657495238,401,1786
3599551667,3844939526,1661302223,1661302325,102,1059
3287714636,3096740365,1656322198,1656322951,753,1423
3032018734,3782730026,1658010285,1658010851,566,1357
3960772879,3112742999,1663365713,1663365835,122,1677
3983727854,3437983939,1663475795,1663476117,322,2452
3711016575,3990109853,1668298643,1668298673,30,2138
3460047535,3980934555,1647542046,1647542346,300,417
3838136289,3247688800,1642143628,1642143664,36,919
3821064356,3275827194,1641702323,1641702995,672,1278
3080200257,3866215730,1647835995,1647836577,582,1807
3333872407,3399631396,1660672573,1660672717,144,1227
3199322269,3290800332,1655369016,1655369381,365,1926
3701214753,3247980767,1667242160,1667242974,814,1645
3697231480,3683361867,1658170276,1658171040,764,1950
3495858842,3464235741,1649909744,1649910062,318,2312
3944398168,3012593677,1662088960,1662089357,397,2361
3287082352,3356689959,1652959644,1652959887,243,923
3264753140,3950225483,1652774357,1652775324,967,683
3944198123,3589441972,1662433897,1662434406,509,1194
3152795421,3651571335,1642374392,1642375382,990,845
3611025093,3252421501,1649655612,1649656475,863,213
3207309302,3352316809,1644736103,1644736331,228,654
3397940369,3718176139,1645889336,1645890134,798,13
3983988321,3622230392,1641367122,1641367491,369,1859
3586025172,3653218860,1668418399,1668418848,449,1491
3122624322,3719763865,1652588738,1652589253,515,291
3580330506,3460504628,1641255386,1641255840,454,2490
3894454988,3941266037,1664527939,1664528249,310,2038
3278980230,3003145369,1664734102,1664734158,56,420
3734893217,3737772457,1649771375,1649771532,157,498
3794462820,3873218862,1647367010,1647367599,589,1511
3701537998,3444809495,1661006687,1661007420,733,1089
3562021711,3829149174,1651964237,1651964696,459,274
3900535275,3911960681,1664395210,1664395642,432,170
3269653223,3569552798,1641928773,1641929641,868,903
3907705988,3739731580,1659276290,1659276435,145,131
3818467247,3118419220,1659859086,1659859109,23,799
3984533628,3715118659,1655368934,1655369854,920,1589
3242752835,3956027073,1654751840,1654751898,58,1760
3817668840,3824227701,1666706756,1666706967,211,172
3123815439,3637412110,1653029565,1653029988,423,1228
3511755413,3846477373,1653114910,1653115713,803,424
3441541439,3289684726,1648859609,1648860459,850,580
3118443532,3872626198,1656686700,1656687559,859,2244
3611763388,3612973191,1669533474,1669533757,283,2007
3802410450,3479778946,1656381864,1656381962,98,380
3196975901,3073924620,1655336541,1655336593,52,2307
3937618865,3300662625,1662841166,1662841997,831,259
3540029077,3265262512,1658060230,1658061156,926,5
3842844573,3798563042,1659168997,1659169396,399,357
3202625372,3176753600,1667971122,1667971405,283,1337
3512215996,3646908383,1666618298,1666619079,781,692
3112615469,3934433729,1656317138,1656318078,940,2036
3661243199,3329848036,1641144347,1641144998,651,1437
3183435456,3561899633,1663535219,1663535412,193,313
3115236500,3091112554,1641373265,1641373996,731,191
3261403182,3858150562,1652937114,1652937391,277,1910
3221885729,3443161524,1666259552,1666260255,703,2478
3811318665,3975075818,1660872128,1660872435,307,1847
3424790413,3933607460,1649567889,1649568362,473,1260
3382159828,3402690548,1641095909,1641096227,318,2457
3586524207,3108123256,1662544988,1662545835,847,2447
3327857419,3828738126,1648305276,1648305490,214,1602
3219440900,3323783108,1655912993,1655913063,70,1933
3376552382,3028841213,1657315662,1657316296,634,2026
3699730203,3696437293,1655252875,1655253562,687,1011
3976156173,3430165544,1669584716,1669584828,112,2345
3073924620,3587440298,1648929815,1648930657,842,1102
3881482215,3194796707,1659187649,1659188025,376,1354
3914348680,3799900837,1642467634,1642467664,30,368
3923635120,3001037251,1661128099,1661128200,101,1609
3885493402,3744563835,1650152172,1650153033,861,2433
3501520918,3763449384,1645688231,1645688755,524,1319
3451307942,3125112685,1642726900,1642726912,12,1058
3389812297,3119345995,1649997086,1649998052,966,2187
3278827891,3525377731,1656106548,1656107373,825,1054
3292739128,3856386170,1666616270,1666616879,609,1365
3783064521,3292812509,1645311999,1645312148,149,101
3365289656,3994130271,1641379499,1641379975,476,71
3377911201,3788785252,1660943682,1660944554,872,1246
3839454838,3423640116,1659224210,1659224939,729,2411
3327253070,3985326073,1646999266,1646999758,492,1588
3898229031,3153902371,1645959975,1645960462,487,2462
3677379196,3282261851,1652997326,1652997628,302,2188
3975096180,3631587282,1644274108,1644274256,148,651
3479087219,3124927662,1649855363,1649855905,542,2423
3547758342,3753659944,1649658329,1649658733,404,1663
3877464299,3490044613,1663068172,1663068716,544,713
3731386559,3862456223,1646457682,1646458631,949,1453
3835621921,3009781198,1663881905,1663882746,841,1117
3879299283,3714897535,1641413548,1641413950,402,579
3740274448,3933332705,1655306742,1655307592,850,700
3666931632,3511755413,1658079100,1658079876,776,934
3960897829,3403911906,1661039949,1661040157,208,210
3911671645,3164122941,1651127300,1651127650,350,2275
3697231480,3528288695,1669517194,1669517509,315,1650
3443084089,3426433476,1664128598,1664129357,759,1880
3963334554,3086530794,1659729332,1659730124,792,353
3882619512,3784040148,1655982222,1655982734,512,442
3378168172,3371002443,1647560065,1647560403,338,1579
3987423059,3492247995,1646034960,1646035615,655,2429
3026244912,3955064333,1669672252,1669672859,607,1214
3532063469,3284829365,1641486344,1641487162,818,198
3267479523,3938097708,1656551471,1656552380,909,2118
3225857817,3036527901,1667519365,1667520242,877,948
3001794280,3453511353,1658488503,1658488535,32,233
3102669962,3552958954,1669250818,1669251390,572,1212
3337845468,3537443088,1652341218,1652341770,552,1290
3223374226,3556450605,1642561950,1642562102,152,906
3672371563,3114277786,1665536194,1665536774,580,885
3342315965,3432765814,1669514321,1669514462,141,1270
3370488301,3309305862,1653690091,1653690499,408,2309
3481467544,3878180077,1667201206,1667202107,901,268
3331426472,3687724937,1646438366,1646438712,346,46
3714575918,3308454699,1656455660,1656456488,828,1520
3965000413,3889126069,1642141165,1642141856,691,1150
3205554156,3619490574,1654723332,1654723475,143,1740
3471587065,3850089310,1661624233,1661624882,649,525
3891518316,3868427833,1659526490,1659526661,171,975
3125314664,3084007689,1643372879,1643372953,74,254
3976453338,3957824946,1653189052,1653189633,581,2118
3079137127,3659224437,1654850062,1654850194,132,1429
3310496626,3919562972,1651105149,1651105274,125,946
3707940691,3897421758,1653077693,1653078387,694,1668
3456602518,3013457125,1663275930,1663276713,783,554
3431595099,3343048708,1643136897,1643137002,105,1612
3891579335,3956887611,1646154799,1646155347,548,1380
3181237998,3798728420,1657725626,1657726213,587,1669
3227246451,3276666399,1645426899,1645427776,877,1461
3970820689,3948862720,1658274116,1658274689,573,822
3242088486,3074619364,1665769255,1665769331,76,2107
3946068928,3185118961,1642867535,1642868076,541,489
3826573375,3278980230,1643934393,1643935247,854,367
3909859344,3409779636,1660567547,1660567941,394,1808
3169688960,3297314002,1654137452,1654137655,203,483
3682803273,3162641272,1661074371,1661074816,445,399
3762525964,3813034205,1654533825,1654534630,805,1439
3147376468,3039544352,1643158710,1643159043,333,2340
3202424407,3287210562,1661412863,1661413393,530,1833
3164550059,3892686083,1646208601,1646209320,719,689
3341573446,3526315797,1660920804,1660921794,990,2349
3595270507,3979899306,1644369709,1644370111,402,1352
3239575265,3852017463,1651912113,1651912758,645,1886
3370217481,3290710394,1655154850,1655155148,298,1149
3775565964,3650342769,1658590785,1658591328,543,788
3348568561,3146645864,1649894136,1649894897,761,1682
3176252124,3056726479,1650552777,1650553058,281,2233
3771758356,3818508802,1645219306,1645219338,32,1287
3545032372,3284940142,1659205721,1659206281,560,188
3337673105,3254930364,1653761074,1653761500,426,1325
3250566757,3166274990,1642676584,1642677454,870,272
3265895976,3812800144,1663743074,1663743740,666,709
3799014776,3218117875,1648571961,1648572580,619,516
3031816406,3318577605,1668593147,1668594054,907,197
3467215587,3895334140,1664698886,1664699401,515,611
3445095607,3389773271,1667565198,1667565556,358,2146
3282275875,3699533383,1647344352,1647344530,178,1821
3364888618,3366822094,1650777148,1650777903,755,1402
3901468403,3970970054,1643723128,1643723406,278,370
3945055663,3860879385,1642455225,1642455583,358,389
3211521816,3994967281,1658638832,1658639173,341,293
3112960048,3268446099,1642023292,1642024011,719,1212
3802018450,3487406679,1650724701,1650724876,175,596
3918552618,3368884196,1667031931,1667032495,564,2298
3333347852,3620006027,1657475350,1657475741,391,384
3604762599,3263168418,1642320319,1642320656,337,1589
3702965571,3870463011,1659630565,1659630978,413,1540
3174712961,3431595099,1641565709,1641566040,331,2496
3224491185,3833683293,1660928455,1660929050,595,2466
3770388331,3416719967,1659197486,1659197789,303,1611
3236819846,3620013325,1657926169,1657926192,23,421
3815102601,3568141696,1653060619,1653060770,151,728
3813287023,3428889808,1669149019,1669149939,920,1243
3563259493,3600573063,1668515277,1668515842,565,884
3903550568,3178090646,1643871497,1643871757,260,263
3358277498,3798728420,1643333585,1643334283,698,1157
3197300293,3596454426,1645846490,1645847426,936,2331
3344205602,3937758732,1667411559,1667411727,168,2485
3746050591,3274208430,1665195289,1665195306,17,2428
3809623566,3688758916,1651810695,1651811677,982,1784
3357478199,3180051747,1649592108,1649592174,66,1027
3194142427,3418662987,1649185471,1649185548,77,1438
3222282745,3678425549,1656201691,1656202631,940,1711
3261527870,3492376573,1648102313,1648103143,830,186
3342009927,3051404798,1643389345,1643390114,769,129
3206149175,3669311789,1656389074,1656389371,297,216
3866534454,3500701807,1658622001,1658622425,424,931
3846298815,3112270906,1649452542,1649452781,239,395
3761576790,3164702890,1659757756,1659757938,182,1006
3769391036,3735855753,1645107770,1645108656,886,466
3982210988,3916776869,1648731671,1648732059,388,89
3980108258,3097501233,1643232745,1643233416,671,1355
3993504996,3180836532,1644392296,1644393184,888,2264
3676634608,3323217825,1658649344,1658649880,536,512
3542832965,3343855888,1667790099,1667790215,116,1053
3694210631,3463003824,1658463165,1658463218,53,2189
3054979282,3319365305,1642980200,1642980790,590,1592
3708337100,3212038287,1658419060,1658419922,862,1819
3291324812,3290794282,1643120813,1643121263,450,2478
3669880471,3132034706,1668699385,1668699920,535,1446
3400121766,3734004050,1668229583,1668229853,270,2222
3373806425,3069316815,1666198970,1666199017,47,656
3833333678,3158894896,1664759584,1664760125,541,108
3034142016,3929988329,1654973782,1654974665,883,193
3669744444,3248395971,1658583601,1658583775,174,1917
3507363672,3714322007,1647081284,1647081350,66,1304
3405110319,3894175918,1645594993,1645595656,663,1325
3845801721,3796587240,1642021741,1642022676,935,1193
3469583371,3536931244,1650021118,1650021126,8,1947
3660998516,3611763388,1660140226,1660140975,749,2191
3354330082,3428501033,1651857442,1651857771,329,537
3638595264,3079415495,1666825909,1666826736,827,571
3262098376,3576284955,1650002063,1650002492,429,1757
3251409316,3062410888,1645727122,1645727246,124,85
3488484971,3804978604,1665860049,1665860189,140,2496
3398814666,3785813162,1662122447,1662123307,860,1539
3348113823,3481006313,1668107677,1668108364,687,1477
3250852254,3802325069,1668587218,1668588150,932,196
3312930717,3352389016,1661096221,1661096655,434,2303
3740009683,3209150433,1651958804,1651959591,787,2036
3069536467,3100440036,1652855088,1652855645,557,1921
3249071020,3939948508,1655700331,1655700987,656,789
3415761431,3439442608,1660591610,1660591719,109,619
3173909495,3946306778,1656160020,1656160930,910,1684
3591834837,3908893546,1642313219,1642313336,117,1222
3391118279,3942965206,1658969950,1658970183,233,2416
3060522981,3719455699,1642475554,1642475623,69,797
3856882586,3872444916,1652444847,1652445262,415,389
3301708925,3712276884,1643938151,1643938522,371,1590
3638847705,3125479535,1647520078,1647520753,675,1654
3153518026,3984215552,1668084415,1668084505,90,1936
3661462228,3561529281,1642203195,1642204044,849,626
3939768853,3195598526,1648823985,1648824736,751,2117
3735277639,3339911597,1652732266,1652732850,584,2220
3012917381,3351786927,1666434497,1666434736,239,383
3747046698,3193830008,1656912451,1656912588,137,393
3306838717,3790329301,1669561750,1669562621,871,1144
3722817789,3804145408,1658635074,1658635404,330,801
3273348089,3510416134,1662985524,1662985658,134,1578
3746155501,3930118877,1653557198,1653558062,864,1708
3619175296,3475835420,1648235697,1648236038,341,2395
3513399148,3570480973,1654124810,1654125586,776,129
3339264241,3058927575,1662961935,1662962643,708,249
3387840253,3488757134,1653255564,1653256296,732,552
3275360473,3722948390,1659074503,1659075038,535,2476
3524315738,3639819433,1660990811,1660991080,269,2362
3402578446,3521408145,1669432957,1669433629,672,869
3975096180,3061619114,1644651184,1644651343,159,2190
3054865222,3107530825,1647305418,1647306185,767,1434
3737809844,3825824228,1650838606,1650839354,748,2374
3455941777,3487104766,1648957280,1648957568,288,1989
3546824914,3185977048,1663059718,1663060258,540,607
3597904540,3917721165,1652545016,1652545067,51,2334
3158988425,3134337442,1663453195,1663453686,491,572
3406509436,3813811121,1643371425,1643371600,175,531
3074477991,3893018254,1645590929,1645591231,302,2146
3123815439,3681631482,1659510314,1659510971,657,1855
3707070213,3957824946,1662569483,1662569767,284,1795
3623374020,3499481975,1663802303,1663803207,904,1616
3404008086,3283922234,1667970756,1667970814,58,465
3698989053,3370867881,1649235844,1649236039,195,1913
3343729897,3043310672,1659656126,1659656915,789,720
3276142713,3128839608,1641076230,1641076947,717,235
3327504995,3683361867,1662126289,1662127247,958,394
3128613298,3382396122,1657221976,1657222586,610,197
3274752508,3806466784,1657116759,1657117234,475,1925
3006507589,3067930449,1643960877,1643961779,902,402
3811318665,3656865344,1659894887,1659895617,730,308
3677965553,3687691090,1651710153,1651710564,411,2147
3432892677,3250108907,1650679833,1650680586,753,1260
3595560993,3632156948,1648186987,1648186994,7,1909
3939477257,3299536518,1669328076,1669329019,943,1435
3628675820,3642498039,1650634626,1650634931,305,1753
3354233805,3625586912,1643207238,1643208049,811,2077
3080853733,3243502165,1641336856,1641337168,312,1213
3546605941,3626672801,1662670799,1662671034,235,1798
3229368997,3267151775,1651061103,1651061464,361,1199
3880046311,3748812993,1646538094,1646538797,703,84
3910837040,3846866111,1645654512,1645655275,763,2200
3959228076,3108123256,1654352485,1654352843,358,2446
3904007370,3997177535,1666518088,1666518798,710,172
3948074176,3233146767,1643879800,1643879835,35,94
3190267458,3914946558,1649267436,1649267849,413,799
3708309303,3598506871,1653241348,1653241830,482,1289
3907635993,3523394395,1643884257,1643884594,337,1825
3429052801,3065350513,1641292634,1641292776,142,1773
3522861132,3404873411,1644251190,1644251678,488,2016
3236975783,3802018450,1666264354,1666265165,811,1703
3968076690,3890159677,1653706772,1653707189,417,2463
3309405529,3785728567,1654185806,1654186523,717,658
3168984273,3349030618,1661178423,1661178761,338,1071
3625034951,3164789962,1668273839,1668274453,614,1983
3599714580,3295850908,1666952790,1666953513,723,813
3590361712,3515044837,1645893502,1645893675,173,2380
3201068600,3388814754,1643463383,1643464231,848,2497
3687724937,3425804563,1658607327,1658607844,517,1166
3728160519,3635697777,1642755002,1642755181,179,526
3987735792,3606270024,1667250204,1667250911,707,851
3857211245,3886368625,1651804017,1651804784,767,394
3650172161,3522132687,1649334871,1649335156,285,734
3959651432,3595726436,1662873082,1662873747,665,572
3570906118,3028364856,1649544565,1649545534,969,1265
3637923107,3103215750,1669437476,1669437779,303,1754
3882415224,3450806791,1646141789,1646142645,856,2268
3247959785,3012152244,1643693453,1643693938,485,1851
3613188168,3402690548,1642820032,1642820619,587,435
3406042920,3311280180,1643306407,1643307389,982,1127
3333339972,3618313240,1654532988,1654533715,727,1223
3423522480,3672524498,1656080759,1656080766,7,1493
3853912096,3116451556,1647824175,1647824461,286,127
3455808094,3620639101,1651888093,1651888140,47,1776
3789727449,3637292465,1643830723,1643831428,705,889
3551380152,3593487418,1650657209,1650657219,10,2367
3831542177,3686826205,1655593053,1655594019,966,1510
3948969420,3411181030,1666899374,1666899995,621,1395
3278886018,3216582576,1661487561,1661488305,744,2409
3812239613,3033373685,1664726708,1664727325,617,1027
3679578513,3925364546,1660930854,1660931471,617,1687
3263033338,3724806243,1644545699,1644546291,592,2465
3166518187,3785222888,1660053910,1660054298,388,2236
3389546736,3962773297,1658042218,1658042664,446,2268
3882414600,3253759705,1656944890,1656945598,708,1835
3871971681,3350852842,1649341223,1649341878,655,1488
3508340066,3395782360,1649280158,1649280857,699,93
3620395885,3696096099,1662084925,1662085025,100,832
3058789362,3623294630,1649955699,1649956163,464,1701
3654381548,3647210250,1649730486,1649730896,410,742
3068242755,3103421893,1641360159,1641360812,653,559
3362647814,3469740343,1666551306,1666552088,782,811
3036527901,3864239870,1641668696,1641669568,872,2093
3398876044,3154823834,1641315253,1641315572,319,92
3298879351,3637292465,1648933338,1648933547,209,514
3286473367,3365289656,1651816077,1651816102,25,784
3469887287,3581449963,1654839444,1654839902,458,2093
3653030573,3498466937,1649920685,1649920821,136,436
3610101662,3148589566,1659938946,1659939149,203,106
3180101007,3344285047,1660334596,1660335403,807,1257
3595499905,3488280503,1649893322,1649894013,691,1770
3696184358,3312656348,1661191183,1661191290,107,2394
3306515955,3567959060,1663405179,1663406001,822,536
3288834634,3344787204,1663692560,1663693057,497,1071
3802545642,3933742178,1661544257,1661544261,4,317
3771811920,3670112572,1644243702,1644244621,919,463
3233920789,3399235044,1665555583,1665555840,257,185
3672371563,3944914500,1646113149,1646113966,817,1527
3957665117,3896281957,1666232804,1666233704,900,1081
3292111100,3298635617,1667122058,1667122416,358,2053
3368654717,3584668339,1650553778,1650554768,990,2016
3775103844,3470404771,1665567831,1665568550,719,2475
3715118659,3934377856,1668101120,1668102089,969,2134
3751418832,3282168599,1650221495,1650222410,915,1571
3866431229,3634282428,1667550580,1667551552,972,605
3304087986,3740376361,1653567096,1653567661,565,2496
3160349110,3894801934,1668278415,1668278659,244,1737
3353878603,3763991129,1650392912,1650393676,764,965
3784912315,3148691436,1642714965,1642715216,251,1249
3864485247,3722945080,1647767865,1647768275,410,1483
3617545187,3043256301,1665623013,1665623939,926,2075
3958275419,3205418435,1658156465,1658156633,168,1857
3352729606,3337108824,1661481392,1661481574,182,1195
3105789496,3776918350,1655588399,1655589183,784,1156
3010531134,3953258545,1654329363,1654329942,579,86
3142274869,3262377052,1647418906,1647419095,189,1265
3727981782,3333543321,1666201373,1666201850,477,1103
3569478966,3750277600,1652390912,1652391106,194,756
3310262408,3954799831,1651153751,1651154306,555,212
3262379384,3948193261,1645489470,1645489835,365,1521
3684537058,3812997079,1646021857,1646022644,787,55
3184680353,3215402575,1643220313,1643220684,371,727
3762571799,3515161257,1667000316,1667000524,208,1251
3971934050,3375769320,1654474521,1654475201,680,1252
3626345917,3384536407,1656082706,1656083110,404,1522
3461108375,3118128782,1657789566,1657790230,664,839
3306460846,3066093153,1656431873,1656431910,37,1111
3895196680,3552494506,1646691185,1646691275,90,2494
3344394548,3183259139,1657194876,1657195386,510,1750
3914166761,3342315965,1655424934,1655425276,342,379
3048077825,3294357161,1641797673,1641797820,147,1958
3773408264,3864301593,1642604692,1642605543,851,635
3670063835,3559863065,1660188699,1660189390,691,498
3232285701,3082026010,1661305302,1661305928,626,1052
3774325139,3135707503,1658434260,1658434776,516,356
3572276937,3184916120,1668786249,1668786623,374,1607
3012264999,3370267721,1656066755,1656067510,755,1359
3314240169,3574285791,1652880745,1652881338,593,1320
3299191225,3935057012,1642513417,1642514004,587,1001
3137412000,3662355477,1651967965,1651968357,392,306
3616901816,3456435173,1653442309,1653443179,870,1265
3604461797,3668421848,1668926860,1668927540,680,251
3418998927,3759737476,1664467552,1664467699,147,532
3876927357,3084969131,1658632508,1658632593,85,2436
3642314622,3351361711,1666795497,1666796018,521,413
3641460659,3987318292,1652256798,1652256800,2,1950
3573941843,3982058383,1669521825,1669522520,695,1719
3321074447,3845511281,1664118858,1664119047,189,853
3187644022,3152860718,1649892953,1649893863,910,22
3838250910,3825332100,1658096667,1658096968,301,1980
3061594029,3931294653,1655668714,1655668740,26,98
3890033502,3948833001,1651119747,1651120415,668,291
3072317138,3468455079,1665032361,1665032628,267,21
3569563212,3573583612,1646221828,1646222556,728,1596
3697322167,3447887397,1668732602,1668732921,319,1555
3401611149,3404873411,1658282370,1658282583,213,1416
3298436959,3992909356,1666142554,1666143204,650,1473
3176252124,3994130271,1660602639,1660603406,767,1543
3603965318,3725439899,1666025771,1666026686,915,2021
3887002610,3165039316,1652141240,1652141590,350,1661
3261195333,3072734804,1641546549,1641547109,560,220
3569006301,3825484587,1648140881,1648141611,730,747
3248250292,3971024525,1667613479,1667613908,429,146
3435224460,3197739962,1657576616,1657577378,762,823
3194259307,3432942151,1658006521,1658006685,164,2243
3122624322,3513925385,1656772126,1656772527,401,464
3387938632,3604596822,1667799854,1667800845,991,1241
3152555864,3310512172,1652075340,1652075468,128,2332
3037042091,3000725837,1650478465,1650478535,70,2199
3430387951,3270273033,1642644311,1642644380,69,1625
3508340066,3049727234,1666134315,1666135054,739,312
3294703062,3585495750,1657403247,1657403375,128,2273
3700737923,3481466662,1668668453,1668668601,148,1880
3790650118,3039106188,1656070923,1656071327,404,2227
3481467544,3693041370,1662233566,1662233979,413,453
3447310943,3815779833,1641249013,1641249716,703,647
3320179826,3557559741,1661833835,1661834174,339,1208
3921930806,3625651694,1665213709,1665213815,106,1239
3390445291,3855537172,1664346549,1664346974,425,598
3693041370,3654861844,1661526024,1661526062,38,90
3828516865,3049141347,1641867932,1641868321,389,2470
3316855337,3665086817,1651471052,1651471486,434,1709
3669324531,3650041115,1654667501,1654668340,839,1724
3091530738,3384460816,1659475269,1659475318,49,1062
3708134798,3695237310,1641519571,1641520145,574,782
3866921322,3907213401,1655807223,1655807795,572,672
3987813210,3528069102,1666596352,1666597122,770,2296
3857400676,3270453709,1645023601,1645024550,949,693
3195032074,3085412399,1669531408,1669531766,358,1388
3033349787,3690665509,1659626752,1659627712,960,1693
3005231138,3249512921,1660944961,1660945067,106,1024
3659732080,3600247537,1662291381,1662291659,278,615
3859976372,3615262736,1661762758,1661763630,872,268
3905356323,3170102962,1655303265,1655303382,117,849
3906772132,3423522480,1669739799,1669740365,566,893
3132258390,3296957627,1654587144,1654587309,165,626
3313192018,3184455755,1650562622,1650563558,936,496
3328373210,3577798894,1657918722,1657919396,674,1311
3216241275,3501770020,1644103469,1644103577,108,1428
3662455665,3882603510,1661501678,1661501943,265,1892
3040219251,3764343778,1661603958,1661604156,198,2086
3669789756,3991673197,1669543164,1669543271,107,2105
3726788021,3878698797,1654183594,1654183941,347,166
3805928545,3397910828,1658252181,1658252459,278,2137
3929497543,3895842487,1642210490,1642210861,371,427
3528069102,3999551936,1658259148,1658260029,881,2337
3868440818,3314495556,1655972696,1655973534,838,524
3433576059,3077143208,1645808202,1645808373,171,1510
3324003851,3884256882,1655958878,1655959601,723,1726
3855223575,3730684727,1648795259,1648796206,947,1724
3815507952,3300479839,1656838665,1656838683,18,18
3478280943,3960727778,1656058748,1656058777,29,2144
3456285013,3175976694,1668965595,1668965613,18,819
3194456422,3769767823,1644816467,1644817031,564,1465
3253589940,3037583613,1659131609,1659132324,715,2279
3991542844,3788336754,1666929754,1666930481,727,758
3863652254,3832252723,1654812033,1654812349,316,473
3923635120,3880837935,1657508228,1657508512,284,608
3475352970,3997312356,1654218325,1654218792,467,255
3624872846,3836762535,1643833328,1643834025,697,2494
3085182687,3038014403,1650053373,1650053828,455,1127
3205864966,3106732056,1658732967,1658733122,155,257
3261376049,3085921604,1660207326,1660207671,345,1900
3711059561,3822404633,1667897905,1667898507,602,10
3056501932,3322083266,1646814080,1646814235,155,416
3129176226,3739613077,1654663792,1654663991,199,1394
3896091695,3729389785,1668286399,1668286501,102,796
3896789438,3123781164,1641901616,1641901779,163,1652
3693129961,3864485247,1648631950,1648632313,363,688
3605412707,3729914869,1660892152,1660892607,455,2073
3462744716,3541060382,1642086759,1642086874,115,284
3337601088,3228737899,1658949804,1658949968,164,1247
3145393304,3862583365,1658139938,1658140767,829,1806
3854859043,3769944434,1660326481,1660327248,767,1123
3575457804,3710786724,1642968020,1642968359,339,2183
3344891111,3638595264,1657984405,1657984632,227,1171
3536421569,3821864560,1653364262,1653365111,849,1060
3130899709,3480375415,1647437308,1647438015,707,282
3261527870,3593967802,1643332003,1643332050,47,1760
3204336699,3338329823,1653134964,1653135301,337,1661
3470586731,3128318593,1653452394,1653452961,567,2191
3880295026,3147336288,1663234621,1663234787,166,2436
3055710852,3247959785,1641763813,1641764415,602,1505
3857081560,3450503481,1658158264,1658159127,863,6
3050434345,3984818292,1664944791,1664945481,690,1946
3053991932,3432910993,1665564748,1665564866,118,2104
3759909818,3631732813,1661861200,1661861509,309,180
3086444841,3570872297,1665932704,1665932958,254,251
3486442976,3298993308,1665348043,1665348656,613,1604
3785432995,3869794122,1669184736,1669184841,105,1245
3412047712,3281146609,1656073004,1656073936,932,684
3625179175,3928241216,1651498452,1651498591,139,1159
3608485872,3115669693,1653014920,1653015043,123,699
3439462043,3271314900,1653898203,1653898716,513,48
3125112685,3125730442,1664882232,1664882276,44,599
3591088164,3693453006,1660332887,1660333311,424,248
3921930806,3651798658,1658259177,1658260149,972,2363
3046006152,3795508879,1666148055,1666148887,832,2421
3795326002,3283671920,1650613000,1650613192,192,311
3319946083,3871180604,1664445926,1664446319,393,1558
3005231138,3657101592,1663069278,1663070136,858,977
3611777140,3526218972,1647330647,1647331051,404,67
3743569811,3288496623,1652117365,1652117748,383,203
3319128889,3843347515,1657071138,1657071218,80,447
3317614106,3474081200,1659029067,1659029721,654,1959
3081188307,3026727334,1665953757,1665954737,980,1824
3309305862,3384255827,1646648269,1646648425,156,47
3242088486,3791055136,1663016972,1663017499,527,692
3569200063,3176526207,1645277359,1645277913,554,2203
3719763865,3202922076,1651164905,1651165698,793,1597
3362405611,3991552312,1642884187,1642884343,156,1764
3659620596,3998987664,1659952262,1659952401,139,104
3792924517,3428889808,1645224565,1645225461,896,1752
3090731052,3639307843,1667661351,1667661955,604,52
3152109348,3566257032,1660915797,1660916332,535,189
3152176779,3849816711,1663392210,1663392213,3,1861
3394249709,3882879531,1648844137,1648844853,716,273
3935809720,3080679691,1642926950,1642927324,374,1155
3099976032,3993814137,1652354995,1652355199,204,1949
3314872000,3398508681,1667389564,1667390457,893,1781
3988935369,3023772977,1643407645,1643408149,504,1758
3415351222,3832719894,1659536072,1659536952,880,2492
3822693340,3602891052,1662547180,1662547620,440,2113
3340464785,3276666399,1650020223,1650020836,613,721
3511194169,3446741935,1664680602,1664680714,112,1480
3904634428,3769391036,1647036178,1647036374,196,1699
3959629367,3838851134,1664037211,1664037465,254,2319
3271864656,3061362091,1665145007,1665145603,596,471
3404904674,3052951476,1668655631,1668656146,515,1563
3095151362,3232781077,1646385393,1646385460,67,1730
3299821745,3172773924,1669301959,1669302869,910,1401
3047477485,3673761066,1668499089,1668499982,893,2220
3319128889,3023025075,1654882807,1654883790,983,2216
3687938178,3365134626,1668250186,1668250210,24,958
3972397754,3744234480,1642239366,1642239576,210,2487
3903108572,3011690678,1644651452,1644651517,65,2061
3413777646,3202187490,1661396263,1661396265,2,790
3053991932,3415020400,1644014725,1644015130,405,2091
3705809622,3546432752,1660525861,1660526630,769,1937
3771146763,3658113721,1669345907,1669346521,614,2274
3080930599,3518717396,1651384473,1651385032,559,1550
3896091695,3072834944,1653135213,1653135642,429,1765
3843331100,3103681676,1668577007,1668577110,103,2413
3862854265,3347434027,1654794580,1654795349,769,813
3017484255,3689464410,1658475840,1658476261,421,1265
3879322451,3080214168,1647822343,1647822686,343,2045
3956500972,3831585514,1665256343,1665257118,775,611
3633730527,3270935026,1648192531,1648192936,405,1176
3005854023,3700737923,1648082695,1648083111,416,403
3013484024,3635487786,1649094662,1649095587,925,2096
3386918140,3571145656,1646694032,1646694626,594,277
3372334548,3232128014,1654505877,1654506007,130,1837
3825824228,3313782821,1668520911,1668521531,620,755
3275223689,3268821463,1652990486,1652990754,268,345
3248395971,3870035420,1655229428,1655229686,258,616
3595726436,3411181030,1665352443,1665352962,519,806
3776862606,3026209549,1653471567,1653472192,625,233
3388004574,3573193288,1664344520,1664344728,208,2456
3755513433,3795503592,1659187391,1659187793,402,1615
3816538946,3279671068,1653611958,1653612684,726,2085
3300412448,3917715509,1645916994,1645917624,630,2299
3658428855,3295905536,1657286387,1657286426,39,929
3228497776,3124004516,1654681662,1654682545,883,1603
3266867093,3550218169,1646756584,1646756683,99,2222
3966525848,3149135097,1649492593,1649493047,454,97
3531642816,3985585282,1653835731,1653836257,526,1531
3637457925,3832144696,1657552129,1657552628,499,1764
3626824650,3389443435,1647939830,1647939896,66,382
3804773972,3182396653,1643357714,1643358440,726,319
3536633962,3958508676,1669718301,1669718940,639,1792
3819415032,3246024635,1667751582,1667752212,630,1148
3346986628,3861496190,1654444568,1654445028,460,1279
3691830908,3303719777,1658658018,1658658983,965,1843
3610930903,3328544337,1643557384,1643558129,745,2054
3338020076,3838993248,1666733201,1666733444,243,1491
3843157491,3452275962,1668488552,1668488959,407,1665
3536128186,3377086230,1650739965,1650739974,9,1001
3685977300,3457191473,1666990737,1666991239,502,1617
3488962022,3829971179,1654714891,1654715320,429,1904
3124079349,3699293407,1668766511,1668767406,895,2048
3015715378,3920482918,1666681961,1666682250,289,2477
3500216283,3884949094,1663573199,1663574071,872,1548
3871851890,3411636309,1669371209,1669371962,753,2331
3412047712,3991299369,1652846223,1652846369,146,2389
3538972815,3300983140,1664577278,1664577635,357,2379
3712727713,3972677516,1644807708,1644807962,254,528
3458493864,3532270724,1655313402,1655313678,276,638
3101886383,3505295000,1646271666,1646271668,2,907
3048388831,3567703076,1665713261,1665713662,401,992
3832995595,3710202750,1648031490,1648031581,91,1738
3945607460,3602829591,1652792335,1652792903,568,826
3851747907,3693581710,1649164433,1649164551,118,1033
3272428764,3770393539,1667393326,1667393452,126,814
3106705860,3371707067,1665413607,1665414059,452,2043
3641983006,3418338710,1657039133,1657039502,369,1606
3543239972,3580774207,1651034479,1651035178,699,1309
3324611610,3972677516,1659984137,1659984373,236,2326
3403223215,3056501932,1648437985,1648438163,178,1568
3615359458,3819770312,1644205176,1644205998,822,2185
3547278175,3782708820,1645017755,1645018649,894,393
3442477300,3625586912,1661075808,1661075984,176,2398
3595535977,3820302319,1644409295,1644409900,605,2247
3420676198,3056267922,1655580791,1655581146,355,132
3502690432,3618941109,1659581065,1659581382,317,1707
3210331889,3239527114,1657391605,1657391989,384,1864
3717781013,3053991932,1660081505,1660082247,742,1688
3874569616,3970049421,1666060484,1666060956,472,1704
3049579265,3640756400,1652457413,1652458051,638,1511
3100201926,3570872297,1646224352,1646224482,130,1851
3829901682,3583307819,1662904438,1662904717,279,869
3041792624,3232469999,1654247101,1654247343,242,935
3800392649,3486262024,1657983194,1657983529,335,133
3603096793,3091595739,1646709218,1646709874,656,1795
3009365802,3247980767,1652767891,1652767952,61,1625
3775645582,3282950540,1666115369,1666116366,997,3
3168576951,3786924052,1641581758,1641582628,870,818
3304490341,3787590278,1657782124,1657782193,69,694
3092941538,3721060604,1657875297,1657875582,285,997
3663100834,3637993177,1660271361,1660271486,125,1981
3448866192,3137829230,1645431989,1645432822,833,181
3249916829,3882879531,1662167512,1662167795,283,1175
3041290048,3660983068,1647209035,1647209360,325,1256
3148256129,3095503795,1663320304,1663320390,86,740
3998329857,3377911201,1667272301,1667272551,250,654
3830850007,3538686599,1646050173,1646051064,891,636
3804648275,3825484587,1668257916,1668258830,914,232
3062464540,3982058383,1646509751,1646510326,575,970
3266042074,3047372637,1669288259,1669289158,899,2178
3561037966,3059870015,1668221245,1668221335,90,325
3032834107,3176410131,1667498783,1667499273,490,1376
3299607426,3042052031,1664956418,1664956994,576,1560
3924559198,3819235768,1643921973,1643922850,877,873
3276666399,3176317370,1641283546,1641283643,97,345
3534715157,3687925631,1662462526,1662462851,325,681
3295278768,3615177362,1649060250,1649060334,84,1645
3692368068,3993122275,1646503048,1646503397,349,1722
3199563620,3675359399,1666371059,1666371979,920,1900
3741978230,3788717673,1642829650,1642830268,618,1653
3562021711,3976055046,1655530497,1655531454,957,1501
3897756969,3024554792,1664524690,1664525087,397,459
3861123581,3698965715,1664507239,1664508004,765,969
3428557602,3727801252,1669235816,1669236250,434,2497
3674037967,3247163175,1658826090,1658826198,108,570
3125289160,3936943386,1662684142,1662684731,589,89
3483670734,3102251970,1661432707,1661432775,68,1444
3672070606,3690667222,1651598949,1651599216,267,887
3060674509,3672087645,1643880818,1643881034,216,1242
3675481622,3902777743,1645355460,1645355586,126,1121
3528475061,3400434269,1662053563,1662054066,503,1429
3995299995,3556061704,1665113824,1665114450,626,423
3418007140,3759165741,1667446171,1667447058,887,172
3074385503,3733102461,1665017380,1665017594,214,1620
3099785418,3772853715,1652871956,1652872902,946,2466
3273258651,3085182687,1658844299,1658845234,935,1613
3157965235,3608893234,1668742318,1668742769,451,1970
3228794031,3439940608,1656653958,1656654912,954,492
3280223679,3649660430,1652820471,1652820792,321,291
3673761066,3844822083,1642331856,1642332280,424,852
3254592040,3771841105,1654755357,1654755423,66,292
3482509515,3388814754,1643666938,1643667731,793,1370
3136396999,3167290048,1644503007,1644503676,669,213
3412109130,3086575348,1661745337,1661745704,367,974
3582531330,3643637605,1642276494,1642276761,267,94
3099984232,3922927380,1666145943,1666146022,79,1278
3509047408,3085676024,1647792236,1647792567,331,549
3706206403,3687151281,1666947585,1666947981,396,2072
3091882022,3071341023,1648417586,1648418198,612,328
3408396410,3566834497,1660060810,1660061570,760,2018
3175505409,3662526382,1660549026,1660549560,534,345
3767581542,3571719140,1651166595,1651167342,747,76
3994388981,3213836945,1663777296,1663777516,220,1988
3962695354,3132034706,1648082135,1648082177,42,1859
3579728276,3129899259,1652245798,1652246647,849,2441
3828342380,3155835978,1669359375,1669359865,490,104
3312656348,3271605522,1656266802,1656267611,809,1093
3279069375,3853056907,1652209679,1652210247,568,298
3903779058,3362249024,1647231846,1647232321,475,1970
3762533949,3163326257,1668214821,1668215505,684,1137
3150485567,3176536531,1666541152,1666541939,787,814
3047388698,3507500782,1651098860,1651099387,527,1566
3715994986,3138958890,1641930835,1641931501,666,1811
3450893865,3379935974,1658842781,1658843550,769,2186
3975380491,3156452001,1665628925,1665629885,960,211
3096408604,3872493238,1643116915,1643116956,41,886
3249305465,3671637527,1648872919,1648873464,545,1649
3404200137,3577216621,1641535474,1641536011,537,1409
3793298032,3371430360,1647107063,1647107064,1,2450
3268670465,3166754795,1642375691,1642375730,39,569
3473102313,3640571571,1659760662,1659761352,690,515
3028841213,3780885377,1663961943,1663962717,774,2497
3407770585,3210536820,1657390946,1657391190,244,568
3487526777,3385273825,1650398939,1650399125,186,773
3771811920,3672609185,1653689858,1653689927,69,2097
3507500782,3700896206,1669134668,1669134755,87,1245
3602340127,3119014132,1664739462,1664739701,239,2022
3885583347,3201276259,1665521304,1665522059,755,315
3873840731,3218136112,1657187268,1657188099,831,2156
3432462167,3570747542,1651537513,1651538395,882,1137
3476566118,3999180921,1664614352,1664615023,671,2182
3652513122,3667028828,1662630463,1662630682,219,2429
3031560160,3565056457,1650162758,1650163000,242,2497
3421600026,3501972053,1657216715,1657217036,321,1022
3128532251,3894382679,1663821322,1663821641,319,397
3567906153,3381846064,1649989862,1649990632,770,1939
3523099697,3918121469,1664350687,1664350937,250,1898
3318577605,3230248695,1669363253,1669363893,640,2277
3631424312,3534752391,1657857188,1657857550,362,732
3777592593,3349030618,1649637936,1649638052,116,28
3617545187,3255776587,1664975483,1664976429,946,2346
3918988651,3289696366,1654941051,1654941571,520,1389
3358374850,3061643986,1643296228,1643296884,656,1062
3492727050,3368387959,1653738284,1653738542,258,1126
3261477798,3460229906,1659683507,1659683840,333,1138
3007911826,3903261473,1646267799,1646267861,62,1040
3432899117,3342315965,1665783673,1665784040,367,940
3066168441,3418276734,1644586895,1644587494,599,1409
3710786724,3109941959,1641741085,1641741805,720,767
3008760173,3463121212,1663402059,1663402844,785,378
3903321481,3085311533,1646469340,1646469519,179,471
3858911279,3867353788,1666039233,1666039352,119,779
3766205598,3722114463,1659496003,1659496543,540,88
3794548376,3080325374,1643954594,1643955230,636,422
3552457707,3465500045,1649315314,1649316003,689,272
3567520646,3347462301,1651103025,1651103702,677,181
3398814666,3269690639,1662157833,1662158811,978,334
3542215276,3080703553,1652935786,1652936507,721,675
3243005694,3250312962,1668235204,1668235936,732,1265
3216171635,3451299629,1663298673,1663298938,265,1951
3793298032,3922341165,1658310701,1658310722,21,1560
3278854404,3099984232,1650147286,1650147482,196,1520
3310255083,3522465860,1665945049,1665945634,585,2477
3343741687,3899782287,1651069062,1651069695,633,2162
3344337283,3880608911,1644045528,1644045638,110,91
3249554278,3093589416,1669658862,1669659665,803,1766
3878925459,3470128186,1641812713,1641812944,231,525
3479401831,3021126829,1667507056,1667507352,296,2101
3691062084,3064574238,1659845837,1659846469,632,1761
3878831823,3987860424,1657778553,1657778568,15,31
3883537438,3660939542,1658599028,1658599174,146,2174
3937429867,3340933137,1657113406,1657114392,986,138
3658910038,3358194777,1642974434,1642975043,609,701
3587324906,3213169891,1642455028,1642455198,170,1883
3816647849,3456602518,1641033171,1641033856,685,1750
3656158144,3777929700,1653880748,1653881063,315,254
3054927562,3251854206,1653876045,1653876861,816,1296
3315182095,3288788264,1648818354,1648819011,657,2130
3544772636,3672609185,1667479184,1667479533,349,136
3291641388,3802267458,1654414922,1654415709,787,1815
3077346044,3155294057,1653090616,1653091538,922,2238
3374007172,3210331889,1649421946,1649422452,506,1808
3853256957,3287508774,1657242877,1657243666,789,1426
3598506871,3024431618,1664022613,1664023286,673,1869
3905744284,3854995649,1648744438,1648745018,580,1221
3747302768,3506187447,1661037878,1661037921,43,1262
3118425000,3264993323,1647683949,1647684185,236,1810
3540735539,3435252882,1641778593,1641778724,131,1231
3811318665,3099785418,1645964301,1645965235,934,647
3109284478,3798631691,1663119343,1663119490,147,961
3772749656,3662300962,1664789656,1664790226,570,709
3955685340,3828555703,1650861500,1650862437,937,1921
3885458258,3463734539,1651833013,1651833331,318,329
3971722824,3143324065,1669250702,1669250839,137,2442
3928723403,3884412861,1651923759,1651923802,43,51
3817579913,3315185864,1643100901,1643100907,6,2425
3012119082,3885696227,1649259664,1649260151,487,1616
3207210781,3453076338,1646939547,1646939963,416,1693
3250867562,3141196312,1650264049,1650264746,697,538
3261866390,3925344243,1650195635,1650195781,146,816
3799776825,3880608911,1643848657,1643849133,476,18
3098820434,3915942384,1651021470,1651021636,166,766
3462744716,3247551122,1661193990,1661194898,908,1825
3027812492,3035135381,1664667806,1664667820,14,2388
3019204329,3995365519,1663137171,1663137194,23,456
3629593465,3499514081,1663784467,1663785454,987,2236
3894454988,3534726913,1664763849,1664764651,802,334
3126940487,3478362234,1650528510,1650528511,1,2125
3740090157,3913071555,1657983776,1657983864,88,2375
3507376482,3515044837,1642020020,1642020559,539,752
3033349787,3470488588,1667988423,1667989062,639,51
3099224416,3389097842,1651943031,1651943352,321,2062
3427342650,3719445490,1665850482,1665851261,779,1617
3152554117,3204359619,1650086712,1650087067,355,327
3895976556,3528278695,1644320422,1644320813,391,547
3414258502,3268225181,1652093424,1652094349,925,786
3790406016,3093589416,1642293051,1642293195,144,2213
3874913687,3965434074,1643514372,1643514837,465,959
3004870031,3976346769,1663143423,1663143666,243,1904
3166492454,3106465076,1651160409,1651161403,994,1801
3533403208,3596841713,1649020066,1649020205,139,131
3943836795,3304728211,1651573444,1651574316,872,2456
3855769157,3962695354,1655669676,1655669913,237,1466
3852212988,3594038673,1668294613,1668295186,573,2311
3828531030,3112314644,1666909586,1666910322,736,2196
3075780193,3587568478,1655306599,1655307591,992,637
3264079501,3796275634,1667442041,1667442715,674,1707
3249305465,3350345176,1650468314,1650469245,931,795
3523631626,3682803273,1663183245,1663183439,194,1047
3787048351,3801579775,1661819059,1661819414,355,941
3124277484,3184000585,1660459990,1660460580,590,1204
3664930564,3809623566,1646546417,1646546835,418,1085
3144068102,3095932716,1665515985,1665516430,445,1474
3364404145,3183507473,1666655346,1666655960,614,737
3346484497,3296956444,1643089740,1643090560,820,253
3795934256,3582859001,1641944830,1641945118,288,1550
3991299369,3651803323,1660560353,1660561175,822,1154
3170102962,3765504986,1641280282,1641280901,619,1723
3124200545,3615419444,1652620305,1652620436,131,2133
3845743542,3307933176,1667958662,1667958713,51,1218
3197693984,3872691076,1648784163,1648784768,605,2408
3198731476,3883176560,1645285157,1645285890,733,459
3526239660,3319128889,1649739523,1649740256,733,2429
3927388172,3888895982,1664456454,1664457014,560,580
3069536467,3896982954,1667209496,1667210415,919,2016
3763804073,3091072272,1662872085,1662872098,13,738
3615359439,3708426776,1648041363,1648041479,116,2205
3568614629,3069881077,1645805540,1645806426,886,1610
3009169806,3034807560,1649284451,1649284832,381,2168
3471651838,3328993418,1641775900,1641776518,618,1980
3640915578,3586524207,1649814691,1649815322,631,372
3030630339,3574708692,1657715721,1657716510,789,2381
3457468984,3025223556,1653507895,1653508815,920,206
3264460374,3049727234,1658511806,1658512523,717,668
3328024680,3453552267,1645806618,1645807354,736,529
3285019414,3761587047,1649984418,1649984610,192,2250
3385183586,3891850013,1659273635,1659274304,669,2090
3515161257,3891027417,1659489162,1659489915,753,968
3696437293,3339911597,1656590052,1656590739,687,535
3409352040,3714909437,1654965320,1654965778,458,264
3329618048,3065530519,1664314212,1664314271,59,1906
3787937000,3357474960,1668647776,1668647989,213,685
3965118569,3971648409,1662588587,1662589073,486,895
3324041559,3149336644,1643675938,1643676242,304,2047
3267411650,3476971345,1668629058,1668629285,227,1704
3266751679,3045070182,1666520963,1666521505,542,2378
3258739109,3403786938,1643643957,1643643997,40,2101
3194379247,3626457002,1666299443,1666300225,782,2269
3483354291,3645768666,1655780892,1655781206,314,643
3015253917,3773770885,1661702513,1661702915,402,587
3321202962,3538972815,1645470297,1645470507,210,531
3666072303,3106465076,1650102340,1650102896,556,2083
3844939526,3641493201,1657823195,1657824191,996,720
3125289160,3645666563,1656694548,1656694876,328,895
3404043594,3601604629,1658803606,1658803811,205,1891
3920669948,3221276652,1650921914,1650922251,337,1354
3701726268,3175979112,1641599459,1641599820,361,1721
3011225738,3005809519,1653719359,1653719649,290,1396
3329463543,3637129082,1668636297,1668636339,42,1088
3102820806,3107501731,1643170754,1643170797,43,540
3268216928,3852344377,1650411418,1650411598,180,1348
3775660991,3658659669,1652856654,1652857267,613,2334
3573915559,3748085058,1656377162,1656377622,460,939
3622848449,3728506494,1643956694,1643957175,481,351
3912014286,3641911946,1651966924,1651967043,119,48
3661494924,3112419355,1641525850,1641526254,404,888
3867543887,3671637527,1647676827,1647677463,636,322
3134890095,3310582583,1647609818,1647610686,868,455
3819405521,3431562624,1654279821,1654280409,588,1479
3847957207,3624103484,1667184583,1667184824,241,1152
3320841904,3337624186,1661787907,1661787965,58,476
3882415224,3849910709,1662544575,1662544581,6,1673
3330924198,3490087619,1667208993,1667209716,723,747
3556549065,3855754332,1650714710,1650715477,767,1780
3324618357,3651055879,1644967555,1644968362,807,832
3058064037,3099649164,1654006404,1654006469,65,758
3066645531,3571576669,1652935141,1652935937,796,864
3200897172,3034815361,1668521477,1668522128,651,1886
3433261355,3361422449,1657200527,1657201014,487,600
3556803718,3927660473,1655472892,1655473631,739,1031
3382777450,3395782360,1661460926,1661460972,46,1415
3057922933,3972649318,1642689844,1642690014,170,975
3253913009,3599874732,1651462711,1651462951,240,1708
3574740304,3211401798,1655494998,1655495218,220,1256
3882254802,3498314038,1668558518,1668559332,814,104
3248452729,3410150990,1655199072,1655199726,654,1335
3108998670,3508340066,1647207642,1647207672,30,1194
3034288673,3719124928,1654302904,1654303535,631,1710
3400786498,3419430775,1658826840,1658827417,577,2231
3014517714,3066439887,1655291477,1655291695,218,440
3380313835,3183079019,1667518452,1667518634,182,1941
3928685907,3505789435,1645042366,1645042747,381,1769
3897976617,3870574001,1645223402,1645223964,562,296
3510416134,3923259150,1666533823,1666533829,6,629
3161412125,3794926978,1661530781,1661531195,414,1917
3728878635,3638595264,1648029015,1648029577,562,915
3063674428,3000254515,1660817903,1660818557,654,423
3389161785,3976055046,1663041166,1663042152,986,765
3693041370,3155320608,1648898546,1648898837,291,1843
3499182342,3925690262,1643960237,1643960292,55,740
3168919126,3264753140,1666464410,1666464420,10,1454
3501732936,3561692706,1648900669,1648901252,583,1747
3338715388,3065548516,1663644101,1663644397,296,2262
3188680599,3571897260,1648697672,1648697880,208,37
3798563042,3959497834,1662813739,1662814252,513,1236
3777568712,3912858275,1668311284,1668312008,724,846
3348198228,3212038287,1661261156,1661261875,719,858
3100572176,3551792540,1663849892,1663850342,450,924
3580901513,3341042744,1657858309,1657858710,401,820
3954285582,3499026312,1660854072,1660854119,47,2459
3873002836,3809965750,1667702067,1667702341,274,333
3055044716,3942965206,1650222616,1650223563,947,1199
3272623699,3954297181,1657078090,1657078518,428,1687
3515856480,3012930968,1650588226,1650589196,970,247
3508108339,3262596597,1649143986,1649144781,795,521
3864485247,3496369924,1651549664,1651549696,32,2255
3420205343,3436636953,1668418917,1668419336,419,1787
3915154684,3267360802,1643462780,1643463680,900,2000
3170036337,3003195362,1654853971,1654854605,634,1381
3749529134,3310496626,1641004700,1641005677,977,1642
3910979746,3049247811,1654772574,1654773160,586,177
3954185607,3522211010,1653746594,1653747547,953,115
3474242977,3418338710,1652348597,1652348738,141,443
3427405967,3182131313,1658075588,1658075704,116,2310
3472603348,3195451932,1656671175,1656671611,436,172
3356765270,3656674833,1644952851,1644953768,917,1183
3802592493,3985486150,1654833910,1654834136,226,2164
3275827194,3120984531,1666227832,1666228487,655,1410
3124927662,3804145408,1642624951,1642625226,275,2017
3660577882,3899890592,1663755799,1663756016,217,2008
3361365460,3368204842,1663963810,1663964048,238,878
3894431064,3548028995,1645165172,1645165449,277,1688
3943184820,3264831577,1665732009,1665732247,238,980
3807922855,3897756969,1666433012,1666433935,923,1337
3460842972,3743835099,1660743310,1660744056,746,1978
3474242977,3118554894,1657920889,1657921702,813,1410
3797617787,3105460297,1653693737,1653694720,983,23
3945086462,3130594039,1665381479,1665382459,980,1423
3864930473,3636528701,1646319133,1646320084,951,942
3657251975,3665668423,1655286491,1655287477,986,299
3619126886,3244198823,1645595289,1645596004,715,1755
3205423909,3077238667,1645249078,1645249122,44,2329
3710681792,3609664184,1653274853,1653275809,956,822
3248397935,3899301205,1646674958,1646674999,41,1262
3069313994,3972677516,1655494450,1655494546,96,440
3476312823,3005101248,1654824842,1654825227,385,898
3654344198,3153413554,1659153616,1659154154,538,2064
3122127756,3417143667,1666308046,1666309018,972,1613
3617715231,3925239812,1641345887,1641346015,128,557
3868397809,3360436723,1657481300,1657482211,911,416
3906396830,3668677061,1653087959,1653088846,887,2235
3032834107,3113938510,1668764939,1668765331,392,2148
3832296106,3664426298,1650577866,1650578728,862,1203
3607393629,3517992014,1650830980,1650831918,938,1970
3049567508,3091595739,1669512436,1669513129,693,2102
3336525489,3603786519,1641123137,1641123444,307,406
3093178960,3292298549,1661836579,1661836623,44,2197
3255149739,3570429285,1649619256,1649619856,600,1850
3608512295,3518717396,1664860822,1664860966,144,2386
3382943055,3768846820,1651763593,1651763886,293,1117
3133902865,3686240080,1655394635,1655395188,553,792
3672123230,3170844702,1661556295,1661556601,306,2249
3668677061,3381060534,1660482150,1660482865,715,1415
3175295329,3707199669,1648956845,1648957793,948,497
3374470605,3595560993,1649557797,1649558008,211,186
3790329301,3782266220,1643944289,1643944949,660,433
3620616287,3594009328,1646533618,1646533624,6,1897
3384307655,3604236901,1655765008,1655765311,303,1104
3097489594,3366321387,1654934496,1654935284,788,874
3541881881,3059447105,1663107415,1663107756,341,2143
3136174856,3034216304,1658368184,1658368233,49,231
3782673553,3833110040,1669596836,1669597763,927,33
3474742534,3485695895,1660418265,1660418888,623,887
3149336644,3595270507,1651863649,1651863887,238,380
3660162411,3088571651,1642010153,1642011036,883,1794
3112856155,3516410980,1669238704,1669239055,351,2299
3361051044,3124941982,1664335803,1664336493,690,817
3986885276,3626020948,1653626443,1653626589,146,9
3971588399,3626156541,1650300944,1650301824,880,2392
3631424312,3622656083,1657921899,1657922656,757,1761
3193403424,3587833146,1645206909,1645207743,834,427
3635624917,3248452729,1657817265,1657818239,974,794
3424254328,3708309303,1655126520,1655126605,85,1496
3352729606,3269956451,1642122747,1642123421,674,635
3098907787,3887519119,1651992560,1651993285,725,876
3254866960,3016299339,1645543972,1645544374,402,2368
3709263457,3028535162,1651649193,1651650128,935,785
3152988371,3888392286,1647370086,1647370319,233,1028
3338882756,3932002704,1649861333,1649862227,894,1301
3248452729,3149191705,1658986929,1658987458,529,971
3316031407,3909765076,1646332735,1646333528,793,1880
3057159511,3220690215,1650330813,1650331311,498,1585
3037048394,3370488301,1667208612,1667208698,86,238
3892142252,3010649870,1666908353,1666908636,283,942
3582544512,3208464777,1655330035,1655330057,22,2394
3107541952,3687938178,1658929146,1658929517,371,429
3963334554,3191265442,1643827884,1643828775,891,1730
3208220195,3779299713,1669646881,1669647350,469,29
3588936901,3620725243,1660103351,1660103509,158,2455
3375253810,3225909236,1665124496,1665125228,732,525
3553328177,3402690548,1650873578,1650874149,571,1822
3433937560,3389161785,1649891990,1649892758,768,46
3364199338,3223463387,1645711417,1645711789,372,1986
3425803609,3276118203,1644920551,1644921240,689,1611
3181236848,3262978596,1662346703,1662346955,252,536
3138539283,3165845148,1662445849,1662445902,53,885
3437603547,3219509030,1653629689,1653630053,364,985
3879325408,3905356323,1656456999,1656457466,467,2198
3330749303,3407156969,1664794129,1664794417,288,1130
3641729236,3670266153,1645278145,1645279041,896,1122
3338329823,3572594221,1656050199,1656050785,586,872
3688076815,3487406679,1668465535,1668466297,762,645
3370966526,3198240429,1646763178,1646763693,515,1353
3110360947,3864249446,1652461953,1652462123,170,1869
3270919620,3419430775,1661881002,1661881651,649,2030
3012264999,3991340294,1663610530,1663611496,966,689
3633479779,3263033338,1646609753,1646610442,689,1910
3217060058,3347896915,1669002293,1669002590,297,2227
3849725507,3910837040,1667408070,1667408796,726,2453
3895990286,3666072303,1658373299,1658373877,578,1578
3118526217,3542827244,1661687619,1661688579,960,2075
3608535655,3838774657,1668221355,1668221841,486,289
3653183152,3025333750,1642837886,1642838328,442,1128
3957411858,3628034615,1649538811,1649539521,710,618
3682993605,3518179871,1652826591,1652827201,610,1795
3708134798,3828503026,1648495978,1648496632,654,245
3055545326,3329463543,1656235534,1656235994,460,1014
3328245802,3749379449,1656464944,1656465032,88,667
3632284739,3939755962,1648680913,1648681687,774,2196
3933892798,3316398180,1650992241,1650992256,15,1348
3069353793,3021006721,1643993504,1643993853,349,2332
3084783158,3101609490,1650543460,1650544408,948,2010
3672350582,3415686543,1652279766,1652280029,263,435
3055644463,3890033502,1661609759,1661609829,70,1409
3895991710,3901026791,1642943574,1642944546,972,978
3100572176,3046080865,1652760610,1652761152,542,1032
3634735892,3081057659,1649381585,1649382018,433,1054
3822816987,3118419220,1662437396,1662438041,645,1703
3971722824,3868630067,1658600532,1658600887,355,1777
3119036139,3469812263,1648863098,1648864007,909,2005
3344282962,3865781327,1654358303,1654359118,815,318
3880849800,3641682706,1653517724,1653518623,899,1619
3086871623,3714105777,1654329849,1654330277,428,1364
3764492400,3683361867,1669683533,1669683931,398,300
3467391664,3079137127,1647443905,1647444452,547,1233
3573252143,3796754155,1643269244,1643269489,245,289
3320381981,3816533759,1655650746,1655651584,838,1605
3547672806,3067150549,1667108189,1667109172,983,2485
3328993418,3750949753,1651496954,1651497320,366,225
3856080546,3102760949,1654443477,1654444416,939,2333
3675353745,3892023630,1662998671,1662999291,620,602
3479308343,3330817237,1646201577,1646202076,499,149
3154309446,3692441467,1660462511,1660463115,604,663
3447203087,3256374123,1645689829,1645690364,535,2063
3938679223,3286473367,1659200631,1659200985,354,558
3073474496,3562243381,1665062214,1665062315,101,137
3925364546,3564089463,1653741677,1653742597,920,2205
3132592220,3454135300,1643056202,1643056623,421,2384
3843347515,3269653223,1660735877,1660736710,833,276
3537943189,3703548595,1657650635,1657651496,861,2039
3571897260,3123781164,1642609596,1642609778,182,1624
3132258390,3999180921,1641918683,1641919245,562,2006
3014646091,3371536214,1659699116,1659699829,713,456
3810798932,3436582780,1660633990,1660634818,828,1788
3185512282,3001889220,1641101457,1641101732,275,960
3254194915,3826737259,1653448064,1653448748,684,640
3659620596,3817668840,1657456502,1657456804,302,199
3897211381,3335818403,1649427612,1649428104,492,36
3184916120,3112602434,1642424201,1642424208,7,261
3188468802,3887305908,1643716433,1643716543,110,2051
3626020948,3759409777,1666898064,1666898841,777,238
3986247608,3990144819,1653149488,1653150232,744,193
3767912489,3506345760,1646828178,1646828833,655,2124
3474315750,3925344243,1649756719,1649757018,299,103
3294278402,3011690678,1665881109,1665881320,211,1750
3894690935,3342685325,1645731315,1645731747,432,2050
3267360802,3252664436,1647332831,1647332898,67,1536
3622596133,3749897140,1643716211,1643716563,352,710
3177036721,3256859026,1666692679,1666692738,59,101
3426433476,3971203354,1649042944,1649043759,815,889
3377774902,3575766470,1662018768,1662019104,336,1068
3994388981,3540735539,1661568297,1661569080,783,1782
3400397224,3035635016,1653741306,1653741339,33,82
3541942422,3795494127,1664366833,1664367024,191,294
3154288650,3224960669,1641146435,1641146742,307,1978
3557643641,3081589831,1652052163,1652052517,354,1202
3481030779,3938973292,1648540431,1648541313,882,1399
3387774254,3269198119,1652565184,1652565716,532,1680
3678624517,3358736286,1641443639,1641444104,465,1147
3014438377,3217029107,1654615694,1654616496,802,2371
3666380447,3824478322,1648202386,1648203358,972,979
3781580109,3860745004,1668184225,1668185125,900,2228
3998728915,3703943697,1665244300,1665245296,996,1390
3235672444,3013862518,1666972532,1666973473,941,1643
3807478002,3818353360,1667443643,1667444258,615,162
3021129414,3236522609,1652319741,1652320050,309,1646
3149804005,3564839908,1653896776,1653897313,537,1008
3785721693,3482473663,1666570789,1666571018,229,1858
3657203747,3687307113,1650313462,1650314067,605,1532
3342009927,3074269946,1666587530,1666588251,721,2426
3594254200,3971180079,1654355412,1654355711,299,2148
3250786481,3167985603,1652373087,1652373502,415,1868
3406953156,3071602516,1656906959,1656907738,779,1558
3260515804,3017005264,1655073330,1655073773,443,799
3683361867,3388814364,1645221830,1645222805,975,255
3927214415,3971926686,1666028769,1666029555,786,472
3243231806,3981846169,1659761640,1659762062,422,1695
3319546209,3190969092,1668642280,1668642654,374,354
3546799061,3351691261,1655611896,1655612647,751,104
3420733881,3694127985,1646362120,1646362319,199,1565
3400329831,3024551635,1653869765,1653870427,662,107
3787817814,3100716894,1648116387,1648116412,25,1075
3017005264,3751600788,1664270525,1664271053,528,841
3032970317,3103871966,1662339098,1662339985,887,364
3031209415,3003116947,1660376252,1660376777,525,305
3934453508,3173791920,1658547133,1658547522,389,174
3170844702,3190544941,1664393055,1664393276,221,1970
3806936803,3865511945,1664967261,1664968151,890,2365
3149688689,3637269987,1647353511,1647354386,875,2179
3072834944,3398735443,1665491977,1665492965,988,835
3469471892,3531574623,1666658901,1666659154,253,1458
3145961063,3386628594,1649393149,1649393587,438,1657
3880599649,3957216784,1658569853,1658569916,63,2306
3633856416,3261527870,1655637533,1655638227,694,663
3645560004,3001302955,1660212358,1660213323,965,2489
3423825173,3550107804,1650641105,1650642073,968,2422
3855984822,3838993248,1651008629,1651008902,273,1555
3108230028,3778228977,1648747331,1648748215,884,320
3407331091,3282950540,1658998901,1658999496,595,2312
3517992014,3351245855,1665448798,1665449444,646,900
3486793392,3341283434,1659913027,1659913784,757,301
3292368988,3969103555,1659690751,1659691410,659,703
3299840986,3769290304,1653682270,1653683105,835,2094
3199315199,3475835420,1652084932,1652085918,986,1658
3335573495,3914926954,1656499919,1656499968,49,2245
3312580754,3946306778,1659588326,1659588642,316,456
3049141347,3550889203,1663155484,1663155712,228,1649
3476558133,3936914064,1646635195,1646635282,87,244
3005125326,3379259059,1656428575,1656429536,961,215
3141963631,3407409307,1648310021,1648310567,546,178
3608535655,3065530519,1653106087,1653106831,744,1934
3541200701,3385846184,1651802093,1651802358,265,2485
3650675743,3392535031,1647257198,1647257520,322,481
3147376468,3097242351,1651296128,1651296477,349,534
3526797183,3399479391,1662472457,1662473223,766,2013
3176608983,3704871253,1654540972,1654541043,71,1082
3973264936,3394220993,1666786786,1666787651,865,2178
3523829341,3651058536,1656497696,1656498233,537,1809
3792924517,3410150990,1665172819,1665173069,250,1267
3952282084,3004951157,1645663228,1645664111,883,1379
3870778205,3903015279,1649181726,1649182652,926,1067
3773177927,3489695411,1644369387,1644369536,149,76
3142869544,3349247221,1659888022,1659888408,386,1510
3206197726,3845363108,1662244500,1662245454,954,1595
3168919126,3968297784,1658864866,1658865468,602,1313
3404945581,3272811357,1645287314,1645288028,714,1463
3048788442,3122818832,1656095471,1656095822,351,1662
3279370751,3253545861,1662813829,1662814072,243,1806
3129582333,3138755786,1657444111,1657444908,797,328
3879605776,3809041613,1665885311,1665885615,304,1066
3885893310,3460229906,1648279667,1648280641,974,322
3651271289,3360575138,1649488835,1649488856,21,2060
3800312034,3548351680,1655246381,1655246601,220,2403
3204175740,3760930897,1650107048,1650107733,685,2298
3177491349,3076285457,1644087624,1644088338,714,19
3735691730,3872626198,1667909731,1667910529,798,390
3479738009,3068659940,1649006544,1649006651,107,2443
3461451325,3711589639,1645065074,1645065889,815,423
3862122399,3993504996,1658172132,1658172680,548,2060
3634936481,3634871077,1648306951,1648307292,341,706
3832144696,3050244048,1655660887,1655660901,14,429
3813854723,3707778731,1659732719,1659733172,453,1203
3242180365,3057201124,1649808098,1649808551,453,1956
3009177873,3078830914,1668443436,1668443778,342,847
3447743170,3898494020,1654276854,1654276873,19,348
3495798110,3748061416,1648407317,1648407682,365,154
3821768923,3991963732,1641157751,1641157866,115,1191
3034440971,3368387959,1664181515,1664181935,420,543
3715894883,3089699104,1650355301,1650355922,621,1446
3797617787,3804768140,1661717482,1661718434,952,500
3955307397,3785432995,1669553419,1669553662,243,304
3007328261,3547749057,1656150061,1656150302,241,1143
3737772457,3567980215,1651284239,1651284802,563,1276
3800460824,3702178313,1664657701,1664657774,73,1950
3015814199,3992345499,1649025887,1649025946,59,1520
3445469609,3389097842,1645046312,1645046509,197,1124
3637944484,3259625938,1669429209,1669429780,571,2019
3124964775,3228073924,1651809588,1651809897,309,1247
3097501233,3511569871,1645417193,1645417822,629,1425
3086444841,3539571109,1660883212,1660883722,510,495
3083388257,3460687455,1656821743,1656821971,228,743
3768311968,3128401376,1648007594,1648008014,420,407
3821064356,3494372287,1668622517,1668623014,497,2131
3661976391,3095503795,1650532521,1650533156,635,177
3287714636,3819584735,1668505248,1668505307,59,1426
3485644295,3327145204,1651259269,1651259635,366,162
3261174036,3012929490,1662550506,1662551063,557,2099
3620725243,3876127195,1648551831,1648552476,645,783
3661705197,3572018229,1656021299,1656021524,225,1927
3618380884,3690586350,1644763277,1644763912,635,108
3363733362,3329463543,1649901168,1649902070,902,2383
3124964775,3696437293,1666309656,1666310413,757,1702
3385183586,3962261300,1656205118,1656205621,503,309
3553939893,3372442199,1647995756,1647996143,387,410
3550329232,3833594316,1667597180,1667597182,2,1343
3218946191,3220405755,1664237868,1664238052,184,480
3371002443,3661559275,1666548559,1666549435,876,1095
3003861546,3098316380,1644774147,1644774258,111,1252
3301471485,3689741006,1650042621,1650042747,126,2212
3091112554,3415145597,1665740586,1665741346,760,1933
3310520005,3756020689,1654728353,1654728711,358,1472
3444313610,3426617058,1649539227,1649539484,257,1884
3345186165,3710769510,1643438898,1643439827,929,1441
3947461796,3548028995,1642850227,1642850601,374,2148
3559863065,3674271275,1654242356,1654242875,519,2468
3046190454,3953796727,1644861947,1644862015,68,2287
3335040022,3793772897,1657930391,1657931362,971,2400
3866534454,3339480960,1656540187,1656541027,840,53
3265434991,3581026789,1651134301,1651134395,94,1883
3918988651,3093523046,1649845810,1649845822,12,190
3750765878,3647398701,1650841080,1650841846,766,2214
3479385096,3827891957,1653941184,1653941359,175,969
3783304213,3946919028,1644887922,1644888074,152,20
3270914746,3943413233,1641841754,1641842144,390,642
3513193858,3362812887,1654800990,1654801700,710,1802
3315759953,3427405967,1654085557,1654085858,301,1814
3697322167,3609274729,1659731175,1659731915,740,661
3924583665,3211015636,1641589436,1641589890,454,979
3737809844,3252187190,1644833276,1644833615,339,872
3256628168,3399180008,1645320645,1645321519,874,1566
3643276679,3388257945,1667542576,1667543553,977,660
3889112055,3562463361,1661214033,1661214285,252,1979
3604593541,3635854686,1643224461,1643225087,626,2238
3787920743,3465406980,1648475589,1648475775,186,887
3307393195,3368322774,1645477139,1645477595,456,978
3083144170,3925393914,1652301226,1652301304,78,689
3974326867,3038067120,1655607571,1655608152,581,1801
3202063550,3952670371,1655653152,1655653628,476,84
3968143962,3462224632,1644267965,1644268851,886,811
3311529434,3670075164,1649638508,1649638556,48,1221
3623620611,3347646218,1652445642,1652446107,465,731
3345186165,3433237569,1641705655,1641705832,177,2036
3247551122,3637944484,1641854236,1641854318,82,1372
3486832676,3719273348,1641747645,1641747690,45,401
3032465570,3812385830,1663984122,1663984133,11,398
3714535860,3105789496,1642904479,1642905217,738,2000
3608512295,3424476490,1650798846,1650799763,917,772
3277883706,3506733308,1656145721,1656145747,26,780
3768846820,3968412854,1649695011,1649695744,733,1413
3707199669,3227652803,1665226369,1665227173,804,2088
3252981510,3501287522,1652537315,1652537901,586,2035
3393000047,3602924213,1643981037,1643981486,449,594
3319946083,3575816255,1641718750,1641719195,445,73
3071322324,3324003851,1655322016,1655322078,62,1431
3323783108,3257118282,1659119044,1659119482,438,1915
3011158212,3454135300,1669174710,1669175062,352,80
3968412854,3225901381,1660673506,1660673982,476,1465
3273857586,3169955779,1656058295,1656058712,417,1176
3772035177,3100716894,1649311068,1649311342,274,170
3352986307,3010790966,1662196383,1662196570,187,2250
3993994586,3066990756,1641132257,1641132815,558,631
3881851624,3071410684,1646913056,1646913858,802,2134
3075780193,3988957478,1647267364,1647268289,925,1280
3604308622,3807323401,1642155525,1642156364,839,559
3106584115,3294569676,1645744758,1645745259,501,678
3675359399,3956191936,1641816184,1641816492,308,2076
3272250396,3477363517,1657626310,1657626794,484,1757
3534726913,3957115705,1649602547,1649602980,433,16
3349847682,3325842490,1650814786,1650815344,558,1216
3618397647,3140608489,1651743620,1651743699,79,558
3760975208,3139882519,1655732979,1655733366,387,1229
3248250292,3601590462,1665782778,1665782829,51,1211
3829901682,3947369111,1647815492,1647815928,436,956
3158873070,3213397142,1644253344,1644254217,873,1032
3862890852,3546284533,1660132961,1660133792,831,2006
3378168172,3592596587,1661505460,1661506297,837,607
3798833025,3592520398,1644748235,1644749026,791,1378
3526327974,3609804397,1651230885,1651231301,416,2142
3584910336,3521160717,1655913307,1655913428,121,407
3405319002,3934125569,1643395808,1643396216,408,8
3748478851,3536128186,1647489212,1647490114,902,1683
3267479523,3292636621,1641586775,1641587205,430,22
3393712145,3347434027,1657521662,1657522140,478,1796
3697822889,3516107650,1649709081,1649709177,96,1007
3124004516,3393724727,1641320538,1641320832,294,1511
3092800496,3687215472,1651976712,1651976996,284,506
3887337385,3726883867,1651068965,1651069922,957,647
3647549073,3826502515,1646946563,1646946628,65,1311
3457108498,3688056726,1665867479,1665867805,326,590
3855777399,3035464149,1641112928,1641113798,870,423
3564883937,3653770219,1643676363,1643676868,505,2194
3313615371,3258739109,1641711102,1641711193,91,2053
3426565803,3991310779,1662842646,1662842832,186,1097
3553725082,3916680089,1653286059,1653286437,378,1555
3575375841,3989563375,1659253933,1659254724,791,501
3825900664,3525088003,1666713073,1666713490,417,1687
3451089348,3809312897,1662287399,1662287520,121,1369
3002316212,3214282155,1649413871,1649414205,334,1606
3692691710,3323797477,1657237647,1657238147,500,218
3234064286,3883812439,1667958039,1667958860,821,621
3573158941,3546859493,1649942178,1649942913,735,1816
3018760022,3704604706,1642429182,1642429844,662,151
3586025172,3969103555,1655044104,1655044224,120,478
3216753609,3648263372,1664115847,1664116494,647,128
3436916222,3058834310,1665008967,1665009809,842,1552
3033373685,3850214790,1643394458,1643395302,844,2201
3335915365,3670112572,1651172144,1651172196,52,2340
3637092038,3673735088,1651047110,1651047830,720,1076
3240324089,3014354609,1646713897,1646714418,521,1083
3945397961,3713455058,1647336036,1647336251,215,2047
3230775095,3838774657,1653601163,1653601814,651,2190
3879936194,3430916751,1645688466,1645689129,663,1017
3059870015,3879001343,1668062387,1668062687,300,633
3419336769,3764078507,1644486776,1644486980,204,1772
3623802234,3912111332,1654199360,1654199747,387,2209
3311280180,3721374677,1643169593,1643170386,793,838
3800239896,3511755413,1654201477,1654201816,339,673
3110639083,3479385096,1664108543,1664109323,780,1803
3275810322,3567637602,1641881180,1641881964,784,1698
3183259139,3068242755,1665594796,1665595390,594,2219
3867214487,3775146250,1641989726,1641990237,511,788
3271436858,3116777827,1653272594,1653273538,944,1867
3787937000,3211521816,1654521779,1654522550,771,675
3832463052,3700109325,1666035174,1666035791,617,1835
3883286458,3760142759,1650207126,1650207668,542,960
3785728567,3390919111,1646224372,1646224955,583,1584
3057837723,3073474496,1668307744,1668307967,223,2494
3926699428,3864301593,1653417932,1653418668,736,1981
3425490548,3731386559,1642422321,1642423315,994,929
3286473367,3691062084,1646279089,1646279445,356,1136
3476450845,3038606123,1653159166,1653159948,782,2300
3009366895,3684537058,1658043167,1658043467,300,2200
3119802700,3723438987,1668396659,1668397006,347,2483
3686641761,3628956600,1647980593,1647981289,696,334
3523465225,3872691076,1642791167,1642791714,547,495
3339611423,3662578193,1668190483,1668190863,380,508
3303698845,3487547990,1643023614,1643024593,979,777
3009169806,3043604048,1658919426,1658920146,720,1988
3223094732,3798343786,1644209074,1644209903,829,1192
3994168332,3683361867,1655373625,1655374291,666,2422
3864143186,3307775998,1662698160,1662698756,596,601
3756028002,3755228064,1667885173,1667885886,713,2236
3412053580,3548484912,1662958303,1662958552,249,734
3942325631,3669324531,1667368212,1667369096,884,2236
3209462413,3070404759,1652611711,1652611718,7,2192
3165039316,3367457506,1649973053,1649973239,186,2488
3442854678,3713834683,1641526334,1641526631,297,1202
3202984277,3699533383,1651120210,1651120932,722,1680
3983988321,3130993420,1647821615,1647822070,455,417
3722380765,3599568023,1668901676,1668902061,385,2049
3156538951,3092292487,1659061941,1659061945,4,1002
3317318302,3370267721,1656753465,1656753818,353,1972
3986885276,3546486600,1653330832,1653331777,945,1198
3479322514,3504641910,1652832565,1652833515,950,44
3680453323,3581449963,1653610166,1653610672,506,1425
3820374377,3724455974,1651077710,1651077737,27,299
3290359932,3772749656,1660595953,1660596302,349,1636
3170036337,3511192827,1658431089,1658432068,979,2466
3832640445,3223094732,1641889778,1641890442,664,2293
3697692313,3117322872,1641733986,1641734401,415,2215
3976984063,3469583371,1656634168,1656634606,438,477
3352376449,3928354041,1668941324,1668942130,806,1914
3250381378,3852344377,1645588625,1645589453,828,1845
3722948390,3665148560,1649322058,1649322284,226,317
3985620157,3531256735,1650464207,1650464750,543,1327
3799459873,3047001138,1655612124,1655612282,158,1617
3884412861,3887397856,1650594661,1650595641,980,839
3468516508,3880298832,1654601904,1654602828,924,1264
3994721189,3370267721,1653592362,1653592676,314,2135
3812732557,3287399418,1664813887,1664813938,51,1668
3950666008,3696716300,1660265718,1660265992,274,2150
3039255124,3865200739,1641010065,1641010422,357,2466
3937129101,3307949630,1647829106,1647829959,853,83
3924141950,3837062335,1662266561,1662267495,934,1555
3172429422,3468703620,1656134730,1656135062,332,1650
3456799118,3992924141,1661425841,1661425919,78,1541
3071023164,3927952722,1642511860,1642512847,987,197
3151386327,3299191225,1645546390,1645547210,820,245
3280558341,3579486534,1667804800,1667805309,509,1625
3768814245,3150627841,1641427075,1641428015,940,991
3983391279,3600247537,1663909424,1663909983,559,2259
3934453508,3642691052,1643826873,1643827704,831,925
3407735827,3300015174,1646026331,1646026492,161,422
3790650118,3822307865,1669744553,1669744969,416,15
3687278591,3149046961,1655087688,1655087958,270,2190
3441680015,3011993360,1645476838,1645477606,768,138
3195148360,3566534974,1653923014,1653923195,181,2032
3903015279,3897421758,1657030522,1657031306,784,1065
3030117347,3210986714,1664593328,1664593679,351,2283
3146653168,3436768933,1642305437,1642305797,360,933
3025333750,3793032912,1641489118,1641489450,332,429
3388490960,3642691052,1646363792,1646363850,58,847
3364600825,3243534925,1650725744,1650726132,388,496
3447077543,3103404280,1656507613,1656508165,552,1973
3315759953,3646596750,1665048113,1665049070,957,438
3888563902,3478771172,1666180848,1666181840,992,2242
3647539125,3613188168,1647018078,1647018517,439,1198
3133694612,3993066194,1668710998,1668711104,106,2177
3544133682,3806570797,1649500079,1649500148,69,1641
3332506866,3659299466,1650030701,1650031176,475,302
3621456276,3482268698,1669660486,1669661382,896,1072
3933332705,3117531188,1654192877,1654193783,906,590
3172293659,3574957979,1645674497,1645674998,501,40
3319601888,3098934820,1658540210,1658540292,82,2326
3751300388,3114733025,1654026913,1654026965,52,735
3952620083,3980867331,1658501118,1658501999,881,1213
3670154961,3710466773,1642044444,1642044465,21,1503
3269629374,3774806676,1650860375,1650860830,455,365
3513169935,3002396640,1669656273,1669656597,324,1679
3695411154,3120823401,1645066088,1645066345,257,2286
3027558279,3030290445,1649130885,1649131016,131,508
3118358674,3675341264,1647102359,1647102985,626,550
3280046501,3323783108,1665305681,1665306506,825,1955
3615262736,3833553454,1668264600,1668264972,372,561
3581470040,3145393304,1660608182,1660608407,225,1775
3885786333,3668174777,1664470891,1664470908,17,984
3761147252,3680060067,1646960717,1646961082,365,1389
3953655387,3923980052,1653705804,1653705883,79,2213
3097982496,3093599187,1643691265,1643691648,383,1577
3555186812,3634936481,1641942277,1641942415,138,935
3375404573,3489695411,1662368643,1662369601,958,803
3814588354,3880620233,1655939122,1655939726,604,2397
3835842311,3849701361,1649164104,1649164383,279,329
3311113773,3841314189,1665349008,1665349076,68,721
3336525489,3846007471,1662256432,1662256684,252,1698
3210136888,3830541998,1658265870,1658265914,44,1729
3600247537,3658428855,1644281323,1644281793,470,1148
3334792271,3032851657,1664144001,1664144874,873,1421
3487387362,3276846453,1658383266,1658383479,213,1069
3895542691,3233932115,1668528870,1668529120,250,1893
3645860854,3347679085,1654781308,1654782184,876,1600
3254174311,3585042042,1642605408,1642606347,939,1715
3208215579,3518717396,1659825461,1659826231,770,1576
3011015055,3571173934,1648867983,1648868629,646,673
3931789231,3948833001,1652791193,1652791997,804,1225
3902777743,3680703930,1657630169,1657630795,626,712
3049592624,3825930964,1664265475,1664266322,847,1170
3962784099,3442330693,1644937380,1644938173,793,1948
3804189322,3454851350,1657721861,1657722650,789,209
3621452884,3151346211,1659315349,1659316152,803,1914
3904907996,3831683294,1657788737,1657789055,318,350
3501308694,3003087336,1669502443,1669503197,754,675
3486907422,3549604297,1659177332,1659177682,350,1096
3465064732,3193095337,1649614539,1649615465,926,359
3600692380,3218798966,1650058013,1650058921,908,255
3080214168,3490415118,1658123712,1658124075,363,839
3260802289,3899618702,1658076072,1658076744,672,925
3465842758,3379756257,1648941277,1648941855,578,64
3472603348,3193344217,1662182035,1662182085,50,2000
3002631535,3172619193,1651024759,1651025445,686,1116
3375966339,3904012023,1644959338,1644960164,826,692
3098891437,3498461454,1648668548,1648669130,582,793
3971020365,3089574886,1659511746,1659512129,383,341
3269966376,3913994422,1660622302,1660622971,669,769
3170292789,3215088423,1658290679,1658290690,11,2325
3392569339,3786724835,1654251665,1654251909,244,834
3099818927,3665668423,1644545695,1644546082,387,348
3785584501,3864143186,1666515460,1666515900,440,378
3124964775,3711314965,1642289939,1642290932,993,1316
3356499294,3886651871,1644968195,1644969154,959,680
3794926978,3072276713,1661213578,1661214088,510,517
3543239972,3364888618,1644406891,1644407757,866,1257
3288309878,3351863157,1649394348,1649394570,222,1700
3514013878,3112259657,1650542687,1650543324,637,558
3035245517,3953796727,1650060180,1650060633,453,1882
3384794661,3232285701,1651553944,1651554464,520,2299
3070395663,3995365519,1643878126,1643878907,781,473
3538692457,3517912492,1653797050,1653797622,572,1962
3977359273,3036381764,1669617273,1669617463,190,213
3047372637,3403337910,1667434693,1667434885,192,1648
3977699882,3418998927,1642420726,1642421557,831,785
3735691730,3489909547,1648312953,1648313403,450,641
3418364050,3797769846,1658928575,1658929094,519,947
3759230876,3356690610,1665091967,1665092560,593,286
3418364050,3426491499,1647299536,1647299798,262,931
3899858422,3051863550,1643743801,1643744694,893,966
3969110896,3308256167,1650799450,1650800247,797,473
3174705393,3678425549,1653631438,1653631907,469,1092
3232333937,3058725687,1655341019,1655341643,624,648
3800566657,3692095834,1650772643,1650773411,768,2499
3205423909,3157965235,1653875108,1653875177,69,883
3434608050,3718684083,1659096371,1659096373,2,1645
3585495750,3397940369,1657651806,1657652193,387,593
3960897829,3311329069,1658795235,1658795652,417,1691
3810798932,3656175066,1645971294,1645971638,344,496
3446946900,3412673526,1654778806,1654779792,986,706
3810891199,3948769271,1655030392,1655030962,570,539
3276840933,3280251149,1667643034,1667643562,528,217
3158873070,3570050230,1659905624,1659905903,279,1916
3253436330,3608450611,1657825289,1657825807,518,1755
3956191936,3002396640,1669136300,1669136639,339,965
3786840082,3382777450,1651447276,1651447852,576,568
3928930330,3506148228,1653091132,1653091624,492,1151
3357966828,3021515419,1647879830,1647880558,728,2147
3017504746,3478570785,1665407170,1665407245,75,2383
3204735172,3006603067,1660588882,1660589474,592,1884
3976367014,3093523046,1651112084,1651112982,898,1049
3398583773,3189673990,1660370497,1660370806,309,275
3749702246,3825900664,1658302459,1658302497,38,351
3784414098,3431354119,1643053178,1643054057,879,1110
3440064321,3416230781,1661901546,1661902080,534,689
3338154846,3486727273,1661379356,1661379676,320,698
3109127825,3022256617,1645728261,1645729130,869,1941
3954297181,3662526382,1643461459,1643461494,35,1179
3958920817,3418662987,1668298533,1668299445,912,886
3948074176,3730845439,1643772087,1643773067,980,789
3324618357,3312580754,1666566161,1666566429,268,1078
3257865090,3374007172,1669540667,1669541507,840,2129
3411708498,3414581321,1641780590,1641780610,20,1457
3330058679,3271409183,1649966246,1649966388,142,828
3900101700,3375021204,1657937039,1657937244,205,540
3430145466,3740438273,1647933658,1647934528,870,1649
3356499294,3719929552,1659645814,1659646343,529,2105
3177628377,3894593426,1668526433,1668527055,622,1152
3934453508,3831255967,1650562110,1650562452,342,234
3491022991,3832703867,1663015780,1663016357,577,497
3022082086,3273752842,1667170021,1667170150,129,1070
3113214024,3364540592,1646166785,1646167153,368,2083
3539364028,3997215508,1661590539,1661591033,494,1393
3105733809,3266962342,1666649393,1666649756,363,1529
3763300182,3253545861,1668833723,1668834400,677,1709
3345458354,3825849470,1665584441,1665585106,665,2302
3209332658,3609274729,1655378552,1655379457,905,1635
3112357538,3431909978,1650121225,1650121875,650,1903
3042176960,3985491144,1664586175,1664586377,202,2360
3462072699,3083020614,1660564734,1660565590,856,1897
3532307372,3558139345,1659528389,1659529078,689,1597
3948310967,3685678285,1646458798,1646459696,898,1501
3007339106,3640571571,1653303880,1653304115,235,1905
3046500774,3758323845,1643786466,1643787249,783,1848
3249145163,3344279346,1663282456,1663283055,599,239
3237807880,3681993008,1644027050,1644027384,334,1620
3109127825,3553712893,1650324469,1650324489,20,1791
3942862085,3347896915,1655403918,1655404309,391,1119
3784414098,3455209070,1662308530,1662308864,334,1459
3689680251,3428889808,1660258312,1660258679,367,328
3500264647,3405155234,1656198700,1656199155,455,1844
3962211697,3055545326,1653377190,1653377207,17,2128
3804768140,3744726408,1644045925,1644046664,739,471
3797237179,3795817960,1668858065,1668858199,134,984
3776398060,3648263372,1655954603,1655955434,831,628
3521302995,3737400101,1662672274,1662672466,192,1961
3863922323,3795792181,1667107129,1667107817,688,2384
3262377052,3138411685,1651189750,1651190153,403,1801
3681993008,3295316821,1657212596,1657213266,670,1950
3239620599,3197176680,1653912658,1653913520,862,1540
3275494433,3777316167,1660792279,1660793213,934,6
3389114774,3196009998,1656865793,1656866141,348,2442
3476558133,3870475008,1645623069,1645623296,227,1257
3636930993,3960727376,1651714230,1651715041,811,1721
3362972722,3748950684,1657955672,1657956200,528,2341
3036470049,3671748544,1653857050,1653857497,447,606
3857211245,3197352308,1669393641,1669394416,775,541
3655135775,3472603348,1650827918,1650827951,33,352
3029500930,3342315965,1660475728,1660476457,729,917
3478921948,3930852270,1642313263,1642313626,363,1183
3584660761,3222438717,1654015740,1654015949,209,1491
3910029798,3055390520,1647042750,1647042875,125,1335
3351216955,3014993252,1666835209,1666835967,758,1189
3413369567,3023025075,1661581140,1661581304,164,296
3190454065,3877205464,1652974615,1652974766,151,1028
3166492454,3143679923,1664553152,1664553685,533,650
3419751912,3370889279,1665795398,1665795959,561,2197
3210071519,3143318519,1655840564,1655840937,373,598
3559863065,3042176960,1656572753,1656573060,307,359
3154139372,3907635993,1663612932,1663612981,49,1009
3656467120,3175706913,1662157409,1662157851,442,462
3740807524,3257821708,1666549306,1666549412,106,1323
3287784262,3930124385,1666405948,1666406403,455,1695
3858121838,3890159677,1641747124,1641747942,818,961
3287600901,3293865251,1668296138,1668296330,192,677
3859976372,3012032774,1657123855,1657124063,208,732
3482235012,3653850140,1666328832,1666329406,574,1785
3457468984,3584910336,1648337254,1648338007,753,2194
3840962989,3670154961,1641824509,1641825340,831,1272
3049969877,3443360830,1668876491,1668877050,559,2403
3245723038,3208220195,1650348772,1650349059,287,1154
3771811920,3818453534,1656593769,1656594450,681,1610
3845496977,3766062750,1664233391,1664234381,990,829
3473037406,3397970538,1667372922,1667373043,121,1421
3707892765,3972677516,1642012533,1642012855,322,1411
3864044700,3881206954,1641976884,1641977587,703,2197
3601562567,3929901413,1657113492,1657113788,296,1414
3956054666,3050607996,1650568277,1650568493,216,987
3532021354,3521410258,1645612355,1645612941,586,1120
3551344746,3215342018,1660829135,1660829579,444,532
3785728567,3523465225,1650470435,1650471009,574,1204
3204302089,3515550503,1663311887,1663312690,803,832
3111639847,3696184358,1644586853,1644587153,300,776
3606954305,3450811740,1665620991,1665621881,890,2012
3286476251,3574240169,1659548590,1659548724,134,1492
3718905579,3300994471,1661028765,1661029753,988,1680
3017758671,3349847682,1660717721,1660718634,913,1054
3340331761,3666486477,1646440354,1646440377,23,1911
3137092101,3329751201,1650372405,1650373034,629,1034
3362598320,3752442248,1664401566,1664401801,235,372
3542078032,3116451556,1651597560,1651597737,177,609
3883265629,3124476593,1659182652,1659183014,362,1970
3253931464,3953465037,1661473311,1661474170,859,2288
3988957478,3079013365,1668386667,1668386957,290,2422
3689828648,3432321849,1643891004,1643891172,168,1264
3503393955,3860268588,1668514493,1668515316,823,106
3587833146,3378542130,1648739146,1648739453,307,1655
3164410972,3181181141,1669047495,1669047918,423,1840
3429010148,3728506494,1651382313,1651383056,743,917
3159873313,3366896849,1656568406,1656568963,557,235
3058951367,3918234060,1648504842,1648504931,89,1854
3437593879,3574985668,1657692474,1657693296,822,2015
3578002057,3405155234,1646176155,1646176259,104,952
3643412582,3952425376,1646877794,1646878079,285,1167
3049147900,3909330778,1653013472,1653014340,868,2237
3843331100,3210422873,1665736356,1665736637,281,2411
3997312859,3369356299,1661100088,1661100771,683,595
3995358434,3137594486,1643721979,1643722479,500,1103
3224128562,3553530817,1641617749,1641618442,693,1132
3787817814,3348113823,1651806891,1651807393,502,1807
3473852885,3899890592,1657055019,1657055945,926,603
3253436330,3162947685,1661078374,1661079286,912,1478
3114361358,3038035861,1669663407,1669663992,585,787
3773488272,3002727939,1641746622,1641746965,343,111
3449352254,3953796727,1641166843,1641167627,784,858
3727981782,3058837915,1644256115,1644256334,219,1206
3487972666,3541942422,1663246275,1663247058,783,1036
3666931632,3772980352,1663367685,1663368343,658,2023
3057721767,3026769225,1665500445,1665501355,910,1283
3523829341,3293201387,1666344451,1666344510,59,1606
3463135439,3993798870,1659052104,1659053086,982,808
3267107046,3103417672,1654421018,1654421206,188,1186
3258098890,3311871585,1655400332,1655401288,956,2388
3570480973,3576315042,1662230465,1662231018,553,922
3595612540,3848995096,1659485732,1659486225,493,1460
3039255124,3376673600,1648412539,1648412692,153,2314
3799459873,3628963667,1643191703,1643192269,566,1131
3361694981,3790896269,1658041095,1658041898,803,2174
3170844702,3398443861,1644834575,1644834994,419,2295
3496369924,3366189965,1653952290,1653952459,169,230
3343249545,3023254734,1655455798,1655456226,428,1459
3570335491,3565803867,1641795189,1641795380,191,1827
3236325866,3948942044,1656692366,1656692657,291,431
3760975208,3715540162,1662875554,1662875643,89,1290
3586776572,3832719894,1641901067,1641901205,138,1331
3389448374,3811337280,1654620468,1654621425,957,966
3852810875,3338154846,1642523264,1642523739,475,1780
3131156982,3830303170,1665869360,1665869727,367,463
3073762858,3361508949,1647146388,1647146568,180,1372
3313975664,3900951859,1645927244,1645927720,476,1649
3067179904,3722247979,1648212675,1648213056,381,313
3234355426,3993637202,1660445300,1660446016,716,2395
3675429073,3477522732,1660070878,1660071124,246,588
3766528617,3204081712,1654328794,1654329014,220,806
3297123407,3152555864,1663831945,1663832093,148,2237
3481584783,3368387959,1647759997,1647760378,381,1742
3624872846,3222446672,1658065384,1658065620,236,2398
3134117241,3952252601,1651066190,1651066324,134,1323
3304728211,3835976086,1652494257,1652494440,183,1781
3172524712,3124562368,1654353066,1654353150,84,2212
3947604616,3776685300,1660627813,1660628321,508,1119
3858911279,3508398331,1663860387,1663860868,481,2417
3276840933,3744386868,1648440375,1648441231,856,1591
3542293606,3318735194,1648504192,1648504317,125,1362
3226052631,3288016190,1660795571,1660795786,215,2478
3158962971,3735547050,1643549085,1643549096,11,401
3084138267,3424650360,1646635208,1646636114,906,554
3982210988,3669311789,1648588207,1648589029,822,16
3689544534,3432364009,1653964001,1653964388,387,1542
3208346862,3653770219,1647569763,1647570482,719,399
3439325479,3407139317,1654822702,1654823672,970,382
3636948225,3345410681,1650068685,1650068805,120,685
3250253670,3377868003,1656245667,1656245859,192,426
3188588023,3062506508,1641000322,1641000797,475,806
3658461707,3702932977,1665165850,1665166807,957,1450
3320179826,3474081200,1661293957,1661294402,445,2243
3957973658,3361529884,1651472718,1651473268,550,345
3537411123,3628554134,1656099791,1656100412,621,269
3767868249,3301148308,1666416863,1666417659,796,1905
3481090623,3170924487,1665702813,1665703658,845,1133
3890580849,3865299110,1668752911,1668753587,676,1831
3391426421,3512215996,1658426580,1658426962,382,1234
3402690548,3600573063,1650342958,1650343563,605,1485
3506952427,3154653229,1651351003,1651352000,997,1502
3846298815,3889541754,1649762914,1649763545,631,1941
3063955055,3184608724,1647036762,1647037000,238,492
3451167153,3352316809,1645403137,1645403820,683,1135
3937077335,3167864948,1666577602,1666578396,794,1072
3938272679,3961183307,1654411144,1654411734,590,1100
3071410684,3327427782,1646229602,1646230287,685,555
3432462167,3533279961,1663119090,1663119837,747,469
3806664868,3150485567,1643422852,1643422877,25,1635
3055050795,3952282084,1647056925,1647057876,951,1695
3762816561,3827431944,1648013625,1648014505,880,360
3379366812,3260867614,1643843533,1643843654,121,2246
3553471050,3816690173,1669583079,1669583348,269,588
3417176290,3277875103,1646371952,1646372560,608,1387
3107541952,3623876940,1650872023,1650872852,829,1934
3984533628,3977987504,1644350162,1644350958,796,2411
3315569726,3402878567,1659490474,1659490758,284,2216
3184720975,3695237310,1663597032,1663597488,456,1416
3973226891,3362812887,1661175672,1661176010,338,2242
3665714575,3120823401,1644819917,1644820723,806,2249
3266498789,3818713435,1649193135,1649193751,616,314
3321818923,3934199220,1662604182,1662604887,705,2494
3120984531,3292797747,1666408362,1666409100,738,771
3806570797,3445469609,1647161273,1647161510,237,1914
3574486853,3091882022,1667697343,1667697630,287,756
3673735088,3960036547,1662654852,1662655842,990,834
3722247979,3698965715,1666094367,1666094902,535,1159
3061814600,3472983363,1647681785,1647681879,94,2062
3463032893,3091275117,1648497688,1648498357,669,1922
3252973419,3083235668,1668618177,1668619154,977,1173
3707070213,3237807880,1642635127,1642635597,470,2142
3087700946,3242622170,1658885363,1658885381,18,350
3485995293,3193830008,1648924322,1648924843,521,1980
3100716894,3272912522,1651229541,1651230526,985,2462
3448135160,3636948225,1641426776,1641427081,305,1915
3746443510,3863485115,1669617124,1669617289,165,1509
3906772132,3615595663,1656127764,1656128217,453,2000
3182135067,3553096192,1658911130,1658911272,142,1384
3534182480,3438961567,1648340024,1648340405,381,1724
3729600228,3232285701,1661493185,1661494027,842,778
3724523438,3994651874,1651709426,1651709875,449,1847
3546290525,3601240692,1643404022,1643405019,997,2229
3621000186,3978667945,1657453612,1657454492,880,560
3098083694,3940067834,1650908222,1650909163,941,1783
3287600901,3298521381,1658482220,1658482340,120,1811
3712869836,3834954155,1648119024,1648119080,56,539
3828713812,3627503494,1664466576,1664467552,976,527
3846477373,3454753343,1655585568,1655585712,144,1821
3317241023,3586734200,1652190205,1652190445,240,860
3112074335,3462744716,1655311984,1655312346,362,2488
3129792187,3507363672,1645952451,1645953059,608,2370
3777929700,3136172164,1657793312,1657793858,546,1621
3587508502,3391324219,1657842473,1657842826,353,818
3924607271,3276618988,1645342573,1645343261,688,1609
3106437492,3149046961,1666230351,1666230492,141,1479
3315056551,3333223237,1655192097,1655192445,348,519
3113321914,3436916222,1660232400,1660232486,86,2272
3770771031,3421671936,1663987082,1663988041,959,2152
3826530948,3623433422,1664835151,1664835721,570,5
3643185661,3963334554,1661333706,1661333944,238,1053
3741978230,3627981146,1663358689,1663359024,335,505
3925504452,3358242037,1659590681,1659591053,372,323
3702932977,3011466658,1667095979,1667096497,518,56
3828722911,3257492375,1664687432,1664687723,291,34
3897433648,3575512492,1645955416,1645955726,310,1286
3001912243,3823133313,1656919375,1656919772,397,24
3779611783,3410737355,1664046322,1664046920,598,179
3006507589,3129677855,1650535122,1650535586,464,58
3386961417,3120949338,1649435265,1649436033,768,990
3969650128,3286555687,1660655966,1660656590,624,1584
3282166903,3261128374,1659518514,1659518650,136,903
3755580356,3731588710,1644726728,1644727259,531,490
3407150254,3797484306,1650746958,1650747937,979,1414
3887337385,3318848700,1669682440,1669683112,672,1967
3447743170,3985879853,1658013004,1658013588,584,899
3195504067,3933742178,1646947956,1646948077,121,387
3785725492,3056982737,1643942891,1643943214,323,35
3098667748,3886521075,1644430237,1644430367,130,856
3499739176,3025014828,1641744248,1641745102,854,1612
3620303845,3855734814,1667411075,1667411159,84,1835
3672751607,3412927884,1654422367,1654422828,461,2497
3426617058,3258577325,1660188103,1660188525,422,842
3496369924,3824083602,1645477646,1645477919,273,792
3472855930,3656000543,1669058120,1669058493,373,704
3313252249,3644100988,1646738649,1646739573,924,2053
3572224210,3498707377,1658794647,1658795128,481,1767
3474625275,3307462662,1652487048,1652487119,71,72
3407513744,3880139481,1658873626,1658874398,772,1131
3383754736,3031026970,1660018026,1660018312,286,1974
3732273041,3794548376,1656202770,1656203523,753,1394
3425856728,3498770747,1666000313,1666001094,781,1778
3473355243,3549105154,1661476193,1661476942,749,406
3667258476,3850546468,1649400861,1649401387,526,1482
3428763205,3908209550,1653644753,1653645346,593,1266
3979550486,3245354614,1660251745,1660251820,75,476
3965585706,3303815040,1664104918,1664105907,989,306
3284948113,3549431178,1649687612,1649688298,686,575
3871971681,3956394849,1659725979,1659726808,829,1646
3491562484,3173642675,1657934007,1657934519,512,1593
3748360490,3809041613,1667633419,1667634026,607,1432
3620303845,3782673553,1662279379,1662279721,342,710
3403024728,3100535469,1662538453,1662538802,349,1447
3114097031,3025333750,1666119788,1666120483,695,1448
3151436331,3508311968,1646977778,1646978371,593,564
3845334081,3456799118,1662464104,1662464578,474,1359
3330817237,3714575918,1663810266,1663810278,12,1985
3200827648,3934377856,1662408182,1662408928,746,191
3629999604,3902777743,1653270172,1653270675,503,536
3784646522,3652177742,1668664532,1668664549,17,986
3333336166,3129283198,1662868538,1662869435,897,2494
3690001044,3309767670,1644303226,1644303777,551,1443
3949713678,3001480546,1652473370,1652473727,357,814
3138958890,3069353793,1665714316,1665715120,804,711
3343177837,3749811473,1665734348,1665735003,655,1670
3254030842,3560756539,1666403988,1666404714,726,1638
3099424302,3599104606,1649556826,1649557569,743,475
3057201124,3698025795,1656791738,1656792522,784,1464
3600247537,3793966136,1643277351,1643277523,172,2490
3904517073,3104459009,1651686152,1651686829,677,44
3067641822,3904634428,1659954553,1659954620,67,2291
3522814184,3463669049,1665166936,1665167726,790,1878
3403323839,3110733657,1660704428,1660705221,793,294
3235672444,3714065380,1665168764,1665169665,901,2314
3766160943,3400211665,1658290137,1658290237,100,745
3316398180,3117322872,1669602886,1669602949,63,1658
3955750752,3209480732,1648664503,1648665080,577,1537
3315283904,3799117805,1657618652,1657619461,809,1459
3876427301,3231537700,1654106411,1654107044,633,1874
3893475632,3813854723,1642053968,1642054472,504,742
3843331100,3359896430,1641866575,1641867148,573,513
3839788123,3064574238,1662420734,1662421160,426,1743
3209464030,3890033502,1645164117,1645164477,360,65
3714322007,3930565588,1663328494,1663329476,982,145
3256566881,3958539607,1667636022,1667636905,883,1161
3316625530,3937728696,1661196040,1661196915,875,2130
3822869749,3456285013,1660907955,1660908240,285,422
3533936136,3337765684,1666066390,1666066891,501,2319
3084555769,3866268396,1668288857,1668289333,476,1287
3003728684,3816863310,1666829775,1666830697,922,2456
3129792187,3094562402,1665111245,1665111881,636,2408
3604376955,3258399411,1645286141,1645286443,302,2418
3192836427,3474242977,1664321953,1664322608,655,860
3391426421,3717137928,1649248059,1649248846,787,2068
3218903379,3286555567,1655006493,1655006885,392,987
3959795133,3612778107,1656079146,1656079844,698,1133
3179547560,3359189419,1642540030,1642540289,259,1042
3037741311,3778147762,1662260890,1662261088,198,1490
3022102664,3526747987,1645692076,1645692636,560,1918
3936980618,3358745496,1643820852,1643821191,339,2488
3128529900,3972052329,1648671084,1648671606,522,2224
3094596605,3315539995,1668035981,1668036835,854,2473
3395457102,3364586923,1667230385,1667230941,556,511
3321818923,3672874828,1660804499,1660804962,463,1015
3734754514,3090304189,1658314537,1658315302,765,665
3647549073,3686249771,1650272853,1650273065,212,345
3679533416,3499841500,1662116985,1662117103,118,2193
3450074680,3695411154,1662041329,1662042142,813,298
3510323514,3055044716,1648230635,1648231507,872,1952
3501520918,3389448374,1659906211,1659906778,567,2280
3355429456,3243840165,1641849036,1641849166,130,1594
3201968141,3359895223,1646452246,1646452281,35,545
3859864317,3796754155,1655229658,1655230118,460,110
3599354804,3062844769,1663570928,1663571358,430,482
3721751204,3035992910,1651155788,1651155842,54,2187
3736681866,3779998740,1654428048,1654428858,810,1692
3350017208,3974804920,1649117872,1649117929,57,1627
3114361358,3265611656,1645338421,1645338626,205,1383
3231517158,3725848338,1655964819,1655965320,501,103
3617958907,3124574350,1644851851,1644852716,865,854
3329751201,3135119423,1669621122,1669621518,396,1267
3382396122,3467215587,1652562454,1652562991,537,2297
3032779815,3224364206,1650322855,1650323462,607,554
3099546139,3922385616,1647214184,1647214675,491,573
3108230028,3123532931,1663469166,1663470022,856,875
3418988797,3570906118,1657358883,1657359538,655,1438
3829901682,3252790120,1649737096,1649737931,835,684
3102251970,3475846394,1661383304,1661384119,815,1189
3028803724,3686144397,1641406389,1641406990,601,1890
3373512814,3312661854,1653278149,1653278826,677,1868
3744147238,3542285714,1652674694,1652674791,97,2015
3835701186,3991340294,1650303330,1650303831,501,1406
3251948771,3254496907,1664828010,1664828552,542,1180
3531118058,3685233592,1644946984,1644947502,518,718
3421645346,3229979386,1653208121,1653208453,332,97
3537735224,3543872563,1644583820,1644584130,310,1883
3548128446,3396524452,1650187322,1650188296,974,1258
3562004989,3648924087,1651649217,1651649850,633,195
3750896410,3204333859,1647534684,1647534983,299,1375
3991542844,3825484587,1663716034,1663716823,789,1685
3928354041,3573583612,1655178519,1655178662,143,1175
3066362135,3956394849,1658277695,1658277971,276,1144
3187523092,3315218003,1654387100,1654388042,942,2179
3406042920,3996469603,1642639408,1642640189,781,280
3879564460,3097128642,1653233438,1653234360,922,1603
3872574112,3709681519,1653980513,1653980792,279,540
3057201124,3648975076,1648145187,1648145202,15,2399
3996587507,3804978604,1644519114,1644519535,421,2189
3050800748,3414901923,1665781915,1665782487,572,1960
3703825153,3913071406,1643376257,1643376859,602,741
3700737923,3776939860,1653888809,1653889349,540,2304
3205472801,3335242048,1658654000,1658654499,499,2299
3375585327,3997541339,1658393419,1658394274,855,582
3382974723,3646908383,1667619795,1667620079,284,2117
3870032753,3048896097,1658606543,1658607389,846,1429
3133153956,3609310097,1648627029,1648627345,316,1705
3414224162,3962031345,1662132269,1662132991,722,1662
3835864517,3892848585,1648101069,1648102051,982,747
3142160799,3952552328,1654334326,1654334807,481,2277
3967506765,3683993851,1647161240,1647161649,409,1024
3259430206,3322337553,1650545300,1650546288,988,1171
3272811357,3985486150,1668642985,1668643210,225,770
3986247608,3000986440,1654637665,1654638647,982,482
3619126886,3836331716,1641205006,1641205748,742,1549
3867603056,3081213963,1651033303,1651033937,634,159
3904881288,3204175740,1665363191,1665363922,731,1581
3841174974,3242622170,1646563580,1646564220,640,1580
3057090135,3184455755,1650543708,1650544265,557,1517
3369356299,3575457804,1653391173,1653391776,603,779
3751346675,3791462728,1648606912,1648607286,374,1822
3379285136,3104050460,1644046468,1644046592,124,134
3289061595,3389443435,1660182526,1660182574,48,1095
3194560289,3743687544,1666107074,1666107586,512,801
3364661787,3586489382,1661796572,1661796819,247,818
3074795505,3010649870,1648157690,1648158258,568,1302
3711847265,3703825153,1665864149,1665864639,490,1536
3300479839,3366354894,1648143444,1648143490,46,916
3084982671,3301620813,1643132515,1643132526,11,1330
3592487083,3987735792,1651796664,1651797022,358,2455
3339349217,3637129082,1664910936,1664911783,847,1979
3153446106,3620303845,1658910769,1658910952,183,776
3913994422,3307033178,1658989616,1658990456,840,1794
3145389444,3228319450,1658873341,1658874308,967,1077
3216243579,3429010148,1651796972,1651797083,111,1463
3521160717,3582471153,1645874547,1645875176,629,881
3420180743,3422728078,1643298018,1643298949,931,1677
3085136451,3040136606,1653762653,1653762901,248,1480
3015156809,3120425371,1642334363,1642334627,264,1626
3402578446,3258854274,1653750940,1653751251,311,1192
3260036272,3060718787,1665705786,1665705961,175,2118
3680100111,3548028995,1652216074,1652216932,858,644
3966525848,3926088173,1658516457,1658517333,876,1877
3468987116,3644272268,1645174711,1645175692,981,2206
3723784545,3119523311,1663868456,1663868949,493,2275
3143620816,3957803611,1641830144,1641830679,535,1255
3991859515,3766818968,1659365641,1659366032,391,1981
3195598526,3234861737,1652540315,1652540342,27,1532
3620748135,3105250340,1658268541,1658268650,109,1445
3391324219,3218869856,1665462367,1665462463,96,979
3261463305,3947229430,1669234103,1669234457,354,786
3822935707,3249554278,1662469083,1662469385,302,1969
3420180743,3274985034,1668424800,1668424858,58,1061
3675481622,3525377731,1653845022,1653845683,661,2185
3450502369,3282231108,1649903585,1649903998,413,1225
3336300808,3637663893,1641795661,1641796583,922,272
3903108572,3437215040,1655509229,1655509362,133,1236
3916290714,3870032753,1655476251,1655476350,99,1807
3198527442,3594038673,1659289514,1659289999,485,2045
3415584739,3518202698,1658183299,1658183561,262,2285
3664273227,3492638245,1657372682,1657372702,20,2121
3385806632,3649252503,1667393032,1667393659,627,1639
3878177076,3605278552,1647497105,1647497704,599,2030
3052681277,3577817989,1660297943,1660298286,343,1566
3271885744,3595535977,1643999796,1644000445,649,1439
3101363863,3290710394,1666418651,1666419194,543,905
3322287315,3733484132,1662524955,1662525300,345,255
3533403208,3927657297,1653646257,1653646884,627,884
3068242755,3641460659,1663649975,1663650598,623,1483
3041792624,3646536668,1663138785,1663139683,898,1745
3438084709,3704120553,1647038713,1647039683,970,1602
3330048607,3209480732,1661436107,1661436819,712,10
3565083183,3450689808,1659381535,1659382132,597,1162
3655923753,3257449240,1660564634,1660564792,158,1063
3175295329,3327873529,1648872722,1648873078,356,2451
3868336757,3691830908,1643640918,1643641006,88,1794
3370217481,3879157400,1664726188,1664726392,204,1854
3134872743,3474543664,1656214508,1656214655,147,963
3617545187,3117732598,1644298812,1644299547,735,1620
3376673600,3320039544,1667881182,1667881844,662,688
3873554599,3287399418,1669334185,1669335009,824,1891
3178529360,3953927472,1656148406,1656149262,856,1736
3689032543,3162844882,1663249527,1663249899,372,703
3134422689,3272217633,1665055117,1665055384,267,886
3936135558,3722551682,1656559880,1656560637,757,1091
3942325631,3563103144,1646564759,1646564955,196,727
3626216693,3228565452,1661714641,1661715404,763,1166
3814045699,3165470497,1659877243,1659878162,919,2107
3028705386,3344957789,1648825533,1648825847,314,211
3592906293,3537443088,1650827081,1650827136,55,1772
3640745969,3576425783,1649262269,1649262674,405,393
3569563212,3562105236,1648775172,1648775842,670,1581
3461628724,3646433612,1662707191,1662708104,913,1569
3846060378,3867554012,1649489946,1649490840,894,1287
3614399988,3888703674,1658868174,1658868198,24,1147
3646544919,3406215034,1668151515,1668152488,973,1266
3271436858,3417532235,1644021803,1644022185,382,714
3942140107,3037042091,1662646033,1662646089,56,1734
3258352640,3131629372,1651913865,1651914118,253,1845
3680694926,3254930364,1657359717,1657360233,516,668
3032834107,3690646467,1667680664,1667680901,237,1326
3796198742,3375782922,1654566449,1654566649,200,561
3480314503,3273289104,1662941942,1662942790,848,893
3233222399,3744788361,1652320349,1652320893,544,913
3074460772,3752817676,1649918038,1649918208,170,1249
3173230685,3795250558,1667678607,1667679323,716,203
3978987003,3816240060,1658501581,1658502237,656,2241
3492629459,3562105236,1668908669,1668908920,251,2182
3885162740,3363125076,1648571069,1648571792,723,1470
3204359619,3115367011,1651193094,1651194080,986,1855
3364661787,3722948390,1659528885,1659528974,89,1417
3944914500,3749188570,1648743571,1648743632,61,62
3142899759,3391206046,1667598139,1667598739,600,504
3442854678,3267479523,1642023319,1642023617,298,1458
3133030655,3441680015,1659452901,1659453085,184,1373
3073798415,3617795950,1655356271,1655357054,783,1029
3096541903,3974804920,1649490177,1649490711,534,1643
3038014403,3395782360,1647070402,1647070614,212,1347
3910846571,3733649713,1648350934,1648351279,345,923
3184680353,3896777982,1643263651,1643263806,155,1565
3805921576,3762690279,1646112444,1646112640,196,1434
3813287023,3603965318,1646767666,1646768520,854,499
3341248102,3496318579,1648334259,1648334675,416,200
3029053911,3793518113,1657441037,1657441121,84,958
3130181848,3298993308,1644262817,1644262850,33,1806
3232304638,3469887287,1649157351,1649158174,823,1296
3593437920,3273752842,1642651160,1642651878,718,1952
3762533949,3419068106,1656483916,1656483991,75,2334
3370350588,3086324092,1641032392,1641033088,696,12
3132611388,3206061644,1662121899,1662122898,999,1460
3054979282,3969563324,1667552438,1667553185,747,719
3445469609,3207309302,1656443341,1656444213,872,1176
3827867076,3940948395,1654031431,1654032090,659,963
3058927575,3640765121,1656125693,1656126436,743,2140
3388628484,3705306826,1644057578,1644058485,907,939
3107501731,3077143208,1662361783,1662362217,434,1065
3413111275,3707867178,1661615635,1661616231,596,1370
3531642816,3600015858,1666411006,1666411757,751,726
3670387440,3266751679,1661544195,1661544562,367,75
3369913868,3329154834,1663206076,1663207041,965,1172
3869991101,3016992122,1651961747,1651961924,177,988
3930142533,3311329069,1667816897,1667817801,904,909
3133788020,3754292816,1661265194,1661265467,273,2129
3104870555,3759165741,1658767605,1658767810,205,918
3258050916,3052376951,1653338877,1653338889,12,1556
3325842490,3767409219,1647234278,1647234838,560,2396
3195598526,3611685224,1660803476,1660804356,880,1484
3506090868,3559176364,1658958686,1658959622,936,1879
3946614568,3059447105,1657992337,1657992465,128,719
3467233007,3868440818,1664963291,1664963591,300,2173
3124927662,3800861252,1659556281,1659556300,19,879
3822816987,3113423573,1641629920,1641630336,416,697
3339962549,3737400101,1649039613,1649040510,897,2362
3384222838,3465238210,1641169300,1641169932,632,1206
3639618179,3142777936,1644514251,1644514730,479,1772
3118358674,3481072834,1657739833,1657740730,897,1863
3695419353,3616901816,1645663747,1645663862,115,1677
3194379247,3149046961,1665809662,1665810613,951,2490
3639352799,3038849431,1664077693,1664078650,957,1595
3148203422,3496921526,1667301938,1667301978,40,2449
3414193650,3419465829,1656946923,1656947715,792,1349
3785361012,3877902487,1645975618,1645976032,414,43
3264753140,3111205819,1657589156,1657589787,631,1391
3537735224,3990312725,1651687205,1651687407,202,1729
3404394014,3837065973,1653933620,1653934282,662,369
3819584735,3806737055,1665770102,1665770441,339,1562
3097145374,3818453534,1659498142,1659498705,563,996
3351803423,3713116694,1649244296,1649244320,24,2415
3679939578,3016616906,1641833370,1641834110,740,1170
3676893681,3566257032,1647753538,1647754412,874,1052
3562547940,3117230173,1667618959,1667619805,846,534
3483354291,3699293407,1662007145,1662007970,825,1844
3733072964,3584910336,1668065636,1668066244,608,504
3097609387,3320488617,1648104983,1648105650,667,2479
3258352640,3039893721,1650566023,1650566691,668,827
3240452269,3588936901,1655916322,1655916500,178,1731
3731386559,3443190053,1646674526,1646675043,517,2447
3287508774,3110395191,1654250313,1654250350,37,168
3724806243,3709263457,1666124503,1666124683,180,395
3586025172,3445666899,1665720601,1665721540,939,369
3482268698,3114733025,1643898828,1643899523,695,79
3211064928,3404432145,1658074141,1658074658,517,1349
3728419832,3066714195,1643736279,1643736390,111,2009
3308353096,3320187187,1641138171,1641138634,463,2250
3487778655,3471288672,1665486870,1665487416,546,96
3663155034,3000165786,1650303465,1650303941,476,1901
3083791573,3220690215,1658983440,1658983446,6,177
3804145408,3180973124,1666855574,1666856113,539,2224
3626552836,3095728444,1664203914,1664203949,35,2035
3367977353,3090304189,1667958361,1667959070,709,769
3259625938,3800392649,1647159602,1647160022,420,1825
3055545326,3911891369,1644868922,1644869893,971,1578
3042702763,3880295026,1651471783,1651472416,633,2495
3986003303,3359901981,1649696319,1649696928,609,823
3342820244,3953002004,1659347360,1659348118,758,625
3053134032,3922766043,1668927640,1668927787,147,891
3746971515,3784040148,1658370033,1658370072,39,20
3732796331,3890054358,1661680086,1661681042,956,1535
3323217825,3832334966,1668664949,1668665761,812,1623
3797270025,3391898268,1660823888,1660824307,419,919
3592974208,3029943531,1654691455,1654692301,846,1059
3386809097,3654861844,1652084499,1652084599,100,2286
3293611774,3924799278,1656924579,1656924794,215,2408
3573252143,3723780339,1656092396,1656093043,647,730
3854219185,3639059199,1657157336,1657158050,714,338
3295905536,3906244265,1650076686,1650077368,682,572
3181047536,3194721041,1664307980,1664308809,829,669
3216912897,3069675415,1646778801,1646778925,124,1220
3156483651,3248167631,1641223891,1641224757,866,1625
3037048394,3744829701,1644160061,1644160833,772,1086
3386846556,3600573063,1665802300,1665802752,452,2131
3759668586,3312805786,1641653933,1641654752,819,1328
3669789756,3527291464,1663903313,1663904046,733,1769
3551111997,3657044188,1652600138,1652600450,312,1543
3914006102,3472052544,1651973799,1651974311,512,1007
3899247202,3445031830,1644964223,1644965128,905,1470
3758849561,3512631937,1669647138,1669647685,547,505
3072080605,3567520646,1645701284,1645701726,442,1681
3156331863,3211064928,1657585488,1657586349,861,432
3695360424,3618380884,1669629616,1669629632,16,61
3055644463,3820302319,1646673185,1646674139,954,807
3435915872,3966056341,1649195595,1649196316,721,975
3744196402,3119698939,1649404980,1649405325,345,787
3675418278,3249512921,1659860849,1659860940,91,1869
3749980168,3132592220,1648866977,1648867668,691,320
3790996735,3868397809,1660513238,1660513998,760,2376
3091062283,3199322269,1660295871,1660296516,645,2207
3970753504,3789380087,1666965706,1666965966,260,15
3451263201,3281907019,1663344797,1663345258,461,1057
3114097031,3798527829,1648387799,1648388763,964,2042
3405319002,3214817416,1651029685,1651029880,195,602
3310935085,3469359731,1649924177,1649924492,315,1597
3211641180,3816863310,1650341172,1650342156,984,1487
3620748135,3174705393,1659679714,1659680090,376,79
3649774117,3773996198,1644631318,1644631905,587,1367
3167557703,3786480807,1658644440,1658644566,126,192
3812481438,3054927562,1667975303,1667976150,847,1493
3822143503,3170058626,1668629667,1668629745,78,315
3500948971,3787298788,1641373472,1641373807,335,757
3638803969,3690665509,1641281698,1641282239,541,1998
3725042810,3046991819,1652931426,1652932287,861,702
3146072606,3154139372,1652480488,1652480709,221,1414
3184720975,3517556603,1646261066,1646261626,560,2080
3710708040,3252535116,1656195296,1656195819,523,1725
3181236848,3788498920,1653301727,1653302211,484,1418
3385430413,3977139394,1644126856,1644127192,336,1333
3729820423,3767581542,1657388432,1657388973,541,672
3579728276,3579921083,1651931074,1651931680,606,1775
3569051470,3637663893,1654309213,1654309623,410,178
3623736661,3725465166,1662224573,1662224827,254,1501
3348234563,3858876644,1652819785,1652820491,706,685
3823288349,3647263296,1642746214,1642746900,686,1092
3972424804,3449395269,1658802769,1658803208,439,2084
3363944559,3926467866,1667746349,1667746553,204,1001
3628956600,3122624322,1656483054,1656483458,404,2134
3914613880,3479322514,1658947613,1658947639,26,1321
3973050834,3196407951,1665112767,1665113439,672,1680
3642339062,3207013037,1650934393,1650934668,275,2437
3290481654,3654344198,1643115243,1643115517,274,2202
3971524060,3223290764,1654322857,1654323118,261,489
3031299470,3653031568,1644477033,1644477478,445,1538
3681001652,3690657404,1659825641,1659825907,266,422
3945266221,3173788210,1649191428,1649191581,153,2481
3254496907,3997397652,1643593992,1643594290,298,2081
3686424169,3666338218,1667463982,1667464475,493,2228
3070520574,3147298514,1641908153,1641908771,618,912
3167034499,3137092101,1652612704,1652613404,700,1022
3622950232,3949133704,1662902465,1662902672,207,22
3381060534,3818453534,1667142011,1667142366,355,2400
3752347758,3072734804,1660304994,1660305347,353,1417
3197201691,3380303288,1661409979,1661410082,103,2485
3657587705,3648593799,1657126386,1657126496,110,1781
3335915365,3555105048,1650797418,1650797793,375,914
3057085790,3845363108,1655433225,1655433445,220,2457
3342199267,3342054027,1660663042,1660663889,847,1875
3287508774,3130462571,1649063531,1649063696,165,1001
3552494506,3455209070,1669745158,1669746058,900,18
3150067482,3879257961,1661198459,1661199363,904,1186
3852344377,3699427202,1651144470,1651145383,913,2218
3815537815,3981348782,1664398415,1664398746,331,1157
3370701718,3249705811,1658224025,1658224225,200,2112
3789999187,3430638959,1664947392,1664947828,436,2069
3837065973,3515480973,1645454070,1645454228,158,1014
3266620552,3606270024,1660923668,1660924594,926,181
3643276679,3474572698,1662630772,1662631007,235,2062
3708754161,3610930903,1658954059,1658954277,218,1829
3778381574,3735167946,1667950742,1667951266,524,1331
3345413125,3086871623,1642733942,1642734809,867,2491
3041809783,3036846628,1668761505,1668761527,22,790
3928685907,3188384391,1659671050,1659671322,272,2431
3599354804,3408944120,1663523849,1663524753,904,54
3956547336,3450535254,1663572219,1663573013,794,861
3633856416,3418998927,1656261968,1656262197,229,1246
3416521015,3379937268,1646228713,1646229711,998,1060
3615359458,3620817271,1649916829,1649917026,197,1222
3342215329,3687552718,1654486604,1654486802,198,169
3501732936,3771758356,1656751867,1656751898,31,767
3845818528,3918891410,1669259497,1669260461,964,495
3212038287,3194618871,1661399438,1661400052,614,2086
3633830454,3360040841,1653739851,1653740809,958,1708
3929887239,3017559077,1646309037,1646309277,240,1126
3732796331,3428062841,1654080622,1654080877,255,1129
3954297181,3241500636,1667240771,1667241539,768,589
3372471333,3108805085,1645672293,1645672353,60,1685
3070237620,3582138072,1657240733,1657241293,560,1114
3423782681,3856080546,1652188143,1652188372,229,1818
3094596605,3003195362,1647795107,1647796013,906,2088
3841174974,3004890840,1664984266,1664984576,310,1313
3745712275,3318717113,1652605171,1652605354,183,1167
3361694981,3358194777,1657397231,1657397505,274,1216
3254227672,3118443010,1651251366,1651252321,955,2326
3506384176,3046043182,1652909044,1652909505,461,2069
3879325408,3194125043,1652413238,1652413498,260,606
3898403925,3581083030,1665546558,1665547003,445,1818
3922972838,3858225831,1656974131,1656974249,118,1758
3025215569,3289108426,1668554673,1668555225,552,319
3911316683,3755228064,1665187798,1665188508,710,1157
3390976131,3730428171,1651516061,1651516501,440,950
3052789625,3907299052,1644850916,1644851140,224,395
3563103144,3029956642,1650274140,1650274203,63,2079
3873002836,3329154834,1656367074,1656367828,754,2031
3619045997,3732472752,1642841374,1642842250,876,1291
3298748343,3538410031,1644188297,1644188560,263,2124
3307305290,3651098556,1667312504,1667313368,864,2485
3074832079,3677674125,1663264854,1663264944,90,27
3711576021,3851778010,1644134266,1644134690,424,1942
3084430345,3361016803,1665796941,1665797704,763,2360
3649465172,3732795074,1668736569,1668737024,455,1687
3197352308,3344891111,1666146962,1666147032,70,510
3430916751,3600879855,1658860795,1658861330,535,1738
3867158050,3442447509,1656100966,1656100984,18,1874
3741344192,3108998670,1643446208,1643446713,505,2293
3832243899,3690633750,1656836587,1656836762,175,1457
3991859515,3631587282,1661577447,1661578022,575,1921
3490430582,3856386170,1650093065,1650093720,655,160
3462825977,3379935974,1648938177,1648938716,539,1405
3252535116,3219292166,1657202364,1657203231,867,711
3535575355,3049567508,1654801342,1654801636,294,771
3236975783,3375253810,1657800041,1657800858,817,1988
3777022057,3933251803,1645788890,1645789562,672,741
3100239217,3856658213,1655149392,1655150392,1000,1472
3884802599,3687938178,1667114065,1667114928,863,2323
3696512728,3401582775,1650116483,1650116902,419,1605
3132258390,3322656350,1652765243,1652765857,614,220
3600015858,3099934862,1642531441,1642531609,168,223
3309242036,3706178319,1654632603,1654633231,628,1725
3119477442,3190417421,1652604770,1652605348,578,2482
3813632607,3315321131,1662884430,1662884616,186,1137
3347832946,3911290843,1662733625,1662733876,251,1939
3992345499,3188680599,1656485573,1656486061,488,954
3086444841,3254496907,1652732495,1652732875,380,1057
3415041326,3416230781,1642521536,1642522524,988,2131
3211945942,3509619062,1664369721,1664370189,468,1356
3032018734,3206061644,1665815600,1665816163,563,2372
3642691052,3332206707,1642875403,1642876080,677,1497
3352595765,3065216937,1662571728,1662572107,379,2369
3583591867,3670622586,1661742369,1661742448,79,496
3135211724,3164410972,1643749769,1643750671,902,1087
3187291408,3513169935,1654872400,1654873165,765,645
3909330778,3815102601,1656841017,1656841133,116,2020
3266751679,3876888791,1658500012,1658500285,273,1686
3608450611,3284443787,1650088813,1650089480,667,2469
3634999231,3984370468,1666248615,1666248882,267,2001
3894247542,3794524447,1668573653,1668574209,556,567
3290481654,3609562862,1641574692,1641574735,43,1324
3904007370,3192005711,1663901661,1663901803,142,2216
3678778706,3205864966,1658957847,1658958539,692,2158
3260802289,3169394495,1641617308,1641617786,478,767
3662876111,3584037261,1650566319,1650566514,195,2154
3087394554,3864239870,1641193553,1641193798,245,1774
3205162065,3753483202,1649788361,1649789183,822,2111
3098667748,3767453896,1650141065,1650141131,66,2222
3956394849,3302344507,1652371977,1652372924,947,599
3131683456,3510166785,1665032273,1665032845,572,1327
3793901427,3534545428,1667792686,1667793200,514,533
3005926074,3838851134,1645022030,1645023000,970,1060
3268670465,3730920499,1663470578,1663470729,151,2350
3368860003,3586128295,1657781276,1657782214,938,157
3034014975,3304499678,1645204641,1645204734,93,32
3357966828,3934914335,1661672991,1661673133,142,2097
3280818938,3579921083,1650678530,1650679420,890,2109
3495919793,3696149430,1649057452,1649057990,538,2202
3813921952,3327681313,1651801651,1651802577,926,1345
3080287966,3671971306,1647179117,1647179354,237,78
3561881366,3931679805,1662453963,1662454956,993,1165
3596661503,3670387440,1643789095,1643789261,166,950
3976730264,3234656999,1652573555,1652574253,698,1923
3088571651,3930909418,1657850039,1657850757,718,787
3976346769,3629942160,1667242714,1667243280,566,1350
3884704204,3458252541,1659098854,1659099094,240,2134
3956027073,3739406554,1655159200,1655159377,177,1581
3356765270,3996319604,1642320043,1642320223,180,437
3766160943,3457542537,1654637899,1654638352,453,833
3811648493,3937728696,1655668917,1655669711,794,364
3427127427,3645625556,1659142173,1659142712,539,1438
3666782310,3012152244,1668452921,1668453247,326,989
3029374380,3578974875,1664734184,1664734552,368,954
3772430644,3429445014,1653351708,1653352371,663,1626
3479738009,3728631423,1660739485,1660740311,826,2356
3539797487,3301471485,1660014792,1660015199,407,2334
3957053810,3689231617,1643252168,1643252479,311,1628
3028780744,3359896430,1661109579,1661110070,491,462
3868936645,3793298032,1651805396,1651806051,655,1301
3114277786,3997167780,1658272927,1658273840,913,935
3447527130,3862829462,1667764074,1667764970,896,129
3722380765,3908895548,1668839217,1668839688,471,1822
3744737373,3600573063,1649971858,1649971880,22,1485
3062704523,3049969877,1669008233,1669008262,29,1481
3420676198,3609880975,1653426504,1653426510,6,1256
3061619114,3146645864,1665542029,1665542555,526,174
3579514433,3714538351,1653539131,1653539267,136,1435
3209748014,3493447321,1645098620,1645098916,296,995
3866532806,3393911160,1643076832,1643077441,609,1297
3689544534,3271436858,1666788402,1666789263,861,1923
3193991721,3599604382,1662639598,1662639650,52,1078
3562814356,3414901923,1669107393,1669107831,438,1500
3981379416,3341042744,1644272473,1644272639,166,824
3722972444,3271182009,1668087422,1668088049,627,1451
3151923668,3352751731,1662247260,1662248154,894,884
3131820605,3555538922,1661916513,1661916923,410,2316
3787465946,3252843201,1641972173,1641972453,280,1357
3233222399,3196794099,1644652065,1644652836,771,716
3161063958,3596007538,1662473904,1662474841,937,1732
3120425371,3608079336,1643364061,1643364338,277,284
3774823325,3907700603,1662243064,1662243131,67,468
3713520914,3089126812,1667693039,1667694030,991,180
3028535162,3833110040,1651812331,1651812857,526,1133
3916244157,3398814666,1669377830,1669378503,673,135
3830388213,3005480994,1661976242,1661976835,593,1074
3649252503,3820225206,1641949451,1641950168,717,1944
3315569726,3270240132,1658442460,1658442741,281,776
3706560099,3073474496,1652385615,1652385889,274,1340
3822146001,3311113773,1658940062,1658940317,255,1295
3534201448,3269653223,1656348863,1656348901,38,469
3773434774,3863448086,1669611014,1669611421,407,1663
3438961567,3040897601,1650216992,1650217199,207,1070
3331904172,3862371205,1650151921,1650152395,474,2422
3224792502,3001889220,1665785463,1665785796,333,2171
3543256939,3788769219,1665114940,1665115471,531,1071
3057725565,3597251704,1660175576,1660176093,517,1207
3145669202,3565392717,1660183831,1660183879,48,1746
3082708890,3296957627,1646555168,1646555250,82,272
3565056457,3534545428,1642092230,1642092829,599,844
3749593178,3534133715,1641469389,1641469784,395,2449
3080829502,3620395885,1644734151,1644735088,937,1037
3839642166,3104164320,1648729987,1648730712,725,1291
3760042128,3631732813,1644905640,1644905703,63,2064
3361870766,3557559741,1648853187,1648853484,297,2430
3707578213,3536832504,1653699869,1653700055,186,1923
3887002610,3624171160,1647258515,1647258776,261,949
3241444105,3727618645,1650088314,1650088861,547,2060
3925496970,3466282430,1641519006,1641519366,360,1838
3807440065,3972687424,1647040708,1647041223,515,691
3759230876,3811337280,1665523303,1665523819,516,1565
3624103484,3952663430,1653338696,1653339062,366,1504
3181912863,3908796611,1652127306,1652127981,675,823
3042461816,3953258545,1651681328,1651681897,569,1353
3957577990,3337601088,1652191658,1652192363,705,677
3286065477,3936980618,1657920386,1657920644,258,1129
3556620301,3443435826,1653748179,1653748610,431,2049
3506045470,3796990042,1648389027,1648389565,538,1214
3906308749,3892206642,1645050380,1645051180,800,625
3094361527,3642498039,1655155357,1655156209,852,2244
3636132038,3311529434,1657192804,1657192835,31,1091
3778402105,3365340586,1662848792,1662849535,743,1194
3816935536,3882254802,1649537273,1649537413,140,1154
3904183865,3454276568,1669549236,1669549738,502,410
3132376039,3284948113,1642659261,1642659833,572,1126
3185360566,3280648157,1650711712,1650712286,574,1113
3701726268,3209288149,1648713313,1648713508,195,1523
3885719823,3597661669,1665323542,1665324341,799,440
3532926054,3032834107,1660931442,1660932185,743,1612
3481293963,3641666820,1645208531,1645208806,275,1218
3833594316,3798833025,1665823939,1665824872,933,768
3306838717,3816561204,1668115533,1668116312,779,2153
3617545187,3293201387,1658771187,1658771256,69,1105
3964987979,3114097031,1645055773,1645056096,323,2160
3252664436,3917956140,1661844709,1661845497,788,640
3388490960,3008760173,1645271189,1645271291,102,2285
3084138267,3508858140,1659880483,1659880714,231,1490
3920875021,3992924141,1667449484,1667449732,248,1013
3727020814,3489915638,1657857022,1657857105,83,1693
3453143238,3133767042,1658911312,1658912226,914,288
3091530738,3367915131,1651731964,1651732733,769,243
3242785599,3540735539,1663129592,1663129996,404,1084
3683460040,3353956873,1648740204,1648740948,744,1293
3946409673,3023530031,1650475699,1650475724,25,482
3466473464,3866921322,1656877365,1656877709,344,509
3595144575,3205359825,1661753826,1661753967,141,1101
3362249024,3224491185,1661148615,1661149234,619,2235
3215443177,3332592315,1644398548,1644399191,643,1800
3058064037,3623936873,1650685326,1650685508,182,47
3793503160,3802790977,1667430562,1667431138,576,1686
3623936873,3562875112,1650799175,1650799580,405,816
3894115655,3168983812,1661175635,1661176152,517,135
3730266625,3755085868,1642325715,1642326343,628,1375
3012032774,3689032543,1652464066,1652464990,924,1747
3096471933,3046351455,1669592020,1669592056,36,779
3877049401,3432321849,1662910620,1662911288,668,2007
3069313994,3771811920,1653614359,1653614891,532,1230
3672276184,3910760009,1660587152,1660587552,400,183
3013433465,3426491499,1660631548,1660632056,508,2263
3849910709,3576317139,1667860974,1667861892,918,648
3735098036,3318345517,1660547855,1660548609,754,1809
3795342940,3655250241,1666289244,1666289379,135,2240
3162836777,3574740304,1644557467,1644558045,578,1997
3047001138,3893872926,1650186726,1650186735,9,267
3645585393,3603786519,1665969452,1665970283,831,325
3417798594,3293865251,1664686379,1664686451,72,1355
3170844702,3328146266,1648804239,1648804336,97,1171
3595535977,3550329232,1642744181,1642744833,652,1935
3561572123,3302455172,1656850930,1656851284,354,444
3631732813,3074928223,1655849469,1655849701,232,869
3547334414,3869794122,1660334620,1660334827,207,974
3149668198,3759510872,1659324626,1659324857,231,1078
3556000533,3224309877,1645544277,1645544356,79,1867
3065350513,3598645736,1663049256,1663049567,311,2119
3885696227,3898403925,1645840008,1645840078,70,2073
3084334078,3948310967,1651679444,1651679790,346,823
3643637605,3686704798,1650716938,1650717489,551,1076
3974326867,3936821313,1656306953,1656307063,110,694
3312930717,3723110330,1642653322,1642654004,682,841
3123999917,3093364150,1653368612,1653369437,825,1004
3790157838,3107865208,1659019262,1659019504,242,886
3623191811,3628927796,1650126252,1650126635,383,1448
3010373186,3150067482,1664556734,1664556972,238,1563
3596567072,3637412110,1658156789,1658157690,901,587
3389497658,3172310061,1667694184,1667694494,310,1485
3335915365,3894175918,1665353914,1665354884,970,638
3589972665,3131820605,1657682696,1657683648,952,787
3621938271,3900571767,1645122479,1645122845,366,39
3018838603,3438553592,1666297555,1666297649,94,428
3744293001,3022453107,1641213613,1641214390,777,1082
3217384934,3360051725,1649697899,1649698788,889,588
3685715658,3668677061,1657237993,1657238395,402,1017
3878852082,3018262582,1664078584,1664079169,585,210
3085676024,3608079336,1649236260,1649236864,604,1714
3348234563,3814641263,1658507546,1658508510,964,438
3090139002,3042702763,1656272122,1656272524,402,1931
3339611423,3653429754,1648594638,1648595469,831,2465
3660754603,3249261763,1665647135,1665647205,70,1088
3625772064,3642377610,1641221305,1641221649,344,2
3403786938,3578616050,1650754320,1650755294,974,2328
3414852594,3311329069,1648945503,1648945605,102,1707
3013814400,3237245622,1662006077,1662006383,306,1437
3485298583,3481030779,1649880639,1649881616,977,1056
3867126446,3395609056,1651579587,1651579923,336,1713
3124723265,3080703553,1651167798,1651168314,516,26
3492134379,3479322514,1667762318,1667763123,805,2248
3089138601,3311921613,1668304678,1668304697,19,950
3855762650,3271039091,1646196902,1646197179,277,2496
3932613929,3824083602,1649515694,1649516467,773,459
3598645736,3164467795,1648955138,1648955350,212,1562
3541413511,3633544934,1647246504,1647247496,992,1435
3570872297,3199411589,1642904094,1642904982,888,317
3098161767,3563972468,1656087431,1656087504,73,463
3733649713,3740807524,1652742454,1652743134,680,1676
3529946433,3198195956,1654936957,1654937859,902,2276
3604852600,3011981503,1645370028,1645370849,821,2187
3970286228,3121336226,1644270458,1644271276,818,582
3890448806,3778894897,1648741154,1648741348,194,2306
3790829012,3941586762,1653041533,1653041941,408,1613
3538410031,3762816561,1655955836,1655955840,4,586
3513180024,3158291556,1646657176,1646657281,105,592
3885162740,3802694367,1646251308,1646251598,290,1902
3672274616,3854859043,1642428841,1642428849,8,1510
3439303987,3480905975,1661223268,1661224026,758,1115
3804145408,3971524060,1643828791,1643829116,325,1175
3779236518,3206149175,1653714877,1653715449,572,417
3375125376,3894616795,1645345351,1645346127,776,898
3846493363,3095151362,1659510332,1659511129,797,470
3310970237,3936821313,1656105367,1656106362,995,471
3559267449,3087333030,1669645074,1669645627,553,197
3606954305,3565700391,1647712511,1647712644,133,2401
3472052544,3581207584,1667038177,1667038859,682,674
3641752896,3021338974,1641827477,1641827532,55,1975
3539402223,3647597870,1661402403,1661402661,258,393
3999228111,3124384203,1650003229,1650003908,679,1987
3010161936,3029053911,1663230966,1663231452,486,1952
3344455273,3939722468,1655699497,1655700235,738,1213
3520943619,3284948113,1656780445,1656780620,175,1731
3358571434,3377179024,1664965445,1664965641,196,2108
3015253917,3582859001,1654847845,1654848814,969,2314
3312656348,3021621189,1664093787,1664093787,0,339
3865200739,3640613606,1669506437,1669506799,362,461
3832438123,3781580109,1641435768,1641436567,799,1341
3432364009,3762571799,1658915299,1658915789,490,487
3740438273,3984977278,1664345548,1664345981,433,1789
3004890840,3634018428,1644613782,1644614231,449,96
3167058279,3835069955,1663866815,1663867556,741,1479
3717926703,3477363517,1654006413,1654007401,988,628
3188588023,3431175768,1666986432,1666986436,4,1055
3882619512,3780654306,1661197210,1661197579,369,2177
3585097526,3122293667,1666293502,1666294166,664,691
3981515277,3985326073,1648851822,1648852427,605,105
3014517714,3969355995,1647241980,1647242603,623,114
3355429456,3741978230,1656259129,1656259614,485,2287
3039176873,3910581173,1650613049,1650613440,391,908
3459188746,3558232376,1649794635,1649794641,6,2160
3557409187,3043611684,1652334683,1652335282,599,528
3260246509,3261128374,1666286111,1666286266,155,2334
3307305290,3288261603,1647924372,1647925178,806,2392
3018760022,3099102864,1669637940,1669638192,252,855
3041155430,3629090721,1655849132,1655850122,990,453
3198195956,3531357820,1648800137,1648800322,185,678
3098820434,3981932099,1648790476,1648790543,67,1679
3565056675,3014438377,1646793971,1646794922,951,1213
3351277781,3409352040,1659851382,1659852195,813,94
3984414020,3103228367,1656034794,1656034896,102,1105
3199892178,3078216798,1662276972,1662277188,216,2434
3785638958,3939469152,1645130445,1645131259,814,362
3841318125,3696448766,1667074357,1667075112,755,2255
3991390314,3564839908,1663260094,1663260933,839,62
3506090868,3079029428,1648077498,1648077515,17,478
3203319376,3696211720,1666312055,1666312871,816,1088
3969744786,3120762596,1653925600,1653926283,683,1877
3851540721,3077590635,1659354259,1659354930,671,1411
3445558523,3376287193,1659988403,1659988958,555,2016
3128248749,3283037458,1660493530,1660493997,467,1445
3457451540,3901468403,1664023549,1664023568,19,2358
3210078490,3807473345,1661104103,1661104210,107,93
3470128186,3391622565,1669051574,1669052141,567,1406
3822126164,3119036139,1645070497,1645071485,988,2160
3117141664,3241341174,1662783135,1662783680,545,801
3082828436,3761201412,1652414950,1652415635,685,2355
3881956491,3252843201,1644306517,1644306591,74,2157
3048405710,3370217481,1664140665,1664141499,834,321
3713404433,3055402951,1663223865,1663224186,321,551
3463032893,3768087701,1643096206,1643096385,179,1641
3906024837,3073924620,1665768396,1665769053,657,1565
3129500635,3550702679,1655050468,1655050688,220,477
3478404891,3123458167,1669580782,1669581644,862,2493
3383348505,3712195438,1666686971,1666687783,812,408
3195813968,3796159106,1662387170,1662387604,434,1499
3785361012,3952185527,1652509144,1652509579,435,422
3765962960,3555272427,1651122038,1651122885,847,1783
3744726408,3920482918,1668723428,1668723508,80,1124
3382110972,3887586447,1659873731,1659874448,717,1783
3895277580,3469812263,1655130599,1655131222,623,93
3761218329,3500264647,1654519062,1654519117,55,216
3569686431,3287784262,1644848711,1644849668,957,238
3178981589,3168983812,1663323436,1663323720,284,1348
3059858458,3985491144,1648673950,1648674461,511,1709
3231701470,3646596750,1661607954,1661608529,575,1199
3724977571,3748360490,1642798942,1642799843,901,158
3848995096,3303698845,1647053654,1647054223,569,2489
3251382188,3184669033,1657291438,1657292287,849,2307
3088553332,3619714539,1665947537,1665947644,107,1877
3995053047,3173034893,1663757183,1663757658,475,2019
3450628929,3312656348,1649360686,1649360882,196,473
3194603908,3394695318,1652421726,1652421840,114,628
3053005521,3600955732,1659194527,1659194702,175,1882
3581302872,3961903747,1664999744,1664999790,46,665
3255485773,3200827648,1666042816,1666043417,601,1848
3948002281,3261837009,1656044790,1656044800,10,805
3472706088,3147089920,1661234532,1661234998,466,1954
3232835207,3672059189,1660895918,1660896784,866,1230
3735943539,3825849470,1668476618,1668477518,900,382
3639819433,3549768940,1652359169,1652359431,262,600
3980207883,3579486534,1656894409,1656894415,6,1029
3047922240,3020452542,1641637463,1641637963,500,1244
3390919111,3968076690,1644513174,1644513332,158,1708
3593553797,3287082352,1647885330,1647885464,134,693
3957803611,3340331761,1659489387,1659489913,526,780
3112357538,3774264905,1652631186,1652632165,979,1627
3283155844,3799249782,1646962566,1646963297,731,264
3801358344,3561254848,1668663163,1668664155,992,2472
3699730203,3181912863,1665814193,1665814479,286,2411
3651055879,3750896410,1666681654,1666682018,364,170
3573826666,3107865208,1646470421,1646471214,793,620
3430375744,3471221302,1650914070,1650914246,176,172
3856600876,3152795421,1647189509,1647190110,601,1291
3556647439,3096695477,1662556566,1662557106,540,762
3598572594,3231988469,1654363179,1654363352,173,674
3043604048,3294703062,1668623380,1668623496,116,87
3832243899,3821180393,1654931732,1654932033,301,713
3303815040,3028643875,1656414487,1656415011,524,1248
3107713394,3196975901,1659298009,1659298462,453,534
3844006658,3674059710,1652755394,1652755859,465,952
3029263333,3741978263,1661970229,1661970333,104,547
3499026312,3059322626,1661145228,1661146171,943,1798
3817667121,3260783577,1654865889,1654866771,882,1076
3311921613,3369356299,1654518704,1654519236,532,1886
3734576015,3267107046,1643103028,1643103181,153,638
3129283198,3474723005,1653421754,1653422112,358,2221
3868397809,3420266147,1669464888,1669464930,42,1822
3542285714,3752652141,1668914883,1668914901,18,1732
3478959759,3157600969,1663995686,1663996114,428,691
3368654717,3471651838,1664857790,1664858191,401,2257
3404330776,3767453896,1666290739,1666291227,488,1780
3562004989,3138001926,1652248068,1652248798,730,2065
3435253366,3304589206,1642129977,1642130853,876,2225
3541372095,3878274883,1644211062,1644211991,929,195
3875750764,3837481005,1654479452,1654480382,930,884
3752621490,3841459327,1644983968,1644984376,408,366
3506952427,3239158180,1646885591,1646885605,14,2409
3486541605,3755085868,1655059637,1655060388,751,2319
3069313994,3555731884,1669218624,1669219160,536,1417
3427127427,3378168172,1643869821,1643870693,872,931
3413948595,3866681013,1646895561,1646895831,270,1673
3683326795,3780039563,1662062621,1662063394,773,247
3301611102,3870574001,1662358877,1662359483,606,941
3656000543,3882438892,1668429048,1668430031,983,446
3922675517,3508108339,1660706543,1660707084,541,2291
3404945581,3518322544,1641991595,1641992463,868,430
3512662328,3732585972,1658774914,1658775673,759,1563
3118554894,3321202962,1657116898,1657117438,540,2071
3383751042,3091275117,1644842748,1644843436,688,2347
3215819425,3443297756,1665145838,1665146475,637,676
3388814364,3996587507,1665991199,1665991892,693,451
3840533238,3081028310,1657277356,1657277511,155,1924
3012602506,3311921613,1653735741,1653736366,625,1306
3235155985,3809387134,1658314404,1658314763,359,1288
3413300274,3731206373,1667021165,1667021420,255,871
3823682564,3593553797,1668380241,1668380356,115,1809
3948743692,3681399132,1666341760,1666342522,762,1220
3106804099,3450811740,1656006563,1656006773,210,240
3776685300,3338329823,1659900615,1659901567,952,696
3657464089,3662578193,1656988761,1656989254,493,1230
3320742371,3059068631,1656527649,1656528399,750,1804
3043736420,3744196402,1646126276,1646126873,597,1881
3463965663,3003402470,1647926531,1647927254,723,388
3972677516,3278854404,1643899944,1643900865,921,1856
3772792062,3705306826,1655095314,1655095648,334,2260
3264753140,3476971345,1667434250,1667434746,496,1820
3697085492,3379076226,1641274764,1641275083,319,426
3595560993,3012272703,1651144330,1651144800,470,780
3315593278,3332592315,1654246712,1654247466,754,1188
3969563324,3604755020,1668105744,1668106228,484,1351
3942399353,3228709105,1642202334,1642202709,375,874
3190778281,3532450192,1641858633,1641859017,384,1582
3594707374,3052681277,1669690976,1669691230,254,646
3750698244,3795990774,1660616587,1660617573,986,1043
3066439887,3592487083,1662909361,1662909500,139,2064
3744737373,3997312859,1656609182,1656609488,306,897
3348102929,3485644295,1668678682,1668679045,363,892
3481482238,3866268396,1667484699,1667484745,46,99
3104009859,3480642253,1648718654,1648719519,865,1633
3825971737,3877483900,1654496033,1654497028,995,2124
3573158941,3947369111,1654413923,1654414019,96,1773
3079809630,3812385830,1668158688,1668159687,999,400
3499739176,3163708045,1665704841,1665705749,908,75
3042943074,3065246027,1651416628,1651417029,401,324
3454546723,3686298420,1661065153,1661065253,100,2035
3846866111,3722945080,1667847676,1667847904,228,1716
3336494171,3553939893,1645076404,1645076954,550,294
3602497998,3368294774,1656797849,1656797850,1,2281
3735538229,3168983812,1662563525,1662564305,780,1417
3688758916,3736118442,1643770395,1643770665,270,132
3139604406,3357247840,1649395427,1649395712,285,2486
3190267458,3064522150,1658814294,1658815137,843,1376
3957689713,3969563324,1648906006,1648906190,184,1036
3773196864,3445281422,1657541386,1657541469,83,2137
3783515345,3879157400,1667885271,1667885702,431,245
3575535453,3407322181,1643979956,1643980174,218,2107
3813921952,3344553610,1655438728,1655438984,256,2363
3890054358,3286065477,1663505792,1663506059,267,144
3712630492,3282412327,1662848681,1662848949,268,1443
3492134379,3983166385,1645705222,1645705698,476,729
3338715388,3181329363,1655910677,1655911116,439,2122
3451249074,3590228003,1646441177,1646441698,521,568
3450102071,3012152244,1641639341,1641639636,295,1020
3151923668,3051654064,1647938940,1647939645,705,177
3527013883,3614430693,1661153418,1661153512,94,1325
3411993487,3663155034,1665174993,1665175097,104,2244
3734534401,3555731884,1655716898,1655717862,964,743
3285243887,3980781580,1658147915,1658148243,328,349
3701151902,3506187447,1642495808,1642496415,607,323
3595144575,3502484697,1663204352,1663204841,489,641
3837447685,3262978596,1643125048,1643125791,743,1662
3154250720,3041809783,1642996959,1642997741,782,781
3971648409,3248733503,1653433894,1653434657,763,2437
3526327974,3555272427,1663897840,1663898093,253,1452
3975405530,3063659192,1652654794,1652655684,890,1424
3735538229,3969103555,1655260320,1655260570,250,77
3157546931,3017484255,1662034943,1662035202,259,2139
3101460702,3939181696,1648954404,1648955042,638,1192
3462280366,3451227417,1653029611,1653030133,522,1333
3082108681,3839695294,1650098020,1650098303,283,1441
3474808421,3966881800,1643917413,1643918244,831,137
3252187190,3970444667,1646038717,1646039041,324,134
3692691710,3770641398,1662429539,1662430450,911,492
3423522480,3376742833,1652681015,1652681766,751,1766
3242088486,3154158203,1668788483,1668789357,874,1426
3915686266,3732472752,1662515192,1662515678,486,2024
3735801716,3549768940,1667904634,1667905597,963,1980
3481689842,3163202728,1666937133,1666937470,337,2337
3978893578,3645341350,1658762513,1658762519,6,2261
3392569339,3476882609,1669276632,1669276670,38,2451
3945943527,3965960711,1648025712,1648025988,276,614
3957695947,3331904172,1656125920,1656126681,761,1331
3460552791,3555966791,1647220532,1647221276,744,576
3325334543,3143909362,1663024002,1663024273,271,1604
3631732813,3813403697,1666556978,1666557453,475,1266
3933892798,3659204779,1669472525,1669473497,972,472
3212095735,3901126730,1646239974,1646240531,557,1495
3995270744,3238270210,1658678110,1658679069,959,152
3621969167,3830388213,1645601353,1645601817,464,2347
3270914746,3046043182,1669581741,1669581885,144,1241
3499514081,3515460273,1665194125,1665194241,116,908
3197660189,3935740815,1648910434,1648910679,245,1820
3386809097,3281445213,1653005393,1653006243,850,1398
3614064639,3639307843,1644934124,1644934815,691,808
3692772256,3457542537,1649153550,1649153940,390,290
3963615140,3557087358,1644636957,1644637342,385,653
3289061595,3814029511,1650783475,1650783935,460,1750
3130612494,3052875832,1652773734,1652773951,217,1514
3598572594,3691367177,1643131540,1643132296,756,1694
3358578228,3399334455,1669164333,1669164745,412,366
3276118203,3095221133,1660546827,1660546848,21,1508
3098165935,3163662966,1664300845,1664301020,175,1017
3470488588,3356144129,1660757662,1660758481,819,1372
3367865740,3092925867,1649183684,1649184560,876,1123
3759608318,3239578622,1666972397,1666972681,284,901
3214711870,3868695814,1656298852,1656299195,343,1592
3693652924,3379105646,1663255143,1663255850,707,536
3758115218,3200978578,1645017122,1645017702,580,816
3309799085,3671355250,1654423709,1654424591,882,117
3501308694,3183165788,1668916235,1668916328,93,1874
3629207282,3720381616,1644004840,1644004956,116,1641
3017484255,3125019722,1647149929,1647150761,832,491
3682419396,3261128926,1644896809,1644897540,731,70
3597904540,3130166522,1663660815,1663661611,796,589
3192612662,3356590035,1650846694,1650846746,52,2393
3611967437,3480905975,1644589508,1644590483,975,560
3443385652,3678425549,1660530357,1660530443,86,1979
3329496705,3773742235,1657711009,1657711678,669,758
3485526833,3205809646,1665876448,1665876758,310,1316
3041563987,3078628091,1666031903,1666032155,252,2304
3217494787,3553301078,1645741174,1645741957,783,816
3835049098,3011225738,1647640869,1647641387,518,850
3343153937,3520385284,1644655004,1644655203,199,1370
3863665550,3878876305,1642754172,1642754707,535,1823
3392213771,3939181696,1657558020,1657558020,0,90
3583169906,3443773400,1660356099,1660356920,821,2458
3264281080,3634282428,1662560867,1662560883,16,1209
3142923526,3284380221,1667457757,1667458583,826,1486
3636621583,3987813210,1667421705,1667422057,352,196
3179405209,3515933745,1669699580,1669699798,218,124
3929464797,3707778731,1658705973,1658706941,968,1686
3575715668,3646797040,1651445689,1651446089,400,1305
3191632331,3566936390,1649848746,1649849487,741,126
3547749057,3269865212,1663473924,1663474463,539,2070
3776906254,3719124928,1652490220,1652490357,137,1339
3938337743,3631568439,1656727475,1656728171,696,1884
3705601482,3929975862,1652085061,1652085735,674,2201
3909523201,3371745136,1663510060,1663510482,422,1674
3710888381,3093387843,1648369439,1648369898,459,2175
3098667748,3243231806,1652461125,1652461379,254,1826
3368294774,3353422891,1656771181,1656771299,118,2139
3171731237,3898641431,1649850427,1649850747,320,984
3641041716,3336376139,1648407864,1648407927,63,369
3010488834,3880439495,1645000425,1645000919,494,1490
3346012606,3790996735,1641252810,1641253623,813,648
3008283469,3339911597,1652666927,1652667679,752,111
3272981808,3231899706,1652491139,1652491700,561,963
3894149054,3446987671,1656371661,1656372310,649,564
3301119536,3041290048,1658766494,1658767171,677,1299
3403925711,3203691315,1669455336,1669455532,196,2216
3707406950,3373656201,1665140884,1665141182,298,658
3607354151,3655566080,1650968491,1650968733,242,1278
3499281518,3771788181,1663960140,1663960405,265,1617
3181388502,3894413849,1658465234,1658465777,543,103
3341283434,3656846834,1659438419,1659439378,959,2007
3501946724,3818508802,1642925307,1642925374,67,1926
3540717336,3473571389,1668455223,1668455629,406,1319
3160963185,3026095831,1649956240,1649956555,315,1295
3108288045,3917067097,1664381834,1664381850,16,2203
3587508502,3735691730,1655794085,1655794380,295,1518
3070557341,3385273825,1645541517,1645542385,868,2229
3832336338,3093178960,1657956175,1657956599,424,1750
3320435078,3089034472,1663144174,1663145056,882,518
3707258240,3414898500,1660435440,1660436412,972,2409
3083494718,3502690432,1653740649,1653741365,716,318
3017712081,3360342048,1648797127,1648797401,274,1502
3471587065,3059416141,1644206429,1644206962,533,2076
3712115076,3304523843,1642006572,1642006832,260,2036
3470228949,3050267205,1664405010,1664405066,56,1382
3377179024,3665148560,1643424729,1643424976,247,1464
3417138981,3823682564,1641181130,1641181673,543,611
3529681535,3894359262,1649416279,1649417258,979,89
3686530724,3846585557,1659990864,1659991626,762,890
3834268660,3973264936,1669501591,1669501862,271,1430
3501962027,3681399132,1646891418,1646891611,193,787
3825930964,3980803977,1646755291,1646756241,950,1072
3530162623,3840306405,1647658763,1647658956,193,487
3069353793,3203904444,1648830473,1648831032,559,1630
3657758228,3153085443,1644883189,1644883524,335,2304
3788785252,3551243497,1669258396,1669259024,628,1972
3199288675,3962536480,1668639629,1668640261,632,1716
3888015355,3792004796,1667901576,1667901623,47,1911
3616429615,3672609185,1657897410,1657898270,860,107
3502587181,3442674561,1661670094,1661670534,440,564
3532634291,3701214753,1659927483,1659927998,515,783
3555912894,3907213401,1652861191,1652861286,95,492
3632283664,3736260750,1667841010,1667841747,737,2251
3344337283,3981817077,1662159191,1662159446,255,1922
3480314503,3248892530,1651813956,1651814926,970,249
3260157601,3680694926,1662241171,1662241438,267,1336
3051903509,3259430206,1658942880,1658943877,997,1662
3644961840,3621000186,1654950699,1654951264,565,610
3258399411,3470488588,1661130659,1661131268,609,2389
3881942272,3891027417,1665821125,1665821583,458,250
3325360523,3314953470,1647820194,1647820573,379,2152
3643276679,3697028552,1641302752,1641302951,199,888
3720475877,3153552268,1656918478,1656918999,521,2413
3562104036,3224864814,1660661203,1660661803,600,1908
3717926703,3753985186,1663295465,1663295487,22,1812
3351921075,3537592483,1650700807,1650701415,608,2010
3643730317,3175478710,1664117030,1664117874,844,1244
3564440153,3442674561,1650878819,1650878983,164,2224
3733102461,3603965318,1650596959,1650597778,819,1510
3953796727,3145045320,1661708534,1661708647,113,183
3121391240,3930474522,1658605352,1658606243,891,1137
3788911315,3487740667,1651524593,1651525299,706,1214
3165884724,3909002163,1663040215,1663040974,759,1939
3969960450,3237807880,1652559726,1652560428,702,1701
3600501749,3365939940,1665510380,1665511208,828,1592
3576961863,3255751346,1656567807,1656568532,725,424
3014392598,3497079704,1666096171,1666096870,699,1687
3011459628,3652765431,1656778360,1656778533,173,433
3947604616,3670154961,1662040132,1662040312,180,1760
3991542844,3431892611,1655821474,1655822141,667,1266
3857013729,3451227417,1660499244,1660499422,178,81
3329190028,3365939940,1660840722,1660841105,383,2091
3124415148,3277298737,1648439150,1648439201,51,975
3690349378,3966130885,1653624515,1653624985,470,2377
3623620611,3086076310,1646481630,1646481982,352,727
3985879853,3316237227,1659898893,1659899231,338,2383
3069841199,3050800748,1648555129,1648555230,101,490
3768087701,3078500208,1664018710,1664019542,832,2320
3318227153,3680677416,1654080198,1654080782,584,1346
3407579711,3347776562,1658360081,1658360680,599,177
3291667893,3351921075,1667466241,1667466331,90,160
3064032505,3541423460,1666600078,1666600836,758,1830
3884949094,3885555985,1662147829,1662148776,947,1698
3592887882,3558312644,1646688900,1646689839,939,1158
3353422891,3851864688,1649554505,1649554706,201,1350
3902970032,3260246509,1646580280,1646580884,604,922
3101410977,3115777637,1642969606,1642969910,304,1252
3683993851,3615359458,1664292310,1664292411,101,300
3471376255,3098161767,1660536097,1660536179,82,1554
3990643900,3735943539,1657138571,1657139277,706,1503
3639059199,3075563867,1664029522,1664029692,170,118
3646159351,3570906118,1660249293,1660249296,3,2085
3571793713,3190859932,1657796555,1657796984,429,2342
3700737923,3440372055,1641490884,1641491735,851,1093
3649724545,3227567293,1655377614,1655377741,127,832
3439905167,3896867161,1647534814,1647535621,807,745
3830243698,3620013325,1660993928,1660994469,541,2342
3995850572,3204935260,1648267017,1648267909,892,770
3755962729,3904183865,1655756972,1655757696,724,1322
3889544424,3777592593,1663892543,1663893212,669,392
3396063880,3536954029,1661520520,1661520522,2,2301
3158554223,3970653700,1656960196,1656960936,740,775
3094125203,3575457804,1652043490,1652044131,641,2240
3787465946,3799480079,1647238816,1647239607,791,1408
3907665331,3210071519,1662296352,1662297158,806,2465
3309767670,3444668733,1646102957,1646103194,237,1850
3522623156,3078216798,1648651233,1648651303,70,1938
3553721378,3133655192,1645829557,1645830478,921,1864
3230843282,3161586578,1667195402,1667195411,9,236
3776783076,3428593255,1653804482,1653804800,318,1282
3957216784,3706085200,1652412333,1652413087,754,2389
3311860866,3561336684,1661531976,1661532681,705,729
3904825547,3780014272,1667506957,1667507256,299,601
3910581173,3014185506,1653435883,1653436389,506,1109
3858225831,3704120553,1643845959,1643846555,596,72
3746979257,3452391459,1664725745,1664726632,887,1275
3801736024,3115303809,1643818390,1643818491,101,2122
3194871172,3848740333,1652463856,1652464571,715,2138
3181329363,3791462728,1644575166,1644575658,492,709
3102672864,3207283619,1662212372,1662212785,413,914
3500201376,3125314664,1642751227,1642752225,998,88
3526088150,3169559952,1643755147,1643755807,660,947
3268745445,3325962611,1666630736,1666631257,521,2246
3117262222,3745420516,1645994454,1645995423,969,516
3772340083,3896789438,1658355137,1658355470,333,1573
3769198196,3345905539,1666084302,1666084308,6,1904
3839695294,3275298041,1662006856,1662007341,485,850
3316978783,3705306826,1649364797,1649365378,581,1923
3073967597,3223412894,1642666053,1642666826,773,1657
3692368068,3615137704,1668438715,1668439226,511,1467
3448378304,3919196366,1654085477,1654085959,482,662
3279069375,3378864156,1649504594,1649505235,641,1179
3919489244,3118807144,1646851411,1646852229,818,2025
3472458500,3391324219,1660319099,1660320021,922,1510
3206549691,3624090791,1658031517,1658031906,389,42
3882415224,3464235741,1648185843,1648186041,198,1320
3871845792,3881578299,1669575894,1669575945,51,1062
3273348089,3144175285,1666382888,1666383801,913,1494
3088602459,3592887882,1659926855,1659927088,233,1654
3054606477,3699293407,1651854213,1651854712,499,255
3331604266,3877902487,1657253932,1657253947,15,554
3379829698,3707767360,1647498334,1647498930,596,599
3568141696,3566534974,1658117599,1658117759,160,659
3954434825,3792924517,1649812267,1649812762,495,1408
3558493130,3795792181,1645130390,1645130550,160,2345
3494009953,3925239812,1642007762,1642008673,911,1093
3165845148,3631660076,1664933068,1664933296,228,1971
3401738714,3342708435,1655655295,1655655672,377,409
3142777936,3008550397,1655314612,1655315506,894,225
3419809319,3090304189,1650685064,1650685193,129,705
3268216928,3629984961,1665564826,1665565436,610,1098
3044064258,3614179985,1655662702,1655663170,468,2081
3070841779,3185250646,1643884539,1643885448,909,1453
3097457183,3602829591,1667410972,1667411915,943,2131
3110339164,3941586762,1667968268,1667968710,442,234
3023254734,3131753608,1658911403,1658912343,940,624
3992708211,3711943152,1654893064,1654893447,383,2279
3497507557,3729325351,1669727304,1669727782,478,1302
3032970317,3872626198,1645833559,1645834369,810,931
3982929088,3673524018,1667649160,1667649873,713,2427
3777091595,3474723005,1667302621,1667302705,84,1520
3959651432,3246571420,1653923706,1653924423,717,1013
3893170545,3718684083,1649907887,1649907911,24,2419
3027478849,3666174374,1657206959,1657207503,544,2189
3211839563,3741929805,1643529363,1643529935,572,691
3629090721,3835036552,1653379082,1653379390,308,908
3686424169,3916557399,1644016484,1644016907,423,1586
3400397224,3773408264,1649799659,1649800656,997,5
3346254669,3512935575,1658589516,1658589841,325,2255
3606331231,3292507015,1651650056,1651650244,188,1530
3342315965,3985418000,1642011347,1642011396,49,1249
3112357538,3432059238,1656151828,1656152464,636,567
3010368174,3627503494,1648871357,1648872205,848,289
3985486150,3609804397,1662728788,1662729101,313,1720
3471221302,3082885404,1643724861,1643725348,487,986
3411340387,3502217263,1668634407,1668634559,152,883
3451307942,3027651085,1662673702,1662673752,50,1091
3536903033,3243831128,1657113741,1657114453,712,1418
3077346044,3638803969,1653236549,1653237414,865,1070
3194560289,3300694030,1660782911,1660783655,744,1747
3383179408,3223204355,1663377533,1663377809,276,1247
3584668339,3277284318,1648612135,1648613055,920,1829
3978720869,3850304083,1659012684,1659013411,727,1980
3270177744,3815605229,1665168190,1665168280,90,2466
3066645531,3827170233,1641869685,1641869727,42,71
3680427036,3251854206,1664267825,1664268398,573,2496
3656654582,3409662195,1653299721,1653300249,528,2034
3771028638,3476558133,1643463722,1643464612,890,943
3468803992,3616651934,1642947789,1642948574,785,749
3586405616,3813854723,1656907305,1656907814,509,2015
3447887397,3859164696,1669655398,1669655819,421,1071
3175676853,3277284318,1659978983,1659979958,975,1158
3308891574,3224364206,1658921229,1658922133,904,2126
3796954140,3856985099,1648345516,1648345761,245,559
3232304638,3582076532,1666575096,1666575795,699,1953
3493752989,3441206388,1663907210,1663907402,192,1380
3643276679,3624298459,1647417090,1647417274,184,1710
3792117640,3608048838,1669315660,1669315863,203,366
3368884196,3691607111,1649874722,1649874792,70,1946
3751022139,3616712503,1650918449,1650919320,871,45
3185469541,3215453691,1648131487,1648131606,119,1610
3000890083,3966770982,1650833707,1650834553,846,985
3532675680,3728797277,1661363282,1661363890,608,2221
3798343786,3778228977,1652222424,1652223053,629,169
3628956600,3976858724,1646571459,1646571587,128,1115
3011015055,3819468348,1644611885,1644612440,555,891
3721136961,3111823829,1661300733,1661301161,428,1408
3567520646,3518202698,1669016702,1669016966,264,635
3745289284,3845256746,1654565347,1654565529,182,2495
3013247537,3156483651,1655453758,1655454148,390,74
3685665978,3460229906,1656537713,1656538180,467,2361
3817579913,3075780193,1668001406,1668001452,46,2340
3551104975,3993756491,1663002086,1663002692,606,1246
3024228189,3532307372,1651565876,1651566317,441,871
3379366812,3750123961,1654268388,1654269069,681,653
3436234030,3819415032,1651123839,1651124452,613,1805
3003728684,3610480358,1654880711,1654881670,959,128
3894690935,3282425868,1649165070,1649165381,311,1619
3112217806,3800312034,1656175129,1656175262,133,1888
3878876305,3836089663,1652937685,1652937913,228,2060
3963995256,3443435826,1647694628,1647695511,883,2135
3977107209,3669311789,1651708408,1651708899,491,188
3373962186,3297626110,1657575419,1657575950,531,1821
3452920322,3870778205,1667399082,1667399421,339,1911
3559489793,3878657197,1642208365,1642208680,315,2046
3753180150,3763317740,1657600741,1657601385,644,636
3976367014,3079809630,1641732788,1641732975,187,1793
3553960271,3172018366,1641869832,1641870359,527,1261
3745532894,3840155084,1662174333,1662175038,705,872
3400542216,3414488975,1667825982,1667826814,832,1476
3292869706,3760142759,1669165451,1669166064,613,300
3394220993,3218117875,1654015924,1654016138,214,1240
3498466937,3501820222,1664486313,1664486973,660,2079
3287116319,3774325139,1644955021,1644955993,972,1932
3630982131,3435698448,1662761309,1662761535,226,1762
3789727449,3815102601,1660854109,1660854372,263,206
3311113773,3094562402,1669248865,1669249195,330,2190
3028780744,3346948485,1651706619,1651707588,969,56
3647951580,3710394011,1647437423,1647437510,87,1929
3718182841,3542285714,1655265537,1655265778,241,1137
3752858965,3882038749,1658234898,1658234955,57,1420
3420489464,3867026366,1663478935,1663479561,626,1124
3321835417,3377901268,1650451937,1650452906,969,918
3970645989,3937758732,1668446007,1668446618,611,2075
3547758342,3558493130,1656773078,1656773806,728,190
3897491493,3747363730,1667126989,1667127113,124,1889
3514458890,3657753711,1641572416,1641573127,711,24
3912672075,3136448234,1660685288,1660685891,603,1823
3647295073,3419465829,1660952467,1660953011,544,2116
3581216621,3456811507,1647676054,1647676890,836,1588
3799624292,3623685885,1663053172,1663053306,134,856
3185444969,3882748527,1644504828,1644505247,419,113
3927649358,3457108498,1650886210,1650886328,118,631
3105607346,3956394849,1656244105,1656245035,930,1194
3851780195,3191265442,1646788794,1646789336,542,746
3913071555,3536219260,1647574313,1647574781,468,2160
3270914746,3031292798,1653261407,1653262168,761,1378
3231496949,3472458500,1664745397,1664745632,235,970
3194871172,3707199669,1648560385,1648560769,384,1505
3559176364,3815462032,1651999673,1652000601,928,1197
3924838447,3087662482,1654486718,1654487237,519,925
3569200063,3173969437,1655831165,1655831330,165,194
3249305465,3622997863,1656004900,1656005167,267,1748
3120949338,3254030842,1642319507,1642320036,529,1627
3100670764,3747929255,1664789843,1664790499,656,1079
3182135067,3515044837,1645570462,1645570719,257,2433
3042176960,3041290048,1647255082,1647255881,799,2440
3451771672,3458252541,1661855895,1661856816,921,1567
3555108136,3857434991,1659545827,1659546064,237,631
3334298803,3633111737,1667534644,1667535424,780,716
3906145952,3802545642,1651025367,1651026140,773,2042
3492103801,3992345499,1655294870,1655295760,890,970
3729389785,3010819705,1647123631,1647123998,367,1858
3944198123,3575576911,1647996037,1647996854,817,973
3103404280,3271876104,1661652337,1661653037,700,1880
3024228189,3212038287,1664990807,1664990959,152,990
3768482482,3625179175,1644957282,1644957651,369,852
3167864948,3052861028,1655471302,1655472004,702,1429
3367279073,3017005264,1647667845,1647668170,325,2132
3143962586,3561254848,1653932194,1653932464,270,907
3362395200,3276118203,1641052359,1641053357,998,2092
3584668339,3929638122,1649525584,1649525807,223,1479
3410613004,3339480960,1657724992,1657725533,541,2182
3472052544,3337765684,1668056524,1668057073,549,1801
3184994293,3938272679,1668696866,1668697177,311,399
3569563212,3563103144,1641114253,1641114733,480,522
3388971461,3920482918,1650696101,1650696599,498,1242
3271876104,3345186165,1655419983,1655420673,690,2418
3322801895,3787937000,1654380041,1654380616,575,180
3922851964,3003641311,1654239259,1654239980,721,1695
3599874732,3774724683,1660327583,1660328117,534,1227
3042046828,3557835284,1651500701,1651501603,902,2048
3880837935,3204114911,1668987234,1668987543,309,1428
3923683467,3878657197,1666004263,1666004478,215,1223
3835842311,3781394729,1654218078,1654218228,150,2424
3608450611,3518322544,1656746496,1656747259,763,1745
3053855376,3057308926,1653141149,1653142147,998,1412
3390919111,3397779824,1665540545,1665540931,386,541
3505417530,3888757366,1644198316,1644198327,11,275
3125008218,3640349880,1649730350,1649730992,642,769
3080200257,3257118282,1661483294,1661483526,232,26
3365134626,3779611783,1641575744,1641576301,557,2113
3254496907,3892469874,1656100868,1656101029,161,1471
3481584783,3554977739,1651310117,1651310849,732,851
3758115218,3531256735,1644375254,1644375342,88,2299
3121128511,3195504067,1643427089,1643427325,236,252
3439940608,3012034151,1656175332,1656175872,540,836
3594231530,3398508681,1658288589,1658289508,919,1265
3191133743,3331335383,1655185269,1655185425,156,1703
3709075485,3130993420,1644520825,1644521335,510,500
3396149289,3460842972,1643597940,1643598560,620,2239
3294278402,3853178623,1666559378,1666559622,244,409
3835049098,3444174394,1649721996,1649722296,300,2317
3105250340,3427127427,1653602953,1653603436,483,786
3119014132,3629999604,1666141884,1666142003,119,545
3042045098,3828531030,1667318475,1667319270,795,786
3740236087,3906065558,1654878177,1654879095,918,73
3342009927,3534726913,1668764031,1668764171,140,1843
3314953470,3536421569,1657358395,1657359080,685,1896
3256648307,3985418000,1660867539,1660867773,234,1520
3265895976,3021006721,1641254651,1641255339,688,381
3830541998,3177190923,1648862795,1648863346,551,2439
3137594486,3048296949,1655413714,1655413964,250,1968
3912511626,3104303534,1666343949,1666344226,277,2218
3915154684,3220690215,1645713742,1645714577,835,1831
3884346810,3358745496,1659354543,1659355097,554,52
3886521997,3716415183,1644278338,1644278773,435,694
3842844573,3104271824,1644085914,1644086175,261,183
3088604045,3031560160,1649398106,1649398480,374,2440
3334102064,3548799053,1658826050,1658826252,202,1296
3344472194,3300983140,1652159448,1652160163,715,122
3906396830,3081396297,1666420188,1666420595,407,2483
3878925459,3624644696,1659297362,1659297879,517,1664
3463003824,3200116756,1655752857,1655753372,515,2339
3125730442,3025108334,1644113230,1644113350,120,1142
3867158050,3046127876,1659196351,1659197236,885,2443
3624947127,3748812993,1645333041,1645333091,50,1094
3037940560,3044772882,1646504922,1646505583,661,596
3092941538,3404020970,1661088472,1661089193,721,842
3730106432,3303025505,1648954097,1648954405,308,641
3296556189,3403933668,1668759083,1668759542,459,422
3411128747,3058789362,1658803402,1658804014,612,64
3682922389,3878180077,1667047334,1667047675,341,2238
3011863548,3707199669,1643002065,1643002924,859,1242
3827122083,3722329316,1650058303,1650059038,735,2293
3487740667,3236819846,1643094274,1643094676,402,1276
3706797905,3180984174,1665731207,1665731249,42,1315
3028705386,3678452420,1653860194,1653860269,75,321
3825173498,3657758228,1645138506,1645138552,46,1757
3486061006,3554862003,1663919265,1663919727,462,1589
3300015174,3816647849,1669396089,1669396725,636,1127
3169955779,3068242755,1653529195,1653530085,890,995
3201213219,3150884811,1666998624,1666999551,927,523
3148691436,3771460646,1663453609,1663454426,817,712
3257821708,3936122118,1668187080,1668187413,333,1964
3407770585,3102760949,1661440801,1661441191,390,1347
3240588695,3906903088,1656435202,1656436148,946,2228
3400542216,3071929787,1644859777,1644860077,300,2364
3590627159,3270935026,1666169537,1666170497,960,1273
3683993851,3714322007,1663356874,1663357425,551,1091
3840659531,3760042128,1643270399,1643270425,26,1901
3792834070,3144405714,1641255244,1641255538,294,1161
3393528919,3490381305,1647675628,1647676321,693,294
3678720106,3508340066,1661364175,1661364658,483,1098
3664242822,3339911597,1646035154,1646035388,234,2497
3940948395,3450074680,1660253950,1660254854,904,130
3927388172,3119345995,1651323542,1651324236,694,1738
3821299576,3220903356,1649725871,1649726071,200,1390
3813811121,3812732557,1659927041,1659927484,443,1923
3440324329,3286065477,1643235232,1643235422,190,2416
3112739600,3480115115,1645443050,1645443798,748,1806
3046127876,3687925631,1649394135,1649394707,572,2383
3904203375,3576411084,1662136635,1662137553,918,2429
3612973191,3276617814,1650861609,1650862027,418,2318
3235672444,3462744716,1659004688,1659005589,901,1464
3869991101,3208464777,1649928195,1649928326,131,1736
3136200575,3420266147,1652643885,1652644781,896,627
3766193314,3964711138,1654494468,1654494943,475,2128
3675429073,3185444969,1649142819,1649143506,687,403
3289061595,3951845301,1646180965,1646181621,656,45
3132486699,3370779634,1662630862,1662631708,846,1250
3285225403,3880620233,1655045475,1655045919,444,943
3688910009,3595284541,1654539742,1654539800,58,938
3454754318,3661016961,1660651348,1660651885,537,2243
3860432776,3751975877,1643571713,1643571973,260,403
3194721041,3777938800,1667641949,1667642122,173,1718
3195214383,3744196402,1647848884,1647849275,391,356
3034159032,3289061595,1658591200,1658591609,409,2203
3533274758,3058064037,1644775151,1644775689,538,2272
3655250241,3092292487,1654475274,1654475531,257,307
3350017208,3678452420,1655739445,1655739882,437,1717
3252593307,3501866086,1648813063,1648813571,508,600
3254030842,3704517188,1667674787,1667675181,394,895
3031816406,3471221302,1645479828,1645480155,327,1890
3125813072,3440064321,1649219366,1649219601,235,1552
3412053580,3130093617,1649332627,1649333205,578,1176
3667528236,3839947308,1652206222,1652206423,201,2138
3999390272,3235825340,1654415064,1654415563,499,2447
3189673990,3085455498,1657752079,1657752660,581,2049
3968000691,3551771231,1664484805,1664485122,317,1029
3906024837,3451285207,1666004382,1666004977,595,572
3570955260,3216582576,1657853512,1657854181,669,1729
3895332326,3581399447,1656386181,1656386622,441,445
3502316165,3091709202,1645378899,1645379745,846,1774
3229321048,3918988651,1641396825,1641397289,464,160
3251106195,3116777827,1641371703,1641372389,686,1978
3374005704,3640523860,1657698189,1657698877,688,2040
3072080605,3247590827,1667553674,1667553889,215,93
3217719618,3036846628,1657537348,1657537703,355,2455
3052822229,3718882981,1648227161,1648227596,435,1071
3928241216,3796065026,1646388251,1646389082,831,609
3348735740,3894036055,1642698664,1642699391,727,2261
3363097423,3483445976,1645916037,1645916350,313,1351
3036448305,3189318073,1657742643,1657742990,347,511
3827867076,3295850908,1662037552,1662038542,990,656
3500595056,3457317780,1661823601,1661823927,326,1462
3811235183,3599869347,1644814847,1644815039,192,2174
3014438377,3605492251,1667933600,1667933816,216,1910
3947461796,3041001828,1641236328,1641237211,883,645
3075313832,3338882756,1656903152,1656903873,721,324
3814029511,3691925367,1668654486,1668655476,990,1058
3261866390,3034750166,1642684885,1642685783,898,1616
3989991456,3050271924,1656283866,1656284588,722,1920
3780885377,3123302108,1645287390,1645287409,19,1013
3288937566,3117531188,1659876019,1659876152,133,185
3273827707,3106429728,1647572043,1647573027,984,1879
3748478851,3303973335,1650474070,1650474464,394,1229
3846060378,3895196680,1657333586,1657333856,270,328
3660548799,3348006171,1647891168,1647891300,132,2259
3394249709,3261527870,1663823891,1663824152,261,1354
3806015172,3046526062,1669072296,1669072473,177,823
3331866261,3840155084,1648371793,1648372529,736,1900
3070404759,3105299236,1662907917,1662907982,65,1969
3793901427,3981657344,1663195008,1663195637,629,1126
3141137322,3824227701,1661435945,1661436121,176,1517
3020429639,3270273033,1658305455,1658306112,657,806
3811337280,3324611610,1655435712,1655436451,739,205
3269653223,3123999917,1645244424,1645244777,353,2125
3072080605,3548545695,1650808922,1650809345,423,726
3840801648,3385413048,1646267803,1646268150,347,629
3687552718,3490430582,1650355248,1650355669,421,1178
3544133682,3905167655,1642002773,1642003578,805,1166
3875750764,3060522981,1649695700,1649696468,768,2387
3577798894,3142160799,1646658531,1646659187,656,295
3352751731,3883257601,1649769774,1649769780,6,1646
3442593383,3743687544,1642509090,1642509230,140,2131
3482483232,3799287196,1641680830,1641681461,631,887
3097563397,3661494924,1655497777,1655498448,671,1474
3918812791,3390919111,1669588606,1669589434,828,334
3371745136,3366189965,1665114101,1665114670,569,1497
3550889203,3760535935,1665862892,1665863867,975,2061
3236132865,3057201124,1642254649,1642254668,19,1869
3575816255,3585042042,1657027560,1657028321,761,461
3205162065,3889840253,1662973268,1662973858,590,2319
3481881323,3332721407,1663636109,1663636401,292,857
3184455755,3391622565,1657993709,1657994563,854,1057
3959504618,3145552419,1656498093,1656498617,524,2200
3992708211,3549703546,1660689875,1660690054,179,518
3287508774,3523829341,1667546970,1667547704,734,206
3553712893,3702671465,1658262153,1658262351,198,771
3931230284,3551810435,1652876860,1652877223,363,2030
3097128642,3252843201,1656684330,1656685066,736,2034
3005200951,3854995649,1668217992,1668218041,49,1822
3692691710,3367457506,1648893036,1648893038,2,313
3061556470,3268826534,1645939381,1645939973,592,1369
3416521015,3296478783,1662005863,1662006553,690,2156
3330548469,3835976086,1657344172,1657344802,630,1877
3863697907,3062486954,1651607004,1651607749,745,1209
3363651899,3962138330,1642790306,1642790755,449,173
3224455204,3667528236,1646524145,1646524222,77,1812
3054573274,3648072719,1662099009,1662099997,988,1846
3963841091,3724157579,1643290612,1643291529,917,608
3398785571,3982736205,1657015844,1657016683,839,150
3244198823,3805953085,1643642254,1643643022,768,1579
3172825605,3249512921,1647806094,1647806245,151,2375
3894616795,3707342422,1641517684,1641518352,668,1110
3571766829,3885555985,1647090435,1647090677,242,2278
3262098376,3947521897,1664414154,1664414312,158,1425
3766528617,3998641184,1667652486,1667653295,809,1964
3304559201,3877090261,1659070622,1659071034,412,593
3909997437,3240452269,1652935030,1652935256,226,1189
3395609056,3775766805,1653304471,1653304937,466,1296
3403389913,3408300554,1662106826,1662106827,1,187
3864414449,3793086361,1650319789,1650320758,969,1764
3751418832,3172524712,1655743609,1655743938,329,1507
3163986082,3154288650,1663600955,1663601728,773,510
3160242179,3464653044,1663091003,1663091795,792,911
3564440153,3338882756,1641477359,1641478250,891,422
3367849829,3261837009,1646016872,1646017319,447,1004
3039035602,3222060578,1667048860,1667049185,325,805
3031816428,3803051709,1645240640,1645240655,15,1143
3340464785,3696448766,1665274793,1665275161,368,1695
3892336923,3278038835,1652871838,1652872395,557,1999
3032747459,3939755962,1650689164,1650689182,18,528
3386490201,3045016501,1643659724,1643660150,426,2283
3587440298,3918581818,1643716839,1643717565,726,2206
3772792062,3670622586,1667403122,1667403975,853,877
3163326257,3270177744,1644858930,1644859707,777,2477
3791389559,3598576303,1653864897,1653865377,480,2274
3119718471,3435036750,1645796998,1645797678,680,362
3995299995,3819467184,1655773474,1655773918,444,2248
3029758309,3319037937,1653082244,1653082743,499,1146
3256628168,3699152541,1654200617,1654200626,9,416
3243534925,3118502732,1667411883,1667411980,97,1053
3991310779,3520571883,1649316424,1649316862,438,2248
3051863550,3510660628,1661820957,1661821872,915,2234
3192612662,3381900638,1649280434,1649280699,265,1559
3449622291,3813811121,1667572360,1667573124,764,1227
3068239649,3248308163,1666943833,1666944240,407,2119
3734004050,3856600876,1668621579,1668622256,677,1004
3673935826,3300203056,1662834324,1662834411,87,863
3875434702,3363768036,1669186672,1669187361,689,974
3961420550,3199315199,1643145084,1643145290,206,1397
3599714580,3788688228,1654761972,1654762919,947,2045
3298521381,3501520918,1650693556,1650694318,762,1352
3660732427,3508311968,1645382162,1645383151,989,1865
3323684905,3801038758,1657028414,1657028556,142,887
3338812942,3757518149,1644875045,1644875875,830,33
3106490071,3749619105,1643508938,1643509536,598,229
3314583046,3841660750,1648592260,1648592323,63,984
3515933745,3181237998,1641627424,1641627964,540,934
3748492935,3853256957,1644869175,1644869243,68,2358
3689741006,3071667890,1659010785,1659011775,990,2430
3199117399,3524315738,1643668398,1643668504,106,774
3728240849,3983113289,1644965407,1644966044,637,1704
3581570568,3264434341,1647011090,1647011383,293,1970
3110121278,3471993716,1660341383,1660341757,374,440
3411993487,3100535469,1663682924,1663683328,404,910
3776334300,3734754514,1652127215,1652127245,30,414
3518717396,3867126446,1658627993,1658628643,650,1036
3664627036,3971722824,1662672078,1662672369,291,1380
3752621490,3734893217,1661902921,1661903766,845,1339
3837550746,3140407144,1657341142,1657341461,319,112
3069431080,3983158937,1664061715,1664061871,156,148
3072911780,3054927562,1655004068,1655004765,697,421
3007911826,3486096604,1649218860,1649219738,878,1010
3808191596,3470102638,1646520063,1646520514,451,180
3813811121,3888312656,1646021603,1646022238,635,736
3489225147,3870243569,1647354140,1647354321,181,182
3643615690,3813290629,1668372358,1668372867,509,942
3981348782,3478921948,1662252630,1662253357,727,1921
3528475061,3567520646,1658968385,1658969052,667,2126
3948260526,3384307655,1665741645,1665741993,348,1109
3081589831,3057922933,1656394123,1656394214,91,2293
3655087982,3206119800,1649327589,1649327686,97,491
3547429967,3411708498,1646480905,1646481656,751,63
3589157304,3145344208,1661459311,1661459663,352,252
3172524712,3223694966,1667861475,1667862183,708,580
3037741311,3472983363,1658771464,1658771802,338,2317
3524482926,3686743575,1641051654,1641052549,895,2293
3098276544,3744788361,1663827369,1663827738,369,1084
3507564472,3526061797,1657586021,1657586626,605,55
3470102638,3574773588,1643488471,1643489390,919,206
3582531330,3858876644,1665640955,1665641106,151,2095
3830408109,3448378304,1647927271,1647927678,407,514
3809458973,3587324906,1657818013,1657818079,66,1479
3889730114,3254930364,1653499935,1653500460,525,1781
3082075242,3152537793,1641505309,1641505923,614,1659
3876696308,3195138141,1649925243,1649926177,934,928
3501287522,3527013883,1643131626,1643132408,782,131
3329618048,3225901381,1668763389,1668763840,451,2238
3037375725,3721110937,1643539578,1643540192,614,593
3343279177,3081725518,1652399722,1652400331,609,73
3463003824,3052889118,1658650464,1658651012,548,984
3799014776,3195032074,1645078470,1645078584,114,791
3087662482,3098934820,1647611380,1647612022,642,332
3328146266,3398443861,1647336651,1647336821,170,603
3180051747,3798631691,1667130852,1667131628,776,2450
3899117968,3978987003,1652224652,1652224996,344,1032
3063714742,3002971802,1663578791,1663579763,972,1170
3103743198,3252157235,1665448424,1665449050,626,1217
3899932297,3033373685,1661471406,1661471439,33,2095
3175706913,3142160799,1649135820,1649136772,952,1378
3009141852,3950433378,1649629994,1649630031,37,1465
3049592624,3471707938,1656106941,1656107386,445,625
3415686543,3166492454,1667939746,1667940462,716,214
3377901268,3060310842,1642792780,1642793320,540,870
3967506765,3678720106,1657331148,1657331351,203,225
3180294141,3074395717,1651096743,1651096924,181,1865
3145552419,3147512839,1668364990,1668365971,981,581
3156928973,3017559077,1651219592,1651219953,361,1508
3906236028,3166206557,1654373997,1654374313,316,2377
3045302814,3832463052,1651861653,1651861704,51,16
3517541359,3747889498,1645380198,1645380685,487,2185
3698633384,3761587047,1653927214,1653927748,534,1541
3692904228,3942393978,1643209877,1643210394,517,5
3292812509,3019601621,1646208261,1646208497,236,1128
3764492400,3714719241,1648838643,1648838970,327,2149
3148549210,3505417530,1642824909,1642825224,315,368
3425803609,3630318253,1654063394,1654064368,974,2300
3500216283,3504446959,1660252708,1660253588,880,904
3546006441,3836855857,1645179050,1645179263,213,542
3915439541,3870779720,1646794605,1646795380,775,1207
3962676436,3841459327,1668851837,1668852625,788,1532
3586405616,3271885744,1656937591,1656937610,19,1275
3967255191,3527291464,1658024114,1658024154,40,898
3842445140,3163551629,1667491218,1667491715,497,786
3012272703,3389546736,1665695769,1665695796,27,2248
3135116989,3130134092,1656826524,1656826800,276,461
3282839568,3246783185,1665179617,1665180502,885,771
3411993487,3550218169,1668994089,1668994345,256,709
3422106507,3650902153,1647506924,1647507090,166,76
3835612256,3962798581,1665840657,1665840831,174,1385
3593704176,3011993360,1664529035,1664529502,467,905
3506937925,3258102756,1665207212,1665207735,523,1128
3550702679,3928930330,1652265687,1652265913,226,1329
3925365269,3181388502,1650102218,1650102328,110,1671
3349433488,3880580622,1657463025,1657463038,13,1923
3275360473,3364390232,1649108548,1649108732,184,44
3677674125,3638595264,1645282415,1645283129,714,91
3807924634,3060883368,1647275321,1647275682,361,848
3285747162,3708809295,1665494223,1665494692,469,128
3659620596,3742275397,1644563371,1644563628,257,1007
3082026010,3976335280,1667762975,1667763334,359,2103
3087700946,3952282084,1650239821,1650240016,195,96
3722247979,3458243810,1664132094,1664132927,833,104
3685049252,3617958907,1644545623,1644546288,665,1873
3772980352,3621726953,1646474378,1646475337,959,1697
3141688992,3519233850,1643108802,1643108974,172,279
3239792198,3232781077,1643607975,1643608106,131,1573
3115367011,3021769525,1650011590,1650011747,157,1098
3974630210,3373729748,1650229605,1650229895,290,1134
3233222399,3105733809,1650531432,1650532010,578,2332
3700419429,3658477943,1646093595,1646094261,666,1440
3527106895,3507431231,1665832657,1665833515,858,1573
3634492534,3868397809,1652692980,1652693627,647,337
3347317107,3106328456,1663864335,1663864753,418,1417
3562105236,3009177873,1653112060,1653112360,300,1856
3890159677,3534224607,1663122341,1663122992,651,126
3090804084,3729389785,1666853414,1666853442,28,2154
3106429728,3408396410,1669097255,1669097573,318,683
3336211604,3093146280,1668517213,1668518101,888,2463
3763449384,3785638958,1659618034,1659618041,7,2118
3631152825,3110691442,1646210744,1646210934,190,838
3900356013,3520106918,1666550558,1666551193,635,761
3097789994,3617324068,1668871804,1668872370,566,440
3907700603,3517149250,1653515497,1653516052,555,702
3339027368,3400329831,1667847998,1667848050,52,1979
3086084685,3458971289,1644624190,1644625068,878,1086
3733143454,3403024728,1660535885,1660536589,704,108
3318577605,3904881288,1641156091,1641156374,283,1865
3571576669,3273518390,1657181403,1657181687,284,1045
3273857586,3397972687,1664654562,1664654597,35,1591
3392535031,3619800237,1645165712,1645166439,727,2362
3147512839,3114733025,1650341379,1650341531,152,14
3821979869,3968337751,1651880643,1651880671,28,1150
3061556470,3473399101,1668180622,1668180824,202,2099
3890448806,3458389447,1663990368,1663990391,23,118
3383573457,3010488834,1655524874,1655524924,50,122
3346631744,3233536885,1649064155,1649064998,843,1334
3158988425,3705943924,1661392067,1661392492,425,327
3947921257,3264121565,1661193121,1661193412,291,1311
3364586923,3846866111,1665501421,1665502022,601,17
3317431311,3601499230,1641233028,1641233611,583,1222
3194069746,3097128642,1645858454,1645859345,891,2401
3289693932,3465382952,1647215462,1647216173,711,1380
3325313312,3304499678,1657435378,1657435544,166,2164
3209150433,3329887381,1649070229,1649070847,618,1106
3179855785,3465238210,1653745114,1653745898,784,1124
3533898881,3503393955,1661181040,1661181439,399,2159
3936914064,3992919381,1647344041,1647344453,412,1444
3585100772,3629593465,1647632482,1647632842,360,5
3527995096,3469887287,1646418692,1646419686,994,1422
3404034127,3892469874,1647873795,1647873964,169,471
3169486525,3909278547,1642525873,1642526744,871,91
3924879744,3362091170,1642900516,1642900954,438,2371
3780808964,3604954681,1650034934,1650035762,828,1977
3784948704,3537943189,1645548766,1645549283,517,1885
3488813245,3315759953,1650072765,1650073254,489,2188
3788769219,3925481419,1644172054,1644172300,246,1276
3177628377,3529946433,1661999169,1661999998,829,2028
3481811999,3647255060,1660918630,1660919086,456,161
3742159503,3373566394,1641931065,1641931072,7,1324
3660998516,3012119082,1658125925,1658126636,711,1839
3507960689,3077346044,1666814562,1666815475,913,653
3730984573,3297477157,1645102391,1645103199,808,2284
3782457642,3253568318,1646824445,1646825121,676,2203
3670267009,3980283928,1666558864,1666559638,774,1261
3916290714,3143274658,1661510674,1661510700,26,248
3697085492,3085921604,1666236899,1666237181,282,1222
3717926703,3991046503,1649900259,1649900287,28,1867
3582033850,3826573375,1650844039,1650844884,845,2184
3896866052,3409949315,1645249253,1645249502,249,1275
3506384176,3656789430,1659058296,1659058654,358,1543
3573193288,3394695318,1663238030,1663238946,916,945
3461263871,3736911154,1668998704,1668999128,424,988
3407331091,3375759020,1662508436,1662509279,843,2252
3772406671,3037583613,1657331543,1657332367,824,407
3395782360,3110482626,1669166945,1669167785,840,1978
3044967578,3269966376,1659434558,1659435129,571,707
3292739128,3129283198,1668439084,1668439988,904,2011
3454753343,3288496623,1655834341,1655834614,273,2246
3241007838,3959093613,1650105785,1650106692,907,880
3722247979,3542078032,1641979868,1641980320,452,2229
3881002245,3784040148,1665125719,1665125908,189,1897
3547072063,3151436331,1654601685,1654602242,557,846
3185469541,3867554012,1650078014,1650078412,398,596
3990849115,3239517474,1661710941,1661711934,993,2425
3123999917,3034470773,1645520769,1645521313,544,2205
3003728684,3067539427,1645821245,1645821974,729,2460
3935601127,3005449860,1644392583,1644393377,794,837
3987735792,3450023391,1666647907,1666648761,854,1183
3334792271,3557556781,1659837865,1659838184,319,645
3890033502,3404934353,1663218400,1663218921,521,82
3489380093,3172293659,1652383587,1652384198,611,354
3751418832,3086835861,1662795022,1662795060,38,1934
3031241695,3862389429,1662851193,1662851953,760,564
3034815361,3749379310,1655602660,1655603531,871,2112
3020452542,3975075818,1661282721,1661283339,618,1297
3042432058,3871321308,1667107779,1667108141,362,1501
3657587705,3840659531,1652540906,1652541797,891,1536
3796875669,3013064040,1658235460,1658236004,544,2326
3567368088,3092925867,1643661045,1643661240,195,805
3420733881,3038849431,1668095868,1668096451,583,402
3295278768,3045427279,1664057497,1664057606,109,1453
3139376524,3790635482,1653792216,1653792905,689,1604
3411636309,3894413849,1647341996,1647342341,345,220
3273289104,3354200745,1644495522,1644495685,163,1485
3239517474,3006603067,1669408898,1669409770,872,2202
3328024680,3502432342,1662220585,1662221248,663,1945
3714259747,3978330638,1661412504,1661412775,271,600
3897739549,3241549340,1655977011,1655977942,931,1820
3973059785,3253589940,1668560552,1668561244,692,573
3079809630,3954490536,1650750237,1650750451,214,1412
3366558556,3701501875,1665279132,1665279201,69,1175
3103856643,3442799166,1659475213,1659475326,113,183
3544133682,3348568561,1662447980,1662448007,27,1157
3485695895,3257594028,1657387573,1657387663,90,504
3167864948,3338715388,1665495068,1665495387,319,2063
3033523546,3170537714,1647234027,1647234803,776,791
3747363730,3930205120,1655872206,1655873100,894,1104
3501820222,3277372807,1651988071,1651988623,552,498
3937197371,3885194706,1667449595,1667450391,796,2094
3267151775,3547365303,1648007923,1648008553,630,2384
3438084709,3449080412,1662756974,1662757872,898,1178
3058855369,3691032308,1659157141,1659157684,543,672
3678336055,3046043182,1653588799,1653589570,771,159
3386809097,3677539420,1653107304,1653107325,21,1485
3929312426,3041223311,1660444318,1660445314,996,2463
3251808759,3168576951,1643726747,1643727630,883,1485
3266828046,3759986276,1655086452,1655087132,680,1620
3451479071,3741978263,1648469995,1648470350,355,650
3028841213,3636619501,1657116743,1657116885,142,832
3534192041,3882254802,1645473765,1645474605,840,1892
3562116841,3606368289,1664447676,1664448366,690,911
3467383586,3345410681,1663052332,1663053085,753,668
3737420070,3070841779,1658116693,1658117268,575,1603
3756028002,3086076310,1643950972,1643951278,306,2034
3812034379,3304958701,1646429858,1646430564,706,629
3204912218,3346254669,1642635402,1642635491,89,1264
3930852270,3010373186,1662317784,1662318306,522,1879
3020683788,3980108258,1664097772,1664098218,446,1045
3131753608,3986557042,1659421479,1659422259,780,2478
3362836351,3058834310,1642022163,1642022381,218,88
3674349184,3941512307,1644160529,1644161240,711,398
3461108375,3786724835,1646325576,1646325712,136,775
3878177076,3831380073,1657138396,1657138562,166,1844
3458335460,3707258240,1660189717,1660190184,467,936
3244198823,3046085814,1669468294,1669468772,478,1520
3217583205,3884750087,1654526460,1654526558,98,1771
3688196978,3646544919,1665307066,1665307452,386,2183
3617340911,3080853733,1657906136,1657906531,395,443
3499541432,3511755413,1666797145,1666797427,282,1831
3161243271,3700968228,1649959063,1649959290,227,16
3321202962,3620236387,1665488510,1665489094,584,2208
3647640857,3739320901,1658081411,1658082006,595,2384
3839454838,3095437969,1656228640,1656228715,75,1663
3496617169,3808082891,1648564278,1648565026,748,485
3091062283,3449395269,1649163076,1649163668,592,1808
3918812791,3749619105,1661233394,1661234094,700,308
3426017820,3084940745,1662064812,1662065035,223,314
3622230392,3948969420,1664721447,1664721762,315,2449
3479580096,3289255457,1660191101,1660191996,895,104
3511569871,3975663862,1667037095,1667037433,338,477
3865511945,3688300477,1642975780,1642975796,16,532
3123795999,3458252541,1660594087,1660595012,925,1208
3554089401,3230775095,1646368015,1646368062,47,2280
3467650879,3671147965,1659803242,1659803646,404,1398
3085851145,3832719894,1668405116,1668406020,904,243
3472855930,3413319616,1664762398,1664762616,218,582
3010546611,3085093321,1654202215,1654202421,206,77
3787333178,3774945806,1646532541,1646532543,2,1368
3778147762,3158209281,1643069230,1643069450,220,1223
3702302181,3167494570,1664247482,1664248271,789,2061
3562456307,3791486887,1660637250,1660638238,988,2018
3883176560,3755413351,1669031804,1669032791,987,1757
3258050916,3061982327,1642863673,1642863867,194,1934
3462744716,3296895937,1651655812,1651655833,21,535
3637292465,3562110382,1649914775,1649915265,490,886
3980207883,3604757184,1656898753,1656899668,915,583
3995299995,3790751649,1668782352,1668782420,68,385
3769269484,3865964859,1647624395,1647625020,625,1616
3462543040,3149143223,1646969462,1646970329,867,2270
3680677416,3624748073,1666286655,1666286823,168,2348
3140608489,3806520351,1666626483,1666627258,775,859
3874913687,3338020076,1642128835,1642129728,893,2211
3054160201,3649649514,1655280160,1655280231,71,1534
3614741796,3650444993,1668083491,1668083742,251,842
3828342380,3673731636,1667729836,1667729901,65,2271
3542824458,3373566394,1668369245,1668369482,237,28
3129899259,3213836945,1650667504,1650668465,961,1888
3232737784,3351843519,1669606117,1669607040,923,2377
3485695895,3364888618,1659616374,1659616936,562,366
3415124478,3442477300,1661819360,1661820052,692,1791
3430375744,3039932020,1645795623,1645795893,270,323
3755228064,3925239812,1668781191,1668781927,736,1369
3875908590,3507939773,1664409656,1664410524,868,1525
3015876104,3440969146,1647965286,1647966267,981,1673
3557409187,3132611388,1651237689,1651237932,243,2459
3663814997,3743860568,1657667287,1657667409,122,1802
3844416504,3822146001,1658676814,1658677235,421,2256
3156331863,3185745995,1654283737,1654283942,205,999
3989563375,3091062283,1668736050,1668736989,939,1215
3004870031,3385760763,1658635818,1658636369,551,1742
3525192232,3432892677,1657679662,1657680410,748,1664
3877811036,3671748544,1659130434,1659131001,567,2115
3802816973,3779611783,1661982856,1661982990,134,2255
3279351560,3105449263,1656861434,1656861487,53,1445
3310294122,3216667034,1646910851,1646911592,741,626
3266991557,3194796707,1658120493,1658120555,62,1556
3987860424,3358968371,1666858067,1666858375,308,1813
3840906120,3803000258,1648833003,1648833489,486,158
3232497890,3264018414,1651081436,1651082093,657,1764
3471463543,3680810431,1651781887,1651782859,972,1866
3825930964,3819405521,1662340797,1662340828,31,213
3762890946,3577114014,1644126975,1644127080,105,1426
3689453273,3960727778,1662538594,1662538659,65,574
3991727598,3769290304,1645143497,1645144464,967,1058
3595726436,3103625074,1664946948,1664947809,861,575
3149534519,3254174311,1656933883,1656934444,561,1906
3894359262,3328015314,1641519723,1641520274,551,2190
3961183307,3216171635,1669120518,1669121471,953,1235
3757518149,3391658891,1643073205,1643073916,711,1402
3681001652,3696211720,1664128439,1664128905,466,209
3336551797,3749282990,1652115783,1652116221,438,735
3661642309,3577990920,1644681912,1644682503,591,451
3031103174,3389161785,1664762115,1664762939,824,303
3808415962,3486907422,1656292247,1656293183,936,2078
3853256957,3286555567,1666143011,1666143941,930,635
3950936299,3521944506,1656465639,1656466361,722,2
3152555864,3866993832,1666169577,1666169668,91,2490
3222282745,3392395230,1654298700,1654299072,372,253
3612612273,3042176960,1645146635,1645147055,420,1558
3496617169,3432864859,1659571961,1659572509,548,1273
3657464089,3444005080,1661269403,1661269674,271,1312
3622933919,3198999623,1666168407,1666169099,692,1185
3039035602,3893227652,1641086383,1641086875,492,1998
3566874478,3034255613,1650331333,1650332233,900,653
3007328261,3712332461,1651166775,1651167473,698,1796
3031292798,3587171844,1660440498,1660441174,676,2425
3069536467,3437259542,1650349179,1650350066,887,1370
3549431178,3881554146,1642350808,1642351635,827,1774
3340933137,3155807587,1645805781,1645806404,623,1647
3055145919,3217173480,1660210689,1660211173,484,1344
3632155506,3544772636,1669059913,1669060840,927,148
3835355277,3868440818,1643207265,1643207618,353,841
3470228949,3571348230,1658689762,1658689912,150,185
3816567987,3753596469,1642353715,1642354287,572,1063
3820585135,3211541773,1643122751,1643123385,634,1549
3035794185,3269622220,1667647555,1667648049,494,1086
3503842077,3668235327,1653187123,1653187195,72,258
3901360663,3928685907,1662596565,1662597212,647,540
3211401798,3940391939,1667344384,1667344464,80,312
3642377610,3981348782,1652331044,1652331734,690,145
3566693010,3850427038,1659222325,1659222743,418,108
3998850502,3896777982,1643176690,1643177058,368,734
3641752896,3086325930,1664087469,1664088335,866,2075
3383348505,3625772064,1652490110,1652490383,273,2015
3706304663,3472855930,1646565519,1646566275,756,1508
3781368357,3021683395,1654255111,1654255249,138,1536
3759967696,3975075818,1652288051,1652288452,401,7
3869293895,3778587500,1667016538,1667016705,167,176
3751300388,3213397142,1645643553,1645644119,566,1499
3858459394,3158834421,1669258699,1669259054,355,1889
3310951639,3908895548,1650842064,1650843056,992,9
3877090261,3691021918,1669596223,1669596722,499,1133
3287901684,3256648307,1661656711,1661657708,997,1809
3985308319,3422374987,1649189515,1649189521,6,1045
3864485247,3581302872,1645210588,1645210972,384,410
3819791378,3973948700,1654977825,1654978290,465,979
3885696227,3062410888,1658374910,1658375224,314,240
3636001595,3144993263,1654899584,1654900090,506,150
3126455934,3716757245,1655094658,1655095049,391,427
3166517941,3339856407,1660607105,1660607453,348,1944
3063478155,3917662641,1667459454,1667460142,688,892
3172429422,3142869544,1666126803,1666127187,384,1559
3553328177,3692691710,1667872090,1667872291,201,592
3956878212,3928894030,1652587232,1652587722,490,2188
3344205602,3149804005,1650133771,1650134234,463,581
3975504102,3302344507,1644287762,1644288270,508,2012
3048388831,3807549475,1652033399,1652033750,351,2091
3046190454,3315218003,1659471936,1659472331,395,1571
3395236647,3884949094,1644718021,1644718815,794,154
3364911803,3492258334,1665875847,1665876773,926,1400
3757499622,3351691261,1665828015,1665828950,935,89
3492909923,3688076815,1650550304,1650551293,989,473
3004964162,3750474676,1641706805,1641706866,61,623
3707676798,3776785233,1648126258,1648126418,160,886
3581083030,3496470143,1658579558,1658579576,18,1461
3827461144,3553096192,1654225547,1654226169,622,1070
3399055713,3435540149,1656544325,1656544878,553,387
3993580342,3428062841,1657871790,1657872045,255,2086
3532021354,3959081575,1667085300,1667085779,479,1007
3753596469,3988337484,1643151981,1643152541,560,1275
3618380884,3458815526,1657980606,1657980762,156,100
3389812297,3118057575,1658451720,1658452226,506,2057
3442779071,3309053474,1662614234,1662614320,86,1576
3378221943,3348620933,1648499056,1648499388,332,880
3104793032,3211514286,1658683171,1658683986,815,53
3629999604,3014646091,1660990321,1660990921,600,2321
3990949387,3751780241,1643211649,1643211891,242,1686
3780368492,3063955055,1645988186,1645988987,801,203
3650902153,3057159511,1667132712,1667133498,786,698
3599604382,3594231530,1658482631,1658482995,364,654
3995412026,3081028310,1644828973,1644829466,493,1829
3275649997,3382453510,1659578740,1659578964,224,1192
3354330082,3561573044,1643721444,1643721916,472,1278
3150817357,3972886254,1644417968,1644418040,72,491
3933940005,3298635617,1661265515,1661265609,94,552
3927886349,3638803969,1658432650,1658433286,636,1332
3057201124,3182643672,1661048016,1661048074,58,855
3097789994,3395782360,1666324365,1666324781,416,1857
3359296227,3167737446,1651424132,1651424560,428,1052
3450102071,3956887611,1658396664,1658397243,579,478
3793503160,3802890793,1667328827,1667329319,492,95
3012032774,3110591514,1665539042,1665539648,606,975
3920875021,3021769525,1658545243,1658545429,186,475
3884798812,3261128926,1664542735,1664543264,529,2464
3648072719,3702671465,1658179393,1658179725,332,969
3058927575,3687925631,1663905859,1663905976,117,2281
3146645864,3264079501,1665163419,1665164416,997,2155
3451823359,3821275122,1653833139,1653834122,983,1087
3269956451,3467383586,1645555365,1645556359,994,667
3998200859,3307636200,1647302168,1647302233,65,1151
3172305265,3963303057,1652939463,1652939949,486,1875
3711710728,3114361358,1661583116,1661583309,193,163
3242785599,3128839608,1642399186,1642399530,344,1478
3672371563,3867603056,1669355747,1669355753,6,1479
3369040211,3206106614,1652286477,1652287147,670,324
3666380447,3926467866,1660269419,1660269493,74,395
3245723038,3807576323,1647844781,1647845533,752,1841
3033692011,3179547560,1644269454,1644269767,313,313
3682922389,3404908537,1661074740,1661075568,828,296
3600856738,3481090623,1667318313,1667318564,251,1989
3284269721,3778381574,1658810417,1658810486,69,1522
3726788021,3491272857,1659350750,1659351723,973,744
3661016961,3978720869,1642248887,1642249669,782,1557
3965926652,3319422840,1657809239,1657810160,921,638
3086583569,3999390272,1651474853,1651474911,58,2105
3976267689,3397169008,1641708263,1641709112,849,392
3131025611,3569401888,1655608175,1655609110,935,1046
3187779586,3453227348,1660886227,1660886257,30,1332
3658428855,3884067849,1653491189,1653491530,341,820
3849028830,3109108614,1665491119,1665491787,668,1405
3974092782,3444067052,1662588361,1662588539,178,1867
3696432858,3492773808,1661696498,1661696544,46,1595
3041385548,3048402049,1669066425,1669067409,984,540
3868695814,3291267409,1652517268,1652518185,917,2489
3761556948,3172825605,1668544345,1668544352,7,1620
3442725932,3995868243,1662914580,1662915459,879,1555
3664337365,3500948971,1658803100,1658803961,861,588
3026035554,3421505883,1645344178,1645344963,785,388
3056501932,3762829533,1661708928,1661709690,762,1199
3562021711,3407746149,1641041104,1641041763,659,931
3629225227,3277883706,1660281586,1660281948,362,2022
3490381305,3934489625,1649135027,1649135128,101,1670
3932002704,3673761066,1651498895,1651499323,428,1630
3432186900,3584704567,1668316420,1668317202,782,1426
3074886612,3530278315,1642408887,1642409329,442,1192
3072741474,3577651077,1668418002,1668418088,86,826
3584660761,3760142759,1658972703,1658973295,592,812
3592487083,3069992620,1666953411,1666953461,50,2345
3366321387,3952316985,1659569498,1659569728,230,1428
3225741855,3708922840,1648534432,1648534590,158,675
3858150562,3095221133,1660843715,1660844298,583,511
3693475435,3865781327,1658529216,1658529742,526,69
3365807352,3760972512,1668091889,1668092484,595,988
3206549691,3927066139,1644085905,1644086357,452,877
3390445291,3819415032,1659928505,1659928757,252,2213
3525261242,3648593799,1667977825,1667978450,625,872
3566834497,3458209928,1646821545,1646822503,958,1475
3840807781,3005700539,1664565128,1664565176,48,853
3887305908,3601604629,1648343328,1648343787,459,18
3072720499,3759230876,1641726472,1641726503,31,2309
3068913990,3582478882,1663681722,1663681872,150,2446
3655923753,3895332326,1661818216,1661818249,33,523
3007328261,3184178717,1648492792,1648493095,303,1352
3609804397,3749897140,1668291098,1668291398,300,1097
3175595669,3888015355,1649107717,1649108402,685,385
3033523546,3450228800,1659568320,1659568453,133,2027
3819415032,3401597507,1657066369,1657067146,777,1207
3944398168,3143226144,1647613821,1647614469,648,507
3666338218,3784168038,1660902075,1660902486,411,1191
3283211870,3408396410,1651311829,1651312483,654,1129
3736911154,3483553551,1669423171,1669423504,333,1397
3845131231,3928354041,1666190685,1666191443,758,2065
3967439884,3154158203,1641067439,1641067563,124,2396
3696359426,3371707067,1656650256,1656651147,891,226
3389560959,3831009076,1651283355,1651283755,400,1523
3136174856,3857687791,1648673582,1648674520,938,1986
3219575313,3367915131,1645220129,1645220152,23,1973
3840533238,3370164589,1657751685,1657751773,88,768
3975096180,3067403592,1667458625,1667458877,252,2132
3114128222,3075519908,1653417086,1653417299,213,1657
3699427202,3944247629,1656242164,1656242281,117,1499
3014552263,3703943697,1669189813,1669190281,468,2276
3896922629,3382856674,1666116713,1666116844,131,2344
3177491349,3307067721,1667672764,1667673688,924,723
3663342046,3217137285,1657676576,1657677222,646,1379
3368630986,3264993323,1664070689,1664071535,846,1530
3400163448,3434662490,1654824454,1654824941,487,11
3438892275,3903709933,1642728980,1642729162,182,2203
3178732875,3614399988,1641183485,1641183943,458,2359
3321312190,3545701656,1668554609,1668554662,53,1351
3008372630,3437259542,1657449593,1657449849,256,2219
3527995096,3716977635,1666304537,1666304800,263,1968
3391857064,3479308343,1654155259,1654155400,141,269
3712581685,3209480732,1654429156,1654429486,330,959
3842413213,3964565126,1642630890,1642631652,762,1374
3641542734,3695161514,1661786518,1661786764,246,672
3228110844,3206399216,1648210741,1648211589,848,843
3983162503,3593487418,1662395509,1662395975,466,1133
3939181696,3185512282,1645004793,1645005168,375,1318
3561692706,3735277639,1648714021,1648715009,988,875
3720307988,3435224460,1642828463,1642829406,943,603
3532926054,3969960450,1663157765,1663158523,758,418
3785813162,3101137807,1644962739,1644963298,559,2050
3058141936,3320187187,1667404834,1667405598,764,793
3152554117,3659752387,1659460227,1659460642,415,657
3496040749,3760304580,1646659065,1646659419,354,1839
3916290714,3928894030,1662667278,1662667709,431,2082
3894359262,3110733657,1641778724,1641779420,696,1591
3325735498,3904625406,1662941286,1662942222,936,1440
3347990376,3596179079,1659604233,1659604378,145,174
3183340735,3924577071,1648722202,1648722328,126,2296
3978728021,3033349787,1654072685,1654072928,243,1084
3168655636,3399631396,1649364241,1649365094,853,2007
3363768036,3990870728,1644595931,1644596363,432,2142
3369865184,3217857851,1649512908,1649513808,900,929
3609104298,3488001885,1646096780,1646096851,71,668
3002013720,3687243333,1660640030,1660640922,892,380
3830015015,3255904598,1654556366,1654557005,639,1349
3343177837,3108342285,1647757584,1647758534,950,1277
3049869003,3306515955,1653379917,1653380289,372,1727
3577990920,3478219461,1650483241,1650483676,435,680
3564033398,3008417861,1667958547,1667958830,283,448
3018325807,3930142533,1644676003,1644676777,774,283
3413984037,3438961567,1646410820,1646411597,777,340
3617349707,3584660761,1648399106,1648399619,513,1656
3488280503,3645943439,1653507209,1653507449,240,368
3587568478,3392534730,1668710168,1668710439,271,990
3395479272,3285331142,1646582424,1646582729,305,979
3903886201,3907872554,1650620063,1650620881,818,1195
3648072719,3549105154,1642912538,1642912717,179,143
3651812819,3972886254,1665172118,1665172255,137,1847
3212038287,3705919583,1654143746,1654143931,185,720
3997312356,3691607111,1666035232,1666035875,643,1688
3250248786,3100027110,1642078838,1642079296,458,798
3565056457,3573158941,1649044803,1649045053,250,685
3919562972,3357474960,1642845545,1642846395,850,793
3859164696,3722817789,1666151950,1666152520,570,904
3041809783,3939768853,1657901146,1657901272,126,1348
3422046745,3116684420,1645791901,1645792094,193,1164
3090731052,3319545220,1648884467,1648885013,546,2486
3190859932,3423965711,1651147457,1651147587,130,321
3094291821,3659224437,1655383917,1655384163,246,16
3959081575,3234030791,1661089431,1661090039,608,537
3880599649,3982538753,1665072741,1665073684,943,1770
3369913868,3261003235,1654966338,1654966579,241,1277
3157212376,3321346285,1659073857,1659074515,658,539
3942140107,3536768410,1659294275,1659295119,844,396
3916244157,3563246157,1643674010,1643674920,910,1672
3163030169,3289850617,1652118192,1652118197,5,158
3222563704,3047643464,1655083156,1655083176,20,1207
3185373368,3309242036,1654209460,1654210307,847,2065
3142899759,3653285237,1650384532,1650385294,762,1641
3405358639,3682028611,1645056143,1645056190,47,1165
3312930717,3427405967,1650435204,1650435905,701,232
3678720106,3401138486,1669210429,1669211143,714,916
3453227348,3058855369,1663467991,1663468525,534,583
3832296106,3985901910,1651483703,1651483851,148,560
3945881377,3052396813,1658015221,1658015709,488,1889
3968143962,3145344208,1649716149,1649716975,826,2319
3238081511,3038067120,1665166121,1665166422,301,659
3936122118,3914166761,1652517216,1652517419,203,1147
3003116947,3927952722,1666656842,1666657738,896,1518
3557409187,3070054244,1656185954,1656186837,883,1992
3867857893,3825484587,1668591306,1668591504,198,1540
3768984387,3766914780,1653628343,1653628879,536,2413
3352005808,3953224601,1649545182,1649545429,247,358
3412501516,3649298405,1667599653,1667600552,899,309
3816015403,3577798894,1644317746,1644318209,463,1759
3005480994,3560756539,1642946039,1642946177,138,964
3264345880,3570050230,1645692874,1645693857,983,1944
3936154124,3401463703,1649915778,1649915916,138,24
3438188875,3650563043,1664299990,1664300422,432,1716
3798509385,3765827886,1656901671,1656902484,813,1245
3172018366,3948942044,1646387213,1646387319,106,1473
3715731774,3870359885,1665729566,1665730208,642,309
3661372760,3928212115,1660188029,1660188668,639,499
3323783108,3243005694,1652524373,1652524568,195,1040
3276142713,3521410258,1666763976,1666764471,495,1803
3835601308,3941317555,1651372140,1651372625,485,16
3603092087,3633479779,1657226918,1657227863,945,1957
3417742545,3330817237,1646810921,1646811653,732,801
3254174311,3316625530,1652987525,1652988428,903,1048
3037130270,3955219063,1651453400,1651453826,426,2267
3309305862,3222870125,1667723960,1667724166,206,727
3419751912,3549604297,1642023387,1642023488,101,441
3158503756,3591834837,1668109675,1668110333,658,2397
3835708711,3937729247,1652940870,1652941536,666,252
3359417056,3268216928,1641677006,1641677775,769,2141
3784414098,3922925129,1643481416,1643481611,195,1777
3179354869,3101669976,1656803234,1656804039,805,1993
3741024153,3673550835,1666764657,1666765016,359,1075
3082075242,3401738714,1665460577,1665461519,942,2000
3504796283,3227951880,1663743185,1663743414,229,302
3952552328,3040889811,1650675288,1650676060,772,942
3526798607,3915637706,1659262232,1659263144,912,1413
3116281998,3929312426,1646839082,1646839718,636,2261
3016995357,3437603547,1663925115,1663925739,624,1043
3553048423,3896091695,1663963538,1663963936,398,2440
3707604534,3049969877,1647686405,1647686742,337,1556
3948754212,3029149493,1655675267,1655676087,820,290
3315854812,3682419396,1649898829,1649899376,547,728
3572325072,3621000186,1644504959,1644505377,418,630
3066360181,3047477485,1657374445,1657375416,971,1849
3772178120,3968076690,1669026599,1669026695,96,1029
3014646091,3489466063,1669553280,1669553623,343,2063
3123522446,3170036337,1655250522,1655251137,615,2315
3885555985,3732796331,1666392781,1666393481,700,1264
3170058626,3745289284,1650928001,1650928079,78,839
3481090623,3268916307,1662397202,1662397817,615,1115
3615359458,3584910336,1648747360,1648748254,894,2445
3438084709,3127549843,1651644114,1651644994,880,696
3026769225,3880196075,1647942814,1647943394,580,1956
3774325139,3179354869,1651151701,1651152435,734,2151
3116777827,3276576100,1664610966,1664611487,521,1528
3528146911,3532926054,1669467299,1669468113,814,1987
3583918364,3915206176,1658630871,1658631267,396,137
3393000047,3934383056,1667626340,1667627007,667,748
3734367959,3084138267,1646534628,1646534683,55,922
3062435759,3559208316,1660722428,1660722589,161,316
3196079047,3897211381,1655054280,1655054967,687,1677
3349566530,3329135548,1642651380,1642651944,564,242
3768549498,3754292816,1655348470,1655349018,548,1429
3034815361,3852731262,1669511314,1669511769,455,1274
3762538736,3432864859,1647432516,1647433142,626,406
3154009016,3382777450,1644515562,1644515682,120,604
3035946381,3089699104,1646202634,1646202808,174,754
3086950119,3833230225,1647647823,1647648424,601,989
3145344208,3253395374,1651761085,1651761087,2,1008
3784698616,3620311248,1658013468,1658013655,187,862
3886344418,3545544203,1650027208,1650027606,398,221
3007308564,3352316809,1659669655,1659670610,955,1716
3209097023,3024431618,1644877898,1644878475,577,1119
3779331078,3339459948,1644624588,1644625308,720,294
3563103144,3982210988,1649526104,1649526466,362,2
3289799796,3242235161,1648687152,1648687755,603,2025
3089548621,3556000533,1652271136,1652272045,909,2187
3732472752,3293615945,1649200452,1649200730,278,319
3870384331,3772178120,1655633406,1655633987,581,1023
3755294305,3719507293,1668962565,1668963024,459,1238
3919162177,3799078288,1663297255,1663297899,644,1693
3948964302,3133694612,1641187235,1641188104,869,1720
3073967597,3125436993,1663930006,1663930507,501,452
3045925838,3355910238,1655654650,1655655386,736,948
3609804397,3343729897,1645153573,1645153681,108,1580
3930794939,3958920817,1647110832,1647111221,389,79
3653031568,3533274758,1648973449,1648974072,623,994
3257865090,3682116874,1660583629,1660584094,465,186
3280818938,3147336288,1661573609,1661574424,815,772
3686025670,3771931468,1668538687,1668539446,759,1820
3952620083,3402354750,1658388779,1658388888,109,1648
3734099449,3549752945,1667415033,1667415468,435,42
3194379247,3315283904,1660935911,1660936793,882,2218
3828531030,3957577990,1668654064,1668654082,18,2146
3860879385,3997177535,1645924664,1645924738,74,1025
3519828744,3998641184,1663739525,1663739611,86,2471
3657464089,3809387134,1643615422,1643615860,438,420
3798728420,3586734200,1652197287,1652198083,796,1727
3801038758,3697822889,1662763063,1662763828,765,769
3192375486,3356144129,1647267029,1647267576,547,2223
3197323395,3035245517,1644345773,1644346496,723,1360
3165973608,3931789231,1650085711,1650086526,815,1484
3573692342,3692498377,1644707889,1644708525,636,569
3358578228,3093131372,1659803567,1659803899,332,1312
3789999187,3075563867,1664626809,1664627415,606,98
3077346044,3907299052,1661316719,1661317076,357,1537
3676100322,3677893619,1649528816,1649529007,191,158
3936179181,3714538351,1669482357,1669482865,508,1609
3068161140,3773770885,1666602458,1666603047,589,1260
3649465172,3554600361,1649182807,1649183351,544,596
3801847517,3971180079,1668298283,1668298801,518,2397
3752652141,3519233850,1657930954,1657931648,694,2283
3739048247,3504919226,1666921476,1666922424,948,788
3948833001,3952286494,1657912614,1657913241,627,607
3785426867,3217173480,1668094481,1668095043,562,1396
3546486600,3316237227,1655354858,1655355657,799,918
3117575075,3189396065,1642766575,1642767079,504,1520
3625979408,3097161771,1668730604,1668731530,926,2268
3439303987,3524131973,1665884871,1665885576,705,2292
3967015655,3981515277,1663693910,1663694039,129,2043
3323834326,3821157240,1658466258,1658466687,429,1698
3039001408,3596932196,1648102666,1648103281,615,1605
3188726102,3557087358,1652117203,1652117407,204,892
3588936901,3041652512,1653312990,1653313645,655,2017
3550820934,3215423327,1667693279,1667693665,386,2143
3303986609,3435319506,1668489762,1668490500,738,780
3085429140,3658451605,1669630164,1669630725,561,304
3392918310,3575576911,1651259168,1651259287,119,639
3925344243,3885162740,1644783346,1644783363,17,1266
3808082891,3271409183,1650662449,1650663201,752,349
3599551667,3626156541,1669467833,1669468142,309,261
3148400970,3082108681,1657209782,1657210107,325,1667
3167074299,3391857064,1642544536,1642544837,301,959
3113214024,3968297784,1647668681,1647669058,377,1604
3604308622,3090354216,1649999829,1650000029,200,946
3288496623,3902329320,1659821632,1659821660,28,2004
3545658442,3980087695,1659816859,1659816908,49,331
3004951157,3425006843,1659411078,1659411397,319,946
3261527870,3589157304,1657460048,1657460320,272,816
3563750578,3823650698,1665262664,1665263482,818,1061
3816026938,3553048423,1660116230,1660116318,88,1987
3840003483,3945397961,1669142194,1669142885,691,1121
3163921304,3800566657,1647423096,1647423774,678,517
3564667780,3377868003,1645187930,1645188552,622,259
3269680998,3670154961,1658957506,1658958075,569,562
3416230781,3114097031,1654242440,1654242629,189,563
3623206706,3653183152,1658574546,1658574885,339,1595
3284443787,3396406579,1656051208,1656051993,785,1153
3229871774,3815779833,1669094142,1669094263,121,2174
3025611145,3098198877,1664387265,1664387934,669,2066
3019576854,3236132865,1650470548,1650470674,126,1255
3558733181,3191265442,1664428710,1664429227,517,1430
3605699054,3325962611,1646627654,1646628093,439,128
3315759953,3442967650,1644319837,1644319921,84,1393
3154288650,3299211422,1656358752,1656359570,818,273
3405319002,3365615023,1662875086,1662875221,135,1404
3654381548,3856985099,1649171399,1649171994,595,711
3192175476,3916674515,1641755534,1641756034,500,1748
3080703553,3414370730,1643283732,1643284063,331,2312
3323217825,3832252723,1666844104,1666844203,99,1822
3260085949,3880046311,1647918056,1647918131,75,511
3372197177,3722817789,1642962551,1642963038,487,1968
3591348696,3719503327,1660670565,1660671000,435,2459
3130612494,3402019498,1643269380,1643270293,913,2083
3292782964,3095559156,1662981577,1662982349,772,1288
3053026624,3070557341,1665603401,1665604133,732,1691
3924960579,3790829012,1661909022,1661910022,1000,1681
3176317370,3142869544,1656051305,1656052103,798,1242
3791894034,3553530817,1655103923,1655104865,942,2210
3253913009,3064758483,1648531984,1648532196,212,21
3744234480,3125350196,1649838178,1649838548,370,1613
3086324092,3341241551,1651463474,1651463546,72,837
3733004020,3564667780,1658818782,1658819291,509,1740
3804329236,3458243810,1661701285,1661701807,522,53
3284443787,3412047712,1650171526,1650171765,239,991
3693925345,3225616352,1664491470,1664492108,638,874
3980675077,3414224162,1641665323,1641666215,892,1176
3576317139,3595469152,1667328645,1667329545,900,1422
3801956152,3934386586,1651521912,1651522597,685,6
3838160976,3633479779,1642070667,1642070774,107,518
3755962729,3870243569,1645343937,1645344766,829,1721
3211064928,3549703546,1664739182,1664739366,184,1116
3398242179,3359278409,1647246733,1647246985,252,557
3669744444,3235992794,1660453650,1660454013,363,2157
3749161560,3956194935,1653792210,1653792952,742,764
3957577547,3787514151,1658008385,1658008711,326,1140
3104050460,3802545642,1665888621,1665889590,969,838
3953483372,3137967669,1648768221,1648768838,617,31
3237563954,3256807270,1645155694,1645156254,560,39
3634539557,3833679984,1651656065,1651656300,235,1032
3036470049,3787920743,1661036804,1661037286,482,1011
3677674125,3727801252,1645010156,1645011014,858,1011
3598522904,3436888201,1649786981,1649787396,415,1876
3664267954,3790964737,1658485528,1658485939,411,1128
3835922991,3086076310,1641331183,1641332050,867,2165
3731828976,3037846389,1644835386,1644836135,749,137
3688790539,3869991101,1651413746,1651414193,447,1027
3137803904,3563343479,1644496929,1644496950,21,2376
3787230225,3429101401,1661966424,1661966639,215,1982
3104816625,3529898997,1660452120,1660452969,849,1740
3413810353,3325735498,1652947424,1652948114,690,390
3645073300,3557835284,1641394012,1641394688,676,1414
3732456028,3580531210,1644227919,1644228723,804,1960
3962773297,3585832857,1663846781,1663846991,210,2302
3129677855,3615359458,1668288339,1668288940,601,1258
3849028830,3505197900,1646630117,1646630395,278,646
3132349279,3088465843,1644087781,1644088746,965,986
3626015702,3359278409,1669148274,1669148762,488,1725
3209544947,3080853733,1647837570,1647837849,279,1062
3487756836,3832296106,1659162078,1659162482,404,1951
3206197726,3880608911,1654397472,1654398206,734,1184
3097457183,3862456223,1644974022,1644974460,438,538
3203691315,3927284839,1656131433,1656132229,796,1862
3457542537,3481548873,1644418001,1644418677,676,758
3040219251,3484710507,1654829075,1654829207,132,2367
3149818961,3688910009,1650609186,1650609315,129,1356
3211839563,3266681677,1652836442,1652837128,686,2491
3473102313,3958920817,1658971051,1658971290,239,61
3338154846,3595984663,1661992949,1661993260,311,943
3583864167,3532450192,1655615765,1655615814,49,1798
3980139195,3586524207,1656343127,1656344049,922,973
3095932716,3782673553,1668678623,1668678999,376,1751
3968297784,3920028342,1666570459,1666571455,996,1196
3276458676,3589984222,1651641232,1651641431,199,809
3292572977,3059416141,1661565823,1661566724,901,2413
3715231431,3888670009,1666668146,1666668391,245,2025
3399334455,3257690557,1649044824,1649045487,663,1594
3000890083,3862122399,1647342060,1647342684,624,144
3499739176,3496369924,1656883368,1656883891,523,2127
3719455699,3674271275,1655731729,1655732468,739,895
3780654306,3809312897,1657108859,1657109396,537,201
3607352755,3727859047,1669466799,1669466847,48,2140
3944247629,3145552419,1642280425,1642280726,301,1721
3246783185,3779331078,1651503306,1651503532,226,890
3408944120,3922385616,1642229989,1642230501,512,2108
3633479779,3617795950,1662427016,1662427699,683,487
3380928920,3441581446,1659450603,1659451205,602,1924
3496617169,3995654203,1654049757,1654050204,447,707
3067179904,3531345844,1668781396,1668781397,1,1338
3048781539,3586950573,1647674944,1647675291,347,2147
3879157400,3974092782,1659912467,1659913429,962,87
3204935260,3388490960,1647423937,1647424118,181,1970
3790356065,3089325315,1641520192,1641520358,166,1402
3468516508,3355429456,1656804831,1656805553,722,1903
3689453273,3942140107,1654571432,1654571593,161,2499
3720240255,3031249180,1667112213,1667112833,620,1244
3204912218,3443131930,1664062212,1664062995,783,218
3232285985,3013314607,1644489887,1644489962,75,856
3134890095,3286555687,1643504834,1643505642,808,1322
3396154732,3368630986,1665739094,1665739141,47,60
3067380299,3463973561,1666284440,1666285351,911,1896
3232304638,3070676307,1662848522,1662848982,460,1845
3737086539,3785721693,1653627155,1653627155,0,633
3321441782,3111639847,1643857766,1643858527,761,1559
3120505983,3153541916,1659740032,1659740293,261,48
3480984393,3625611440,1665334151,1665334838,687,0
3202063550,3673743780,1645438824,1645439739,915,1725
3789380087,3790406016,1646455760,1646456699,939,1606
3161243271,3157600969,1646096176,1646096487,311,279
3013433465,3890159677,1668810167,1668810339,172,407
3948833001,3984977278,1650514323,1650514546,223,1968
3719763865,3370267721,1653217020,1653217759,739,333
3004160380,3679615343,1669098776,1669099657,881,1108
3270177744,3129677855,1658629043,1658629323,280,2498
3408604990,3681001652,1664506782,1664507390,608,528
3839454838,3223518905,1665441400,1665441938,538,595
3494990710,3799776825,1659163113,1659163963,850,2444
3614430693,3191265442,1652633457,1652634241,784,1312
3248250292,3794575914,1654619956,1654620076,120,2449
3905999483,3501972053,1649441502,1649442201,699,1923
3977107209,3141108539,1647679134,1647679754,620,1307
3029956642,3505322684,1644938403,1644939273,870,2039
3215423327,3520825972,1658074084,1658074224,140,288
3743682237,3173667762,1665891228,1665892167,939,1426
3235086334,3802823421,1665096273,1665096744,471,1200
3050244048,3271479070,1641341108,1641341674,566,1815
3617349707,3723870491,1662299918,1662300863,945,249
3800337461,3914926954,1669715658,1669716563,905,60
3913366963,3911392700,1649540849,1649541548,699,1220
3728506494,3212095735,1650285608,1650286001,393,1502
3776685300,3018756378,1654762755,1654763630,875,2395
3837877764,3689032543,1661281352,1661281576,224,1364
3350017208,3646687421,1649540173,1649540419,246,1252
3140407144,3715994986,1656755659,1656756249,590,2145
3911891369,3894359262,1668082730,1668082890,160,320
3802816973,3599007187,1654708990,1654709931,941,794
3707767360,3479401831,1664721393,1664722323,930,630
3888764578,3432462167,1665477743,1665477978,235,1774
3595469152,3048405710,1659267046,1659267186,140,2046
3522963106,3817548425,1654853350,1654853589,239,488
3012593677,3971524060,1651623609,1651624011,402,1069
3036448305,3165307890,1660839813,1660840525,712,2292
3262645455,3854184537,1653595020,1653595640,620,1378
3653335612,3229318915,1666913006,1666913245,239,652
3929464797,3294703062,1655357194,1655358046,852,1535
3331255997,3232436630,1664849068,1664849250,182,562
3149668198,3389812297,1647548243,1647549075,832,221
3784959270,3518246885,1662714664,1662715539,875,1494
3541372095,3992345499,1661142040,1661142203,163,321
3069316815,3707947874,1661204473,1661205293,820,191
3805314214,3804145408,1649905086,1649905921,835,152
3972441567,3785586097,1655724581,1655724743,162,1496
3276458676,3658295713,1666158699,1666158860,161,610
3868427833,3928727074,1654698406,1654698680,274,854
3856756422,3742159503,1668733635,1668734118,483,2292
3681993008,3428557602,1649203156,1649203260,104,130
3913071555,3044967578,1662151335,1662152055,720,1951
3228565452,3529056509,1669122177,1669122995,818,2492
3584660761,3738761840,1669259997,1669260699,702,2258
3337108824,3271039091,1667597529,1667598225,696,35
3290710394,3104303534,1648298338,1648298697,359,689
3325735480,3427520419,1665455656,1665456056,400,1786
3594707374,3835784338,1660813772,1660814140,368,850
3477363517,3664989774,1645407869,1645408504,635,1290
3379829698,3255248380,1656594909,1656595774,865,1559
3981515277,3126778118,1661241158,1661242022,864,50
3310970237,3846585557,1653859212,1653859594,382,2307
3115245083,3058290794,1642971373,1642971513,140,2215
3426017820,3405799068,1660539952,1660540763,811,2133
3764298989,3777684793,1652798495,1652799160,665,1981
3807549475,3344957789,1666837763,1666838716,953,804
3090910630,3261913628,1645482319,1645482850,531,2149
3668471634,3716861274,1665879321,1665879988,667,2183
3571477883,3545652885,1644921300,1644921800,500,1398
3278886018,3691317999,1669729599,1669729901,302,131
3533954093,3242180365,1643300286,1643300994,708,2154
3438465122,3344205602,1656783817,1656783855,38,1476
3245723038,3780808964,1657292607,1657292789,182,1926
3031249180,3472112661,1660337172,1660337792,620,866
3838250910,3676893681,1662529246,1662529573,327,1379
3732796331,3988539489,1647043657,1647044008,351,1299
3821391381,3091418450,1660419165,1660419770,605,623
3640387984,3771028638,1661961380,1661961963,583,874
3296151097,3450102071,1652794420,1652795029,609,1677
3357966828,3594231530,1659709037,1659709121,84,1155
3260571568,3034159032,1661916429,1661916949,520,1343
3112419355,3782266785,1656094318,1656095123,805,1503
3914946558,3520511256,1649819642,1649820572,930,2024
3204346356,3159525512,1664883465,1664883841,376,2291
3289437738,3651900802,1658971980,1658972626,646,1413
3765693461,3102776006,1653038986,1653039424,438,13
3894844173,3799287196,1654130101,1654130345,244,2120
3713308621,3054432255,1662049349,1662050079,730,1630
3676634608,3172130228,1666740800,1666741531,731,827
3899782287,3660577882,1651826110,1651826128,18,1936
3993504996,3896866052,1651270333,1651270514,181,2370
3010161936,3340337106,1663953864,1663954044,180,640
3289799796,3319601888,1661871939,1661872171,232,1099
3297949666,3066757468,1668487149,1668487713,564,89
3812239613,3321818923,1644656518,1644657181,663,368
3010713914,3636132038,1648917466,1648917933,467,1988
3152456543,3909585382,1647284641,1647285123,482,830
3826956383,3359278409,1647259741,1647260573,832,380
3283447626,3496921526,1641271924,1641272458,534,2427
3122109326,3977872515,1663760399,1663761123,724,1058
3355078629,3936029875,1653055699,1653055777,78,725
3099818927,3255252214,1648918959,1648919331,372,1303
3304958701,3998763119,1661175903,1661176243,340,2229
3143189190,3806629780,1644284290,1644284444,154,1332
3336376139,3866921322,1649246635,1649247164,529,285
3297826818,3639117164,1659105707,1659106651,944,1966
3573975424,3114036217,1659540713,1659541028,315,544
3152537793,3283447626,1662987274,1662987759,485,651
3677001111,3314583046,1641448206,1641448933,727,242
3967147343,3205809646,1656217145,1656217593,448,2235
3532355049,3357474960,1661690037,1661690408,371,1163
3301994647,3537151295,1662916300,1662916802,502,117
3363651899,3460229906,1652254266,1652255212,946,1883
3289799796,3775753518,1663821001,1663821362,361,398
3276118203,3208757755,1649504814,1649505349,535,1953
3475686271,3060728062,1665877812,1665878786,974,247
3576284955,3337624186,1655721507,1655722440,933,1987
3569478966,3016068435,1652552338,1652552464,126,1752
3428176980,3711422567,1648748693,1648749356,663,442
3226220903,3572792752,1656515416,1656516162,746,773
3775565964,3723870491,1650120653,1650121336,683,1134
3045691620,3561543601,1641340291,1641340682,391,2252
3063715610,3975379893,1653105306,1653105421,115,1188
3572325072,3162405135,1655280740,1655281292,552,1681
3070588700,3457468984,1649013972,1649014436,464,206
3183867254,3050607996,1651198104,1651198605,501,2214
3653069495,3711576021,1645085621,1645085921,300,1588
3556819852,3205864966,1663445302,1663445697,395,2010
3319506258,3362598320,1658936797,1658937078,281,197
3766966794,3744196402,1663943075,1663943702,627,1599
3266127117,3106584115,1665906661,1665906807,146,1769
3675418278,3768984387,1642455358,1642456300,942,1016
3544227988,3949133704,1666697346,1666697580,234,2321
3035135381,3567368088,1668335299,1668335523,224,164
3714259747,3816538946,1644083346,1644083722,376,966
3911849911,3577878798,1656048353,1656048727,374,2163
3014646091,3195716414,1665423198,1665423528,330,2011
3647994845,3297949666,1654693707,1654693811,104,250
3759967696,3446156273,1652373920,1652374766,846,1833
3350812449,3197282936,1655892472,1655893468,996,755
3996469603,3244997486,1652172952,1652173820,868,353
3467211844,3702345362,1650669158,1650669514,356,1284
3104396432,3888757366,1650673006,1650673088,82,602
3460552791,3984259471,1661397327,1661398107,780,2207
3621462507,3829546967,1664387902,1664388785,883,231
3095559156,3233507128,1659405066,1659405495,429,2280
3074412412,3712195438,1662381826,1662382161,335,1938
3414748923,3415584739,1654380872,1654381326,454,1596
3574486853,3964711138,1664505426,1664505817,391,2021
3504893701,3521258004,1668687053,1668687842,789,2467
3797769846,3653850140,1653402016,1653402261,245,814
3255776587,3627902900,1642319931,1642320052,121,457
3889498156,3080325374,1647256566,1647257129,563,2308
3066588932,3057725565,1668583852,1668584831,979,902
3793772897,3512502358,1647256815,1647257459,644,2413
3687215472,3096408604,1647483247,1647483849,602,59
3047922240,3952552328,1644421048,1644421620,572,2269
3749266673,3817252660,1657575083,1657575382,299,475
3503489321,3632283664,1644419282,1644419505,223,2090
3659299466,3938416139,1664313469,1664314403,934,1469
3090804084,3772178120,1641221103,1641221810,707,676
3128133737,3814608487,1657259364,1657259834,470,1818
3461628724,3894382679,1642195345,1642195839,494,1261
3503510962,3846298815,1659343315,1659343968,653,2272
3252753513,3900051900,1656613337,1656613570,233,1152
3334965309,3102820806,1663872663,1663873076,413,1347
3894508827,3783119155,1652446085,1652446529,444,38
3575277293,3964830238,1642954391,1642954631,240,1097
3805953085,3756020689,1663748383,1663748555,172,1003
3960494982,3591724433,1659036707,1659036900,193,1474
3029481461,3756778635,1659546762,1659547434,672,2472
3463973561,3164789962,1649320280,1649320529,249,1962
3686320266,3387170357,1645333749,1645334675,926,699
3805742408,3445714649,1649473236,1649473885,649,204
3557559741,3824845857,1642357797,1642358773,976,961
3662455665,3646536668,1661341190,1661341511,321,1049
3622848449,3336127092,1645103059,1645103932,873,2431
3802694367,3043611684,1667848599,1667848737,138,2173
3413319616,3927952722,1644506446,1644506950,504,1140
3942393978,3173586762,1669203773,1669204648,875,1598
3721340009,3796990042,1651211816,1651212100,284,956
3638803969,3880849800,1662393817,1662394272,455,1865
3625869317,3260306978,1660678723,1660678936,213,1399
3996963058,3304252236,1642045823,1642046495,672,2495
3814355412,3771588829,1669556227,1669556626,399,1052
3929312426,3743682237,1641526233,1641526467,234,2404
3622933919,3149143223,1666512250,1666512669,419,1301
3347397074,3237987905,1663917292,1663917713,421,42
3880298832,3868630067,1650129614,1650129708,94,56
3135712818,3710189327,1659928320,1659929306,986,783
3798509385,3337624186,1646979025,1646979263,238,385
3407513744,3953465037,1665256719,1665257219,500,726
3365289656,3716757245,1647241197,1647241358,161,338
3352667302,3870463011,1646876553,1646876683,130,2390
3699152541,3591264259,1646110547,1646111241,694,1538
3785813162,3112856155,1650225274,1650225372,98,2498
3483666747,3552091513,1657801872,1657802442,570,1960
3647216166,3316485303,1656634511,1656635264,753,1768
3287600901,3946015739,1656984415,1656985252,837,1502
3420676198,3244763805,1664173191,1664173766,575,250
3965164080,3744563835,1649662583,1649663404,821,1143
3284948113,3364938815,1651208449,1651209080,631,1503
3519828744,3909002163,1662367355,1662367759,404,2200
3216667034,3838160976,1667161677,1667162092,415,1366
3734518688,3799459873,1648837502,1648837640,138,251
3145389444,3530462613,1640991701,1640992234,533,571
3278689627,3244502667,1656213301,1656213868,567,2331
3327795374,3378522829,1641838434,1641839024,590,2055
3269966376,3021515419,1644466007,1644466362,355,1314
3480308437,3364945349,1642466272,1642466397,125,1918
3270111894,3054927562,1644672469,1644672723,254,1920
3369731959,3156928973,1663314749,1663315619,870,70
3094361527,3860432776,1655741687,1655742025,338,1835
3617715231,3089574886,1651006695,1651007319,624,737
3224952698,3284940142,1668550869,1668551824,955,1750
3983694493,3161999632,1648640745,1648640875,130,434
3118406319,3260157601,1657983235,1657983300,65,2497
3131156982,3999314182,1665258329,1665258568,239,1599
3420137628,3960727376,1658591013,1658591635,622,1934
3914006102,3748950684,1642066361,1642067045,684,247
3971020365,3368654717,1655249082,1655249114,32,133
3846060378,3708134798,1659625031,1659625754,723,1618
3644100988,3861717658,1663172163,1663172927,764,865
3953118937,3182243157,1657587096,1657587325,229,2122
3508224327,3175196290,1645353210,1645353437,227,471
3264317816,3412989654,1667862757,1667863079,322,1837
3726378645,3372197177,1651318188,1651318847,659,224
3495798110,3462224632,1666025882,1666026567,685,1773
3935809720,3855754332,1643235075,1643235499,424,1652
3772749656,3367768003,1658647441,1658648253,812,489
3751300388,3897211381,1657688448,1657689015,567,667
3229871774,3783916284,1651000170,1651000805,635,1301
3957665117,3075465136,1657831122,1657831298,176,1047
3220750989,3154079557,1658226462,1658227433,971,1455
3569563212,3531118058,1652727997,1652728097,100,450
3030117347,3345905539,1641886900,1641887766,866,1220
3790039057,3268446099,1648789926,1648790213,287,1379
3137350861,3403933668,1659746236,1659747167,931,281
3064574238,3501508123,1653605010,1653605387,377,1584
3649265606,3188936143,1662034001,1662034619,618,1161
3145312014,3857013729,1645762488,1645763021,533,433
3620522583,3832585790,1643839115,1643839926,811,1953
3335040022,3386809097,1644761833,1644761989,156,2175
3524131973,3866582723,1653739527,1653739896,369,992
3593704176,3833345079,1654443995,1654444953,958,387
3735691730,3505295000,1664153178,1664153726,548,2333
3343752753,3952663430,1646125074,1646125885,811,353
3820070209,3182982515,1663575252,1663575970,718,79
3317748904,3648370843,1651299407,1651299485,78,1591
3809623566,3604769442,1650070472,1650071000,528,364
3187257156,3102820806,1664639100,1664639106,6,1607
3820225206,3501732936,1656081595,1656082036,441,635
3066714195,3692772256,1645104478,1645105237,759,884
3261419893,3468324129,1645631652,1645632121,469,1799
3292812509,3190003253,1663254391,1663254980,589,2036
3361870766,3132802864,1645046480,1645047278,798,1921
3701103798,3657305306,1650280254,1650280377,123,1141
3398242179,3506971803,1646942722,1646943415,693,460
3339459948,3061594355,1668802022,1668802314,292,1714
3538692457,3063791472,1660010087,1660010873,786,1757
3052376951,3056501932,1649935394,1649935510,116,2002
3359600983,3009635817,1648028543,1648028825,282,19
3003941040,3797294746,1642594091,1642594500,409,1493
3892800106,3435319506,1656157295,1656157765,470,1192
3292782964,3340337106,1661079924,1661080801,877,498
3892686083,3295352365,1660679351,1660679639,288,1596
3161784330,3670519908,1668113213,1668114095,882,275
3382110972,3475322181,1658749219,1658749754,535,1023
3564198089,3327145204,1658618348,1658618419,71,1667
3848740333,3622950232,1659821287,1659821577,290,1878
3045925838,3911185524,1664440164,1664440270,106,587
3647398701,3024431618,1646560669,1646561339,670,844
3428260922,3939098308,1644681503,1644681787,284,1045
3476060971,3722078855,1644066165,1644066546,381,604
3909558934,3862389429,1664747560,1664748304,744,943
3639013476,3460572652,1649893373,1649893832,459,134
3077145114,3411340387,1644296492,1644296562,70,619
3888764578,3797653596,1663040144,1663040828,684,2331
3880849800,3355429456,1648488286,1648488524,238,661
3402543059,3375759020,1644746978,1644747333,355,1027
3262811174,3331866261,1657148411,1657148778,367,1592
3230775095,3057102903,1650628090,1650628864,774,312
3740807524,3449504551,1667122175,1667123006,831,1574
3989392973,3880295026,1663907209,1663907452,243,1230
3095170532,3339385127,1641401599,1641402287,688,1317
3560132016,3528439013,1648110191,1648110390,199,2475
3002316212,3566825897,1662498930,1662499067,137,2328
3923683467,3705752007,1657422292,1657423018,726,2362
3400604704,3634328779,1659001817,1659002194,377,666
3327311623,3520341683,1653414190,1653415130,940,433
3161586578,3898229065,1663679109,1663679510,401,1067
3344549344,3601562567,1644616308,1644616707,399,2461
3518322544,3616794499,1651931969,1651932414,445,664
3526815452,3902437090,1647831445,1647831577,132,2403
3500320805,3797295915,1666783885,1666784174,289,349
3637861848,3959497834,1662814504,1662814603,99,504
3893937230,3787937000,1659582344,1659582438,94,1468
3519375692,3712549911,1651642283,1651642345,62,297
3899585675,3501786397,1656918806,1656918900,94,252
3485801867,3042176960,1659409714,1659410478,764,1897
3170036337,3339025394,1651237668,1651237860,192,807
3556647439,3926815435,1648623576,1648624071,495,1160
3844939526,3744575844,1666223854,1666224083,229,894
3780678233,3929887239,1645774943,1645775363,420,497
3115669693,3027870588,1661938974,1661939072,98,1329
3065810858,3054432255,1655589334,1655589897,563,446
3950428741,3823650698,1645962028,1645962703,675,740
3262596597,3341573446,1657563547,1657564023,476,769
3626020948,3111817334,1649033736,1649034192,456,1417
3658260972,3866260144,1645109085,1645109265,180,691
3264018414,3950433378,1661110773,1661111074,301,383
3181181141,3023880168,1648514395,1648514791,396,2011
3553241769,3599869347,1641451923,1641452784,861,1300
3207309302,3591264259,1647843757,1647844105,348,1663
3945633602,3840155828,1660555412,1660555937,525,487
3443161524,3505480563,1641787952,1641788902,950,290
3404317985,3364600039,1645209627,1645209903,276,761
3152933136,3658659669,1661597386,1661597737,351,715
3110639083,3447257561,1652884408,1652885036,628,517
3846323092,3432522125,1659044643,1659045233,590,722
3827122083,3982736205,1654484668,1654485549,881,340
3120092137,3449080412,1656401297,1656402048,751,2252
3836535079,3188126815,1641476959,1641477059,100,2099
3051404798,3928235124,1663427593,1663428505,912,80
3173034893,3388971461,1647211049,1647211130,81,1043
3821064356,3821594953,1649135478,1649135862,384,1511
3222375785,3941783209,1656600154,1656600234,80,1226
3015814199,3900843323,1651519460,1651519898,438,1934
3671154785,3567926021,1652571408,1652572352,944,659
3332797032,3185745995,1642006533,1642006967,434,1157
3104944123,3473394094,1656182521,1656183367,846,1052
3929887239,3065405448,1659820012,1659820330,318,1252
3855734814,3294526671,1642388211,1642388966,755,2419
3768311968,3756020689,1646419394,1646420278,884,347
3791279041,3109108614,1649344274,1649345136,862,1587
3822146001,3722329316,1658689009,1658689022,13,1521
3271409183,3868348947,1653099497,1653099510,13,2445
3243902799,3683507812,1665162610,1665163215,605,197
3149804005,3759668586,1660605628,1660605897,269,1574
3282561101,3038035861,1669624616,1669625429,813,2192
3614430693,3686424169,1646629602,1646630596,994,728
3323217825,3269653223,1643731483,1643731771,288,1405
3819468348,3263168418,1661763093,1661763199,106,1338
3884346810,3894149054,1643499566,1643500443,877,2316
3409050239,3797294746,1645318583,1645319049,466,1523
3195159288,3744829701,1654723312,1654723732,420,705
3446289365,3271318708,1659124021,1659124377,356,756
3044161404,3845496977,1659053992,1659054679,687,2143
3117531188,3893671286,1667845205,1667845558,353,1068
3687243333,3124200545,1650334629,1650335597,968,109
3508718004,3360040841,1663657042,1663657510,468,743
3989392973,3991542844,1660419461,1660420169,708,1301
3986003303,3239469849,1662848354,1662848833,479,393
3065298582,3855777399,1643689196,1643689854,658,934
3379296882,3357478199,1641367360,1641368046,686,2197
3170985187,3992345499,1660535054,1660535398,344,2420
3129582333,3773488272,1663096654,1663096683,29,801
3929497543,3211641180,1641836415,1641836980,565,1658
3223374226,3637092038,1664991918,1664992660,742,2482
3852741277,3838160976,1664680071,1664680125,54,2146
3661559275,3043736420,1648967156,1648967656,500,1579
3806015172,3778405053,1648912681,1648913642,961,773
3172018366,3233507128,1660492572,1660492975,403,267
3284284605,3007357837,1657133338,1657133779,441,1834
3841904297,3472820961,1668618093,1668619031,938,760
3004964162,3293775646,1662484040,1662484146,106,291
3755413351,3435915872,1664601903,1664602658,755,549
3102655595,3393501277,1651517666,1651518659,993,2078
3066892936,3691474413,1666196689,1666196689,0,1530
3136707992,3058141936,1655941845,1655942753,908,1539
3823917098,3491398730,1645070116,1645070964,848,733
3917067097,3538863873,1651523753,1651523887,134,428
3407139317,3721541321,1660731959,1660732655,696,2254
3096746005,3478166190,1646617169,1646617467,298,695
3456602518,3515460273,1655857508,1655857923,415,2289
3190267458,3937197371,1669562985,1669563779,794,2416
3686530724,3763093748,1645077055,1645077157,102,2122
3521081470,3840449491,1656571462,1656571538,76,2104
3908007955,3183259139,1665601319,1665602069,750,2055
3615666134,3056252574,1652355803,1652355985,182,766
3938505582,3333543321,1648358662,1648359509,847,1487
3050817805,3825824228,1659557681,1659558391,710,1769
3457390239,3376266236,1641393023,1641393292,269,18
3007702341,3365663032,1663926769,1663927691,922,263
3875483766,3523305140,1666857518,1666858276,758,2192
3722329316,3652728312,1649050170,1649050176,6,3
3638595264,3584660761,1641571425,1641572299,874,712
3502432342,3581011004,1647488376,1647488724,348,1857
3857211245,3754795349,1664818760,1664819447,687,587
3301148308,3590259850,1658007670,1658007908,238,273
3650205106,3266127117,1643053913,1643054351,438,427
3981348782,3760047951,1656900768,1656901754,986,2139
3993814137,3461292351,1669610105,1669610816,711,2189
3143189190,3569686431,1663936846,1663937102,256,2106
3734035973,3053005521,1666505854,1666506229,375,1607
3036346251,3421294150,1654268027,1654268434,407,496
3298748343,3817073865,1661683837,1661684142,305,1449
3622230392,3569578952,1651603554,1651603874,320,2396
3837904800,3098316380,1663687597,1663687632,35,1152
3890875667,3925688803,1652366009,1652366756,747,643
3859360549,3277577090,1651821318,1651821695,377,2172
3173667762,3506952427,1642571243,1642571425,182,2147
3505417530,3018612279,1645776596,1645776998,402,1861
3133694612,3348802129,1643213166,1643213263,97,398
3702932977,3767912489,1641794693,1641795465,772,84
3799480079,3549038219,1642826933,1642826975,42,652
3588728644,3425803609,1663412026,1663412985,959,844
3189759788,3323797477,1643654608,1643655340,732,927
3038832798,3695411154,1642687117,1642687477,360,1423
3218903379,3000725837,1667696672,1667696763,91,2315
3700287335,3819172879,1651126102,1651127095,993,2496
3231938844,3952185527,1668621340,1668621485,145,848
3158894896,3464595898,1658818922,1658819691,769,863
3098513510,3249554278,1651959810,1651960283,473,2390
3578298884,3417049317,1650740344,1650740727,383,1616
3542996543,3300983140,1643936855,1643937691,836,2017
3027870588,3606545393,1647857667,1647857945,278,1707
3272217633,3099224416,1655628839,1655629311,472,767
3202225412,3927660473,1655206995,1655207532,537,779
3118406319,3752176146,1655497018,1655497035,17,73
3784040148,3951354982,1668251448,1668252151,703,2337
3863652254,3364586923,1661991023,1661991222,199,2385
3693475435,3292797747,1644725825,1644725990,165,1536
3414328029,3808541027,1661611502,1661611957,455,56
3939977057,3545214789,1646006888,1646007635,747,2320
3775753518,3890159677,1665295778,1665296141,363,21
3900588986,3923635120,1659697315,1659698151,836,1325
3454448670,3160071792,1661823115,1661823726,611,1265
3594795944,3696947299,1669063169,1669063615,446,1201
3993637202,3973948700,1642763607,1642764171,564,2425
3916261675,3408903285,1649058792,1649059478,686,1627
3382983805,3884802599,1662441682,1662442216,534,879
3880608911,3149896107,1657497512,1657497774,262,1400
3328798665,3749208805,1648818651,1648819146,495,727
3175196290,3399503261,1642608003,1642608277,274,414
3600015858,3480375415,1649674420,1649675135,715,2077
3181912863,3763270952,1647614207,1647614596,389,1582
3047643464,3117575075,1647538429,1647539286,857,2219
3883976824,3953465037,1653682083,1653682126,43,7
3043736420,3090354216,1655346404,1655346625,221,1945
3388159268,3124200545,1651914384,1651914572,188,414
3306619417,3396149289,1642830967,1642831310,343,2482
3759393612,3217494787,1649647996,1649648266,270,201
3995868243,3859634422,1662507019,1662507905,886,181
3780039563,3356689959,1650268914,1650269673,759,1465
3320272612,3482576542,1653706556,1653706737,181,187
3615848654,3234851871,1669369933,1669370294,361,1332
3476450845,3086653619,1657796575,1657797389,814,2342
3436916222,3638803969,1652459073,1652460030,957,2050
3810891199,3901902653,1647975027,1647975776,749,695
3342082281,3749308364,1668487919,1668488022,103,987
3777835723,3804328787,1649693103,1649693900,797,485
3479322514,3867101565,1645360990,1645361089,99,2155
3643173963,3062015697,1664815491,1664815588,97,788
3330058679,3653218860,1657149893,1657150033,140,1431
3881206954,3004708023,1641527326,1641528273,947,898
3964830238,3012272703,1667400043,1667400707,664,1358
3791279041,3235672444,1648950124,1648950761,637,1025
3817073865,3247959785,1665800754,1665801691,937,1019
3824845857,3875008839,1645016004,1645016162,158,841
3039176873,3287399418,1668382007,1668382989,982,2072
3245773600,3139198469,1641765625,1641766143,518,2023
3126995401,3764298989,1646876717,1646876888,171,1342
3599327423,3703457098,1645834095,1645834525,430,753
3799078288,3379935974,1650545711,1650546546,835,1400
3818823702,3413810353,1646311534,1646312001,467,2321
3266270844,3876867156,1646253866,1646254496,630,2404
3206119800,3287399418,1647899850,1647899864,14,1966
3105460297,3086444841,1648812275,1648812820,545,258
3973401658,3490942401,1665077250,1665077343,93,2247
3714122939,3501308694,1655062591,1655062705,114,2126
3045127324,3921317746,1645441680,1645442241,561,1954
3011993360,3337601088,1663199004,1663199967,963,160
3153552268,3218738751,1669525355,1669525608,253,786
3700167321,3481030779,1644621476,1644621774,298,2114
3713308621,3743669526,1644250713,1644251037,324,1798
3808415962,3202063550,1641774478,1641774965,487,1129
3194796707,3674005769,1665023610,1665024258,648,2150
3713231806,3768013956,1665935334,1665935920,586,695
3323698166,3040742963,1649234265,1649235070,805,1389
3052396813,3365939940,1646866933,1646867521,588,1260
3817668840,3988976739,1649851713,1649851971,258,2235
3379598529,3291267409,1648708652,1648709190,538,2388
3499787925,3889544424,1659989917,1659990210,293,1231
3096408604,3410150990,1667957378,1667957722,344,1447
3582046255,3083479870,1664475034,1664475081,47,1546
3144993263,3859680527,1662126695,1662127248,553,1103
3828530052,3885026939,1665844856,1665845731,875,1011
3157496248,3597557082,1653874309,1653874568,259,988
3292365668,3126746702,1656023591,1656024100,509,2338
3963787394,3434662490,1642868428,1642868739,311,1327
3647398701,3774722709,1655515276,1655516208,932,211
3517541359,3245723038,1664880987,1664881455,468,1813
3618313240,3500595056,1654034985,1654035093,108,1051
3423522480,3148256129,1647208608,1647208933,325,1319
3496617169,3338812942,1657180927,1657181392,465,377
3744563835,3264831577,1652590788,1652591172,384,1751
3994721189,3405319002,1647678103,1647678770,667,2230
3784646522,3402880726,1646480111,1646480624,513,326
3934953223,3002013720,1653906410,1653906629,219,717
3632156948,3563343479,1669441067,1669441180,113,1369
3421178618,3440322150,1658212332,1658212508,176,1339
3316031407,3117531188,1651093683,1651094367,684,958
3260571568,3752653418,1645336340,1645336893,553,162
3526218972,3321752938,1650590772,1650591032,260,119
3815774397,3494372287,1656406658,1656406909,251,2104
3129170273,3083388257,1651806212,1651807210,998,835
3461263871,3945370501,1646381906,1646382318,412,2049
3981932099,3830866959,1655534322,1655534421,99,1755
3346832945,3622978712,1647534832,1647535276,444,1135
3730984573,3732796331,1667712575,1667713043,468,2384
3499514081,3084982671,1645606776,1645607642,866,180
3156261740,3697028347,1654444496,1654445108,612,1009
3802592493,3395609056,1649632421,1649633375,954,1433
3625950355,3399503261,1655813786,1655814724,938,959
3951354982,3309388750,1659924340,1659925079,739,1938
3007911826,3324394622,1663698362,1663698834,472,383
3658910038,3250108907,1643060865,1643061103,238,117
3872170030,3753998489,1660908467,1660908548,81,1819
3100670764,3985513037,1642550235,1642551225,990,784
3906065558,3520324090,1648357927,1648358126,199,2041
3272555962,3898229065,1642279558,1642280420,862,2276
3149304177,3715894883,1650702337,1650703148,811,1215
3872626198,3867857893,1643630790,1643630837,47,1288
3413056504,3410719383,1657649810,1657650129,319,687
3763270952,3090179745,1646135705,1646135736,31,841
3675359399,3391441349,1667624562,1667625092,530,1036
3531345844,3401957566,1661208585,1661209164,579,1646
3525152477,3047628685,1654698429,1654699066,637,70
3140608489,3365316758,1667138659,1667138847,188,668
3784040148,3530157274,1641536383,1641537355,972,106
3929794333,3734367959,1654468358,1654469143,785,1716
3237824925,3469524230,1667117140,1667118123,983,1041
3003005378,3590672346,1651908182,1651908402,220,613
3796343532,3508133844,1660190101,1660190929,828,238
3031816428,3157765022,1641137778,1641138528,750,1330
3434662490,3173809486,1643391954,1643392243,289,37
3064644311,3490435539,1643635655,1643636516,861,1639
3774945806,3367849829,1662151236,1662152018,782,2192
3643372353,3697650296,1641899706,1641900432,726,1146
3162844882,3546824914,1658991618,1658991961,343,388
3025014828,3201479561,1658201486,1658201678,192,364
3217375075,3487547990,1652810079,1652810809,730,506
3089548621,3481584783,1653382631,1653382634,3,2082
3106788261,3157308488,1655412216,1655412853,637,1451
3005809519,3332012161,1652741354,1652742110,756,454
3887032656,3839454838,1658808431,1658808877,446,1036
3470286872,3041792624,1658879273,1658879306,33,144
3166517941,3578298884,1668744710,1668745691,981,934
3656002043,3309106486,1644136026,1644136232,206,604
3379613190,3790298140,1662613476,1662613767,291,376
3666782310,3105931624,1649200620,1649200669,49,374
3664930564,3040563913,1645760143,1645760147,4,621
3580953063,3467686942,1650980286,1650980808,522,2054
3864414449,3000165786,1669484267,1669484381,114,2348
3073924620,3408104715,1666580554,1666580889,335,1931
3322801895,3082708890,1667527565,1667528113,548,67
3294446147,3565128218,1644606336,1644607134,798,1323
3870779720,3489453670,1660715115,1660715228,113,1248
3323198594,3058750967,1662056846,1662057531,685,316
3662526382,3408396410,1655487873,1655488715,842,1640
3644951156,3301620813,1641534779,1641535692,913,64
3938337743,3369049258,1641130952,1641131048,96,781
3609562862,3783304213,1669256351,1669257332,981,1306
3832243899,3784646522,1644490945,1644491756,811,2404
3527291464,3313782821,1649228523,1649228874,351,698
3114733025,3292507015,1645200293,1645201019,726,2367
3404934353,3093599187,1658805782,1658806767,985,274
3085001659,3787880772,1659899567,1659900300,733,1168
3435915872,3762571799,1643340771,1643341559,788,727
3158291556,3227970299,1653925988,1653926202,214,302
3927273567,3463800741,1656871013,1656871556,543,642
3557400406,3372271387,1665989387,1665990051,664,1255
3411495833,3599551667,1649033594,1649034369,775,1400
3892686083,3541423460,1647751785,1647752625,840,574
3437109709,3973264936,1644112321,1644113201,880,271
3854184537,3932077086,1645027542,1645027994,452,722
3249705811,3197362399,1654639640,1654639967,327,742
3850304083,3720381616,1641703619,1641704010,391,1142
3418338710,3777592593,1641214707,1641215490,783,2278
3748837929,3686407290,1650932812,1650932891,79,624
3845338893,3680100111,1669329423,1669330059,636,1629
3322656350,3357692565,1641742806,1641743194,388,1033
3515044837,3092800496,1668001306,1668001464,158,251
3269653223,3167864948,1653098161,1653098876,715,0
3777929700,3344394548,1645370593,1645371461,868,164
3067641822,3896960517,1667206156,1667206905,749,705
3618545572,3644164788,1657985252,1657985777,525,902
3705809622,3649649514,1646433794,1646434343,549,339
3108500091,3016283694,1659050555,1659051311,756,2071
3492773808,3307933176,1668740545,1668741077,532,124
3965585706,3999390272,1662008285,1662009109,824,1203
3620787716,3100440036,1665783370,1665783929,559,2231
3755413351,3949480596,1658384871,1658385467,596,318
3149181988,3161243271,1658933170,1658934128,958,1592
3623294630,3553960271,1658666667,1658667304,637,1051
3073798415,3723700913,1648072516,1648072727,211,1566
3624683080,3870384331,1656506161,1656506947,786,453
3415145597,3822869749,1651455872,1651456486,614,1973
3232342525,3437221963,1654432984,1654433276,292,2278
3338020076,3022256617,1654837430,1654838271,841,1493
3594038673,3606994517,1654873146,1654873159,13,1875
3089699104,3793840002,1656488358,1656489091,733,1551
3939281989,3184270447,1656860776,1656860848,72,574
3992924141,3741134467,1661750337,1661750562,225,69
3250627439,3660551283,1665970095,1665970407,312,1925
3576411084,3607978764,1661302755,1661303643,888,1524
3419809319,3449395269,1656439957,1656440596,639,956
3838774657,3802325069,1668685399,1668685998,599,2136
3241425701,3127783768,1650172317,1650173201,884,1892
3892142252,3690043318,1657240335,1657240749,414,1779
3969241066,3423073970,1665611251,1665611285,34,2030
3407770585,3421178618,1654596474,1654596904,430,727
3201587444,3896594746,1642066220,1642066847,627,1653
3368884196,3840906120,1650227692,1650228552,860,309
3036470049,3199797181,1665264512,1665264776,264,408
3229881750,3011458038,1661587675,1661588522,847,1145
3604769442,3152537793,1657523487,1657523536,49,333
3281753784,3479778946,1641902825,1641903488,663,85
3344637531,3787058440,1651658448,1651658584,136,755
3121128511,3195138141,1661638221,1661638324,103,538
3928723403,3782182063,1666247389,1666247515,126,2380
3145552419,3196934109,1658229190,1658229616,426,2069
3473399101,3890194122,1653398484,1653398842,358,996
3900535275,3203319376,1641780531,1641780560,29,1896
3861153303,3099013723,1651684582,1651685514,932,2138
3326046744,3781580109,1658719386,1658719398,12,829
3427860415,3776934270,1662977950,1662978582,632,1543
3135119423,3962798581,1652480714,1652480752,38,1806
3461938856,3546866871,1661386395,1661386884,489,1477
3086324092,3129500635,1664241728,1664242110,382,752
3187982526,3842362489,1649169683,1649169856,173,2200
3257947713,3508202949,1652587767,1652587829,62,2290
3893937230,3790883274,1649437968,1649438286,318,368
3010649870,3989741708,1668491761,1668492095,334,40
3536768410,3101161243,1644200933,1644201421,488,1344
3945370501,3690646467,1653537657,1653538195,538,561
3730270448,3482148686,1641417465,1641417809,344,245
3563750578,3523045898,1668863176,1668863418,242,32
3860519596,3382777450,1654418876,1654419555,679,900
3346832945,3683993851,1649393682,1649394327,645,295
3670387440,3645778086,1650457334,1650458141,807,364
3628792484,3774164657,1648841699,1648842037,338,1310
3539866422,3875945215,1642647322,1642647683,361,1690
3677965553,3996319604,1644107971,1644108025,54,508
3041385548,3496369924,1650556196,1650556849,653,1900
3010649870,3769647112,1643979977,1643980940,963,2300
3247948931,3649298405,1648907808,1648908601,793,179
3636808827,3472820961,1667065643,1667065774,131,314
3776334300,3719124928,1669576781,1669577704,923,600
3157765022,3087876190,1659110778,1659111458,680,1521
3738835445,3211965606,1642516036,1642516634,598,220
3096412109,3283056652,1659369771,1659370459,688,1194
3828219822,3318848700,1657569454,1657569714,260,94
3316855337,3967747142,1649591951,1649592837,886,1102
3109390601,3482473663,1649110959,1649111021,62,675
3226451761,3945299482,1666310222,1666310452,230,1790
3193483812,3955685340,1641796290,1641797215,925,339
3433576059,3181047536,1666872283,1666872320,37,1519
3297477157,3664337365,1650763282,1650763948,666,686
3714719241,3662507847,1647342689,1647343529,840,2003
3901459563,3802890793,1643244389,1643244484,95,1405
3634282428,3298857826,1647799180,1647799588,408,1589
3933845116,3192193744,1657046282,1657047006,724,1394
3804648275,3276341369,1668656831,1668657274,443,1559
3153851884,3151539194,1669677378,1669677386,8,1101
3462224632,3478288963,1655413737,1655414073,336,298
3687689210,3685049252,1645269861,1645270457,596,1838
3584660761,3037940560,1659357527,1659357787,260,1600
3296066748,3140488273,1664556737,1664557421,684,1268
3924607271,3729340640,1652045951,1652046080,129,1838
3397397223,3720240255,1649800679,1649801541,862,306
3799480079,3784123884,1647304837,1647305442,605,1221
3752176146,3142777936,1656055817,1656056180,363,772
3737504606,3085931016,1655153032,1655153051,19,2246
3893872926,3796954140,1643869400,1643869641,241,938
3294319716,3759393612,1651440343,1651441088,745,1204
3525377731,3240839516,1656875291,1656875722,431,1142
3915175620,3294278402,1657940508,1657941460,952,742
3852810875,3059602794,1644023076,1644023424,348,1113
3780991625,3814572709,1642406903,1642407243,340,2096
3034288673,3415041326,1663461146,1663462125,979,682
3855521057,3750896410,1652022332,1652022877,545,1705
3168818004,3596839317,1664915939,1664915949,10,2180
3261128374,3142848483,1654822734,1654823223,489,500
3974804920,3835976086,1644784698,1644785138,440,1782
3368387959,3715994986,1657380633,1657380657,24,2282
3017883382,3878274883,1649825544,1649825822,278,495
3806570797,3022707615,1642307097,1642307996,899,1961
3439120258,3185977048,1659609517,1659609597,80,742
3251948771,3583864167,1667913917,1667914113,196,2083
3261685435,3993798870,1652828962,1652829567,605,645
3325842490,3420520626,1652477683,1652478111,428,400
3034255613,3564395523,1667907002,1667907655,653,37
3338715388,3818276871,1654973564,1654973693,129,1792
3686743575,3296556189,1655382318,1655383123,805,2462
3469437983,3920277028,1654577828,1654578638,810,258
3959795133,3599714580,1646786055,1646786828,773,30
3304087986,3578219289,1659991926,1659992441,515,220
3432899117,3697571838,1658748940,1658749158,218,2215
3563738755,3413040065,1642903768,1642904461,693,1397
3265434991,3132349279,1649483853,1649484641,788,140
3616218859,3364888618,1647096156,1647096182,26,1321
3752701792,3158554223,1668248422,1668249264,842,915
3500053511,3479608671,1664518795,1664519751,956,2238
3055545326,3347462301,1668041763,1668042350,587,1492
3035464149,3959504618,1642705754,1642705881,127,1453
3006738164,3741273371,1652284118,1652284145,27,812
3395479272,3257973966,1661036311,1661036682,371,109
3069225011,3652765431,1658906035,1658906716,681,1875
3167121088,3782673553,1644750398,1644750542,144,1765
3973440480,3801579775,1665552600,1665553124,524,2113
3151982756,3821594953,1669340996,1669341846,850,345
3720223108,3223094463,1658984228,1658984335,107,1089
3372093069,3936360658,1652553493,1652553775,282,2120
3038849431,3590672346,1664869715,1664869912,197,183
3387568587,3130166522,1652388176,1652388214,38,679
3900241568,3804768140,1668582762,1668583563,801,2466
3885087517,3777820691,1648197634,1648198096,462,71
3799776825,3566834497,1656031632,1656032293,661,2499
3946015739,3117234289,1643363802,1643364123,321,1459
3432364009,3292010262,1645477327,1645477882,555,1118
3858911279,3085931016,1646104700,1646105543,843,2464
3061366261,3852017463,1660680759,1660681388,629,426
3017758671,3222375785,1659219492,1659219910,418,1517
3633498077,3110591514,1665944946,1665945268,322,1995
3855063597,3821049069,1659943296,1659944218,922,2340
3456295243,3985159412,1655149892,1655150872,980,616
3941489594,3880837935,1658480597,1658481539,942,908
3916456426,3748944220,1663516096,1663516190,94,879
3556450605,3938583443,1654625247,1654625932,685,651
3323809275,3724669056,1663864299,1663865003,704,1369
3645585393,3710851755,1654986575,1654986990,415,2415
3208106743,3951692395,1664042714,1664043453,739,1018
3682608460,3055644463,1648073704,1648074246,542,2157
3722551682,3254030842,1648657312,1648658275,963,2271
3519828744,3182097979,1668080819,1668081171,352,2064
3737086539,3387311534,1653274393,1653274464,71,267
3557559741,3099976032,1657427208,1657428072,864,621
3407409307,3962453693,1668714555,1668715076,521,1285
3705919583,3815102601,1656837269,1656837303,34,912
3142230569,3853448159,1657565908,1657566510,602,2392
3026035554,3682006274,1650737522,1650738346,824,1485
3915817603,3760535935,1650698558,1650699167,609,736
3265712439,3313619618,1669721742,1669722073,331,1329
3751780241,3763723423,1662481346,1662482070,724,1695
3750896410,3090588645,1658307146,1658307381,235,2042
3678624517,3089126812,1660299881,1660300530,649,287
3890875667,3251948771,1649482265,1649483233,968,1110
3075519908,3442967650,1653753741,1653754610,869,317
3881519714,3359722926,1663881441,1663881711,270,326
3139928298,3623351962,1658450314,1658450365,51,2048
3572224210,3940948395,1646359442,1646360284,842,2144
3175976694,3023140319,1643326904,1643327247,343,1500
3106429728,3623620611,1643565279,1643565849,570,1840
3623294630,3148284665,1653253301,1653253438,137,1990
3762422234,3842560828,1659805810,1659805976,166,2165
3663884600,3835049098,1642895697,1642896651,954,1342
3582859001,3342199267,1656849218,1656849985,767,1217
3565700391,3294783182,1652775584,1652775866,282,1177
3771931468,3644334498,1647338733,1647339664,931,230
3801847517,3036846628,1668490048,1668490352,304,2492
3384222838,3566534974,1665464435,1665465410,975,2299
3468633309,3196704660,1656052588,1656053193,605,304
3396149289,3300203056,1656827965,1656828408,443,2074
3254083367,3246759301,1653700278,1653700456,178,573
3254503569,3537592483,1656754621,1656755389,768,1556
3265181921,3817548425,1653657465,1653658103,638,1215
3595612540,3061362091,1665082783,1665083624,841,600
3215088423,3102588374,1641869581,1641870566,985,458
3891258957,3090731052,1651246917,1651247856,939,304
3931294653,3297290662,1666871412,1666872370,958,2130
3150893774,3390329949,1647815935,1647816803,868,2442
3686424169,3362796099,1664727871,1664728797,926,1831
3582531330,3193657080,1662097591,1662098494,903,469
3732795074,3557751532,1643857090,1643857979,889,849
3740404190,3064961160,1654481555,1654481810,255,526
3243883781,3129955835,1660103147,1660103929,782,416
3354395496,3093131372,1641773419,1641774074,655,1633
3973264936,3918234060,1658554545,1658555349,804,1740
3811827366,3262377052,1655011190,1655011403,213,321
3433835303,3175298013,1646716423,1646716832,409,1796
3724455974,3735817368,1666964875,1666964939,64,1743
3396146110,3655786063,1647724545,1647725345,800,696
3777684793,3306290309,1657513623,1657514220,597,1544
3272555962,3692498377,1656654886,1656655871,985,2301
3442927979,3141391673,1663141482,1663142437,955,2062
3145948160,3452275962,1653982417,1653983138,721,1496
3658461707,3513368682,1661573285,1661573818,533,762
3462744716,3569557301,1647458959,1647459037,78,88
3631340178,3333776110,1647475318,1647476301,983,1030
3012155922,3672524498,1657935018,1657935643,625,258
3972424804,3269294562,1653586325,1653587287,962,648
3034750166,3276010368,1661268949,1661269552,603,1577
3144175285,3040897601,1646818800,1646819281,481,1107
3970286228,3262379384,1654486895,1654487216,321,1818
3677965553,3222438717,1643673052,1643673885,833,1305
3904183865,3976405875,1655423847,1655424452,605,2124
3098264219,3084882941,1649372632,1649373278,646,111
3852633699,3026025743,1650346540,1650346678,138,1793
3003087336,3679578513,1661890902,1661890939,37,673
3400434269,3167716044,1660189091,1660189174,83,1441
3658910038,3494009953,1654390509,1654391006,497,310
3491356699,3983158937,1654835013,1654835857,844,270
3334792271,3390441234,1659520938,1659521748,810,879
3608893234,3034985161,1663247523,1663248152,629,1345
3625938415,3412675211,1651428575,1651429491,916,95
3170296955,3098538909,1660954534,1660954657,123,340
3356689959,3875118670,1654764889,1654765743,854,1396
3350812449,3156261740,1650508023,1650509005,982,784
3359896430,3335242048,1662947842,1662948290,448,1973
3875750764,3069225011,1660300743,1660301329,586,1351
3898188404,3420520626,1651521388,1651522205,817,1856
3399180008,3361694981,1668256292,1668256580,288,898
3143909362,3623191811,1648973220,1648973527,307,2094
3392105056,3763723423,1661521244,1661522084,840,521
3290176410,3666579485,1665941708,1665941719,11,2394
3343177837,3376960491,1645245484,1645245659,175,230
3446289365,3453227348,1659293476,1659294368,892,645
3548128446,3869794122,1668820739,1668821130,391,1475
3173322239,3440064321,1650035802,1650036139,337,260
3105259495,3968682824,1644029622,1644030133,511,506
3037130270,3592320524,1660739329,1660740224,895,1149
3811318665,3067403592,1645537212,1645537282,70,2226
3169072505,3243044619,1656622724,1656623421,697,268
3611763388,3470286872,1644035622,1644036380,758,1249
3982929088,3985854594,1664594687,1664595336,649,1619
3118128782,3085931016,1660129297,1660129873,576,959
3316287541,3512631937,1664146670,1664146842,172,1770
3633730527,3232128014,1668962824,1668963437,613,1941
3622950232,3930909418,1664902798,1664903786,988,1349
3743687544,3954285582,1667182410,1667183224,814,873
3879787945,3525751984,1652027842,1652028319,477,685
3378542130,3226092646,1669435815,1669436331,516,1781
3588936901,3454753343,1668701746,1668702478,732,2442
3666148943,3712727713,1664041508,1664042360,852,1947
3440778681,3904352989,1642852142,1642852589,447,76
3499272388,3547365303,1660012163,1660012437,274,1085
3016971363,3890033502,1656130067,1656130167,100,2286
3314932010,3482473663,1669480602,1669481570,968,1203
3603853942,3845496977,1652534865,1652535139,274,1375
3206243555,3465500045,1651216486,1651216844,358,52
3139928298,3381821132,1649626417,1649626578,161,1115
3777592593,3975504102,1652023126,1652023798,672,514
3088562105,3045925838,1651037492,1651037633,141,1127
3379935974,3826257607,1655014863,1655014906,43,1884
3063955055,3366609475,1662731182,1662731897,715,2121
3033692011,3661136551,1665785554,1665786056,502,1430
3647951580,3637269987,1654637374,1654638012,638,315
3429101401,3416521015,1642383306,1642383476,170,713
3489695411,3215443177,1669224495,1669225276,781,364
3908209550,3163202728,1652793794,1652794126,332,730
3544965463,3666931632,1666323792,1666324716,924,415
3364586923,3629984961,1644529303,1644530273,970,916
3605195406,3443435826,1664752068,1664752436,368,1215
3833722302,3514152633,1648689596,1648689667,71,2156
3791894034,3098891437,1659780087,1659780725,638,1696
3046510463,3503453854,1662892751,1662893292,541,753
3441206388,3729914869,1654757557,1654758446,889,1818
3093178960,3855165548,1648057105,1648057337,232,2340
3784040148,3752347758,1664551104,1664551606,502,94
3807785088,3804189322,1664175748,1664176453,705,1033
3815235622,3217384934,1643664856,1643665435,579,595
3153541916,3092118254,1653724975,1653725067,92,1957
3462714323,3424476490,1648327781,1648327904,123,1045
3914926954,3089138601,1653468316,1653468812,496,1235
3035464149,3434864548,1650550001,1650550731,730,2355
3776906254,3233507128,1658321740,1658322064,324,645
3935379393,3780991625,1652985478,1652986414,936,2295
3693000511,3242912660,1650620988,1650621598,610,298
3214817416,3215257603,1659419891,1659420857,966,104
3561692706,3032747459,1660214590,1660215477,887,1733
3449352254,3503489321,1641138037,1641138471,434,1824
3649658953,3849725507,1648286390,1648286457,67,1809
3555186812,3289332257,1660248018,1660248443,425,2379
3486582851,3454546723,1652968784,1652969329,545,2217
3834160941,3156538951,1665158060,1665158107,47,1997
3187523092,3757370089,1653282836,1653283776,940,158
3952654862,3731206373,1662848590,1662849061,471,338
3143962586,3497288872,1652721446,1652722321,875,723
3973401658,3533497399,1650052326,1650052888,562,975
3997215508,3348620933,1652292242,1652292565,323,889
3069675415,3500595056,1641224526,1641225489,963,958
3250248786,3328024680,1657871015,1657871290,275,1771
3973264936,3097457183,1665036748,1665037616,868,2498
3060757458,3840962989,1651419122,1651419277,155,2155
3249252169,3737086539,1651612525,1651612720,195,1465
3029451399,3124476593,1666054079,1666054743,664,769
3990144819,3901902653,1656508127,1656508490,363,992
3391898268,3489083203,1646068435,1646068573,138,2477
3795326002,3845122668,1667935323,1667936292,969,1048
3554822566,3504893701,1642892063,1642892253,190,2275
3623769570,3704871253,1648058144,1648058381,237,1951
3232333937,3621000186,1643101176,1643102075,899,1534
3475835420,3533497399,1645791332,1645791501,169,69
3894593426,3310953839,1649936698,1649936749,51,2344
3602340127,3228794031,1658141401,1658141424,23,2075
3005700539,3671974600,1644741767,1644741939,172,2393
3451370887,3289437738,1663306006,1663306995,989,1992
3364600825,3362972722,1655630360,1655631252,892,2005
3243873593,3426617058,1642039986,1642040264,278,1091
3048296949,3180728306,1643125197,1643125339,142,1504
3879322451,3883265629,1659176407,1659177404,997,127
3832265812,3753180150,1644158243,1644158623,380,729
3791279041,3139087074,1662401353,1662402223,870,1524
3188726102,3615359439,1668676098,1668676661,563,2320
3140064319,3098422570,1666394090,1666394748,658,2381
3467933841,3429684538,1643945027,1643945173,146,338
3037984397,3733619028,1648650775,1648651322,547,293
3028063669,3820466728,1651309701,1651310086,385,456
3555187890,3601690466,1655456183,1655456933,750,2487
3805888209,3975065378,1666519382,1666520308,926,2407
3531842620,3858519840,1659719057,1659719274,217,319
3299536518,3898012654,1650827583,1650827909,326,31
3734035973,3388328160,1668874824,1668875241,417,880
3828761401,3029149493,1644847276,1644847773,497,482
3735855753,3015956370,1667873557,1667874206,649,982
3580330506,3281597338,1658878977,1658879124,147,503
3054659800,3101265323,1656396514,1656396963,449,580
3527269010,3526798607,1651084900,1651085659,759,1312
3325360523,3669311789,1643973212,1643973746,534,338
3972056646,3057756725,1649367398,1649368095,697,1685
3423965711,3254592040,1643560548,1643561088,540,2209
3952889735,3164122941,1648357462,1648358215,753,1898
3739233756,3125459736,1644511035,1644511443,408,1648
3055545326,3938776287,1652727978,1652728889,911,21
3287171733,3092003105,1649847949,1649848280,331,2037
3677893619,3070241461,1664663839,1664664287,448,1248
3505270174,3206243555,1645859296,1645860268,972,433
3942134694,3485459472,1664378069,1664378440,371,409
3516399207,3278703976,1647080890,1647081614,724,1462
3105829075,3637292465,1667377972,1667378416,444,1964
3143189190,3149046961,1668408194,1668408727,533,187
3085931016,3811827366,1660152352,1660152613,261,577
3940222685,3955825968,1661259703,1661260084,381,2390
3868902207,3604596896,1665868125,1665868478,353,106
3503453854,3439660528,1648358136,1648358140,4,622
3917373940,3452773006,1644245110,1644245980,870,4
3268349855,3187561832,1662667651,1662667655,4,2277
3832144696,3957695947,1668112683,1668113017,334,1919
3143452523,3204735172,1658591027,1658591933,906,1950
3108500091,3351786927,1646902387,1646903312,925,974
3592379849,3881554146,1649563853,1649564215,362,162
3647295073,3233318289,1644869538,1644870225,687,1198
3356499294,3525261242,1661842915,1661843051,136,211
3224800126,3342708435,1644566558,1644566745,187,736
3922341165,3734565675,1669312391,1669313345,954,673
3865964859,3355429456,1650030727,1650031326,599,227
3678336055,3275360473,1665423681,1665423970,289,68
3670158499,3421600026,1665524530,1665524565,35,155
3698965715,3177951035,1658625016,1658625479,463,1058
3347152834,3935809720,1645924865,1645925767,902,1768
3170102962,3935125903,1655007263,1655007449,186,819
3385806632,3073332785,1653521047,1653521983,936,345
3109465057,3876867156,1661820479,1661820596,117,305
3651058536,3473399101,1665000854,1665000939,85,1931
3260306978,3029807207,1651427339,1651427506,167,1562
3462412055,3475322181,1644201134,1644201168,34,35
3595049641,3601562567,1653906302,1653906819,517,1421
3725989619,3450817021,1641599967,1641600401,434,558
3945370501,3082075242,1669129557,1669130156,599,348
3410261725,3506952427,1646529617,1646529771,154,2269
3064701445,3099984232,1643795048,1643795733,685,1096
3946015739,3920437320,1657847140,1657847533,393,1964
3518607253,3435340439,1667312715,1667313213,498,1888
3216753609,3325334366,1664414253,1664414296,43,1204
3989392973,3692861248,1647178073,1647178554,481,1241
3175478710,3686240080,1642715191,1642716022,831,692
3660489961,3888856112,1654695741,1654696528,787,1464
3897212070,3468922263,1650125909,1650126745,836,92
3654899608,3261477798,1659064084,1659064118,34,925
3950146840,3292797747,1648916364,1648916894,530,386
3304252236,3015253917,1645369097,1645369197,100,2129
3420137628,3144993263,1660157217,1660158075,858,527
3553301078,3321074447,1646594192,1646595092,900,476
3351906355,3835621921,1653067386,1653067518,132,931
3118976994,3631340178,1662203536,1662204526,990,1055
3702541874,3830053941,1641198199,1641198885,686,664
3128043317,3424211722,1667877168,1667877220,52,198
3967015655,3364911803,1668016650,1668016677,27,2370
3605587138,3876377964,1660494493,1660494867,374,1146
3183256246,3830053941,1654612548,1654613032,484,2134
3458478056,3994844749,1656642686,1656643303,617,557
3564592902,3717926703,1662474312,1662474334,22,2002
3334171572,3914946558,1644762641,1644763582,941,2149
3430916751,3447812768,1649280576,1649281122,546,532
3672751607,3703943697,1665854910,1665855824,914,365
3921962724,3713520914,1646792844,1646793724,880,1594
3967372197,3254367735,1653437024,1653437701,677,151
3837481005,3141048645,1656221575,1656221946,371,870
3030074344,3582471153,1664731419,1664732013,594,2403
3975462879,3569478966,1654822668,1654823414,746,2123
3333336166,3910837040,1641012469,1641013109,640,1618
3149668198,3359417056,1651130076,1651130861,785,2087
3422728078,3155835978,1657897063,1657897240,177,869
3348006171,3567237541,1655269250,1655269715,465,172
3387170357,3926815435,1665694614,1665695127,513,1760
3237824925,3439940608,1648177811,1648178152,341,760
3085136451,3880295026,1661001933,1661002621,688,669
3929901413,3830015015,1653293877,1653294854,977,86
3671830270,3683793217,1667382000,1667382122,122,367
3403512366,3543668840,1642408990,1642409706,716,2100
3767453896,3812239613,1669606196,1669606236,40,329
3946306714,3920437320,1662555197,1662555839,642,2107
3596500107,3343033950,1665864828,1665865325,497,2269
3967147343,3124574350,1642349862,1642349879,17,1139
3109941959,3476403398,1669067390,1669067953,563,959
3743669526,3315391438,1662368815,1662369596,781,1437
3353295219,3341694529,1646440313,1646440388,75,482
3486096604,3733975709,1651645414,1651645673,259,1223
3757139792,3129138715,1644985662,1644986433,771,1530
3045427279,3112357538,1648142410,1648142934,524,1235
3413305965,3329154834,1657646595,1657647319,724,354
3454554705,3391262941,1667831570,1667832103,533,2203
3362836351,3413781764,1665407700,1665408543,843,1294
3273518390,3545214789,1661902157,1661902690,533,1459
3150503842,3651503901,1643835219,1643835467,248,2068
3822143503,3022767670,1648800808,1648801444,636,1176
3678340379,3180252962,1657082533,1657083445,912,1319
3309869716,3137092101,1649275877,1649276107,230,1312
3031103174,3681489851,1666183518,1666184256,738,170
3408115806,3908209550,1656272126,1656272688,562,2085
3478771172,3327933393,1649292932,1649292936,4,483
3238443990,3772337054,1648854302,1648855002,700,1193
3996084129,3117749198,1656916279,1656916313,34,1920
3790964737,3916456426,1664754849,1664754870,21,728
3694591547,3545652885,1647021715,1647022114,399,1806
3997215508,3223313152,1665947563,1665947718,155,1568
3040416131,3148256129,1653705299,1653705738,439,102
3045016501,3234861737,1649600692,1649600985,293,1940
3005101248,3083388257,1642539914,1642540656,742,692
3395782360,3585674939,1642714901,1642715186,285,1635
3294094629,3415888174,1647707882,1647708022,140,2378
3895332326,3716524134,1651721254,1651721965,711,2427
3157308488,3191811632,1665916194,1665916369,175,2163
3501508123,3158338043,1665651952,1665652160,208,2019
3243883781,3181074947,1654963194,1654964137,943,1623
3841459327,3510660628,1665116187,1665116559,372,2431
3580280923,3600879855,1660069947,1660070673,726,2307
3053855376,3111514903,1650493355,1650493515,160,914
3594173372,3035895563,1648148877,1648149270,393,1038
3524480094,3988957478,1647358474,1647358590,116,1933
3401156180,3993995217,1654495906,1654496684,778,2308
3309799085,3147896698,1657265991,1657266579,588,2168
3704871253,3214698363,1641872349,1641872787,438,914
3391037775,3946015739,1653131020,1653131576,556,1329
3417411117,3291819950,1664586015,1664586695,680,2313
3147047674,3925690262,1647506401,1647506625,224,1878
3925690262,3949522552,1657550585,1657551162,577,1279
3816309635,3644100988,1641376569,1641376613,44,157
3375125376,3966130885,1658036404,1658037196,792,2140
3153040217,3232209052,1667670495,1667671048,553,1317
3434864548,3442293538,1650256252,1650257112,860,816
3817252660,3308256167,1644242976,1644243475,499,2383
3281397783,3265895976,1666176153,1666177063,910,159
3060989519,3855113371,1642396813,1642396889,76,1258
3629797745,3592520398,1657390940,1657391207,267,1057
3316496524,3364404145,1649330599,1649330664,65,71
3636930993,3825426771,1668824448,1668824512,64,2247
3290860752,3310953839,1655672288,1655672769,481,1013
3744386868,3799287196,1660082945,1660083421,476,1930
3749980168,3641983006,1649683460,1649684279,819,1834
3341283434,3246024635,1659150684,1659151017,333,1095
3512662328,3110360947,1646305884,1646306086,202,675
3949970421,3188726102,1645404486,1645404655,169,603
3371745136,3468654589,1658156677,1658157151,474,984
3086084685,3388159268,1650986114,1650986373,259,1674
3985734621,3931677547,1642727875,1642728476,601,85
3857081560,3184000585,1648774271,1648774594,323,724
3763723423,3115494713,1657953568,1657954356,788,234
3438574719,3813811121,1650185393,1650185521,128,1406
3562456307,3901086549,1642749857,1642750210,353,1750
3696856656,3211965606,1668873204,1668874173,969,1172
3115777637,3791055136,1657983175,1657983947,772,2236
3117262222,3958507300,1661941320,1661941963,643,1870
3800014504,3159669419,1645724700,1645725453,753,105
3243044619,3336211604,1657734906,1657735515,609,1909
3255485773,3193483812,1654193060,1654193796,736,1933
3321441782,3046787822,1646892425,1646892950,525,2484
3103743198,3681993008,1663669190,1663669722,532,848
3878943307,3440064321,1668378240,1668378573,333,1451
3670709726,3813290629,1644524451,1644525346,895,534
3245773600,3328015314,1661456759,1661457646,887,916
3895332326,3116281998,1655293824,1655294168,344,256
3501287522,3831009076,1653294816,1653295794,978,1129
3205988899,3071765048,1646948841,1646949537,696,2062
3555187890,3451749535,1655856857,1655857605,748,1385
3224364206,3826573375,1656949865,1656950129,264,943
3599551667,3749211785,1653177737,1653178293,556,1363
3663038239,3576422890,1651359345,1651359805,460,1237
3542832965,3553960271,1664704516,1664705356,840,892
3627902900,3814045699,1650109284,1650109636,352,1034
3622997863,3469524230,1669443109,1669443898,789,1719
3964524277,3616803531,1642989268,1642989383,115,818
3469722588,3074051284,1660163090,1660163208,118,216
3580594125,3255751346,1657305232,1657305559,327,1434
3960267299,3103740757,1643516677,1643517442,765,1897
3256787088,3611353561,1650513605,1650514362,757,853
3937445570,3501508123,1661772829,1661773193,364,664
3557751532,3545032372,1663526700,1663527023,323,1578
3168820334,3980207883,1659728219,1659728623,404,654
3619660501,3920028342,1650919821,1650920610,789,618
3492247995,3162284444,1661659785,1661660232,447,857
3325944344,3277372807,1644780344,1644781258,914,243
3506273643,3336991621,1665967151,1665967405,254,219
3215423327,3814278185,1668272038,1668272694,656,1599
3384307655,3359901981,1656848583,1656848995,412,530
3534581934,3998641184,1648807837,1648808467,630,767
3858876644,3060718787,1645321391,1645322378,987,78
3225909236,3156683897,1645440883,1645441131,248,1848
3823650698,3567906153,1658589593,1658590395,802,797
3260036272,3615595663,1662272735,1662273601,866,82
3021289375,3736871918,1644940285,1644940753,468,619
3098891437,3610239794,1651609214,1651609249,35,972
3066439887,3461508348,1655647535,1655648153,618,1269
3270273033,3533497399,1645180388,1645181057,669,541
3983988321,3496921526,1654237328,1654237954,626,2052
3622950232,3346261120,1642204327,1642204364,37,415
3131930167,3361694981,1657574634,1657575227,593,456
3234030791,3586778995,1663611009,1663611237,228,953
3269294562,3277372807,1655702087,1655702092,5,2068
3806647877,3462483679,1644552412,1644553306,894,392
3946614568,3258399411,1659988020,1659988020,0,2399
3674271275,3385007362,1657550581,1657551298,717,2150
3419751912,3776783076,1644344792,1644345242,450,2431
3451167153,3487406679,1665948062,1665948425,363,1649
3262864867,3981173642,1663218188,1663218378,190,970
3355910238,3366845170,1645544673,1645544807,134,287
3786516095,3298770258,1648127024,1648127210,186,522
3320039544,3837550746,1662672279,1662673068,789,1883
3776063818,3021679982,1668475277,1668475503,226,1590
3779998740,3021769525,1645915483,1645916091,608,1592
3026727334,3880580622,1663024133,1663024251,118,959
3115494713,3455209070,1648578019,1648578526,507,1329
3066067288,3686240080,1644452959,1644453434,475,2193
3988337484,3995365519,1654681515,1654681520,5,602
3834152797,3112742999,1664577513,1664578308,795,235
3771504908,3358241145,1646953761,1646953808,47,1793
3831585514,3132802864,1645272916,1645273615,699,988
3976095218,3435540149,1645059204,1645059936,732,1994
3805314214,3147512839,1642988986,1642989665,679,310
3016971363,3264673951,1659832793,1659832828,35,1065
3664273227,3048296949,1657192750,1657193003,253,1287
3546284533,3808022912,1667796832,1667797569,737,300
3196934109,3898699023,1669745346,1669746049,703,233
3845980646,3867543887,1660141289,1660141575,286,220
3494746675,3715231431,1663675274,1663676105,831,1400
3112389617,3279351560,1655686665,1655686868,203,783
3977987504,3941489594,1654006960,1654007607,647,114
3502554871,3884256882,1647548029,1647548071,42,555
3381845607,3618013844,1665936537,1665936820,283,1193
3104396432,3256736613,1659737720,1659737848,128,829
3956547336,3377528840,1654881732,1654881967,235,2145
3950225483,3910029798,1655803149,1655803541,392,1924
3786516095,3744759130,1662339686,1662339801,115,189
3217719618,3060121211,1646885966,1646886173,207,949
3947174877,3480100868,1646594783,1646595756,973,1643
3498770747,3743886187,1652114912,1652115133,221,2056
3321441782,3505295000,1668226966,1668227370,404,488
3132611388,3368420871,1655700568,1655700655,87,1496
3943184820,3060718787,1650783019,1650783271,252,2255
3544353013,3826257607,1653875789,1653876297,508,1341
3309388750,3567926021,1664579267,1664579307,40,1796
3208831400,3261169929,1646542034,1646542277,243,2034
3962536480,3962676436,1649549897,1649550166,269,74
3515170949,3761307187,1647813310,1647814118,808,29
3451167153,3323809275,1658499775,1658500538,763,34
3524131973,3950936299,1669355728,1669356453,725,357
3117262222,3156980878,1655054376,1655055005,629,240
3086894794,3646908383,1658534655,1658535093,438,2424
3124277484,3623620611,1664244253,1664244389,136,1691
3029053911,3537450451,1651556545,1651557495,950,2367
3495420849,3395307809,1668771976,1668772106,130,62
3166274990,3567926021,1667672291,1667672295,4,395
3598572594,3930994715,1642472595,1642472966,371,186
3639013476,3898188404,1659637466,1659637543,77,2351
3273348089,3296895937,1664364575,1664364692,117,2207
3202161567,3835069955,1653561746,1653562420,674,2220
3232333937,3992226673,1658417519,1658417909,390,727
3451823359,3551380152,1665767951,1665768810,859,1114
3101161243,3852834619,1642130212,1642130371,159,1315
3093387843,3012457192,1653647683,1653648271,588,705
3048788442,3088604045,1662639776,1662640119,343,1206
3268446099,3400121766,1646405029,1646406022,993,72
3722726470,3444809495,1664447148,1664447633,485,2245
3103728720,3116777827,1657064759,1657065741,982,244
3920875021,3252021647,1660195504,1660195702,198,2113
3023075779,3228574805,1667067330,1667068018,688,1478
3713834683,3574957979,1661712161,1661713127,966,816
3098161767,3132486699,1652963407,1652964379,972,2286
3489915638,3699947490,1653512231,1653512396,165,30
3223094463,3993365296,1644273825,1644273879,54,2263
3004517047,3798223043,1664668754,1664669583,829,765
3581570568,3813290629,1663936331,1663936439,108,2499
3308001923,3781537659,1650836101,1650836951,850,1860
3706215600,3247980767,1661505570,1661505999,429,2046
3319446954,3539303536,1655716669,1655717386,717,212
3659326501,3782673553,1643232096,1643232211,115,1027
3522132687,3668078009,1668901498,1668902094,596,632
3798223043,3653429754,1652044014,1652044917,903,1498
3773830646,3630966486,1652215075,1652215347,272,360
3397970538,3660732427,1652957537,1652957563,26,1206
3577798894,3577216621,1644982471,1644983380,909,926
3208831400,3012593677,1658484780,1658484874,94,2315
3158029379,3987423059,1652877467,1652877796,329,2478
3398795724,3465382952,1654757317,1654757473,156,1103
3328798665,3458243810,1653999772,1654000006,234,128
3563840007,3799117805,1662820698,1662821582,884,507
3420205343,3580330506,1661402104,1661402314,210,2093
3361508949,3143189190,1653346074,1653346645,571,1179
3372271387,3611062566,1662849403,1662850241,838,1682
3435036750,3046380642,1661104983,1661105220,237,807
3657333207,3708034201,1643611895,1643612629,734,491
3831699015,3820225206,1658202117,1658203094,977,642
3400329831,3825173498,1645927552,1645927996,444,1313
3766966794,3893018254,1650502448,1650503006,558,1437
3686944200,3075465136,1650208442,1650209277,835,288
3397779824,3403512366,1648854334,1648855150,816,1283
3118443532,3009141852,1644766407,1644766985,578,612
3259880338,3987005983,1645661821,1645661891,70,2314
3486810833,3273059265,1662277099,1662277551,452,1641
3772739629,3992528955,1668865459,1668865793,334,1361
3252535116,3693102953,1647743603,1647744497,894,1975
3300662625,3041792624,1659674839,1659675812,973,1577
3552282443,3961903747,1641237017,1641237945,928,2327
3251382188,3524282034,1656711725,1656712035,310,1853
3149896107,3794481759,1657373499,1657373634,135,1329
3927649358,3618013844,1644458538,1644459043,505,2399
3445422843,3830015015,1650246261,1650246567,306,1510
3297826818,3002438521,1659206689,1659207213,524,2308
3819415032,3855769157,1655696757,1655696883,126,807
3487992433,3180051747,1653487588,1653487623,35,1801
3180252962,3114128222,1658511680,1658512049,369,850
3318735194,3479087219,1646864828,1646865080,252,797
3927952722,3406595083,1657207738,1657208293,555,2310
3206422081,3546782886,1652341610,1652341845,235,2452
3706797905,3359417056,1660942368,1660942949,581,1229
3034040451,3278038835,1661079353,1661080080,727,1901
3188126815,3693652924,1664862916,1664863218,302,1535
3781446747,3740236087,1645257041,1645257317,276,60
3407331091,3835112188,1649637780,1649638414,634,1617
3887743057,3784105182,1663071321,1663072244,923,1779
3108818977,3949002357,1645507338,1645507960,622,2106
3938973292,3284433811,1660831406,1660832205,799,271
3887036201,3108427765,1665746031,1665746616,585,23
3237807880,3964711138,1647378442,1647379226,784,317
3761576790,3984818292,1647543356,1647544171,815,498
3841287368,3425006843,1665948823,1665949747,924,534
3762538736,3000254515,1659219080,1659219966,886,1467
3804978604,3022252567,1662283574,1662284093,519,778
3514218549,3612973191,1667954219,1667954781,562,1079
3293416862,3095151362,1641779527,1641780380,853,1008
3477692188,3526088150,1659838033,1659838420,387,824
3813511439,3640349880,1657533277,1657533382,105,2162
3550741990,3137829230,1657802950,1657803489,539,1397
3713062516,3933892798,1665520481,1665521206,725,2305
3810798932,3983113289,1655214069,1655214428,359,1835
3503393955,3430145466,1648390941,1648391918,977,2357
3506937925,3814608487,1661717065,1661717944,879,2011
3856985099,3910029798,1647046343,1647047151,808,377
3350017208,3784040148,1664475281,1664476144,863,843
3821594953,3840801648,1650236317,1650236902,585,693
3300694030,3328146266,1658046110,1658046987,877,685
3185360566,3832438123,1652554150,1652554798,648,1685
3356144129,3075313832,1667739631,1667739920,289,1480
3408460871,3388726341,1643970873,1643971509,636,1788
3722329316,3403925711,1667083137,1667083774,637,1901
3777929700,3144068102,1650870073,1650870613,540,555
3309242036,3621462507,1660935952,1660936907,955,1257
3741929805,3599714580,1653885963,1653886476,513,2263
3938583443,3108818977,1658836351,1658836668,317,475
3937728696,3816493730,1667280135,1667280592,457,2056
3836331716,3635324805,1664007201,1664007508,307,1212
3800451074,3607959490,1668355612,1668356307,695,1614
3436582780,3356028416,1663335174,1663335627,453,1979
3486541605,3371289776,1646785861,1646786150,289,2098
3928951547,3232285985,1651000093,1651000422,329,2133
3716257088,3726378645,1641152617,1641152653,36,1337
3197323395,3684926586,1658682015,1658682537,522,1275
3476903669,3396146110,1648381193,1648381832,639,1806
3782266785,3507338655,1646791010,1646791063,53,1663
3277298737,3357048496,1668728545,1668728682,137,1584
3673597203,3649649514,1652359215,1652359454,239,206
3763991129,3343232841,1641870525,1641870925,400,1898
3924799278,3497990894,1661905377,1661906227,850,109
3753998489,3674037967,1668703123,1668703428,305,1595
3351441481,3668645457,1643095399,1643096393,994,962
3306669471,3157308488,1655464070,1655464698,628,1894
3723780339,3645314586,1656570021,1656570320,299,1995
3414488975,3517449502,1669101010,1669101467,457,530
3595469152,3198022110,1657206564,1657207142,578,236
3952286494,3421728246,1647811783,1647812007,224,1365
3574486853,3358156140,1641488165,1641488336,171,1369
3569051470,3261685435,1648915618,1648916477,859,941
3555903175,3783723078,1657613530,1657613759,229,1809
3100535469,3985326073,1643115319,1643116153,834,1674
3911316683,3785584501,1644993452,1644994180,728,212
3822736402,3137195290,1649970641,1649970757,116,1360
3147896698,3596841713,1659174308,1659174973,665,505
3685158343,3643637605,1650612147,1650612378,231,1438
3707403309,3885235661,1655738406,1655738549,143,1270
3303698845,3278297907,1666901727,1666901750,23,740
3893018254,3852344377,1654892133,1654892919,786,2217
3569390971,3555187890,1651265211,1651265465,254,1713
3340337106,3415522797,1655736217,1655736878,661,775
3790406016,3103404280,1660816557,1660816829,272,53
3727981782,3407460146,1655381453,1655381773,320,1607
3313975664,3849701361,1648222241,1648222486,245,1138
3438465122,3942134694,1665363719,1665364419,700,2495
3644128961,3069431080,1668911483,1668911737,254,2386
3571145656,3371430360,1657206364,1657207244,880,2196
3938337743,3794103075,1666417743,1666417851,108,1866
3592519306,3166274990,1645998907,1645999136,229,215
3778228977,3364247623,1662819982,1662820947,965,17
3362249024,3975663862,1651594950,1651595370,420,1902
3149545838,3220690215,1656645632,1656646374,742,976
3997050001,3884412861,1667737174,1667737771,597,521
3461505923,3914348680,1645141883,1645142709,826,604
3793117012,3932212405,1660248518,1660249241,723,1633
3494613087,3827122083,1662146199,1662146439,240,1788
3010173509,3235825340,1651700052,1651700238,186,2189
3302700303,3486208738,1659351200,1659351255,55,1506
3260783577,3977539783,1661266175,1661266465,290,1727
3860430252,3856080546,1659621982,1659622980,998,192
3240324089,3307721045,1669160751,1669161557,806,2213
3475779347,3283211870,1651798888,1651799629,741,202
3241500636,3469648387,1649139623,1649140268,645,147
3814029511,3590621650,1665924271,1665924988,717,1719
3288555658,3645778086,1668089584,1668090540,956,379
3071023164,3141688992,1651832165,1651832166,1,1680
3102760949,3558492617,1669492446,1669493315,869,1181
3404934353,3051395031,1644562735,1644563535,800,1667
3156942626,3191414403,1664793770,1664794494,724,526
3328479258,3309799085,1648762247,1648762701,454,2078
3143324065,3132863382,1644623513,1644624292,779,289
3433768649,3159240548,1658830214,1658831081,867,871
3470488588,3271409183,1643069083,1643069552,469,424
3184539687,3264121565,1654197081,1654197706,625,1281
3657597585,3271314900,1647473866,1647474081,215,2229
3993438914,3984461468,1652638483,1652639394,911,2359
3714535860,3599327423,1651581444,1651582091,647,76
3288329354,3001912243,1650139623,1650140075,452,1587
3031292798,3561899633,1655592450,1655592940,490,1333
3163552496,3735700656,1668986372,1668987114,742,1277
3983988321,3796343532,1668223209,1668223438,229,473
3894193367,3118526217,1650905601,1650906469,868,2015
3194618871,3029016525,1641785228,1641785610,382,2109
3682608460,3329190028,1655321999,1655322583,584,2298
3073798415,3818039978,1665170508,1665171418,910,32
3000383745,3262377052,1646729713,1646730297,584,2146
3325842490,3542824458,1652702534,1652702752,218,572
3052889118,3635697777,1668891253,1668891700,447,1797
3725042810,3309405529,1649171099,1649171296,197,2446
3241007838,3524315738,1662619028,1662619627,599,1087
3918383192,3036346251,1666840467,1666840912,445,228
3442799166,3452564658,1642629399,1642629771,372,292
3021129414,3704517188,1655569545,1655569811,266,1789
3364842162,3031816428,1652383051,1652383805,754,1954
3002350398,3250359001,1657799183,1657799836,653,2083
3740090157,3079038995,1666352736,1666353301,565,1559
3330924198,3675366639,1661058731,1661058976,245,1799
3311860866,3079415495,1652432995,1652433361,366,1478
3447812768,3325981847,1663161979,1663162686,707,1504
3276840933,3912672075,1647578251,1647578839,588,337
3821120962,3348198228,1645878440,1645879230,790,1678
3285747162,3388257945,1658093267,1658093426,159,2445
3050800748,3581570568,1644398290,1644398411,121,1243
3623974243,3547429967,1651375643,1651375777,134,1433
3583585259,3516585405,1643775130,1643775315,185,810
3024611625,3487740667,1649952876,1649953200,324,2009
3882559155,3113793993,1665690422,1665690868,446,260
3641703512,3166805288,1644233120,1644233141,21,1285
3980867331,3660891061,1663080374,1663080765,391,846
3206248943,3502587181,1641794043,1641795018,975,255
3129594470,3534752391,1656960814,1656960882,68,879
3584402021,3341890542,1661355055,1661355509,454,2330
3036046331,3502690432,1649836952,1649837146,194,229
3100176230,3624294521,1643147749,1643147852,103,1555
3319546209,3029849131,1658079301,1658079985,684,550
3058141936,3574486853,1644514315,1644515193,878,1812
3746969288,3924141950,1659091101,1659092086,985,679
3789314517,3315185864,1659566851,1659567527,676,2325
3509167906,3263488499,1661134220,1661134778,558,293
3967506765,3090441115,1667067088,1667067108,20,2477
3637663893,3522465860,1641379518,1641379653,135,1381
3487526777,3355429456,1655158539,1655158587,48,2437
3372271387,3339719117,1654543926,1654544723,797,76
3397376963,3774264905,1644394186,1644394668,482,1595
3563750578,3450023391,1645341264,1645341514,250,742
3899585675,3427127427,1660277106,1660277348,242,1282
3786924052,3848740333,1664891347,1664891633,286,714
3043354217,3982210988,1667558866,1667559578,712,1312
3741413739,3339264241,1654320877,1654320884,7,1968
3934953223,3494372287,1651685757,1651686214,457,1626
3959261742,3765693461,1657224301,1657224791,490,1864
3524482926,3378168172,1647387638,1647388120,482,185
3601519220,3683507812,1654001991,1654002942,951,2121
3687293094,3956194935,1664174544,1664175161,617,1534
3207801201,3134117241,1653987936,1653988546,610,1060
3822126164,3974630210,1644280470,1644281399,929,1379
3086551217,3389497658,1653796734,1653796837,103,1510
3009177873,3852673624,1660865324,1660865344,20,2478
3594682644,3837157118,1643205673,1643205965,292,1382
3421294150,3608512295,1656217496,1656218377,881,240
3318577605,3400684585,1643597571,1643598549,978,2186
3819415032,3388328160,1646889649,1646889690,41,915
3289061595,3192193744,1651035028,1651035507,479,1268
3107865208,3206549691,1665009987,1665010825,838,219
3153851884,3046617108,1654910932,1654911082,150,1875
3253759705,3479738009,1651349001,1651349807,806,1665
3656654582,3057837723,1668411723,1668412307,584,210
3618532396,3211945942,1664441018,1664441347,329,2374
3618532396,3256787088,1645387659,1645387680,21,983
3542824458,3669744444,1658295066,1658295515,449,2080
3706085200,3364059276,1665865881,1665865908,27,1677
3437259542,3143909362,1666693350,1666693831,481,1216
3347832946,3102992210,1669615225,1669615853,628,742
3911632634,3748061416,1647327679,1647328456,777,856
3297949666,3280668606,1653091180,1653092174,994,709
3829874150,3724116295,1656254810,1656255117,307,1945
3487526777,3993866389,1652909357,1652910229,872,1976
3149804005,3379296882,1663901480,1663901695,215,333
3315539995,3333339972,1652037211,1652037226,15,1022
3851747907,3032888380,1667579807,1667580461,654,317
3402349073,3538686599,1651705882,1651706604,722,287
3654527501,3665668423,1659321355,1659321775,420,1178
3697028347,3441581446,1651120947,1651121789,842,448
3276771725,3400233871,1665713452,1665714317,865,2105
3601690466,3355942761,1643905968,1643906768,800,2033
3888895982,3128287586,1652348140,1652348827,687,863
3145045320,3697322167,1654907741,1654908143,402,1459
3239620599,3554832209,1656178921,1656179184,263,1002
3935383578,3805060036,1644173779,1644173912,133,572
3218798966,3029956642,1663894713,1663894837,124,1659
3129138715,3141048645,1657110071,1657110121,50,143
3652728312,3511192827,1647034665,1647034866,201,232
3916244157,3229495084,1653970342,1653970643,301,2005
3036448305,3669789756,1650741456,1650742143,687,1674
3391540103,3853448159,1649033902,1649034810,908,1470
3449395269,3510634049,1656310557,1656310907,350,735
3831346903,3200978578,1668969298,1668969805,507,843
3918602291,3315283904,1669168058,1669168637,579,79
3379598529,3075293628,1655120105,1655120781,676,2293
3101265323,3241033604,1652469830,1652470033,203,1098
3576862500,3646151081,1651878706,1651879243,537,1432
3891579335,3693581710,1658348355,1658349070,715,472
3658782272,3917662641,1668415463,1668416213,750,2408
3101161243,3142160799,1663405514,1663405800,286,789
3049447132,3818467247,1667594696,1667594993,297,1754
3410150990,3048788442,1658180236,1658180697,461,2428
3150289965,3415020400,1647534240,1647535130,890,2092
3027129249,3217060058,1654226144,1654226653,509,1183
3249627758,3389309088,1664479475,1664479512,37,1177
3734381035,3691925367,1667715143,1667715400,257,2338
3249252169,3353295219,1660676820,1660677053,233,1226
3055050795,3565781990,1647475039,1647475224,185,1386
3233146767,3725903222,1667172727,1667173506,779,463
3394695318,3257203631,1666882664,1666883529,865,865
3875892624,3247163175,1651476715,1651476961,246,1559
3370350588,3400233871,1664446383,1664447009,626,1587
3759165741,3870485916,1646373527,1646374288,761,2387
3294319716,3858911279,1648150826,1648151748,922,2321
3077145114,3900876329,1663449875,1663450061,186,948
3152200344,3886368625,1666498065,1666498557,492,2389
3288555658,3640605424,1642673051,1642673770,719,541
3209462413,3499026312,1644876250,1644876377,127,2457
3633382140,3809458973,1668869916,1668870383,467,20
3699730203,3166483466,1650550013,1650550115,102,1712
3800014504,3934489625,1668007778,1668008557,779,864
3197352308,3870463011,1650040868,1650041112,244,1821
3453839667,3143293050,1669206951,1669207860,909,1325
3678340379,3983490056,1666904314,1666904427,113,1882
3886917024,3653218860,1668661820,1668661892,72,376
3559301819,3701979416,1650674718,1650675569,851,1870
3179855785,3568097363,1645066191,1645066380,189,2011
3741344192,3654899608,1653832831,1653833575,744,509
3541920859,3224130773,1666556694,1666556961,267,1666
3036527901,3185977048,1643162627,1643163606,979,181
3648118736,3061362091,1650536444,1650536526,82,54
3187982526,3762690279,1652291094,1652291900,806,1437
3817667121,3144405714,1641997675,1641998006,331,647
3129582333,3310953839,1658081459,1658081808,349,1714
3385806632,3885393767,1661793581,1661793635,54,2332
3733484132,3726892870,1666867572,1666867863,291,2416
3006508919,3779331078,1664467217,1664467744,527,2097
3266991557,3710782213,1663013027,1663013624,597,2321
3318227153,3607385542,1644618923,1644619577,654,1961
3549209951,3846477373,1654734713,1654735666,953,127
3292782964,3132376039,1662857894,1662858484,590,2285
3026209549,3621462507,1645791066,1645791424,358,854
3417742545,3087662482,1660057917,1660058834,917,1575
3576422890,3473355243,1641734610,1641734895,285,810
3034325039,3287988080,1657137660,1657138077,417,2001
3697338181,3542204344,1666611980,1666612965,985,2130
3051776472,3845743542,1648610709,1648611159,450,2062
3845801721,3874569616,1669588105,1669588495,390,1556
3389097842,3541881881,1654933566,1654934246,680,2075
3129899259,3139087074,1659329457,1659330175,718,2484
3263328793,3925496970,1658115393,1658116148,755,1336
3676893681,3094759406,1666146175,1666146246,71,964
3463121212,3988223257,1648945980,1648946449,469,1802
3866215730,3252664436,1654085116,1654085700,584,1535
3835355277,3773742235,1669550151,1669550712,561,321
3596247005,3523099697,1646346551,1646347500,949,420
3645585393,3869505474,1647033725,1647033790,65,1686
3903015279,3933940005,1652447329,1652447495,166,1837
3968433032,3605308632,1662933845,1662934082,237,2465
3077552507,3395457102,1641403006,1641403038,32,1368
3272217633,3023448006,1657630499,1657630719,220,138
3012339110,3478166190,1655689649,1655689945,296,2330
3558517913,3320381981,1652825124,1652825210,86,485
3719785520,3730684727,1656300019,1656300266,247,750
3732472752,3183079019,1658366115,1658366290,175,720
3625950355,3344549344,1659007951,1659008587,636,872
3334298803,3328993418,1646415976,1646416220,244,418
3298436959,3340837702,1655241885,1655242148,263,2048
3304958701,3324041559,1662423632,1662423773,141,1065
3115344578,3649073682,1662997038,1662997652,614,2152
3584704567,3301148308,1647750591,1647750998,407,350
3447077543,3955219063,1648387488,1648387899,411,836
3122293667,3223694966,1655591325,1655591850,525,2156
3755513433,3725848338,1646429411,1646430002,591,1700
3381060534,3881206954,1658995644,1658995823,179,1876
3731257404,3735538229,1645120000,1645120778,778,587
3361319934,3560015501,1645689787,1645690436,649,2487
3229448014,3954297181,1656000136,1656001042,906,1842
3271648296,3702709444,1657427194,1657428061,867,1043
3268821463,3127403665,1644079233,1644080027,794,277
3914946558,3474315750,1663301285,1663301523,238,1361
3061366261,3809332572,1657424424,1657424724,300,1726
3447310943,3977043818,1649102529,1649102704,175,1280
3118358674,3053855376,1663383358,1663384073,715,1065
3386724007,3980501547,1647014041,1647014587,546,1930
3931108765,3176526207,1644810584,1644811387,803,1006
3570906118,3154435614,1643732537,1643732931,394,2441
3103625074,3759393612,1667063515,1667063980,465,2428
3464653044,3655087982,1654394522,1654395394,872,301
3856985099,3718714231,1649040665,1649041329,664,2191
3030290445,3769198196,1644426465,1644427359,894,825
3773207612,3959093613,1651408786,1651409255,469,2375
3307251676,3876687977,1641529633,1641529648,15,328
3765660727,3132959520,1659997527,1659998340,813,377
3997541339,3856467502,1646788515,1646789264,749,395
3157765022,3856386170,1668329950,1668330878,928,2078
3881378306,3722323538,1650378112,1650378779,667,245
3165700370,3115669693,1658401706,1658402661,955,755
3204333859,3705996677,1658729187,1658729670,483,1887
3945607460,3559489793,1644964568,1644964890,322,317
3023880168,3329498574,1652533751,1652533792,41,1236
3561336684,3790883274,1665427927,1665428518,591,1846
3060970440,3489811088,1645255228,1645255777,549,434
3540799664,3689231617,1647935716,1647936580,864,2372
3047643464,3892206642,1643608082,1643608470,388,58
3606270024,3217719618,1647262043,1647262864,821,319
3191970772,3489273340,1649919288,1649919527,239,868
3087333030,3292739128,1642401274,1642401823,549,990
3090731052,3178749877,1661898072,1661898934,862,123
3048504189,3481149583,1664285464,1664285478,14,1473
3704120553,3551170621,1655841113,1655841512,399,1316
3408108471,3045981034,1646644995,1646645894,899,1823
3206119800,3431883681,1646930062,1646930905,843,1133
3260515804,3493447321,1663937540,1663938417,877,1487
3360575138,3978667945,1668006210,1668007078,868,28
3991087724,3511325003,1667113896,1667114363,467,1162
3788769219,3182097979,1667445659,1667445673,14,2122
3220432369,3689303525,1647799068,1647799571,503,2215
3983490056,3485578733,1644697093,1644697745,652,852
3215815915,3822126164,1646242407,1646242929,522,1217
3911619189,3385806632,1660725610,1660725908,298,757
3505272067,3821064356,1651972548,1651972817,269,1572
3537592483,3225466850,1649483698,1649483899,201,2113
3831039944,3095932716,1645732635,1645732798,163,1753
3410972917,3497911447,1642980129,1642980906,777,1405
3182097979,3247758952,1651289063,1651289987,924,1857
3565001530,3057756725,1646324065,1646324604,539,1337
3695558824,3828219822,1644151479,1644152315,836,2331
3508224327,3598522904,1664430522,1664430756,234,1662
3105460297,3759409777,1654905965,1654906028,63,973
3649724545,3042943074,1665659604,1665660063,459,1826
3760930897,3952889735,1664284827,1664284991,164,1020
3885026939,3778675824,1643920057,1643920790,733,1838
3250248786,3623736661,1668480625,1668480639,14,145
3631660076,3562859716,1655050121,1655051120,999,1321
3171569619,3494680258,1654758740,1654759386,646,724
3826257607,3783051630,1644244769,1644245104,335,1982
3956547336,3658271419,1653019814,1653020243,429,587
3931789231,3506090868,1651388734,1651388765,31,2006
3731116644,3120419076,1645192014,1645192715,701,981
3546866871,3535467955,1644086444,1644087350,906,2002
3447447895,3949002357,1646062412,1646062622,210,1600
3035464149,3629090721,1664161126,1664161637,511,1935
3153858233,3699152541,1644599071,1644599972,901,520
3121336226,3573939226,1643947978,1643948585,607,787
3205383513,3131683456,1665295671,1665296249,578,1989
3077346044,3565056457,1647120666,1647120882,216,2495
3819547274,3726367604,1662977530,1662977703,173,1310
3762422234,3962211697,1641249235,1641249517,282,1234
3841672169,3494372287,1642513289,1642514147,858,1178
3678505160,3084882941,1641572519,1641572951,432,1066
3220690215,3800861252,1657204636,1657205627,991,1218
3025581381,3428176980,1652822566,1652823211,645,15
3096412109,3620985435,1660965370,1660965394,24,1625
3984467207,3929497543,1648809795,1648810121,326,1169
3638803969,3559863065,1644398700,1644399528,828,1887
3327061038,3691830908,1653833586,1653834077,491,2253
3436636953,3494498890,1641084426,1641084766,340,1301
3680139573,3022453107,1651879285,1651879850,565,1987
3729475963,3794408677,1662482449,1662482527,78,2141
3351863157,3399334455,1651494252,1651495222,970,1102
3567906153,3344394548,1648806859,1648807285,426,1064
3225616352,3115494713,1660661329,1660661659,330,1113
3471797400,3452219424,1663845868,1663846807,939,1456
3818028118,3331977197,1657043334,1657043905,571,991
3382693942,3645341350,1668595697,1668596183,486,518
3197497279,3624947127,1646020975,1646021732,757,2097
3463540687,3909309427,1646585579,1646585861,282,2324
3804328787,3842362489,1647387627,1647388024,397,1484
3371745136,3355848120,1644021547,1644021576,29,1317
3231971396,3953258545,1657781066,1657781135,69,2028
3500053511,3406357109,1659698251,1659698487,236,2032
3875892624,3048405710,1666531177,1666531461,284,2038
3181047536,3499182342,1658580945,1658581443,498,1319
3577718759,3074477991,1644680177,1644680511,334,396
3530278315,3197176680,1646993005,1646993226,221,1711
3606368289,3882603510,1661078151,1661079025,874,539
3141391673,3740404190,1667900425,1667900549,124,2024
3102669962,3734035973,1651568380,1651569379,999,2461
3872691076,3012152244,1664704295,1664704464,169,999
3581470040,3092365114,1652268291,1652269021,730,568
3748841094,3122109326,1659185144,1659185505,361,786
3333037570,3096541903,1643738724,1643739457,733,1051
3000725837,3107366519,1655611025,1655611220,195,2228
3661494924,3979550486,1656836641,1656836902,261,1920
3725439899,3624683080,1660980186,1660980349,163,2423
3988790434,3884346810,1666992060,1666992279,219,67
3797617787,3546034581,1642532233,1642532574,341,1642
3770393539,3906065558,1663677150,1663678034,884,2003
3013484024,3148589566,1656247498,1656248448,950,1450
3658260972,3611025093,1654101691,1654102415,724,504
3470112947,3563428558,1651740283,1651741042,759,985
3825971737,3530806404,1651099847,1651100838,991,84
3194664110,3023254734,1655895562,1655895709,147,237
3559208316,3221685249,1656441789,1656442522,733,1908
3306669471,3918812791,1662962827,1662962861,34,512
3899782287,3777091595,1661052645,1661053583,938,1124
3239377872,3300203056,1650951936,1650952741,805,1498
3577878798,3852731262,1663109688,1663109901,213,1164
3277284318,3164355501,1669663375,1669664181,806,1249
3590627159,3299211422,1666285433,1666285548,115,2488
3476312823,3623206706,1641416199,1641416877,678,2476
3469507401,3339633388,1641797298,1641798099,801,1537
3440598942,3149135097,1654599229,1654599341,112,1696
3954285582,3532756620,1668976964,1668977623,659,98
3960494982,3707892765,1657437612,1657437815,203,1774
3665148560,3959795133,1641471659,1641472343,684,1150
3790751649,3714909437,1651060164,1651060490,326,1353
3282166903,3048361071,1664149990,1664150252,262,1225
3118443532,3077552507,1651998107,1651999076,969,1421
3311860866,3511569871,1641658525,1641658843,318,1759
3061362091,3607352755,1648841520,1648841913,393,2088
3718714231,3408978529,1651840659,1651840707,48,406
3347462301,3080214168,1662758011,1662758087,76,2079
3110639083,3124476593,1662106270,1662106778,508,252
3176252124,3570429285,1653624935,1653625696,761,1970
3292636621,3799776825,1661233763,1661233901,138,2347
3252981510,3883537438,1657140672,1657140758,86,1049
3047629830,3795326002,1649463443,1649464441,998,369
3590243603,3145220460,1666434144,1666434651,507,2107
3994913668,3924865492,1652483557,1652484348,791,1717
3065530519,3284159385,1655576117,1655576960,843,984
3784105182,3365829981,1667179700,1667180624,924,649
3467613173,3313431689,1655694479,1655694994,515,911
3964690423,3713116694,1669188095,1669188617,522,1511
3634624974,3375177760,1664581925,1664582588,663,409
3058789362,3359417056,1643760756,1643761381,625,996
3976147939,3817513264,1650661697,1650662378,681,343
3960450011,3006603067,1665156054,1665156936,882,2162
3493393225,3518246885,1660067278,1660067730,452,258
3209150433,3638527581,1644313020,1644313428,408,1382
3795264165,3924838447,1661290406,1661291186,780,823
3335565751,3552091513,1664160605,1664161089,484,1285
3576386271,3457542537,1660384233,1660384465,232,1620
3935379393,3280491285,1647598726,1647599043,317,492
3311921613,3661369487,1668586175,1668586684,509,878
3539510682,3017712081,1666790859,1666791000,141,2419
3160349110,3881000980,1651095231,1651096222,991,647
3279550373,3863948017,1664115095,1664115620,525,1276
3010368174,3167290048,1660155717,1660156120,403,189
3651503901,3824545323,1661263071,1661263859,788,376
3753596469,3779998740,1656626438,1656627234,796,1918
3771028638,3368571252,1643745601,1643745761,160,80
3018149057,3799014776,1648697173,1648697228,55,1879
3276576100,3753596469,1643450925,1643451561,636,1206
3177433990,3243018622,1661622409,1661623077,668,355
3764318951,3570955260,1665124292,1665124452,160,1810
3033079935,3193483812,1663171346,1663172302,956,519
3437593879,3115494713,1651368771,1651369665,894,2438
3867799694,3720240255,1660371057,1660371959,902,864
3977043818,3251382188,1663004017,1663004347,330,2469
3720223108,3223159718,1664118650,1664119650,1000,1247
3457417743,3247551122,1668462149,1668462767,618,1412
3398278082,3734579045,1664717418,1664718344,926,2117
3734331528,3168535205,1665086582,1665087187,605,154
3848866443,3434324683,1663321467,1663322204,737,2108
3121128511,3809458973,1654651503,1654652085,582,725
3604461797,3960494982,1644002342,1644003121,779,1557
3843953645,3895422097,1658557916,1658557919,3,1905
3172130228,3397376963,1664911949,1664912142,193,2232
3401138486,3039864595,1654772017,1654772689,672,809
3105946115,3297434061,1653174786,1653175386,600,1116
3967015655,3889288487,1652458913,1652459900,987,1850
3072347750,3969744786,1652729836,1652730335,499,1824
3649252503,3792527009,1651980624,1651980773,149,420
3338329823,3476820014,1651968218,1651969217,999,1369
3820466728,3833987128,1650436422,1650436563,141,2005
3319545220,3450023391,1645699817,1645699877,60,594
3673810421,3123166182,1668763565,1668763676,111,1680
3831338864,3548609816,1661137639,1661138518,879,866
3261419893,3241444105,1664763330,1664764209,879,1329
3043604048,3479322514,1663200937,1663201748,811,289
3258739109,3984259471,1651416305,1651416949,644,468
3967747142,3052279761,1667399788,1667400555,767,331
3924865492,3258399411,1656363945,1656364370,425,586
3615359439,3397779824,1647161520,1647161944,424,1382
3916456426,3672482112,1642466624,1642466832,208,197
3803799575,3395679954,1660285076,1660285790,714,1148
3149818961,3456285013,1658831038,1658831993,955,1444
3853256957,3283059949,1663210758,1663211607,849,599
3123677020,3486727273,1642368172,1642369130,958,2045
3016283694,3260085949,1659989930,1659990814,884,1264
3424944206,3270935026,1655849216,1655849623,407,490
3123795999,3488962022,1657642004,1657642559,555,599
3557559741,3153858233,1660639290,1660639689,399,211
3623092479,3334483625,1665401118,1665401676,558,379
3806936803,3307185651,1652167565,1652167676,111,644
3510323514,3832773624,1647074757,1647075055,298,1565
3435340439,3242897248,1647487438,1647487648,210,1378
3444174394,3681795615,1665688021,1665689020,999,1792
3676100322,3956878212,1649682722,1649683053,331,2444
3081188307,3490415118,1648152146,1648153059,913,2013
3713006411,3353878603,1665337878,1665338856,978,2257
3110016926,3276341369,1646108381,1646108988,607,2268
3149534519,3006388757,1647806988,1647807383,395,1693
3475612329,3039255124,1659978433,1659979421,988,409
3220424979,3191460519,1652634968,1652635937,969,1184
3299607426,3658656847,1641711246,1641711433,187,2100
3907764491,3878698797,1645007469,1645008416,947,299
3309468510,3828921434,1651783178,1651783366,188,53
3377179024,3965867792,1655085358,1655086183,825,183
3819415032,3855754332,1654837982,1654838945,963,2070
3505480563,3858951131,1667884694,1667885352,658,2345
3529732289,3284137438,1667952760,1667953555,795,2137
3048497124,3625034951,1667642085,1667642720,635,2080
3749529134,3893849847,1663193263,1663194054,791,1844
3277577090,3207013037,1641436447,1641437306,859,130
3853056907,3140971443,1656953244,1656954130,886,885
3904517073,3590243603,1657696397,1657697101,704,1835
3882748527,3202625372,1656454950,1656455814,864,1140
3879325408,3295518987,1642181504,1642182087,583,987
3563407459,3742012582,1665261871,1665262051,180,657
3375799029,3208802379,1651264735,1651265643,908,1806
3992927391,3516488694,1664473466,1664473948,482,2024
3579642249,3545150522,1654343526,1654343857,331,2253
3971722824,3659158165,1646249519,1646250493,974,1983
3214698363,3917448920,1660529313,1660530219,906,1681
3724157579,3879001343,1652975233,1652975590,357,1993
3934199220,3065548516,1658540886,1658540951,65,600
3445714649,3457390239,1666445616,1666445961,345,1540
3786322776,3085676024,1650924288,1650924688,400,729
3740807524,3556729365,1651627661,1651628212,551,932
3795765856,3492034029,1642724141,1642724148,7,1701
3070795112,3297123407,1661340007,1661340120,113,566
3261255394,3742647803,1667570582,1667570590,8,677
3963841091,3604514331,1646031321,1646031813,492,762
3439221238,3976335280,1652688221,1652688776,555,1508
3823161778,3902705203,1641592849,1641593144,295,2404
3265262512,3219637680,1656888691,1656889604,913,1290
3969110896,3516676045,1663532102,1663532380,278,2295
3889079063,3207258694,1666280090,1666280374,284,1890
3728419832,3311113773,1649553296,1649553552,256,240
3558492617,3494009953,1669429078,1669429656,578,2010
3612720177,3444005080,1667502830,1667502834,4,1609
3731399462,3609003771,1656545425,1656545609,184,1797
3306188967,3401677898,1642834543,1642834898,355,2344
3985486150,3832252723,1648733266,1648733300,34,2451
3688345244,3351145248,1645099528,1645100060,532,1892
3261128374,3630614328,1647056667,1647056910,243,214
3674037967,3862583365,1642721066,1642721219,153,1217
3482933937,3128529900,1655147003,1655147225,222,435
3328922333,3187807330,1656321553,1656321673,120,260
3718652649,3802790977,1663379511,1663380282,771,2107
3671974600,3523546928,1641256727,1641257374,647,48
3134436515,3079038995,1658397385,1658397623,238,869
3272535116,3497171741,1661049195,1661049208,13,2064
3106781266,3646151081,1648877949,1648878335,386,432
3247948931,3019204329,1655188803,1655189577,774,2451
3283947136,3401156180,1663650017,1663650693,676,884
3724523438,3709518724,1648491791,1648492562,771,2300
3809387134,3872626198,1662693370,1662694307,937,2450
3957577990,3970820689,1655288069,1655288096,27,2002
3106804099,3884704204,1668794507,1668794544,37,1422
3189111071,3174544371,1641574891,1641575660,769,983
3402349073,3127771930,1662692458,1662693177,719,719
3355135607,3483553551,1643167895,1643168575,680,510
3255115511,3382974723,1645678840,1645679422,582,1256
3549635553,3436422088,1650620468,1650621171,703,786
3106630738,3232737784,1651919125,1651919654,529,563
3029016525,3618380884,1646084901,1646085454,553,2018
3834720743,3328737379,1658505388,1658506207,819,2057
3368630986,3891235779,1641490370,1641490988,618,575
3486262024,3267360802,1645902835,1645903557,722,1051
3657753711,3875008839,1644707249,1644708044,795,2429
3545032372,3802749978,1655145734,1655146274,540,1107
3372093069,3166284447,1651952208,1651952906,698,2076
3016568360,3689232908,1655766602,1655767367,765,1394
3896308173,3431082237,1643903121,1643903335,214,410
3888260346,3625179175,1641672327,1641672722,395,660
3284284605,3726378645,1643125327,1643125566,239,1756
3449622291,3063714742,1663055073,1663055876,803,387
3257732454,3316398180,1657997584,1657997746,162,2177
3450689808,3911849911,1647022243,1647022329,86,1412
3852506516,3863652254,1667611510,1667612063,553,1813
3756028002,3757693725,1660424850,1660425808,958,2467
3899301205,3251948771,1643048681,1643049349,668,569
3135116989,3594254200,1661575317,1661575427,110,1045
3955685340,3931229167,1668499372,1668499457,85,1507
3355418256,3613018005,1652383707,1652384007,300,1793
3647938021,3507960689,1665713556,1665714524,968,2243
3868474839,3122085251,1650100842,1650101352,510,476
3379285136,3835355277,1651902707,1651902760,53,2113
3475612329,3504398546,1650716208,1650717107,899,33
3540717336,3939477257,1653126594,1653127314,720,211
3601562567,3577276558,1668719979,1668720572,593,882
3532675680,3787654868,1648476005,1648476992,987,2446
3586600196,3032018734,1665814416,1665815068,652,1348
3571173934,3261403182,1650716064,1650716648,584,2437
3335040022,3812481438,1650346519,1650347216,697,2456
3622334419,3909859344,1653370757,1653371328,571,640
3894247542,3284380221,1650982120,1650982857,737,2436
3908893546,3102251970,1657742333,1657743134,801,2165
3423825173,3795817960,1646572823,1646573231,408,856
3935601127,3001509229,1650734319,1650734817,498,123
3687151281,3377086230,1660331324,1660331720,396,2302
3770561730,3490942401,1654692570,1654693382,812,291
3093300732,3645537857,1658256979,1658257841,862,871
3426753006,3760224151,1656999219,1656999777,558,585
3340337106,3738591594,1665903029,1665903452,423,212
3346978275,3735801716,1660742170,1660743063,893,2224
3677306151,3576386271,1668210404,1668210746,342,2186
3946614568,3469812263,1651687301,1651688085,784,1484
3919439752,3954055058,1651021085,1651021929,844,1719
3867554012,3037844343,1647426454,1647427323,869,59
3007934266,3613801852,1668736505,1668736958,453,1937
3192505750,3027110508,1664909295,1664909701,406,1691
3814355412,3461108375,1652028783,1652029416,633,1094
3728224229,3156522255,1654740727,1654741187,460,728
3657699213,3949771162,1650182701,1650183134,433,4
3082912574,3314932010,1664428224,1664428503,279,2258
3254695387,3904825547,1668399706,1668399943,237,1474
3609003771,3468963532,1665510364,1665511243,879,616
3625894399,3930118877,1645474139,1645475118,979,224
3776785233,3806629780,1659759680,1659759921,241,1878
3747062640,3924799278,1662958967,1662959503,536,527
3353500391,3350017208,1644367903,1644368463,560,714
3150474600,3515460273,1667670601,1667671468,867,1260
3569573616,3084430345,1650075733,1650076002,269,674
3486582851,3756028002,1660307091,1660307605,514,1427
3315402916,3361482296,1657309327,1657309365,38,1790
3940067834,3937129101,1641390508,1641390811,303,1494
3017740025,3862371205,1663061838,1663062109,271,1299
3181074947,3430638959,1668040516,1668040714,198,2371
3202161567,3179891006,1650436057,1650436116,59,448
3838136289,3918812791,1666218600,1666219569,969,667
3553725082,3690015481,1643576972,1643577356,384,673
3965434074,3029149493,1654457766,1654458383,617,1342
3404394014,3841318125,1658775950,1658776674,724,1725
3081396297,3194140038,1666380865,1666381516,651,1311
3552091513,3901736828,1664396916,1664397195,279,2080
3116451556,3085093321,1647993684,1647994416,732,440
3046351455,3227446097,1646870406,1646870661,255,1440
3308015697,3827170233,1651512224,1651512413,189,2327
3751346675,3122818832,1659183786,1659184469,683,697
3998200859,3418338710,1656239772,1656239942,170,1017
3328544337,3553241769,1641771832,1641772080,248,1024
3922851964,3061619114,1657717258,1657718235,977,2123
3344205602,3829597039,1653000292,1653000973,681,2169
3482891017,3424553049,1658567499,1658567808,309,2288
3175929512,3012930968,1655719781,1655720382,601,906
3722726470,3361482296,1651892710,1651892958,248,81
3596661503,3988223257,1659562218,1659562506,288,1170
3963995256,3989991456,1646910249,1646910978,729,2165
3884551317,3716977635,1657040676,1657040922,246,524
3930347129,3510281371,1642002635,1642003037,402,1348
3696856656,3028841213,1642267257,1642267452,195,26
3055603453,3446519765,1648478781,1648478844,63,2471
3043736420,3646079529,1654337706,1654338034,328,1070
3052789625,3889840253,1645165904,1645166724,820,2417
3499281518,3259344210,1654038311,1654039106,795,1927
3753863307,3532569602,1651420502,1651421355,853,2220
3347152834,3178640485,1669366519,1669367261,742,664
3307251676,3527269010,1641441541,1641441683,142,1121
3727544443,3553939893,1642712154,1642712371,217,2497
3432892677,3342685325,1643632915,1643633751,836,2482
3604762599,3705809622,1661433027,1661433697,670,1661
3897433648,3105815944,1657015471,1657015821,350,920
3059858458,3180984174,1668786626,1668787625,999,2364
3748837929,3748841094,1660136047,1660136507,460,348
3945943527,3721374677,1666560517,1666561274,757,1256
3163030169,3138662322,1651138327,1651138932,605,2169
3932161358,3456799118,1652475799,1652476323,524,292
3835708711,3896960517,1658096990,1658097376,386,307
3379598529,3693000511,1668825218,1668825424,206,2473
3597557082,3739233756,1650021945,1650022007,62,2419
3012034151,3928354041,1655130671,1655130922,251,1245
3298748343,3446741935,1659037399,1659038223,824,1422
3817667121,3058789362,1663587761,1663588129,368,995
3513847916,3917721165,1656275107,1656275724,617,305
3192194263,3033925963,1664615100,1664615302,202,764
3352005808,3859864317,1653536141,1653536836,695,82
3597403559,3292812509,1657182406,1657183036,630,64
3435252882,3278854404,1642301416,1642302130,714,2401
3600472145,3158338043,1666759470,1666759746,276,2122
3072277927,3897030063,1663545888,1663546199,311,2089
3320179826,3267107046,1657550823,1657551049,226,978
3625611440,3002029298,1647979892,1647980729,837,45
3175505409,3495147813,1655762883,1655763303,420,797
3428299424,3790298140,1642112658,1642113564,906,604
3790298140,3993076833,1663650900,1663651899,999,2150
3115928790,3414328029,1642103962,1642104773,811,332
3211003582,3827810459,1662068087,1662068151,64,1234
3844666457,3327166880,1656753609,1656753672,63,2375
3178732875,3911621945,1657331514,1657332402,888,543
3852731262,3980971387,1648615759,1648616109,350,1301
3583985803,3456799118,1648234050,1648234519,469,1201
3671296032,3282587673,1661545541,1661546284,743,1051
3390416640,3662455665,1665519292,1665519827,535,1989
3899585675,3095124554,1643462245,1643462548,303,799
3399604947,3689232908,1651143959,1651144821,862,1484
3102089102,3243902799,1667721021,1667721104,83,1711
3486832676,3060718787,1647657116,1647657940,824,91
3795934256,3880608911,1659051982,1659052675,693,59
3595270507,3584925664,1642513817,1642514159,342,35
3749619105,3411921561,1652760996,1652761371,375,1051
3650902153,3014552263,1648785737,1648785797,60,1332
3012323943,3685678285,1662564520,1662564563,43,1626
3222060578,3728974462,1646769926,1646770565,639,1214
3611685224,3889112055,1668959758,1668960199,441,616
3073944007,3633830454,1663170311,1663171201,890,1741
3889537515,3400211665,1662111352,1662111529,177,895
3225328547,3333095694,1665849367,1665850336,969,2379
3920669948,3516019563,1654295733,1654296098,365,222
3776419392,3403933668,1656592904,1656593227,323,313
3803606691,3001037251,1647837875,1647838325,450,2227
3151386327,3524131973,1650397980,1650398417,437,417
3231971396,3529576659,1654445764,1654446536,772,2145
3186584232,3132258390,1656200979,1656201500,521,2021
3414834461,3301620813,1669341138,1669341655,517,1087
3481072834,3567926021,1657073000,1657073145,145,2362
3151386327,3378168172,1653730024,1653730874,850,1869
3887564578,3348406323,1657936026,1657936137,111,993
3145039731,3576961863,1658465813,1658466288,475,1889
3244514632,3895277580,1648520964,1648521911,947,2074
3670387440,3919439752,1643399065,1643399650,585,2100
3442593383,3768482482,1649532823,1649533679,856,1048
3394220693,3053134032,1668710628,1668711568,940,1068
3338329823,3683440211,1668875112,1668876072,960,1696
3249554278,3589366986,1662568479,1662569077,598,1911
3010767150,3615177362,1666720833,1666721039,206,1133
3922358932,3750949753,1665636422,1665637170,748,1237
3086564112,3133902865,1651437974,1651438138,164,2335
3050370620,3395670756,1656334472,1656335170,698,1695
3816194055,3977539783,1660650274,1660650615,341,1973
3884247169,3898959510,1656990129,1656990912,783,1724
3156483651,3344337283,1663871517,1663871834,317,519
3701726268,3729356619,1647283081,1647283809,728,1138
3526365568,3342260000,1666845950,1666846318,368,1269
3693862073,3276576100,1666206884,1666207090,206,1020
3749327438,3164789962,1651905867,1651905894,27,34
3094291821,3082434177,1645313175,1645313780,605,2348
3121128511,3749266673,1650001389,1650001836,447,1386
3889705477,3707940691,1654825361,1654825844,483,1271
3659701814,3563488722,1654588144,1654588434,290,1750
3261255394,3812385830,1648249515,1648249523,8,1900
3639695113,3658017612,1646631398,1646631517,119,278
3165700370,3545544203,1662593692,1662593745,53,977
3643372353,3359722926,1669372510,1669373115,605,464
3241444105,3735943539,1651240906,1651241318,412,1993
3717899735,3084730908,1656134486,1656135366,880,479
3647685310,3692512390,1663660404,1663661019,615,1607
3811389743,3274208430,1655495715,1655496007,292,299
3489273340,3284829365,1654313459,1654314103,644,492
3206243555,3720223108,1666517279,1666517294,15,1339
3712727713,3055390520,1647299786,1647300544,758,952
3882254802,3890194122,1665453403,1665453845,442,257
3076767349,3373656201,1666508836,1666509002,166,1161
3451227417,3920261171,1657954006,1657954168,162,409
3465796988,3389773271,1656316379,1656316953,574,2288
3758622438,3463973561,1645715075,1645715343,268,1324
3170292789,3824083602,1652528054,1652528848,794,1767
3346604377,3833572466,1645555258,1645555561,303,629
3600334566,3295850908,1645544126,1645544679,553,2364
3223290764,3270453709,1658298015,1658298034,19,1604
3878683407,3829901682,1655978443,1655978592,149,2062
3041296119,3121932256,1650439315,1650440087,772,1916
3032123620,3619529955,1653737022,1653737408,386,1242
3633080652,3351218513,1666070507,1666071457,950,183
3748478851,3880835949,1661069613,1661069848,235,1631
3579924256,3979696807,1646567840,1646568170,330,509
3090666521,3881002245,1654491393,1654491513,120,1436
3721060604,3663871563,1658810623,1658811089,466,1264
3433835303,3880011397,1655742758,1655743360,602,785
3595144575,3988913212,1657847819,1657848297,478,1862
3409034003,3308531560,1647934925,1647935369,444,1333
3830579550,3109465057,1667085205,1667085383,178,884
3984348951,3611025093,1658659552,1658660011,459,2488
3149181988,3175976694,1645068053,1645068769,716,2070
3430145466,3936980618,1653884978,1653885591,613,2240
3613021322,3911316683,1667470954,1667471805,851,1719
3450023391,3597485446,1664561504,1664562155,651,724
3402439234,3154680228,1666031833,1666032453,620,233
3058725687,3338082003,1667815204,1667815587,383,2195
3929887239,3377868003,1656332931,1656333045,114,607
3318848700,3371745136,1659168820,1659169139,319,938
3151288415,3871971681,1655277562,1655278462,900,1260
3959629367,3974318707,1644442933,1644443236,303,401
3938679223,3622848449,1665218224,1665218993,769,2000
3609043475,3625611440,1658321796,1658322683,887,2313
3396146110,3032498591,1658593071,1658593094,23,1778
3297826818,3838082378,1643441682,1643442401,719,2060
3740376361,3555452314,1641531930,1641532317,387,228
3925523737,3110339164,1664521309,1664521934,625,394
3252981510,3533274758,1669247475,1669247777,302,302
3404563689,3034643506,1657307287,1657307374,87,1140
3472855930,3705752007,1645550364,1645550841,477,1020
3779299713,3785813162,1652724306,1652724507,201,106
3911364139,3473037406,1655294349,1655295061,712,770
3853448159,3898959510,1646363695,1646364324,629,106
3892023630,3299817472,1666184213,1666184467,254,1829
3526630913,3806466784,1646659311,1646659813,502,208
3481466662,3346288809,1665516948,1665517845,897,2413
3304499678,3584668339,1661974276,1661975118,842,699
3981348782,3538686599,1662621033,1662621895,862,274
3859976372,3282950540,1651413161,1651413548,387,1187
3346484497,3376960491,1668690490,1668690987,497,2141
3752652141,3938025728,1665463885,1665464721,836,1192
3881554146,3896281957,1667175319,1667175955,636,1130
3928989640,3958733956,1666742255,1666742786,531,990
3929282989,3683326795,1662176403,1662176529,126,2381
3212038287,3038211411,1649712538,1649713181,643,2059
3041928480,3177879837,1646560870,1646561675,805,1406
3006388757,3695161514,1648798386,1648798629,243,942
3341300979,3896960517,1654544301,1654544517,216,1072
3293504206,3740807524,1666327213,1666328114,901,2172
3976346769,3661037098,1669567430,1669567659,229,826
3422374987,3524589150,1663205523,1663206203,680,860
3144068102,3298044531,1657306643,1657307321,678,2294
3050607996,3913994422,1660835614,1660836353,739,1596
3976335280,3698898645,1661939753,1661939988,235,1064
3515138485,3762571799,1653764830,1653764888,58,2017
3052789625,3504457520,1647899581,1647900104,523,1024
3200897172,3510660628,1652677030,1652677446,416,2190
3919162177,3672609185,1644858501,1644858949,448,535
3111514903,3039001408,1658721380,1658722259,879,1888
3623351962,3919196366,1648254241,1648254863,622,1057
3742344076,3451167153,1660047773,1660048159,386,2283
3949771162,3972917056,1663486045,1663486227,182,676
3115236500,3281146609,1666504923,1666505252,329,1644
3228805720,3013814400,1657976363,1657977347,984,1186
3509328343,3141635102,1666759272,1666759635,363,2152
3867205407,3178837482,1646735889,1646736879,990,1931
3310169810,3675093452,1664447073,1664448009,936,221
3907213401,3062506508,1648519672,1648519831,159,277
3109390601,3717406689,1641945424,1641946109,685,1326
3383573457,3423073970,1648261748,1648262065,317,1081
3462862340,3790039057,1642798820,1642798977,157,2026
3776918350,3474666564,1666290045,1666290935,890,38
3438130685,3976858724,1650094688,1650094952,264,243
3130993420,3686207600,1652084103,1652084169,66,348
3971020365,3252973419,1665450370,1665450904,534,514
3678720106,3139376524,1653297896,1653298039,143,238
3939948508,3093534312,1648451823,1648452217,394,363
3454851350,3051253299,1645001275,1645001919,644,1199
3483553551,3817057878,1668875243,1668875376,133,133
3536768410,3693888320,1654741795,1654742365,570,1930
3855113371,3590627159,1669051885,1669052034,149,107
3438474821,3523052385,1660039620,1660039829,209,302
3565781990,3462862340,1656709320,1656710085,765,1382
3474543664,3640756400,1649953209,1649954055,846,1375
3458971289,3044564753,1646077601,1646078505,904,2070
3342054027,3696448766,1641009415,1641010003,588,2206
3569552798,3128449335,1665119421,1665119801,380,1278
3900356013,3968636198,1645288751,1645289663,912,2408
3315391438,3553712893,1643726642,1643726696,54,1944
3021727735,3392156471,1650542412,1650542553,141,786
3178742688,3862583365,1649675432,1649676037,605,239
3232342525,3783325820,1667873575,1667874399,824,1738
3102760949,3868427833,1667373059,1667373892,833,1490
3827867076,3233222399,1647123800,1647124078,278,971
3036346251,3115303809,1654704218,1654704598,380,854
3835621921,3956054666,1641346843,1641347706,863,1345
3555105048,3360158658,1650468410,1650469151,741,2111
3113516667,3352759849,1657410495,1657410658,163,1928
3422374987,3482826953,1657783378,1657784268,890,887
3465064732,3874913687,1653265137,1653265966,829,2118
3904007370,3712332461,1648174341,1648174366,25,1322
3508340066,3489254440,1654119915,1654120419,504,591
3359078190,3486262024,1645499537,1645499887,350,1919
3365708107,3768984387,1641046844,1641047561,717,396
3740236087,3029943531,1650942774,1650943088,314,740
3606368289,3145961063,1650974557,1650975405,848,2445
3663228098,3857211245,1648392389,1648393020,631,794
3748627476,3067150549,1641500902,1641501753,851,114
3996978717,3575375841,1664488968,1664489839,871,2107
3879967963,3520341683,1655023822,1655024354,532,191
3485578733,3736118442,1652519538,1652519690,152,2324
3183259139,3528439013,1646235680,1646235863,183,247
3838823979,3909281743,1665621609,1665622143,534,1861
3246028948,3460047535,1642537882,1642538822,940,40
3271039091,3091595739,1654188530,1654188900,370,599
3718562533,3964565126,1648606590,1648606848,258,1983
3848272906,3793996748,1651497726,1651498079,353,421
3689464410,3243133485,1660850311,1660850861,550,461
3038014403,3530495336,1669382923,1669383050,127,1211
3001889220,3532355049,1652994809,1652994831,22,995
3834174227,3575816255,1647070181,1647070898,717,420
3285019414,3687724937,1669426890,1669426939,49,1910
3941317555,3952889735,1652366681,1652367532,851,2012
3067380299,3404785260,1656151597,1656152555,958,2355
3131683456,3507952797,1652955211,1652955414,203,791
3981817077,3706215600,1650131230,1650131770,540,1844
3546605941,3691474413,1643339815,1643340664,849,893
3240037909,3180062640,1643200140,1643200758,618,351
3536903033,3066854514,1664785835,1664785837,2,1678
3670266153,3508858140,1650102146,1650102950,804,2347
3165536332,3239418137,1646335126,1646335239,113,970
3932077086,3569738818,1654460928,1654461352,424,1152
3748511559,3685665978,1661442810,1661443184,374,2061
3994409144,3816935536,1655383316,1655383936,620,2469
3310970237,3124321462,1641710299,1641710807,508,2002
3456364565,3939973483,1650505505,1650505746,241,690
3125378100,3834826280,1650461730,1650462342,612,1899
3046351455,3732585972,1645542409,1645542885,476,1965
3870384331,3691834770,1648686296,1648686583,287,214
3880608911,3312888621,1652929465,1652929830,365,1957
3064461314,3562875112,1667036074,1667036299,225,810
3976095218,3659158165,1668381965,1668382922,957,1719
3033692011,3154704216,1662219649,1662220030,381,1740
3284838720,3092956442,1646833741,1646833768,27,599
3880837935,3900051900,1664376553,1664376860,307,878
3095430228,3896997211,1656187548,1656187892,344,1279
3549635553,3218946191,1660629529,1660629695,166,823
3084030782,3618532396,1641094388,1641094776,388,574
3929305160,3860432776,1669572840,1669573202,362,554
3154250720,3998763119,1641893804,1641894268,464,1144
3751300388,3287901684,1647190327,1647190338,11,910
3263842575,3681795615,1658160329,1658160898,569,282
3660983068,3474723005,1648547282,1648547906,624,1196
3481006313,3678624517,1662479357,1662479363,6,984
3275301708,3530278315,1669276996,1669277120,124,1160
3398876044,3596839317,1663213599,1663213843,244,1106
3903779058,3651421358,1646859609,1646860310,701,1152
3653780780,3545652885,1653569562,1653570226,664,870
3382856674,3310512172,1660279409,1660280225,816,2063
3814851615,3372197177,1663532920,1663533326,406,331
3934125569,3529898997,1662987361,1662987612,251,2391
3886720244,3256787088,1668233602,1668234002,400,1061
3649252503,3836762535,1652119099,1652119415,316,1274
3904907996,3744563835,1645252067,1645252127,60,523
3632283664,3424431005,1642580751,1642580846,95,426
3404959548,3228277648,1659169575,1659170080,505,2249
3328015314,3537735224,1648912530,1648913346,816,655
3492773808,3704120553,1654632493,1654632755,262,130
3592320524,3361422449,1649267995,1649268397,402,554
3324069408,3835708711,1655019246,1655019272,26,1984
3936821313,3693862073,1664511193,1664511679,486,34
3110395191,3740404190,1668596081,1668596694,613,1367
3260783577,3949445116,1649265648,1649265974,326,1780
3149181988,3127549843,1661851252,1661851867,615,2223
3439325479,3621452884,1661230310,1661231163,853,581
3733240502,3502432342,1652661997,1652662327,330,464
3376552382,3031816406,1657019820,1657020247,427,139
3534852421,3488813245,1659968554,1659969360,806,2114
3002931773,3398124878,1663718822,1663719077,255,1745
3624911947,3287508774,1660710786,1660711088,302,2077
3663228098,3939722468,1644432484,1644433126,642,2423
3379296882,3062410888,1654050586,1654051450,864,1634
3914427859,3644100988,1656140204,1656140381,177,376
3711710728,3513576000,1669464231,1669464872,641,135
3112742999,3744737373,1654588275,1654588403,128,1405
3165423009,3776063818,1661757939,1661758359,420,30
3734534401,3980139195,1661497114,1661497721,607,186
3415686543,3102760949,1659790887,1659790940,53,869
3813403697,3066451739,1646653052,1646653364,312,1712
3934453508,3217583205,1664580390,1664580590,200,1089
3318654389,3846007471,1662748779,1662749198,419,1250
3132802864,3349716508,1644098570,1644098774,204,2448
3925504452,3760142759,1647683110,1647683565,455,523
3371785046,3085429140,1664812660,1664813413,753,750
3357478199,3787590278,1643555699,1643556471,772,639
3772035177,3699533383,1663473272,1663473455,183,592
3883497013,3193991721,1643662007,1643662431,424,953
3562110382,3816194055,1656147551,1656147815,264,86
3283211870,3779192515,1642742278,1642743193,915,2010
3957053810,3666079547,1651302488,1651302814,326,1261
3982058383,3244071979,1658489350,1658489569,219,1733
3473314396,3317961564,1668800509,1668800551,42,1935
3307926705,3995365519,1644814289,1644814689,400,1778
3715766296,3470287808,1644989142,1644990026,884,49
3166274990,3324455158,1668456410,1668457195,785,1784
3370779634,3350783192,1644689673,1644689856,183,1609
3286473367,3063955055,1653746111,1653746782,671,2474
3577798894,3618380884,1662527587,1662528391,804,284
3776862606,3110733657,1645426852,1645427623,771,747
3154653229,3216171635,1649419659,1649420128,469,1814
3655498745,3319128889,1642956139,1642957113,974,203
3378791519,3131683456,1649631053,1649631333,280,805
3285243887,3593603889,1655446334,1655446535,201,530
3686240080,3821039922,1654115775,1654116612,837,203
3977699882,3636619501,1664135864,1664136241,377,2390
3128043317,3937728696,1652872437,1652872718,281,699
3167864948,3249512921,1655767304,1655767662,358,259
3635487786,3666179764,1657986998,1657987987,989,2275
3098161767,3034142016,1644157909,1644157957,48,1573
3691021918,3351691261,1641904570,1641904866,296,1112
3127419046,3034815361,1666716354,1666716590,236,1688
3590831664,3888856112,1642912993,1642913517,524,1010
3090057747,3582138072,1663402750,1663403616,866,1195
3836089663,3492034029,1646476553,1646477348,795,1140
3553939893,3836597583,1664737236,1664737287,51,4
3722114463,3293237543,1644829101,1644829192,91,1912
3802040767,3679939578,1655005784,1655006645,861,2278
3795990774,3858519840,1648833824,1648834078,254,2040
3428499342,3518179871,1653516500,1653516995,495,2315
3198520645,3887036201,1659570896,1659571348,452,1530
3038529026,3752000675,1660520248,1660520621,373,2018
3631703207,3820302319,1669568188,1669569113,925,1254
3306934792,3741273371,1641878820,1641879599,779,482
3848936636,3032800454,1643410513,1643410695,182,375
3575784654,3770393539,1643514046,1643514630,584,1294
3883176560,3692568210,1662202019,1662202384,365,287
3446547180,3893937230,1664037476,1664038083,607,1271
3659563225,3585042042,1650802993,1650803283,290,2329
3407909365,3124222667,1667611875,1667612071,196,614
3542927039,3880052402,1642725688,1642726469,781,1393
3571766829,3488962022,1645977954,1645978648,694,1002
3444174394,3265324040,1659470084,1659470210,126,1984
3369330833,3854859043,1661496978,1661497120,142,959
3802545642,3159645889,1662632032,1662632631,599,1095
3696096099,3604426149,1663262203,1663263088,885,2145
3400211756,3448866192,1649847276,1649847954,678,790
3595535977,3696184358,1641919624,1641920436,812,451
3095437969,3469722588,1649178793,1649179528,735,2473
3893828389,3478741068,1669451017,1669451407,390,1060
3315218003,3992818695,1659939706,1659940234,528,2097
3697028552,3981932099,1659582235,1659582731,496,1265
3950146840,3494680258,1652627319,1652627524,205,124
3829084330,3268826534,1641699535,1641699832,297,1188
3067179904,3184955498,1646244422,1646245261,839,1671
3601590462,3798527829,1660034072,1660034186,114,2385
3477770827,3233146767,1647561652,1647562035,383,1692
3936943386,3450806791,1642374923,1642375483,560,2026
3987162833,3128287586,1663777215,1663777656,441,2406
3140055258,3630982131,1652738716,1652738897,181,808
3112070783,3877464299,1668634601,1668635026,425,766
3915686266,3569525429,1658440323,1658440418,95,1341
3885719823,3201933010,1649958929,1649959642,713,184
3970653700,3720934127,1641706110,1641706710,600,1810
3311252249,3183435456,1656497504,1656497614,110,1709
3749308364,3389560959,1645121729,1645122533,804,1204
3749897140,3285019414,1652402827,1652403079,252,1411
3159669419,3405749286,1647569024,1647569491,467,945
3494544431,3496807015,1669248376,1669249149,773,30
3443297756,3103421893,1663999617,1663999639,22,771
3255978821,3725611236,1654126132,1654127027,895,1263
3176432386,3327166880,1657604155,1657604811,656,1139
3953465037,3501520918,1641932954,1641933159,205,711
3729553337,3578068647,1662251048,1662251758,710,79
3785728567,3547358965,1669103018,1669103347,329,1968
3169496287,3679617161,1641968978,1641969827,849,1386
3393156673,3663871563,1655634179,1655634722,543,53
3759867623,3889705477,1665462899,1665463529,630,2299
3985486150,3319782337,1659179422,1659179877,455,318
3041792624,3855113371,1655308917,1655309095,178,531
3128514837,3289017659,1657971480,1657972161,681,1449
3480905975,3739865914,1652079171,1652079752,581,1182
3150067482,3064701445,1664281474,1664281644,170,194
3706027798,3669789756,1641400449,1641401426,977,2202
3281397783,3968076690,1643491017,1643491789,772,1496
3293775646,3280046501,1661276950,1661277575,625,1672
3978667945,3341241551,1654192623,1654192821,198,1726
3912916652,3970753504,1651819175,1651819540,365,428
3067985831,3833230225,1658259599,1658260168,569,2307
3309405529,3041223311,1659750144,1659750414,270,1159
3828761401,3901026791,1662366500,1662367159,659,2038
3687938178,3321202962,1668672971,1668673255,284,1361
3451106027,3206149175,1664430754,1664431264,510,2351
3323698166,3971648409,1652548409,1652548503,94,603
3938973292,3275436235,1664399517,1664400291,774,801
3644272268,3894382679,1652348516,1652348816,300,624
3265712439,3411181030,1665576351,1665577070,719,2017
3724770746,3828738126,1662329332,1662329337,5,1464
3708034201,3804824307,1646523177,1646523567,390,1292
3570423127,3741024153,1642428472,1642428828,356,931
3358374850,3453431236,1657466452,1657466773,321,500
3973059785,3820254686,1668436505,1668436834,329,2485
3485695895,3665931760,1648955698,1648956564,866,1462
3564296836,3077827896,1649753048,1649753250,202,1044
3800861252,3551111997,1648788195,1648789171,976,2184
3907700603,3407322181,1659896740,1659897628,888,1363
3464754983,3478404891,1668892015,1668892675,660,979
3790157838,3113938510,1668556810,1668557775,965,2292
3735286926,3105648731,1662221003,1662221983,980,2040
3359901981,3751300388,1648427600,1648428160,560,1643
3653757569,3136707992,1642564292,1642564526,234,384
3649724545,3435518470,1642951661,1642952221,560,883
3405110319,3159900056,1658649419,1658650332,913,240
3563134874,3417742545,1651824383,1651824656,273,1033
3567637602,3603702697,1644596798,1644597086,288,546
3318717113,3126455934,1644330006,1644330914,908,2360
3214068022,3821120962,1655940790,1655941661,871,143
3509619062,3172524712,1664836858,1664837093,235,1185
3277577090,3580594125,1652421925,1652422664,739,2358
3450102071,3768311968,1658504871,1658504983,112,1728
3489473144,3718823049,1667122377,1667122978,601,1459
3284829365,3485578733,1643793750,1643794257,507,687
3185360566,3844006658,1658939348,1658940225,877,801
3355910238,3066588932,1665441212,1665441511,299,257
3003116947,3503510962,1654866337,1654866631,294,249
3266498789,3818276871,1642422756,1642423208,452,860
3006508919,3413777646,1644332216,1644332857,641,2339
3788336754,3298527612,1664178762,1664179061,299,661
3833722302,3478280943,1667190867,1667191651,784,476
3046617108,3895855296,1642104700,1642104977,277,906
3835708711,3813511439,1659381447,1659382308,861,166
3806737055,3144551332,1658142342,1658142600,258,1373
3587568478,3474666564,1667672869,1667673863,994,537
3439221238,3099546139,1664862586,1664863292,706,749
3862102577,3780039563,1664254584,1664255523,939,59
3445023517,3941986034,1645029208,1645030080,872,1097
3632156948,3345458354,1649627912,1649628082,170,721
3980675077,3730428171,1647926194,1647926446,252,1781
3517992014,3173369021,1647571340,1647571403,63,1401
3795326002,3513368682,1644370556,1644371179,623,1610
3701726268,3050701199,1647659626,1647660250,624,1572
3825824228,3043047337,1663777703,1663777722,19,1836
3710331536,3241584825,1663331059,1663331790,731,1496
3183507473,3468633309,1666431645,1666432504,859,933
3875118670,3363944559,1662777043,1662777586,543,2376
3264865965,3836762535,1667385183,1667385899,716,1203
3062844769,3634041831,1652433572,1652433841,269,1626
3271201418,3855777399,1654621211,1654621636,425,1471
3861499264,3308454699,1645804361,1645804388,27,134
3320187187,3022082086,1659551615,1659552021,406,1069
3197739962,3240839516,1652483670,1652483762,92,2370
3993866389,3063520189,1644178627,1644179229,602,2482
3759668586,3122109326,1667372575,1667372813,238,1034
3165039316,3532307372,1648992055,1648992341,286,775
3660732427,3728506494,1663671689,1663672074,385,2242
3698358344,3824845857,1669415664,1669416599,935,1298
3562104036,3905581902,1656798026,1656798114,88,665
3408104715,3596483616,1650494245,1650495090,845,2184
3884704204,3532675680,1656713784,1656714320,536,2290
3548351680,3236975783,1645722134,1645722245,111,2344
3841174974,3523394395,1646718121,1646718187,66,35
3368860003,3368322774,1660180335,1660180421,86,2237
3204346356,3039972849,1660867971,1660868834,863,761
3928930330,3759230876,1642734207,1642734458,251,1566
3751418832,3553301078,1641682710,1641682877,167,2468
3752773975,3478166190,1669416969,1669417371,402,2383
3327795374,3159562411,1661945042,1661945466,424,408
3997353499,3544020942,1660552065,1660552434,369,361
3571972204,3849201069,1647277126,1647277243,117,2319
3300694030,3821299576,1650675954,1650675975,21,552
3994168332,3270177744,1660752785,1660752992,207,2203
3093364150,3862890852,1669330237,1669330461,224,38
3947704522,3891258957,1666776284,1666776503,219,872
3649252503,3733440098,1655826488,1655827223,735,2426
3239517474,3020108220,1652425255,1652425520,265,1015
3044345094,3714203425,1642440209,1642441142,933,807
3685505113,3526218972,1643904632,1643904980,348,838
3286555567,3703457098,1648910465,1648911214,749,2403
3752817676,3353855658,1669429096,1669429202,106,2245
3556803718,3268826534,1653465013,1653465054,41,40
3942140107,3468173779,1644044540,1644044860,320,352
3498770747,3892686083,1643733955,1643734067,112,731
3521160717,3374174584,1667415970,1667416588,618,1935
3379935974,3671147965,1651106084,1651106279,195,344
3893475632,3471651838,1646580831,1646581334,503,1068
3942325631,3676690161,1643630742,1643631077,335,1562
3204508195,3114036217,1655657215,1655657755,540,175
3962773297,3361670451,1660585064,1660585996,932,1032
3451771672,3147336288,1664618650,1664619422,772,1252
3812732557,3468682335,1668401357,1668401458,101,2336
3899772312,3128248749,1669159708,1669160285,577,1335
3816863310,3724157579,1649076857,1649076878,21,2019
3595284541,3799249782,1663352842,1663353091,249,696
3572325072,3892850406,1662157184,1662157574,390,1416
3205472801,3942852295,1650655060,1650655833,773,1624
3755269138,3649774117,1652674283,1652674872,589,269
3906216789,3879787945,1658622239,1658622416,177,44
3561899633,3734576015,1663252694,1663253674,980,1896
3202881162,3257203631,1661271077,1661271667,590,1177
3509864353,3092360885,1644680248,1644681239,991,1099
3402804885,3639117164,1649940743,1649941357,614,684
3931677547,3370701718,1667605853,1667606477,624,1484
3888141694,3632284739,1663586037,1663586048,11,221
3433576059,3640349880,1667466051,1667466727,676,404
3142777936,3481090623,1652929942,1652930596,654,1033
3306378570,3100535469,1649302511,1649303327,816,403
3157821920,3882038749,1664639549,1664639946,397,2432
3341591226,3247758952,1663725309,1663725405,96,1731
3650367155,3328373210,1656607854,1656608067,213,403
3579514433,3973666003,1661093329,1661094214,885,2102
3366385571,3480308437,1648099861,1648100208,347,108
3886780901,3521271030,1651089528,1651090212,684,1905
3047713943,3651571335,1642493728,1642493753,25,564
3021492589,3388257945,1645836748,1645836805,57,303
3733143454,3828921434,1654920572,1654921092,520,1786
3353500391,3260695363,1662302268,1662303190,922,444
3351182329,3601590462,1660063813,1660064406,593,2314
3717926703,3131938458,1655132222,1655133083,861,422
3070520574,3796954140,1652600456,1652600856,400,1983
3710331536,3885926991,1654879072,1654879096,24,920
3253436330,3602497998,1665515808,1665515995,187,1055
3573450428,3141963631,1659298378,1659299077,699,220
3432892677,3987162833,1668837507,1668837669,162,1501
3773408264,3844822083,1657522514,1657522842,328,1760
3557087358,3818039978,1645740415,1645741022,607,2497
3762816561,3785586097,1652662841,1652663432,591,1188
3395307809,3066645531,1668411987,1668412007,20,2125
3165492854,3139087074,1661738405,1661738761,356,888
3790650118,3736483863,1653275397,1653275811,414,1534
3746890721,3175832070,1651597441,1651598194,753,1790
3209480732,3521944506,1655872739,1655873269,530,1887
3292365668,3034815361,1669342877,1669343743,866,2405
3248452729,3657101592,1658257422,1658258049,627,724
3689518345,3914601322,1649739336,1649739966,630,745
3805653360,3561881366,1663139916,1663140572,656,893
3401568650,3315569726,1646021554,1646021844,290,1858
3640957872,3341042744,1642928876,1642929871,995,1564
3678452420,3619714539,1664151044,1664151332,288,69
3727544443,3026025743,1665012132,1665012349,217,2075
3646286885,3266042074,1663137154,1663137657,503,1079
3962045766,3304728211,1657879103,1657879367,264,1820
3096274177,3930242126,1668759966,1668760465,499,838
3282261851,3588376802,1667129481,1667130010,529,471
3882619512,3239469849,1659054034,1659054808,774,552
3704517188,3855548589,1655360500,1655361391,891,758
3049579265,3754139010,1668207887,1668208023,136,2271
3265434991,3417138981,1647986425,1647986568,143,2035
3671971306,3096274177,1661447563,1661447605,42,494
3703881738,3835842311,1664109836,1664109965,129,76
3106584115,3175595669,1664543187,1664544053,866,1353
3069675415,3272879760,1657973995,1657974381,386,1536
3052822229,3834954155,1643662157,1643662253,96,542
3596179079,3419430775,1653874929,1653875183,254,1087
3398443861,3622485921,1647999127,1647999788,661,1004
3533414032,3691032308,1646374820,1646375327,507,702
3029481461,3477522732,1656960096,1656960391,295,1765
3351145248,3447555067,1641550742,1641551599,857,523
3545214789,3206248943,1644831015,1644831491,476,155
3022082086,3066750826,1661646147,1661646972,825,1932
3824353209,3505295000,1652993263,1652993457,194,777
3416230781,3931677547,1651303942,1651304381,439,1631
3625504025,3749211785,1667297258,1667297310,52,1260
3665798527,3744575844,1653064425,1653065193,768,2307
3043180716,3483553551,1643492621,1643493372,751,221
3984467207,3297290662,1647447343,1647447735,392,1254
3626672801,3640587334,1659942250,1659942353,103,861
3051876837,3364199338,1641128655,1641128853,198,1039
3991686619,3670154961,1650859743,1650859779,36,2047
3465382952,3181912863,1669575075,1669575209,134,2420
3868397809,3261376049,1661676543,1661676945,402,356
3739233756,3553096192,1646433166,1646433279,113,550
3686641761,3292956980,1667392589,1667393196,607,1362
3002829154,3361694981,1648866823,1648866927,104,2131
3052951476,3688056726,1655273253,1655274206,953,279
3594231530,3693270664,1655739897,1655740295,398,1595
3425490548,3980781580,1658551090,1658552053,963,618
3056726479,3430102174,1652762021,1652762821,800,343
3423909447,3478166190,1645493583,1645494085,502,2428
3185977048,3900755896,1664744750,1664745336,586,1492
3625950355,3978925529,1664030673,1664030765,92,309
3262728353,3910846571,1649236745,1649237508,763,2185
3906903088,3537294800,1649943666,1649944621,955,550
3725903222,3717926703,1664585230,1664585313,83,1844
3528271389,3627886263,1665850572,1665850727,155,788
3848963466,3651803323,1664840131,1664840237,106,577
3518817978,3505417530,1660597689,1660597826,137,741
3363733362,3839454838,1651616097,1651616372,275,2468
3403389913,3078231218,1653931089,1653931218,129,463
3152555864,3969435749,1664222636,1664223411,775,1582
3695558824,3161805415,1665437342,1665437578,236,1758
3276482511,3546290525,1668923745,1668924409,664,258
3093254727,3106804099,1668496876,1668496998,122,864
3635854686,3922358932,1652135807,1652136252,445,144
3788688228,3777592593,1659405843,1659406550,707,2173
3417820101,3818028118,1659702861,1659703446,585,2019
3985308319,3679533416,1651355614,1651356381,767,879
3661705197,3034256232,1665430807,1665431383,576,658
3485801867,3898403925,1658194473,1658195189,716,1612
3118057575,3574394407,1658008851,1658008871,20,850
3828516865,3780885377,1642436489,1642437158,669,839
3853258306,3595270507,1653033022,1653033152,130,646
3743682237,3620236387,1644402965,1644403413,448,1573
3098934820,3762690279,1662522601,1662523358,757,2327
3382983805,3775501779,1668027723,1668027771,48,29
3727544443,3962722941,1659115158,1659115999,841,2150
3416719967,3855476133,1655068578,1655069217,639,1257
3391540103,3334792271,1649395759,1649396054,295,1754
3345138946,3010173509,1643428223,1643428578,355,1527
3678425549,3107501731,1654973473,1654974444,971,919
3823761286,3496470143,1659584455,1659584484,29,2087
3783051630,3527067891,1663390752,1663391268,516,2204
3429074631,3613700451,1641247674,1641247900,226,2221
3444005080,3250023388,1648391886,1648391962,76,2373
3693862073,3762816561,1669311906,1669312246,340,1855
3951751770,3434363944,1668192666,1668193580,914,952
3190972776,3713482005,1657679332,1657679375,43,1351
3747889498,3292797747,1666827003,1666827181,178,2182
3833692711,3324473595,1650893578,1650894199,621,1105
3551884757,3818467247,1669656134,1669656824,690,1979
3459188746,3707676798,1654100097,1654100804,707,2427
3875750764,3251948771,1645136004,1645136335,331,965
3236325866,3005480994,1641576403,1641576449,46,1701
3666072303,3134166826,1651503137,1651504084,947,146
3649252503,3520344153,1653326928,1653327552,624,1737
3753391012,3603853942,1668250490,1668251058,568,526
3562104036,3750756562,1651137809,1651138033,224,1435
3405358639,3734381035,1658391051,1658392024,973,1963
3793840002,3630982131,1648750480,1648750786,306,12
3386490201,3073944007,1658392817,1658392912,95,388
3401957566,3498989393,1654749653,1654750398,745,780
3476403398,3944398168,1662714820,1662715018,198,2113
3805953085,3235992794,1656201003,1656201130,127,1166
3280648157,3715766296,1658538433,1658538684,251,1242
3069818047,3880439495,1666609924,1666610088,164,1758
3991963732,3522465860,1668348269,1668349144,875,322
3622230392,3270111894,1644294425,1644295336,911,189
3362091170,3385806632,1651497613,1651498485,872,64
3856386170,3974326867,1663287310,1663287613,303,2432
3722220404,3658656847,1655227830,1655228288,458,2261
3751826055,3150551034,1644341711,1644342229,518,1879
3442244098,3819584735,1667341963,1667342278,315,2402
3005809519,3894036055,1665485486,1665485965,479,1408
3819415032,3951751770,1648231678,1648231997,319,798
3032431944,3319365305,1662955472,1662956240,768,693
3672276184,3525377731,1654405811,1654406768,957,2165
3855113371,3419336769,1667711411,1667711908,497,2317
3429052801,3544087053,1659263887,1659264664,777,2045
3037583613,3274507247,1662238181,1662238221,40,1038
3936468941,3247551122,1643115030,1643115806,776,2023
3741929805,3112742999,1656549126,1656549267,141,2114
3662040060,3253931464,1646635347,1646636232,885,2339
3424553049,3943927246,1652952571,1652953179,608,1733
3446952845,3088595440,1646177594,1646177867,273,2467
3107482740,3203734562,1665817069,1665817219,150,413
3139882519,3790748869,1652168057,1652168292,235,1975
3920436432,3157190919,1651082670,1651083325,655,2202
3639059199,3379366812,1644700520,1644700570,50,555
3358241145,3008576449,1641807418,1641808155,737,1282
3427937915,3623685885,1643993652,1643993967,315,2271
3351205685,3288529545,1664265127,1664265899,772,198
3924990392,3160906988,1663252907,1663253043,136,360
3517912492,3970917362,1668888473,1668889184,711,117
3879766152,3757518149,1654339999,1654340657,658,1733
3730337290,3870998298,1650423350,1650424132,782,621
3827170233,3405110319,1651951754,1651951947,193,392
3308015697,3736260750,1642577925,1642578265,340,1968
3673524018,3096475097,1643107462,1643107561,99,1161
3620700244,3290860752,1660585318,1660586009,691,2195
3623802234,3814017798,1663820135,1663820360,225,2467
3472458500,3283922234,1667320156,1667321042,886,839
3769767823,3936179181,1652449238,1652449901,663,524
3554832209,3173108957,1654428573,1654429093,520,2492
3031249180,3602340127,1648825462,1648826150,688,1969
3105871139,3016871175,1669508819,1669509394,575,1586
3145344208,3028643875,1662242923,1662243043,120,928
3004870031,3378522829,1642028899,1642029232,333,0
3977317498,3991046503,1649873351,1649873694,343,1957
3545188902,3931229167,1650986420,1650986866,446,2030
3371063992,3722948390,1641832105,1641832408,303,487
3954988798,3378864156,1648226880,1648227101,221,1743
3709075485,3428142421,1656934302,1656935255,953,901
3530495336,3313615371,1655224242,1655224245,3,498
3983158937,3704517188,1649697358,1649697581,223,1539
3481584783,3007480776,1642109128,1642110078,950,1929
3671789954,3456433627,1668805027,1668805330,303,23
3163030169,3094940809,1668993087,1668993693,606,1170
3576284955,3521410258,1647983416,1647983852,436,915
3482406705,3220800349,1656786361,1656786491,130,1260
3094277549,3893671286,1656197897,1656198765,868,676
3702064029,3232436630,1653761870,1653762334,464,470
3256374123,3878808489,1658002675,1658003435,760,1711
3489538095,3607580736,1644911406,1644912212,806,1521
3606111278,3350067994,1652410699,1652411555,856,284
3909330778,3405352606,1654343327,1654343363,36,2244
3793086361,3970917362,1663370034,1663370581,547,1708
3632101943,3592264904,1662799356,1662800112,756,818
3257492375,3712549911,1656105205,1656105277,72,581
3295316821,3900876329,1649683369,1649684350,981,1897
3446490643,3109941959,1649911040,1649911390,350,2234
3764343778,3318663320,1655231507,1655231614,107,2086
3463875425,3479778946,1653384656,1653385601,945,791
3966130885,3109941959,1659251862,1659252341,479,1392
3561529281,3958449916,1651316429,1651316874,445,1024
3083388257,3312661854,1663493574,1663494323,749,1391
3511192827,3104271824,1643313697,1643313857,160,1326
3298044531,3103215750,1645612542,1645612858,316,1302
3493138014,3115494713,1655831183,1655831822,639,1112
3357858376,3188643066,1641753322,1641753795,473,1620
3749308364,3187982526,1651505367,1651506158,791,768
3398242179,3295385873,1651665879,1651666687,808,1229
3612720177,3402019498,1648274503,1648275160,657,2123
3479359145,3368860003,1669200035,1669200177,142,1551
3315759953,3175295329,1650048837,1650049083,246,831
3802410450,3923647484,1662003471,1662004239,768,1793
3220736075,3756778635,1660702485,1660703190,705,2125
3289630313,3965000413,1663113416,1663113665,249,1770
3066429600,3136200575,1651883831,1651884065,234,1153
3998209085,3371745136,1644770924,1644771684,760,2159
3129683689,3264281080,1666158951,1666159117,166,1622
3071602516,3859221152,1646780738,1646780800,62,2060
3640585545,3261477798,1658294845,1658295543,698,2015
3365939940,3731116644,1650542930,1650543492,562,1069
3739439527,3523394395,1657510612,1657510969,357,405
3830330372,3928723403,1648744175,1648745137,962,642
3035464149,3374007172,1668863599,1668864449,850,1410
3659285822,3132210207,1643675161,1643675514,353,489
3782182063,3707258240,1662275469,1662275740,271,1502
3994927164,3284284605,1643890472,1643891345,873,1212
3652728312,3404959548,1659989997,1659990292,295,1126
3080889735,3949668592,1657078316,1657078786,470,1993
3194617168,3297681098,1647828364,1647828454,90,2301
3570050230,3639695113,1643279381,1643280236,855,969
3620725243,3927864902,1656356691,1656357506,815,946
3765693461,3893475632,1662002658,1662003074,416,111
3647685310,3974318707,1659996188,1659996337,149,760
3533279961,3029149493,1655896098,1655896717,619,451
3623191811,3974917779,1643084055,1643084909,854,2161
3205601088,3786516095,1649306986,1649307663,677,1255
3329449985,3474723005,1665052061,1665052739,678,451
3164355501,3298857826,1644647725,1644648068,343,701
3594271876,3166206557,1658940962,1658941251,289,40
3619490574,3668441547,1657035546,1657035683,137,1567
3994844749,3580310329,1656111087,1656111447,360,560
3698906761,3809458973,1656700582,1656701531,949,196
3329253794,3955750752,1647902668,1647903304,636,2007
3806737055,3864930473,1646760200,1646760847,647,1916
3085412399,3383686911,1663666766,1663667657,891,478
3301708925,3661369487,1668041678,1668041758,80,1349
3457998128,3898495918,1651023574,1651024373,799,628
3433557410,3506585658,1650134785,1650135242,457,1291
3710681792,3993866389,1655451006,1655451840,834,2424
3964565126,3252664436,1643124391,1643125043,652,1879
3588936901,3660548799,1653004261,1653005120,859,2119
3811318665,3341042744,1645109319,1645109687,368,2183
3124363805,3505026131,1667389883,1667390425,542,949
3374005704,3233375810,1667555352,1667555921,569,1064
3004708023,3191133743,1667976919,1667977813,894,1580
3817579913,3414258502,1654829068,1654829493,425,1581
3266042074,3051863550,1657592003,1657592414,411,113
3548484912,3165129580,1663274523,1663275201,678,268
3228574805,3413810353,1646254887,1646255356,469,771
3834174227,3435036750,1652411882,1652412336,454,1710
3708101315,3647295073,1643584204,1643584839,635,1921
3221031593,3897293094,1646691904,1646692218,314,2288
3404330776,3075313832,1666938391,1666939383,992,1858
3524109178,3620985435,1645474649,1645475461,812,643
3046080865,3287440691,1651127122,1651127573,451,1188
3474242977,3400786498,1655131981,1655132957,976,365
3576961863,3396146110,1666471022,1666471790,768,874
3790157838,3242912660,1664338390,1664339376,986,923
3400397224,3940948395,1644039749,1644040528,779,2191
3799900837,3190906256,1661169434,1661169715,281,1078
3428593255,3030630339,1657257475,1657257619,144,2067
3535941714,3869711224,1651621573,1651621799,226,1652
3011225738,3323198594,1666579430,1666579707,277,312
3734533600,3744293001,1647938020,1647938345,325,2184
3923635120,3693041370,1660262721,1660263502,781,2497
3717926703,3939722468,1642893844,1642894130,286,1043
3426433476,3738981251,1664342710,1664343587,877,274
3683440211,3349301564,1661283765,1661284289,524,181
3498758411,3827954829,1643889477,1643890277,800,1970
3242785599,3086835861,1659267403,1659267822,419,698
3865463499,3692095834,1656005114,1656005401,287,1756
3788717673,3454851350,1663765668,1663766444,776,2163
3671539226,3573939226,1652346517,1652347132,615,278
3181032246,3651803323,1654220396,1654220675,279,1217
3046707177,3682793223,1663780174,1663780471,297,1790
3333336166,3822404633,1657537852,1657538447,595,697
3412673526,3584037261,1650166464,1650167458,994,77
3860883669,3065434950,1659977838,1659978241,403,1995
3863697907,3722972444,1669477748,1669478172,424,1836
3850214790,3177943874,1647441190,1647442125,935,1053
3348278635,3257080734,1655713670,1655713912,242,806
3544020942,3828833040,1665522254,1665522814,560,471
3737504606,3537443088,1656187646,1656188048,402,2090
3251382188,3496369924,1668057933,1668058540,607,1242
3453884967,3376552382,1656071502,1656072039,537,1135
3228794031,3818655962,1643918560,1643919164,604,661
3321818923,3032834107,1648157157,1648157712,555,2361
3452219424,3278297907,1653359996,1653360471,475,488
3210536820,3805772843,1667059859,1667060805,946,808
3046127876,3228110844,1645091051,1645091268,217,1411
3990037235,3202460554,1662246962,1662247734,772,1450
3797079865,3067220098,1643500083,1643500628,545,2091
3516399207,3000863237,1644745544,1644746463,919,919
3587568478,3572689902,1660634110,1660634593,483,1719
3306144283,3828761401,1660789674,1660790028,354,2175
3435915872,3046380642,1649080409,1649080785,376,1348
3238270210,3465500045,1660280583,1660281424,841,2126
3795609815,3295278768,1651312893,1651313579,686,427
3707476548,3080007856,1651012647,1651012829,182,1483
3731399462,3328544337,1650633801,1650634353,552,891
3695419353,3698358344,1665887369,1665888320,951,17
3919489244,3517449502,1663308789,1663309782,993,1633
3429101401,3640765121,1649880908,1649881795,887,750
3462743550,3885583347,1660785515,1660785938,423,2207
3848963466,3232497890,1667661579,1667662537,958,1870
3890181496,3385846184,1668518869,1668519490,621,2367
3027812492,3855563284,1658765955,1658766034,79,957
3557556781,3221885729,1668213113,1668213466,353,789
3099818927,3584139105,1658061567,1658062552,985,2154
3194259307,3793117012,1650654729,1650654967,238,271
3640765121,3125350196,1650213702,1650213910,208,1750
3548609816,3103871966,1661872361,1661872419,58,1690
3490435539,3071322324,1652928960,1652929294,334,1182
3445530012,3589984222,1668395873,1668396741,868,1066
3945633602,3073474496,1643385047,1643385677,630,2483
3142101976,3791547480,1644573503,1644573660,157,1825
3401568650,3261376049,1645408279,1645408515,236,1205
3938679223,3680703930,1644736145,1644736332,187,88
3187644022,3297826818,1669228053,1669228656,603,500
3272555962,3052681277,1663827240,1663827831,591,2480
3254262388,3439660528,1662094977,1662095284,307,2013
3525442421,3450074680,1666410109,1666410607,498,1168
3618941109,3532634291,1666297365,1666298254,889,2481
3161586578,3822693340,1646546301,1646547159,858,23
3644128961,3990520153,1648046270,1648047216,946,1713
3469471892,3194069746,1645319694,1645320088,394,930
3978667945,3787514151,1668272301,1668272585,284,281
3311329069,3354579861,1647109828,1647110037,209,1757
3791315348,3280223679,1657031155,1657031781,626,136
3101137807,3181236848,1648800146,1648800505,359,973
3503842077,3434324683,1666248341,1666248402,61,1663
3042046828,3371289776,1667153121,1667153334,213,2079
3378542130,3403471618,1667943000,1667943055,55,590
3976405875,3551380152,1645738956,1645739443,487,1661
3822187489,3956394849,1653581003,1653581910,907,140
3357048496,3573941843,1646617780,1646618500,720,598
3980108258,3661369487,1668781517,1668781993,476,466
3409978701,3876097800,1668126509,1668127286,777,1214
3631587282,3621456276,1651698495,1651699228,733,1101
3349716508,3880948714,1665581949,1665582896,947,716
3279069375,3505322684,1667081280,1667082099,819,2113
3632763218,3700412611,1645559872,1645560370,498,2422
3458389447,3630966486,1663230854,1663231252,398,1191
3319946083,3315854812,1641755123,1641755335,212,81
3739731580,3402019498,1656699456,1656699966,510,969
3415686543,3120208739,1661226023,1661226554,531,1569
3177651100,3220800349,1666080266,1666080420,154,1670
3582168015,3537443088,1651991598,1651992167,569,41
3512353520,3437593879,1666410596,1666411391,795,903
3593487418,3273147497,1651191668,1651191768,100,2254
3229871774,3337624186,1665096869,1665096941,72,1236
3124147703,3395307809,1666535123,1666535998,875,1534
3060674509,3445666899,1643324445,1643324820,375,721
3188726102,3915686266,1663370783,1663371730,947,2005
3452564658,3429887771,1655328975,1655329237,262,2255
3687278591,3570230022,1654976784,1654976936,152,2132
3573450428,3437109709,1655774517,1655774678,161,1463
3269889273,3419068106,1660854264,1660854665,401,718
3790751649,3870778205,1661052197,1661052474,277,91
3507338655,3969435749,1663964829,1663965595,766,195
3888851378,3893601176,1641324649,1641324996,347,890
3790180006,3023880168,1659365412,1659366071,659,311
3256736613,3608200385,1655406442,1655407399,957,1019
3565381166,3945332462,1642637707,1642638457,750,556
3307251676,3244198823,1654201912,1654202492,580,506
3407778626,3330548469,1659197949,1659198788,839,12
3719124928,3554741157,1659323513,1659324432,919,1046
3755962729,3634885711,1656657232,1656657266,34,1701
3604260104,3039544352,1662660559,1662661055,496,1545
3429074631,3997215508,1661517557,1661517770,213,376
3402349073,3229080104,1647485074,1647485673,599,2467
3800312034,3193483812,1657612473,1657612567,94,2052
3079137127,3010488834,1654562520,1654563184,664,2242
3016871175,3381769309,1647177180,1647178179,999,1417
3399622567,3466204914,1642457075,1642457707,632,1148
3495798110,3728419832,1641637233,1641637886,653,2336
3680427036,3188717499,1663777414,1663778226,812,7
3184680353,3343177837,1655577256,1655577496,240,1111
3599694754,3241500636,1643298532,1643298813,281,972
3275436235,3037279735,1644995231,1644995672,441,1162
3787920743,3870359885,1642465297,1642466192,895,519
3682993605,3251372174,1665118543,1665118767,224,258
3580310329,3664112134,1652698460,1652699237,777,773
3876427301,3590228003,1664027784,1664028025,241,742
3818039978,3470287808,1662418408,1662419287,879,1853
3211641180,3060727793,1668386098,1668386460,362,733
3128009914,3894359262,1642542348,1642543142,794,2420
3469887287,3735943539,1659808379,1659808882,503,1151
3776334300,3410150990,1649803260,1649803338,78,2178
3432462167,3437603547,1664833819,1664834646,827,480
3057085790,3586524207,1666403542,1666403590,48,511
3117575075,3150289965,1652338820,1652338826,6,42
3262811174,3369792484,1666948455,1666949426,971,1371
3885493402,3375799029,1647818817,1647819462,645,1783
3662040060,3638297718,1643921774,1643921817,43,2474
3215040043,3696211720,1659620120,1659620124,4,1721
3914613880,3649447383,1650882803,1650883529,726,1196
3461108375,3361051044,1653062716,1653063415,699,1724
3101886383,3425815854,1656053607,1656054074,467,45
3943184820,3765962960,1647705024,1647705353,329,441
3351843519,3836331716,1643019695,1643019931,236,1547
3754292816,3826502515,1665855048,1665855778,730,1822
3761775611,3498461454,1651997891,1651998173,282,304
3733770591,3218746999,1664860764,1664861567,803,1928
3479608671,3969355995,1654041839,1654042269,430,1789
3787298788,3392395230,1642156065,1642156375,310,2099
3214068022,3458389447,1642557438,1642557954,516,2214
3712727713,3034014975,1653469414,1653470113,699,2061
3682028611,3479608671,1653926468,1653926787,319,281
3139604406,3822307865,1650701803,1650701894,91,373
3178090646,3313687025,1643442779,1643443253,474,2308
3734893217,3290794282,1641891084,1641891140,56,442
3523508617,3387840253,1641205049,1641205398,349,549
3588579914,3362395200,1651087439,1651088275,836,1711
3691062084,3866532806,1656839685,1656840360,675,154
3343232841,3948219301,1651847951,1651848628,677,1391
3342538148,3603965318,1645323078,1645323353,275,1617
3081803809,3084940745,1647969944,1647970774,830,1507
3006953744,3256648307,1641854683,1641855406,723,77
3669874673,3474115926,1660779586,1660779959,373,1303
3851747907,3197693984,1668449853,1668449894,41,726
3736871918,3697650296,1653245153,1653245909,756,1366
3868116298,3703457098,1644127026,1644127698,672,98
3680810431,3231727990,1648820448,1648820703,255,133
3973050834,3204912218,1666999658,1667000627,969,1030
3733072964,3502599631,1652462795,1652463506,711,424
3577530061,3505600550,1663455370,1663455674,304,1500
3862854265,3713126710,1664050457,1664050491,34,2056
3741494242,3252790120,1642137867,1642138415,548,614
3961189789,3501786397,1641089351,1641089717,366,1200
3703534908,3727981782,1664928604,1664928724,120,1562
3843347515,3373806425,1664253593,1664254081,488,2466
3919562972,3940948395,1669019045,1669019881,836,2227
3011459628,3554977739,1653265133,1653265390,257,1856
3908893546,3719084637,1647090399,1647091341,942,1012
3801768919,3855476133,1645950427,1645951202,775,2383
3451106027,3275301708,1662569375,1662569705,330,373
3016995357,3658656847,1643712483,1643713241,758,2260
3515161257,3928521533,1647116915,1647117822,907,2124
3877049401,3376552382,1655653005,1655653267,262,484
3657597585,3395525819,1647429495,1647430000,505,411
3878274883,3584660761,1669476987,1669477423,436,38
3982929088,3357966828,1648623746,1648624697,951,1581
3600796487,3046500774,1650832608,1650832838,230,2233
3745248673,3275360473,1642186511,1642186770,259,337
3980283928,3806520351,1657154220,1657154688,468,1024
3435253366,3552282443,1646246494,1646246861,367,1396
3313619618,3466473464,1655288805,1655289520,715,496
3567637602,3434575449,1654289676,1654289685,9,1383
3654922401,3965137487,1652718706,1652719450,744,2000
3595049641,3704437148,1659851125,1659851681,556,1150
3976970303,3895370398,1658338671,1658338925,254,572
3289255457,3869505474,1646000974,1646001133,159,1779
3198195956,3755962729,1647834887,1647835619,732,1498
3611353561,3345650412,1660894345,1660894498,153,385
3648257100,3529732289,1653457246,1653457369,123,1720
3430464852,3630963449,1656495206,1656495827,621,2449
3275810322,3723780339,1651068452,1651068649,197,798
3015876104,3750474676,1666418581,1666419314,733,1886
3892686083,3554778587,1660040159,1660040646,487,1415
3816011687,3810952134,1648121025,1648121089,64,1600
3017715856,3272623699,1654495326,1654495970,644,179
3239418137,3249261763,1660028430,1660028833,403,1860
3599160097,3961189789,1668720863,1668721495,632,1893
3577651077,3395457102,1666776604,1666776800,196,1577
3722323538,3405955824,1656451269,1656451454,185,1828
3142106289,3023254734,1665090945,1665091021,76,834
3526747987,3775146250,1645330904,1645330905,1,2429
3568645029,3900241568,1664888519,1664889207,688,1029
3814851615,3793086361,1657010897,1657011079,182,914
3962062858,3699263886,1650998041,1650999018,977,2491
3762525964,3862890852,1655141042,1655141638,596,1100
3734381035,3724861653,1654554459,1654554568,109,1440
3379726555,3719929552,1641756545,1641757467,922,684
3753180150,3411347712,1648528633,1648529611,978,767
3322663101,3734893217,1658227327,1658227580,253,500
3877205464,3423782681,1664246620,1664246787,167,1277
3007446724,3725653558,1662508668,1662508724,56,1430
3092564684,3913680174,1668468011,1668468748,737,1092
3902329320,3132349279,1648096847,1648097698,851,392
3117234289,3168329235,1653406226,1653406617,391,1446
3799078288,3936029875,1653797311,1653797923,612,1699
3004624310,3411495833,1643783888,1643784863,975,722
3411636309,3845886572,1645884691,1645884960,269,1825
3638281686,3591348696,1668580400,1668580517,117,1679
3708896596,3120505983,1648027913,1648028530,617,659
3339027368,3250253670,1641253171,1641253972,801,492
3276576100,3279538648,1669611670,1669611773,103,1710
3888505889,3182502852,1661974784,1661975323,539,982
3002350398,3131131112,1661880449,1661881312,863,1015
3830866959,3410972917,1644174607,1644175389,782,2010
3758323845,3569600936,1649494864,1649495844,980,743
3852500776,3117322872,1648049099,1648049849,750,36
3875243979,3215257603,1649142741,1649143162,421,709
3689231617,3449365489,1669210509,1669211355,846,45
3239792198,3575715668,1669235830,1669236491,661,211
3660468597,3393156673,1658796507,1658796975,468,2200
3844416504,3805921576,1644362992,1644363562,570,1716
3928572443,3341211432,1668759158,1668759702,544,151
3663985085,3278190233,1666073450,1666073462,12,470
3343729897,3717137928,1654640817,1654640938,121,263
3501820222,3015156809,1652732497,1652733032,535,2063
3636528701,3371289776,1659703462,1659704220,758,254
3855218155,3606368289,1662291032,1662291179,147,1772
3810915449,3956027073,1667648292,1667649049,757,1385
3038529026,3916776869,1661999214,1662000173,959,2383
3967255191,3810891199,1648592564,1648593298,734,1449
3010161936,3798223043,1644089920,1644090789,869,1421
3659224437,3098891437,1648254903,1648255410,507,2387
3291819950,3928867307,1660854342,1660855316,974,550
3650342769,3486286893,1665766493,1665766559,66,1138
3047001138,3181086026,1665497451,1665498383,932,145
3343177837,3974481828,1642941257,1642941813,556,1794
3516089114,3112270906,1660303598,1660303953,355,1199
3827195774,3852685738,1662717202,1662717706,504,2125
3730428171,3984259471,1667194293,1667194750,457,255
3029849131,3111823829,1644401169,1644402094,925,998
3034985161,3557215676,1661008499,1661008797,298,1297
3423640116,3408115806,1653346018,1653346900,882,1113
3490942401,3351216955,1643780766,1643781727,961,670
3623294630,3199563620,1667638270,1667638877,607,2023
3554753273,3660551283,1644027811,1644027981,170,2021
3553530817,3406953156,1667974689,1667975372,683,1971
3549105154,3004160380,1648667736,1648668396,660,2417
3804768140,3123532931,1667161069,1667161681,612,2346
3414719919,3792527009,1646747641,1646748129,488,1563
3462825977,3472817347,1665715002,1665715105,103,348
3528439013,3264018414,1641786163,1641787037,874,1189
3923692475,3302344507,1661854130,1661854304,174,2164
3300983140,3066645531,1664415150,1664415912,762,1212
3012264999,3170519162,1642268434,1642268478,44,1590
3829149174,3344549344,1652431398,1652431918,520,375
3002316212,3344787204,1647725304,1647725840,536,548
3225616352,3731386559,1662023805,1662024772,967,746
3839688715,3569390971,1667569216,1667570088,872,1625
3199892178,3564839908,1656961419,1656961650,231,467
3427405967,3492657889,1664911706,1664912586,880,46
3579684205,3210422873,1663483453,1663483465,12,386
3523654557,3567491118,1651465830,1651466022,192,88
3352729606,3493447321,1645671953,1645672721,768,424
3527269010,3639090741,1660362670,1660363477,807,154
3234355426,3558493130,1662187141,1662187185,44,601
3069746677,3406042920,1664477619,1664478357,738,171
3474975781,3350017208,1660095172,1660095557,385,1190
3278038835,3972917056,1662323668,1662324347,679,959
3211641180,3261447619,1657333006,1657333124,118,2332
3955750752,3377743288,1646547368,1646547645,277,665
3445422843,3460678842,1652888361,1652889093,732,2334
3089138601,3311118815,1663671947,1663672220,273,434
3975380491,3022102664,1665400999,1665401617,618,460
3375847073,3671296032,1644429728,1644429960,232,1617
3526793212,3321346285,1647233026,1647234012,986,2311
3668421848,3369731959,1659724564,1659724681,117,1198
3670387440,3735700656,1650868041,1650868473,432,881
3005809519,3700109325,1641820146,1641820810,664,2084
3409804938,3159240548,1650943628,1650943666,38,1103
3897412947,3704437148,1655174514,1655175266,752,2111
3058855369,3532594788,1667305272,1667306220,948,1984
3561037966,3257034858,1663453651,1663454433,782,0
3044226207,3565128218,1663074699,1663075549,850,1256
3917229175,3586524207,1652642252,1652642780,528,562
3827954829,3456364565,1641259897,1641260102,205,256
3003243547,3836565798,1659589389,1659589696,307,2239
3625869317,3287116319,1669194015,1669194296,281,625
3445689630,3172310061,1657531377,1657531564,187,554
3164836342,3993332175,1656214888,1656215802,914,11
3210071519,3784698616,1668950036,1668950400,364,2174
3599604382,3629412022,1649466878,1649467069,191,1036
3762816561,3366643644,1642856690,1642857414,724,1189
3085182687,3866836302,1663422947,1663423542,595,832
3797930164,3357474960,1646529261,1646529571,310,2196
3969241066,3006388757,1647773060,1647773850,790,54
3787817814,3808952164,1660233103,1660233693,590,714
3307185651,3811472324,1665889425,1665890147,722,1567
3422745115,3838993248,1651159582,1651159925,343,81
3840801648,3830303170,1649944249,1649944891,642,2175
3605519659,3130134092,1657661435,1657661569,134,921
3102027139,3875945215,1652466352,1652467089,737,2413
3673948643,3597459911,1641372265,1641372821,556,2070
3248395971,3278819973,1668323759,1668324004,245,468
3290359932,3544087053,1645049652,1645050140,488,1526
3134436515,3283171763,1659448876,1659449740,864,583
3217494787,3861123581,1659028194,1659028607,413,2305
3292797747,3581083030,1653791015,1653791252,237,1228
3153085443,3010373186,1660648372,1660648499,127,1763
3664408598,3934911409,1658377235,1658377512,277,1840
3323698166,3199797181,1666742169,1666742954,785,2211
3563488722,3173108957,1668480922,1668481450,528,1082
3276840933,3865847882,1657222729,1657223051,322,600
3293775646,3826573375,1653642392,1653643333,941,363
3553471050,3270111894,1642227191,1642227925,734,635
3937129101,3273752842,1658897620,1658898005,385,2134
3944198123,3447257561,1656345184,1656345735,551,105
3067897101,3293007803,1650702772,1650703663,891,1117
3463509445,3250023388,1648992999,1648993300,301,836
3123677020,3016508907,1654223482,1654223845,363,1465
3796587240,3610480358,1664839707,1664839919,212,996
3189673990,3149560686,1651887093,1651887194,101,1773
3072834944,3650172161,1661159432,1661160312,880,1464
3335565751,3217250826,1641636291,1641637124,833,2241
3854848967,3863080370,1643399862,1643400263,401,2375
3234064286,3408108471,1667157986,1667158141,155,266
3239020709,3081213963,1642327410,1642328299,889,1969
3604694727,3755269138,1648267550,1648267798,248,956
3592520398,3315391438,1643961702,1643962004,302,796
3003145369,3994721189,1659261529,1659262410,881,2365
3478404891,3574240169,1667808085,1667808447,362,350
3327166880,3474115926,1650299763,1650299805,42,1278
3276617814,3300104659,1650818853,1650819508,655,2343
3286473367,3909173527,1642255588,1642255822,234,834
3243059921,3727706350,1649258886,1649259158,272,1358
3733102461,3343048708,1659837947,1659838827,880,1261
3241341174,3460047535,1656824787,1656825466,679,958
3129677855,3687925631,1656697327,1656697731,404,942
3102760949,3152109348,1655792476,1655792798,322,702
3537443088,3745419810,1658785358,1658786013,655,2456
3885393767,3285243887,1648443812,1648444738,926,1374
3331882759,3773789419,1658761838,1658761897,59,900
3364893066,3256231811,1655642192,1655642987,795,1531
3134380066,3748850384,1658067749,1658068401,652,2473
3255904598,3587568478,1662274561,1662275091,530,548
3720381616,3781307416,1669597345,1669597838,493,2034
3323834326,3242406857,1650105940,1650106167,227,1041
3253395374,3383755219,1649663476,1649664316,840,2194
3156942626,3342009927,1660161179,1660161364,185,978
3665148560,3649724545,1651933750,1651933895,145,236
3389812297,3206061644,1649835806,1649836116,310,708
3957115705,3324069408,1663503712,1663504330,618,222
3836597583,3056982737,1665323507,1665323548,41,2304
3813287023,3887108152,1656475408,1656475468,60,758
3551344746,3791389559,1665130235,1665130863,628,839
3634282428,3744563835,1643276701,1643276880,179,1214
3096740365,3811482837,1666872030,1666872276,246,2478
3398865388,3852810875,1651498211,1651498627,416,503
3610577318,3426666423,1642044414,1642045096,682,2112
3367685887,3882315040,1653091988,1653092865,877,2020
3480115115,3372544937,1653468068,1653468733,665,480
3175118084,3572018229,1663803225,1663803243,18,2155
3137967669,3643939596,1663172156,1663173080,924,468
3524315738,3673743780,1645842352,1645842503,151,1206
3989550849,3248167631,1669373813,1669374797,984,2075
3022403169,3657044188,1662011377,1662011740,363,1439
3074928223,3259367927,1666687955,1666688111,156,2272
3321699949,3987318292,1661672027,1661672671,644,2355
3300104659,3809965750,1650546712,1650547521,809,1466
3816011687,3366354894,1643876164,1643876390,226,2010
3195032074,3896357807,1653364871,1653364900,29,1082
3611657912,3554778587,1649843754,1649843934,180,1228
3827867076,3563750578,1667799037,1667799685,648,387
3348234563,3033925963,1658759590,1658760088,498,999
3889705477,3701151902,1658110207,1658110442,235,648
3239578622,3609664184,1658698160,1658698276,116,2368
3714535860,3953768846,1667684155,1667684910,755,1535
3332206707,3885849262,1646731762,1646732393,631,679
3952282084,3953444491,1655285147,1655285786,639,1048
3012457192,3880835949,1652154682,1652155679,997,718
3288834634,3055044716,1661309477,1661309768,291,756
3396146110,3504258562,1662865671,1662866628,957,414
3315583401,3828531030,1656839601,1656840104,503,775
3380213005,3316318605,1663227598,1663227934,336,861
3104306511,3324069408,1649029956,1649030875,919,1074
3741494242,3079038995,1651850497,1651851247,750,2389
3431354119,3445666899,1647185977,1647186754,777,1927
3857841054,3762422234,1669628253,1669628898,645,210
3451749535,3139126728,1641111585,1641112014,429,506
3412307376,3173809486,1644527016,1644527255,239,1188
3338020076,3640756400,1643273712,1643274473,761,604
3150485567,3350812449,1650455339,1650455600,261,999
3114361358,3140486428,1666937679,1666938237,558,1708
3777929700,3679578513,1662810859,1662810985,126,1326
3542369467,3269357443,1644580641,1644581143,502,32
3251372174,3562472924,1644355767,1644356482,715,1473
3342215329,3644961840,1668504680,1668504854,174,773
3194140038,3643173963,1650182031,1650182424,393,12
3550516008,3234355426,1646122824,1646123036,212,116
3324473595,3865239822,1668594323,1668595221,898,745
3370267721,3474376744,1668056970,1668057043,73,1983
3415041326,3936042616,1647347010,1647347440,430,595
3640756400,3078791988,1659149968,1659150717,749,1393
3026244912,3174705393,1649913719,1649913976,257,2380
3292010262,3119718471,1645934532,1645935337,805,1818
3381313507,3776398060,1651668240,1651669117,877,1228
3369469616,3344957789,1656772440,1656773012,572,1011
3862138776,3998209085,1645862607,1645863125,518,1750
3840846518,3963334554,1645137476,1645138115,639,1702
3714535860,3463734539,1651473365,1651473432,67,141
3131820605,3501820222,1650076346,1650076544,198,1142
3284443787,3441541439,1658842434,1658842823,389,2136
3932613929,3767983934,1665254691,1665255538,847,1170
3733770591,3303973335,1652962739,1652962871,132,2226
3639117164,3449136061,1661649130,1661649800,670,2370
3264673951,3359078190,1657681223,1657681998,775,1316
3708034201,3124384203,1652118509,1652118807,298,158
3314240169,3928020650,1656376151,1656376871,720,1410
3563407459,3593603889,1646570097,1646570706,609,158
3191792012,3163708045,1665973305,1665973849,544,647
3127616448,3824227701,1666334869,1666335241,372,2461
3619309272,3400684585,1657932566,1657932959,393,2314
3534581934,3763912599,1669711603,1669712569,966,2420
3661369487,3164550059,1644675622,1644676131,509,1491
3576315042,3470228949,1665086441,1665087353,912,1190
3477889008,3890875667,1655938489,1655938997,508,239
3344455273,3658271419,1647576348,1647576498,150,1588
3709736172,3127616448,1663709333,1663709832,499,2464
3686207600,3152438109,1656245451,1656246093,642,1019
3948577391,3789279639,1660830654,1660830727,73,633
3515161257,3623433422,1658225634,1658226076,442,976
3029016525,3414852594,1661861627,1661862186,559,109
3286466102,3533898881,1644698552,1644699255,703,1188
3893389283,3720012234,1655359009,1655359436,427,1617
3338154846,3348620933,1651005226,1651005340,114,721
3685158343,3369469616,1660133658,1660134377,719,398
3008609242,3069675415,1641641180,1641642165,985,2129
3950433378,3764343778,1657647781,1657648299,518,65
3876829785,3880196075,1666727754,1666727836,82,168
3729034883,3712115076,1654043678,1654044362,684,238
3211956216,3048409719,1662512075,1662512208,133,2287
3254952204,3537411123,1653419373,1653420184,811,2226
3257594028,3147376468,1645964885,1645964906,21,839
3163470555,3266127117,1649956776,1649957621,845,2264
3081188307,3902543996,1645262991,1645263911,920,132
3222563704,3549604297,1658656859,1658657548,689,2292
3592974208,3908895548,1665872054,1665872207,153,952
3491356699,3895370398,1661032891,1661032993,102,1505
3719884534,3138662322,1662794677,1662795486,809,1361
3612269633,3894175918,1657991953,1657992794,841,2395
3486442976,3094596605,1666061205,1666061309,104,1723
3104009859,3469648387,1668603550,1668604158,608,1196
3091595739,3069313994,1662244370,1662245273,903,849
3227652803,3258098890,1649875275,1649875604,329,227
3837877764,3392293203,1650624329,1650624807,478,367
3519828744,3659563225,1665872766,1665873537,771,475
3933332705,3818823702,1662025162,1662025958,796,242
3647685310,3439442608,1641011990,1641012794,804,2421
3470128186,3897293094,1655425609,1655425822,213,2025
3359896430,3211965606,1652797082,1652797952,870,1055
3857215319,3386846556,1653430256,1653431149,893,1747
3446519765,3457341479,1646863920,1646864056,136,1726
3012602506,3689741006,1655230167,1655230180,13,2300
3076570841,3659285822,1658806958,1658807845,887,209
3950047958,3378522829,1666607268,1666607457,189,2354
3413898378,3308353096,1644269114,1644269849,735,561
3065350513,3462033895,1642130747,1642131354,607,365
3812800144,3953465037,1662281963,1662282211,248,320
3170547321,3344549344,1649618183,1649619068,885,1119
3548252436,3029956642,1645504163,1645504532,369,2167
3664242822,3125818794,1662479150,1662479345,195,1284
3270935026,3740102481,1648295377,1648295988,611,1963
3626015702,3308015697,1663403325,1663404065,740,2184
3769836039,3030192990,1660144295,1660145123,828,1432
3491346910,3553712893,1641319680,1641319784,104,2430
3105250340,3083144170,1655257195,1655257960,765,85
3845801721,3486810833,1668096020,1668096193,173,90
3000863237,3137803904,1659655327,1659656078,751,113
3655087982,3099102864,1661816515,1661816776,261,1180
3572325072,3534852421,1641558530,1641558907,377,1997
3388159268,3684411297,1665351470,1665351893,423,392
3575512492,3830243698,1657266584,1657266735,151,2288
3832773624,3417143667,1648554417,1648554633,216,2064
3483827042,3284616898,1646692798,1646693683,885,348
3941548978,3649660430,1659352861,1659353123,262,1076
3073924620,3408944120,1658147022,1658147052,30,634
3261463305,3707767360,1654270221,1654270862,641,820
3718882981,3375177760,1665390545,1665391107,562,277
3595336393,3854535872,1664871472,1664871688,216,527
3343232841,3704120553,1649931499,1649931975,476,2094
3239517474,3142869544,1644643778,1644644600,822,633
3178728299,3237697952,1658037056,1658037260,204,317
3231988469,3872691076,1666721188,1666721255,67,976
3745532894,3261403182,1643669355,1643670171,816,789
3152200344,3271876104,1653103723,1653104338,615,537
3377774902,3017559077,1668335306,1668335772,466,2444
3339459948,3091817310,1644115506,1644115641,135,455
3516089114,3473728186,1651613064,1651613528,464,56
3520392773,3518864357,1667952122,1667952353,231,715
3881956491,3625979408,1661416967,1661417366,399,1514
3207309302,3894036055,1660492491,1660493192,701,1339
3253436330,3803051709,1647055478,1647056048,570,2202
3071602516,3950146840,1648485164,1648485322,158,181
3844822083,3337624186,1663787565,1663788099,534,728
3894030912,3458389447,1641181711,1641181945,234,278
3348198228,3266666808,1643364086,1643365018,932,2213
3902705203,3291984936,1654419140,1654420107,967,117
3665714575,3105679045,1649912113,1649912220,107,1554
3015253917,3633498077,1668568730,1668569565,835,1040
3037577001,3457998128,1651351065,1651351196,131,375
3776063818,3044967578,1641129327,1641129569,242,48
3114863942,3689518345,1647405550,1647406009,459,857
3260861147,3429887771,1654177524,1654177898,374,1553
3464734783,3676690161,1652203345,1652203651,306,204
3250248786,3114361358,1661802193,1661803077,884,1951
3995358434,3826737259,1642444340,1642445120,780,2335
3102669962,3868630067,1647462378,1647462708,330,1600
3439325479,3253931464,1650698942,1650699205,263,264
3130166522,3668235327,1664223938,1664224305,367,1675
3202922076,3974318707,1644314369,1644314910,541,1483
3639695113,3325360523,1665227857,1665228354,497,903
3987005983,3932803365,1662940630,1662940870,240,1555
3104009859,3371707067,1654569289,1654569558,269,775
3866431229,3922927380,1657889808,1657890438,630,1908
3866681013,3486832676,1653224981,1653225111,130,1757
3806936803,3701726268,1658461868,1658462451,583,2220
3714535860,3277343126,1656298214,1656298757,543,2314
3278980230,3211956216,1668816644,1668816794,150,1625
3805283132,3382015551,1648874623,1648875070,447,725
3011458038,3041652512,1658491448,1658491663,215,627
3992818695,3281907019,1647762323,1647762514,191,2035
3131548243,3309158757,1656478716,1656479192,476,193
3917662641,3210080881,1661135004,1661135364,360,820
3604769442,3710422072,1657670439,1657671242,803,1653
3098161767,3193344217,1665726735,1665727568,833,1362
3967506765,3783325820,1650412430,1650413355,925,224
3551810435,3810915449,1650819986,1650820437,451,81
3442330693,3949480596,1666320114,1666320590,476,1012
3149688689,3821275122,1645331723,1645332700,977,2098
3278297907,3486541605,1668979108,1668979673,565,1301
3319224567,3619660501,1666514609,1666515236,627,118
3363902315,3880353584,1664776639,1664776679,40,929
3548670552,3713455058,1646904323,1646904428,105,138
3823951765,3025333750,1656896058,1656896935,877,721
3261837009,3592379849,1655227954,1655228603,649,536
3428062841,3167058279,1669572921,1669573738,817,169
3516743828,3746229411,1650909978,1650910682,704,1145
3610930903,3262203147,1643398917,1643399389,472,1840
3096662890,3429660049,1662802992,1662803990,998,1888
3643615690,3019601621,1642251359,1642251849,490,505
3472855930,3644951156,1654471654,1654472516,862,1684
3330924198,3788336754,1654761926,1654762044,118,17
3672350582,3443190053,1646962052,1646962059,7,1524
3765475472,3000725837,1669116382,1669116554,172,999
3631660076,3210331889,1669565459,1669566353,894,984
3852253700,3846060378,1650198808,1650199654,846,789
3702439685,3463032893,1656086444,1656087215,771,2069
3856587038,3584037261,1658902323,1658903187,864,1953
3372334548,3366643644,1669303050,1669303626,576,2134
3922697372,3590831664,1650686442,1650686741,299,1588
3054160201,3155756336,1651222841,1651223429,588,1969
3719084637,3699293407,1644494161,1644494773,612,700
3609003771,3957973658,1663196507,1663197192,685,367
3300203056,3679983127,1663582605,1663582838,233,1128
3507338655,3542129823,1665669990,1665670634,644,1591
3218903379,3601562567,1652290591,1652290694,103,2061
3656000543,3437983939,1647676249,1647676720,471,340
3142869544,3134380066,1642877665,1642877864,199,816
3748478851,3192367201,1656541235,1656542103,868,2021
3297626110,3337108824,1664395494,1664395936,442,1074
3419465829,3572224210,1668212905,1668213777,872,1945
3590627159,3258577325,1641611459,1641611595,136,201
3632101943,3449395269,1643590446,1643591149,703,918
3576386271,3402880726,1646754234,1646754769,535,806
3086273441,3777091595,1661327449,1661328265,816,2385
3243005694,3416521015,1653333230,1653334226,996,2160
3261174036,3913905115,1653163424,1653164215,791,1506
3498707377,3391426421,1668377460,1668378428,968,2254
3617349707,3793086361,1654567105,1654567128,23,367
3992817916,3977860015,1654949501,1654949687,186,1080
3527269010,3600472145,1645044792,1645045279,487,2035
3442753076,3736085476,1667134725,1667135196,471,708
3330048607,3420137628,1650228756,1650229427,671,343
3500097822,3213169891,1655907307,1655908003,696,1888
3923523643,3312580754,1655283300,1655283720,420,649
3277883706,3289017659,1664501140,1664501358,218,1179
3051876837,3308028752,1648087145,1648087424,279,23
3137529896,3786924052,1643359157,1643359502,345,1335
3486606390,3035838196,1661590134,1661590955,821,1758
3313975664,3291324812,1668384717,1668385654,937,2383
3603965318,3188162412,1656583288,1656583869,581,2284
3558281313,3900951859,1648246558,1648246765,207,1329
3163986082,3679615343,1654864981,1654865164,183,1984
3884802599,3772980352,1647975918,1647976203,285,2176
3418364050,3222119601,1646182702,1646182989,287,1185
3977699882,3733072964,1660486764,1660486769,5,882
3550908209,3615359439,1648497464,1648498391,927,811
3975864053,3104306511,1641511213,1641511502,289,1679
3090103866,3975065378,1647029930,1647030013,83,1323
3218964640,3795934256,1667051899,1667052802,903,2145
3232209052,3325735498,1653495266,1653495834,568,1251
3689544534,3059151355,1666652238,1666652331,93,872
3132674107,3666148943,1645168535,1645168667,132,208
3927660473,3625979408,1665205890,1665206557,667,2454
3814588354,3948743692,1652578676,1652579127,451,2247
3315391438,3811785839,1669192075,1669192779,704,908
3245354614,3771616536,1654010630,1654010676,46,18
3394249709,3647255060,1641393369,1641394265,896,426
3357474960,3362298218,1656751957,1656752745,788,2289
3487104766,3595336393,1654706962,1654707127,165,983
3865239822,3826573375,1666245553,1666246393,840,2057
3069675415,3463003824,1645680954,1645681767,813,1798
3631568439,3670387440,1662273336,1662274114,778,1428
3103625074,3246783185,1662267633,1662268520,887,1939
3440969146,3956878212,1654768916,1654769608,692,95
3950982431,3039932020,1661733100,1661733989,889,1089
3140488273,3718026583,1666396374,1666396525,151,1275
3404432145,3849910709,1660220758,1660221014,256,1297
3686424169,3766966794,1664970334,1664971304,970,1826
3732256987,3727801252,1659829288,1659829726,438,2054
3546034581,3915111520,1662601849,1662602123,274,75
3793032912,3037741311,1646877906,1646878692,786,1274
3537151295,3669880471,1644908635,1644908979,344,2422
3269653223,3910585793,1661402053,1661402640,587,2199
3673549679,3635854686,1668599061,1668599577,516,1865
3120823401,3881519714,1665876568,1665876665,97,2409
3894175918,3600856738,1648642592,1648643172,580,669
3727801252,3402543059,1656327569,1656327738,169,1324
3753863307,3816240060,1668209794,1668209856,62,35
3271885744,3923635120,1647801590,1647801866,276,2269
3481006313,3480905975,1660586806,1660587736,930,1323
3268446099,3243502165,1641766059,1641766939,880,829
3437593879,3892848585,1643320479,1643320951,472,376
3095151362,3070520574,1644958191,1644958225,34,2214
3922423821,3775968124,1669736410,1669737287,877,1718
3447527130,3313426081,1654352880,1654353631,751,505
3490435539,3403471618,1649424176,1649424238,62,849
3231899706,3685977300,1654685719,1654686509,790,1433
3332458882,3049579265,1642881880,1642882730,850,1513
3173406646,3389105515,1641163855,1641163920,65,978
3733190374,3344279346,1666072232,1666072643,411,2378
3005809519,3882315040,1653295001,1653295595,594,485
3733440098,3946306778,1648314642,1648315636,994,1833
3127447356,3641618845,1645680994,1645681894,900,709
3692441467,3040867771,1654728744,1654728814,70,2477
3720475877,3885583347,1644720744,1644721590,846,2018
3195629628,3379937268,1654235861,1654236750,889,2339
3528271389,3727794902,1653187107,1653187776,669,1345
3307462662,3465229825,1662696177,1662696462,285,1694
3066426534,3697322167,1668958267,1668958401,134,257
3935740815,3337673105,1646291338,1646291917,579,271
3879936194,3190544941,1653336535,1653337161,626,1054
3837904800,3763317740,1641689224,1641690082,858,679
3283671920,3940067834,1662760996,1662761753,757,1631
3733484132,3967250644,1655874424,1655874772,348,2157
3947712728,3412673526,1669588022,1669588315,293,2254
3381846064,3881519714,1657570471,1657571134,663,1959
3707584091,3869991101,1666512610,1666513049,439,830
3966525848,3344713569,1662347519,1662347686,167,1192
3064574238,3494498890,1668155747,1668156070,323,1891
3908312889,3313615371,1657781582,1657782339,757,221
3675353745,3089548621,1656927518,1656928043,525,1877
3946833004,3308454699,1645559445,1645560416,971,1338
3199472785,3272217633,1656268069,1656268308,239,163
3254496907,3391056146,1647623164,1647623941,777,1554
3243086924,3656865344,1660827683,1660828184,501,1553
3856474495,3026095831,1641460946,1641461528,582,2230
3598409790,3543239972,1655147425,1655148302,877,1593
3010673027,3118406319,1663106917,1663107737,820,1843
3282166903,3189111071,1646167557,1646168257,700,2163
3210078490,3958375464,1650765329,1650765339,10,1658
3399479391,3867640062,1660426574,1660426643,69,1272
3516488694,3457191473,1645038227,1645038624,397,289
3224952698,3744234480,1651805585,1651806485,900,1490
3760432849,3311244386,1641749650,1641750624,974,1939
3302700303,3292172583,1641833225,1641833831,606,2146
3735691730,3339459948,1651760042,1651760120,78,2148
3592906293,3543926712,1655745267,1655745322,55,422
3469887287,3746243275,1659488577,1659489431,854,1378
3377868003,3152109348,1663377340,1663377629,289,1347
3014552263,3136172164,1651297043,1651297247,204,2215
3582267659,3510660628,1652659690,1652659942,252,2096
3950982431,3134793811,1645304864,1645305051,187,558
3361514629,3445558523,1667546953,1667547945,992,796
3079013365,3499182342,1668999883,1669000757,874,2279
3016508907,3647263296,1667570149,1667570870,721,2079
3388814754,3406332128,1652549750,1652550440,690,2252
3096746005,3935383578,1650475882,1650476670,788,750
3960908616,3344891111,1660206938,1660207795,857,596
3607608267,3754139010,1658935698,1658936030,332,89
3141391673,3840416991,1666332602,1666333025,423,2241
3847297747,3934911409,1652852234,1652852251,17,2083
3206512870,3316318605,1667973555,1667974419,864,530
3339027368,3254503569,1647139100,1647139781,681,1501
3996084129,3097563397,1641883671,1641883682,11,1916
3020446596,3574486853,1652383233,1652384201,968,2146
3125289160,3420520626,1658986988,1658987368,380,181
3377179024,3463973561,1642047492,1642048017,525,1890
3900241568,3129993467,1647233998,1647234413,415,884
3662876111,3776398060,1659992545,1659993176,631,2158
3499281518,3008283469,1666947668,1666948256,588,1386
3000780515,3598645736,1654468445,1654468927,482,774
3161805415,3574240169,1646299533,1646299642,109,1268
3280648157,3541597384,1664789367,1664790352,985,2122
3776419392,3918891410,1660530485,1660531218,733,600
3019576854,3741983763,1650550025,1650550252,227,2064
3005125326,3946833004,1656271933,1656272457,524,2290
3889079063,3759787118,1656926594,1656927026,432,2092
3339415879,3066451739,1641369907,1641370304,397,2181
3440322150,3073944007,1652512455,1652512608,153,1476
3705996677,3150893774,1650939866,1650940305,439,1498
3222563704,3059075236,1649046937,1649047680,743,478
3523631626,3306378570,1664274703,1664275117,414,1692
3550329232,3689020840,1652970483,1652971317,834,1114
3282839568,3823206701,1645304150,1645304522,372,85
3862918742,3807922855,1660988723,1660989468,745,327
3595560993,3926200409,1660959453,1660959466,13,932
3592453741,3489453670,1665838334,1665838911,577,2288
3342315965,3389114774,1648692227,1648692909,682,304
3993814137,3959651432,1657020097,1657020785,688,1949
3375253810,3616901816,1662064271,1662064369,98,746
3408903285,3526218972,1663162407,1663162968,561,88
3456602518,3307775998,1656860668,1656861274,606,1844
3760047951,3596951808,1654972080,1654972201,121,700
3441541439,3771146763,1654336983,1654337614,631,98
3721541321,3059848821,1667434911,1667435841,930,1819
3055390520,3442244098,1645478640,1645478903,263,1218
3823790407,3834011879,1657364978,1657365654,676,1533
3309106486,3194871172,1648648590,1648649424,834,2095
3400397224,3086871623,1650020764,1650021374,610,5
3421505883,3792253761,1653349951,1653350139,188,1910
3925754107,3233318289,1661529328,1661529352,24,1083
3672164838,3058834310,1657963121,1657964101,980,1373
3076285457,3645585393,1665249428,1665249717,289,1224
3806015172,3980926444,1646678491,1646678944,453,1027
3669789756,3424254328,1650912644,1650912688,44,1581
3630123918,3990312725,1642022557,1642022829,272,1918
3698989053,3730106432,1658867125,1658867931,806,2487
3599568023,3461628724,1652929082,1652929504,422,2097
3467810757,3371767777,1657752163,1657752303,140,1500
3994913668,3106371588,1668700124,1668700236,112,1333
3913162487,3129792187,1667205856,1667206166,310,1311
3210080881,3572746096,1653292955,1653293617,662,843
3066093153,3611657912,1659961809,1659961998,189,149
3150485567,3857081560,1649885651,1649886366,715,406
3949133704,3101410977,1669697125,1669697497,372,582
3004870031,3368734939,1661310668,1661311198,530,1512
3346254669,3412715210,1665955597,1665955718,121,517
3459018363,3548545695,1659785744,1659785921,177,1305
3034985161,3658295713,1642447846,1642448344,498,2246
3772739629,3263488499,1641788360,1641789330,970,2133
3006603067,3931229167,1652091136,1652091273,137,1518
3680100111,3986557042,1668954697,1668955542,845,1672
3174373725,3913243283,1641128862,1641129600,738,2076
3391206046,3719455699,1641884628,1641885069,441,722
3003705867,3689303525,1667522823,1667523467,644,1043
3613018005,3401463703,1645178700,1645179454,754,607
3790407401,3385603289,1646197153,1646197490,337,1279
3188726102,3468803992,1668208238,1668208393,155,953
3538410031,3634089207,1651386696,1651387141,445,1672
3104306511,3603594711,1652970002,1652970450,448,906
3772910484,3083479870,1656065055,1656065246,191,1701
3035245517,3952670371,1653731163,1653731450,287,1586
3447326124,3312656348,1650573501,1650573643,142,2459
3246701704,3354574342,1660430187,1660430934,747,1371
3106630738,3569600936,1668519506,1668519794,288,319
3279550373,3478921948,1664485231,1664485893,662,217
3022082086,3515460273,1655304820,1655305554,734,1249
3035737560,3021253966,1669127624,1669128144,520,1712
3246260241,3132349279,1661077623,1661077631,8,2479
3484699376,3343279177,1652457677,1652458666,989,1199
3163395401,3706797905,1661363150,1661363486,336,1713
3590621650,3369792484,1662224347,1662224447,100,232
3379285136,3080200257,1665332007,1665332909,902,1369
3469648387,3003330774,1659100181,1659100254,73,1195
3772749656,3925754107,1656747611,1656748514,903,824
3057314040,3108818977,1643537464,1643538043,579,314
3438084709,3141997314,1648679848,1648680411,563,373
3237339326,3457361080,1651167047,1651167239,192,274
3671355250,3150027454,1661407176,1661407493,317,1798
3649442188,3823288349,1652875273,1652875756,483,2137
3476450845,3599694754,1644507218,1644507371,153,52
3936659399,3650041115,1651063923,1651064170,247,78
3708754161,3863485115,1662344765,1662345078,313,990
3010790966,3798833025,1650855912,1650856009,97,303
3748812993,3256217137,1658511438,1658511944,506,258
3321699949,3945633602,1645912260,1645912765,505,736
3139935588,3547072063,1657635287,1657635358,71,2474
3640349880,3444149733,1653384967,1653385791,824,2457
3759510872,3895277580,1647801889,1647802872,983,492
3778228977,3553241769,1643548999,1643549532,533,647
3618941109,3365708107,1646398761,1646398945,184,1298
3622485921,3707578213,1665812798,1665813274,476,283
3106276005,3910839994,1668888613,1668889602,989,108
3876377964,3249145163,1650694694,1650695523,829,1106
3546954605,3204935260,1667735828,1667736307,479,1425
3009141852,3338882756,1646086156,1646086361,205,300
3659158165,3540730645,1661537915,1661538001,86,112
3002727939,3962062858,1651239976,1651240115,139,1886
3122127756,3130899709,1661605195,1661605316,121,553
3023025075,3606643671,1642161689,1642161929,240,363
3139087074,3075088680,1665712334,1665712622,288,1865
3711847265,3865847882,1645940843,1645941121,278,1414
3215342018,3143452523,1664953551,1664954306,755,1031
3258352640,3166274990,1661475093,1661476039,946,2000
3187644022,3687724937,1654135511,1654135614,103,727
3198338148,3122246747,1666545171,1666545192,21,1670
3498707377,3301093931,1660656187,1660656301,114,120
3614206353,3456080836,1661020482,1661020627,145,1780
3969563324,3876377964,1658264496,1658265316,820,454
3206386504,3436975295,1655041302,1655041872,570,2232
3337601088,3766205598,1660555031,1660555863,832,1721
3065405448,3554778587,1663454251,1663455037,786,1249
3526491245,3051776472,1654531579,1654531767,188,1529
3534752391,3582060994,1642177710,1642178656,946,2343
3115177011,3651803323,1664976438,1664977203,765,1660
3865950417,3666380447,1661342999,1661343259,260,2180
3516676045,3096854657,1649065787,1649066377,590,1371
3599795440,3749593178,1656900750,1656900903,153,1098
3282587673,3576961863,1663845151,1663845885,734,632
3102332016,3369865184,1656355624,1656356307,683,1017
3762829533,3915154684,1668369071,1668369222,151,190
3996978717,3915344164,1662095773,1662096155,382,1202
3360158658,3553721378,1655291524,1655291878,354,1220
3054573274,3482509515,1651799863,1651800187,324,676
3870778205,3772739629,1656657789,1656658019,230,2278
3391441349,3487547990,1662994828,1662995288,460,1406
3269653223,3245723038,1667967302,1667967928,626,1882
3999390272,3350387055,1665667161,1665668022,861,898
3177491349,3927214415,1645058283,1645058969,686,1887
3118406319,3408108471,1655914628,1655915558,930,208
3311860866,3928290954,1656005876,1656006109,233,1589
3231794234,3664273227,1657051469,1657051904,435,594
3047643464,3180062640,1656615812,1656616314,502,563
3089613411,3985513037,1645145772,1645146550,778,771
3687938178,3019576854,1662000432,1662000562,130,736
3854848967,3608775321,1656614940,1656615780,840,912
3873218862,3990144819,1643976740,1643977604,864,633
3118976994,3613021322,1641288001,1641288493,492,845
3408978529,3800337461,1668950903,1668951837,934,1793
3839610928,3439364410,1647211244,1647211758,514,2483
3637518238,3415145597,1653806064,1653806595,531,138
3679846649,3191970772,1654626374,1654627280,906,1465
3322337553,3352005808,1647576963,1647577060,97,661
3700896206,3552958954,1652179332,1652180004,672,976
3404317985,3133788020,1665695070,1665695521,451,483
3570480973,3973713516,1653256377,1653256698,321,2309
3885235661,3271919876,1648527809,1648527919,110,659
3190859932,3968412854,1654772943,1654773122,179,1781
3361051044,3460027343,1663585823,1663585904,81,2460
3245919207,3924607271,1654720064,1654720353,289,1693
3296531648,3977495302,1654637607,1654638314,707,343
3215502915,3782941796,1653585694,1653586071,377,1406
3017883382,3337967165,1658087036,1658087928,892,1718
3660548799,3285516363,1652884072,1652884661,589,2228
3875434702,3337765684,1656684158,1656684880,722,626
3352667302,3239517474,1665497118,1665497926,808,844
3801956152,3950047958,1644359913,1644360001,88,2125
3393314546,3941689381,1644956338,1644957252,914,375
3292111100,3901086549,1641234091,1641234321,230,2124
3262379384,3917715509,1642783249,1642783826,577,1268
3515480973,3782377691,1647764780,1647765438,658,1169
3676100322,3984570592,1656852658,1656853319,661,1361
3605699054,3278703976,1664044972,1664045345,373,1595
3447470600,3424897066,1645347386,1645348296,910,1641
3161243271,3549671217,1642588804,1642588850,46,1249
3103417672,3895422097,1666095644,1666095959,315,925
3946306714,3854995649,1666415611,1666416015,404,1536
3289108426,3233920789,1662236886,1662237327,441,61
3698989053,3918581818,1648623591,1648624229,638,577
3597485446,3922927380,1667330004,1667330090,86,705
3772337054,3040627958,1665671979,1665672397,418,830
3117234289,3876427301,1644204542,1644204893,351,1612
3188588023,3428501033,1648341864,1648342557,693,1747
3565700391,3740404190,1641107357,1641107659,302,589
3622984488,3224309877,1662047962,1662048744,782,1083
3332012161,3456285013,1642111400,1642111639,239,1389
3364911803,3071810518,1664917222,1664918146,924,2442
3087278716,3626457002,1645101361,1645102051,690,2253
3987431029,3880011397,1664704656,1664704910,254,1416
3462825977,3652480299,1662312815,1662313365,550,1383
3331904172,3466282430,1666700067,1666700515,448,1075
3625684557,3959408689,1644418387,1644419076,689,1757
3708101315,3649036403,1660085296,1660085661,365,1395
3191632331,3416230781,1652687464,1652688380,916,1961
3560053389,3499787925,1649317666,1649318657,991,1480
3543257848,3057725565,1668829463,1668829503,40,53
3327427782,3414748923,1668206020,1668206206,186,1400
3062410888,3620725243,1642221905,1642222544,639,2487
3099224416,3807924634,1668946393,1668947337,944,145
3884750087,3097834756,1642470785,1642470786,1,1861
3098264219,3665599335,1660175678,1660176088,410,941
3581083030,3832585790,1648888183,1648888726,543,1149
3561692706,3767912489,1647026791,1647027531,740,1801
3557643641,3230277243,1667564288,1667564491,203,2321
3698521503,3725611236,1652019562,1652019982,420,1477
3352376449,3451089348,1664632555,1664633333,778,2243
3493752989,3900051900,1668299593,1668300162,569,140
3917984429,3303025505,1650235255,1650235334,79,1703
3941586762,3292636621,1645152397,1645152974,577,1036
3258050916,3827431944,1657081490,1657081884,394,845
3832296106,3290359932,1659319455,1659320356,901,1183
3898699023,3554832209,1648392753,1648393359,606,1521
3830541998,3048788442,1662195928,1662196312,384,1948
3250926786,3385760763,1648073153,1648073633,480,1831
3522814184,3914166761,1660476410,1660477284,874,143
3376960491,3257821708,1645500123,1645500982,859,1183
3386809097,3093146280,1659883163,1659883861,698,1304
3916261675,3580953063,1657070132,1657070870,738,1839
3011985525,3693652924,1651297859,1651298482,623,45
3194069746,3123522446,1664223698,1664223912,214,560
3217857851,3506143492,1650934102,1650934424,322,2141
3898118371,3132210207,1655198365,1655198476,111,353
3927066139,3886521075,1657510090,1657510094,4,266
3897712112,3161234904,1649170478,1649170613,135,1299
3489225147,3870032753,1651130972,1651131250,278,2425
3818039978,3311113773,1656665374,1656666128,754,1660
3014185506,3158209281,1658085094,1658085967,873,1391
3327311623,3246571420,1644968531,1644969053,522,1817
3598841094,3484710507,1649785922,1649786617,695,2104
3347854994,3958710935,1647401766,1647402161,395,1075
3699730203,3607354151,1647745963,1647746692,729,1476
3429887771,3546943801,1668756992,1668757601,609,659
3942399353,3035402024,1648062213,1648063013,800,1010
3862685266,3268916307,1661909022,1661909827,805,1876
3454297726,3666079547,1645380823,1645381549,726,46
3482933937,3006456611,1643301669,1643302465,796,1041
3453839667,3205383513,1656681717,1656682513,796,1769
3928951547,3446481380,1656805148,1656806020,872,998
3272856923,3924799278,1645128838,1645129095,257,568
3478280943,3209748014,1659468452,1659468865,413,1187
3243059921,3255182489,1650659505,1650660030,525,1979
3746550027,3106395050,1649763101,1649763972,871,2271
3027064938,3614741796,1661702863,1661703612,749,1643
3285331142,3229368997,1651685240,1651686153,913,1064
3368294774,3594903436,1660741942,1660742430,488,188
3899890592,3372197177,1643544693,1643545066,373,98
3584925664,3318577605,1662004431,1662004867,436,823
3634885711,3187779586,1653719680,1653719935,255,1257
3777846262,3009688248,1656238349,1656238989,640,168
3487778655,3055944630,1655800403,1655800944,541,74
3273348089,3565056675,1660511676,1660511943,267,341
3507338655,3231517158,1658491097,1658491760,663,2341
3084060274,3564089463,1662305517,1662305628,111,484
3257034858,3663814997,1650086487,1650086792,305,1059
3576317139,3452258976,1652025588,1652026072,484,497
3112313754,3185210514,1667335704,1667335975,271,1840
3935022176,3491398730,1657889997,1657890379,382,179
3249252169,3779331078,1658039926,1658040103,177,2032
3314901091,3882983178,1649719184,1649719530,346,1705
3220800349,3442927979,1648602292,1648602456,164,1086
3624139591,3064644311,1659964316,1659964726,410,95
3691021918,3920436432,1645121889,1645122071,182,2025
3065298582,3118518203,1662502165,1662502954,789,1096
3487104766,3887791096,1648718966,1648719790,824,408
3672693214,3696607958,1647263377,1647264224,847,2248
3565287194,3439280560,1668032152,1668032428,276,2215
3050434345,3115494713,1660769674,1660770569,895,1434
3722483331,3578616050,1645717017,1645717617,600,1780
3363944559,3037844343,1645459028,1645459579,551,198
3320742371,3999314182,1662785827,1662786381,554,1795
3765827886,3961830711,1654896358,1654897013,655,2219
3487992433,3136810446,1663117141,1663117918,777,1324
3970124384,3142747577,1648817667,1648818458,791,732
3250381378,3800201060,1668316704,1668316954,250,1602
3992817916,3411128747,1661894142,1661894885,743,1724
3922423821,3333103680,1644626731,1644627202,471,2027
3299536518,3895334140,1654454159,1654454552,393,982
3354055639,3371435731,1663774175,1663774557,382,246
3656654582,3458815526,1654485173,1654485301,128,314
3138801114,3641372344,1650419536,1650420450,914,470
3345458354,3725963743,1642104957,1642105029,72,2456
3526239660,3163708045,1660969805,1660969930,125,960
3297290662,3035838196,1662113756,1662114318,562,1349
3435518470,3017559077,1657593834,1657594060,226,1530
3469524230,3669324531,1644251828,1644252541,713,773
3839967647,3357478199,1651087550,1651088039,489,2169
3988546259,3551243497,1667853848,1667854041,193,1722
3115494713,3866993832,1660519791,1660519974,183,2248
3894593426,3716137932,1668828120,1668828679,559,980
3130166522,3234620335,1667031812,1667032421,609,378
3150551034,3159873313,1646768297,1646769052,755,793
3619800237,3308256167,1647127208,1647127264,56,1502
3963547295,3479778946,1656702065,1656702411,346,2236
3387568587,3752621490,1655021295,1655022024,729,2476
3831255967,3648257100,1650666966,1650667086,120,860
3390445291,3346164838,1648955299,1648955874,575,75
3849725507,3216657133,1656529938,1656530453,515,1806
3377473764,3961830711,1642189997,1642190022,25,2308
3451749535,3978987003,1656381319,1656382059,740,2159
3271156755,3139455252,1642030113,1642030423,310,147
3088504949,3730270448,1644213489,1644214090,601,192
3829901682,3647255060,1652661226,1652661625,399,1928
3385246088,3657305306,1664419100,1664419895,795,674
3828713812,3252421501,1662744679,1662745336,657,2430
3778228977,3442477300,1643631354,1643631394,40,579
3439442608,3457451540,1660814577,1660815429,852,2455
3990343743,3807473345,1654331994,1654332959,965,2124
3540735539,3399368823,1668398147,1668398580,433,1983
3470287808,3300994471,1648441684,1648441944,260,1842
3474723005,3009169806,1666979935,1666980924,989,2146
3764298989,3276232281,1655945210,1655945893,683,722
3960215733,3919439752,1665401915,1665402222,307,367
3687307113,3277810331,1643819215,1643819638,423,2444
3511755413,3412047712,1666347015,1666347803,788,1878
3843953645,3746550027,1661790759,1661791059,300,1222
3244198823,3824478322,1665396967,1665397663,696,2265
3527106895,3033925963,1648135397,1648135820,423,2402
3670291498,3462224632,1664275577,1664276480,903,1544
3886368625,3520571883,1650428652,1650429378,726,138
3924607271,3007480776,1641390418,1641390631,213,1034
3084555769,3167058279,1660229732,1660230471,739,1933
3206386504,3873002836,1643095864,1643096183,319,728
3853644964,3586405616,1648767909,1648768470,561,1223
3993637202,3639059199,1650278833,1650278979,146,495
3879967963,3543732655,1654344782,1654345124,342,124
3657251975,3838823979,1668675587,1668676488,901,494
3139935588,3084030782,1641630806,1641631724,918,2449
3852633699,3063674428,1641992400,1641992691,291,1304
3506458720,3204412545,1665438287,1665438400,113,450
3671539226,3230277243,1652410360,1652410365,5,1066
3622978712,3784123884,1646408963,1646409525,562,490
3565052722,3382396122,1645958869,1645959425,556,1730
3380930960,3788785252,1663649221,1663649710,489,810
3291667893,3094940809,1644773192,1644773534,342,2463
3776027879,3550874434,1653544901,1653544999,98,2231
3385264040,3672350582,1663695483,1663696451,968,186
3881002245,3828219822,1653118869,1653119539,670,778
3591264259,3615177362,1659469557,1659470040,483,848
3485926280,3280405059,1668259707,1668259814,107,769
3540251095,3209097023,1659292662,1659293539,877,1393
3651812819,3260174905,1645020951,1645021833,882,165
3424621981,3687293094,1653697687,1653698498,811,1854
3187807330,3822917630,1657548216,1657548640,424,257
3668753730,3876377964,1665160808,1665161324,516,1474
3958375464,3490415118,1655322181,1655322297,116,826
3890821469,3607393629,1649488363,1649488796,433,1628
3057837723,3727794902,1656734276,1656735188,912,1505
3373239702,3653031568,1655605067,1655605592,525,41
3792004796,3042046828,1655876233,1655876851,618,100
3019572992,3702541874,1668713225,1668713696,471,2377
3148259657,3587568478,1666904456,1666904496,40,1660
3662300962,3104816625,1643847158,1643847163,5,675
3672699331,3474666564,1650205384,1650205551,167,2054
3668625909,3550218169,1645967888,1645967921,33,1738
3269653223,3082108681,1661429333,1661429856,523,1039
3592043925,3250786481,1654077593,1654078052,459,63
3314932010,3056173313,1666171817,1666172260,443,1739
3062789212,3122818832,1667920503,1667920680,177,842
3516410980,3944198123,1649248553,1649249292,739,410
3120186347,3739048247,1642505205,1642505647,442,235
3406042920,3049424358,1645330334,1645330826,492,1995
3639659256,3134872743,1655600915,1655601201,286,2329
3145393304,3192472683,1669490222,1669490805,583,2164
3275360473,3722578408,1651466687,1651466736,49,504
3929925771,3502050886,1658662764,1658663645,881,2219
3810915449,3301994647,1642991947,1642992885,938,1634
3988957478,3345413125,1657589686,1657590030,344,873
3154009016,3431354119,1649322549,1649322977,428,1415
3274452346,3801847517,1660586806,1660587229,423,1018
3918552618,3623351962,1646883712,1646883874,162,1455
3064758483,3673743780,1641650511,1641650882,371,1599
3198527442,3885026939,1663201753,1663201777,24,1528
3608512295,3577990920,1668626751,1668626966,215,1978
3095772004,3837481005,1644216870,1644217608,738,1738
3822404633,3728506494,1648286551,1648286653,102,2384
3727981782,3957689713,1641470041,1641470743,702,444
3741681613,3790964737,1655364397,1655365096,699,530
3214282155,3106781266,1658878850,1658879350,500,2331
3494179125,3982960576,1667355496,1667355809,313,243
3112298724,3081701001,1658329081,1658329646,565,216
3809387134,3365381632,1644037098,1644037440,342,951
3437707461,3134380066,1666078400,1666078692,292,455
3298042916,3965118569,1656749739,1656750391,652,2283
3193344217,3163326257,1654724930,1654725369,439,2495
3210986714,3710189327,1641952163,1641952299,136,2133
3268826534,3402349073,1653240711,1653240864,153,1952
3584668339,3018612279,1664006453,1664007291,838,1310
3749188570,3221276652,1644656108,1644656397,289,211
3378542130,3391118279,1657341884,1657342325,441,300
3167034499,3536156667,1641325016,1641325309,293,673
3765827886,3790180006,1653763076,1653763909,833,1337
3150289965,3901579796,1668832403,1668832548,145,42
3690633750,3548609816,1652058023,1652058627,604,683
3241944871,3721226798,1669178502,1669179285,783,1952
3368420871,3769198196,1649893341,1649893968,627,1466
3878876305,3534581934,1642541148,1642541166,18,595
3225989431,3866534454,1648662749,1648663332,583,957
3967015655,3822146001,1655237478,1655237803,325,335
3234861737,3025310934,1646823908,1646824442,534,1065
3880052402,3673935826,1644291016,1644291101,85,2218
3652513122,3762856505,1643015606,1643016487,881,1557
3409949315,3770561730,1653533105,1653534024,919,969
3772430644,3569443529,1654798710,1654798798,88,351
3317431311,3709665583,1641869727,1641870694,967,1642
3183259139,3696211720,1662582223,1662582346,123,2284
3074385503,3196616254,1668645291,1668646013,722,1112
3356317749,3800460824,1664954850,1664955647,797,357
3357048496,3145438438,1668258167,1668259042,875,883
3558232376,3007446724,1667868851,1667869269,418,1851
3226298244,3910149883,1665860021,1665860645,624,2092
3106788261,3616094004,1661846188,1661846651,463,1470
3950936299,3776685300,1669739382,1669739486,104,450
3973264936,3373962186,1652971570,1652971931,361,1921
3649073682,3197323395,1645580324,1645580916,592,1077
3982916950,3687552718,1668804340,1668804521,181,571
3580280923,3343059553,1664838928,1664839731,803,819
3130612494,3197323395,1668940285,1668940810,525,359
3861123581,3010713914,1650238323,1650238679,356,44
3518717396,3235086334,1665915714,1665916612,898,359
3707199669,3128401376,1653626741,1653627233,492,1133
3187807330,3847957207,1644983553,1644984435,882,1175
3577651077,3261333996,1664240396,1664241285,889,2122
3095430228,3522963106,1646047433,1646047893,460,1324
3442081758,3314932010,1652307968,1652308436,468,892
3376552382,3246260241,1644477819,1644478462,643,277
3149304177,3857687791,1643947452,1643948010,558,579
3937758732,3516743828,1654643506,1654644259,753,966
3193991721,3444067052,1649288603,1649288856,253,2295
3183640403,3282166903,1669285957,1669286249,292,173
3729475963,3522211010,1658357352,1658357741,389,1099
3684883542,3722247979,1668533043,1668533648,605,1887
3285331142,3148284665,1648958714,1648958991,277,63
3875570780,3346860393,1664056739,1664057106,367,1941
3152554117,3864930473,1654440977,1654441685,708,517
3371063992,3225616352,1657468821,1657468996,175,1370
3691474413,3250359001,1651416662,1651417661,999,300
3957973658,3046510463,1655305998,1655306286,288,814
3300412448,3896867161,1655056514,1655056632,118,1064
3532450192,3356728242,1641614645,1641615187,542,957
3442194248,3541372095,1669627678,1669627777,99,1825
3890448806,3862456223,1660373112,1660374002,890,1824
3180294141,3120186347,1655736217,1655736770,553,2324
3242897765,3949133704,1650997837,1650998166,329,2213
3653739025,3059602794,1658395306,1658395501,195,799
3318735194,3355910238,1654219717,1654220293,576,2327
3217375075,3165845148,1648055349,1648056164,815,961
3201933010,3269690639,1659135571,1659135827,256,834
3344143432,3542824458,1651492931,1651493699,768,70
3674335911,3508202949,1660804038,1660804403,365,73
3352986307,3365708107,1645466636,1645467308,672,2352
3184680353,3903588940,1665541327,1665542218,891,727
3555272427,3525978019,1654266961,1654267306,345,519
3018760022,3293237543,1658296710,1658296874,164,298
3678505160,3380303288,1651124914,1651125152,238,1102
3717406689,3421078448,1662408796,1662409542,746,655
3582478882,3066007042,1644007925,1644008213,288,579
3739338939,3117749198,1647760937,1647761295,358,486
3494971523,3017407853,1666622292,1666622315,23,568
3739406554,3476820014,1662095350,1662095899,549,1981
3153831709,3135116989,1650874795,1650874811,16,93
3109959336,3135951344,1654677370,1654677619,249,1793
3877638741,3287171733,1655363081,1655363986,905,2019
3067897101,3107501731,1652780338,1652781055,717,806
3052396813,3696205962,1669640979,1669641112,133,1725
3470102638,3727995134,1644327726,1644328520,794,1075
3073540574,3433835303,1647246717,1647247671,954,992
3889537515,3217719618,1655418380,1655419086,706,2136
3892800106,3910149883,1655560946,1655561262,316,187
3917956140,3710769510,1666016040,1666016724,684,159
3109941959,3911316683,1648961359,1648961953,594,758
3011466658,3448952875,1668161673,1668162267,594,1653
3579921083,3711847265,1645102681,1645103408,727,1501
3451771672,3281369687,1657930179,1657930996,817,135
3359896430,3185611253,1652712978,1652713200,222,1261
3292667822,3353956873,1661806457,1661806965,508,542
3235245267,3465406980,1641800789,1641801658,869,2201
3003321686,3102119693,1650673758,1650674440,682,2098
3355976871,3592453741,1663671265,1663671419,154,278
3199797181,3370120843,1660281401,1660281759,358,718
3060310842,3104870555,1662086119,1662086431,312,1079
3768984387,3066757468,1650891137,1650891144,7,2426
3052789625,3041632417,1661048931,1661049475,544,1731
3734518688,3232546504,1653665081,1653665982,901,1231
3886720244,3774916473,1657383367,1657384344,977,1169
3001912243,3802592493,1650831315,1650831661,346,474
3940387270,3391622565,1668197799,1668198262,463,148
3266270844,3187291408,1653011823,1653012620,797,2394
3128009914,3074460772,1650247216,1650247484,268,2341
3844499309,3750698244,1666799357,1666799841,484,2316
3428595992,3076431464,1662517893,1662518742,849,127
3203128336,3017484255,1649256284,1649257261,977,1128
3254930364,3817667121,1644472534,1644473311,777,1104
3763188005,3475779347,1641112022,1641112579,557,1456
3040136606,3973713516,1661302635,1661302642,7,957
3929464797,3162947685,1661863529,1661864406,877,703
3597459911,3831009076,1654879643,1654879896,253,2115
3582046255,3153335208,1646495652,1646496458,806,398
3559696066,3562104036,1665926851,1665927390,539,446
3342190885,3172310061,1647441269,1647441502,233,1222
3831039944,3994130271,1666761956,1666762236,280,1944
3305480485,3930205120,1667171814,1667172123,309,321
3897739549,3522623156,1641027281,1641027780,499,1780
3583864167,3000890083,1658336658,1658337610,952,592
3311860866,3361482296,1645426332,1645426686,354,1136
3503842077,3730270448,1668787558,1668787826,268,2419
3487756836,3215402575,1647381400,1647382378,978,1230
3866922475,3241007838,1646432179,1646432548,369,1571
3393314546,3058846696,1664301753,1664302161,408,658
3810861883,3112856155,1647417089,1647417500,411,1427
3242406857,3960215733,1669397161,1669397362,201,1238
3413300274,3604769442,1663575323,1663575957,634,760
3084066396,3219292166,1657046516,1657047029,513,1174
3878876305,3315569726,1663828419,1663828968,549,597
3133788020,3359189419,1650233154,1650233313,159,109
3204963755,3313265862,1656217323,1656217719,396,1879
3283059949,3478101953,1669156375,1669157017,642,1683
3672699331,3339962549,1652318109,1652318217,108,301
3599604382,3748061416,1664405885,1664406700,815,2121
3284832227,3835202206,1656598453,1656598459,6,1943
3959504618,3414224162,1649941288,1649941779,491,2420
3545544203,3306753571,1641659936,1641660056,120,1675
3845980646,3474315750,1663754477,1663754572,95,39
3009177873,3001480546,1653626060,1653626680,620,2333
3059022884,3901086549,1651736216,1651736409,193,602
3297681098,3872493238,1663331462,1663331929,467,491
3807922855,3917373940,1642220785,1642221336,551,1803
3483553551,3980841914,1655054496,1655054931,435,588
3569557301,3849977339,1660093212,1660093576,364,1491
3870458690,3020108220,1657491931,1657492108,177,677
3994651874,3106630738,1668025036,1668025344,308,1266
3272811357,3268570857,1644909348,1644910333,985,319
3371745136,3242235161,1649070945,1649071587,642,2090
3499481051,3360436723,1648925796,1648926479,683,395
3830015015,3730368703,1655255661,1655256415,754,1161
3931108765,3728631423,1645654973,1645655018,45,285
3996978717,3345733128,1658525048,1658525097,49,14
3795269127,3910846571,1652349017,1652349099,82,42
3710943716,3018651462,1657985270,1657985392,122,1581
3614179985,3310715907,1663212169,1663213029,860,2080
3313687025,3189435516,1657935696,1657935744,48,1532
3711701083,3528278695,1649381738,1649381826,88,2103
3990949387,3254592040,1650464897,1650465554,657,1221
3890638606,3043310672,1667236136,1667236231,95,746
3609601814,3958507300,1650939087,1650939251,164,1149
3211641180,3290794282,1652003062,1652003397,335,125
3147047674,3321202962,1654339215,1654340030,815,1461
3439221238,3253059691,1663590427,1663591250,823,950
3971926686,3789999187,1648768767,1648769324,557,1553
3794251958,3837157118,1661339228,1661340003,775,2316
3645484554,3115344578,1651795924,1651796898,974,836
3942520090,3224095644,1645531716,1645531951,235,184
3833572466,3463734539,1645122127,1645122982,855,85
3416521015,3368987950,1668130522,1668130597,75,1043
3707403309,3405373154,1653865146,1653865260,114,1418
3545067538,3594795944,1661482652,1661483418,766,1896
3952185527,3174499556,1663619793,1663620628,835,2297
3154553765,3508858140,1655552789,1655553392,603,1243
3880353584,3260174905,1662780940,1662781844,904,181
3393712145,3889967886,1657897100,1657898026,926,1364
3741494242,3782266785,1662680608,1662681156,548,1739
3137967669,3158834421,1658440340,1658440554,214,1355
3909309427,3205162065,1656707984,1656708129,145,1135
3826530948,3071023164,1656841956,1656842782,826,1664
3398814666,3903947013,1652932725,1652933567,842,1619
3518246885,3935379393,1658754294,1658755243,949,2185
3875118670,3819415032,1653695728,1653696617,889,744
3982538753,3406868680,1667917816,1667918354,538,2114
3738624659,3561572123,1643202670,1643203212,542,1472
3431595099,3278827891,1659440748,1659441690,942,1411
3097457183,3666072303,1645610774,1645611118,344,1658
3610480358,3598223917,1660224714,1660225568,854,275
3820225206,3437593879,1666520684,1666521221,537,1903
3561062307,3792012199,1648715296,1648716000,704,1628
3366896849,3265571367,1651803807,1651804557,750,1453
3695419353,3413056504,1666571225,1666571267,42,828
3530491537,3670550887,1664780662,1664781234,572,1739
3467215587,3976757440,1657596180,1657596263,83,1933
3471085694,3664273227,1641572840,1641573695,855,766
3896091695,3197693984,1666074640,1666074809,169,991
3549671217,3670267009,1655092992,1655093782,790,1171
3325735696,3220424979,1662603136,1662603871,735,2033
3248096339,3496470143,1667040605,1667041492,887,418
3665557228,3165492854,1642450572,1642451282,710,990
3473525108,3264345880,1664964259,1664964713,454,568
3046618211,3451749535,1647033130,1647034061,931,1098
3550820934,3106705860,1667836413,1667836588,175,2451
3909173527,3678624517,1667211425,1667212387,962,353
3481620613,3786840082,1654428304,1654429195,891,1995
3452219424,3639035607,1651663415,1651664375,960,1530
3185611253,3190544941,1650807803,1650807819,16,1651
3344957789,3363279084,1664033101,1664033725,624,2466
3389812297,3049247811,1668482952,1668483021,69,1487
3915315003,3939477257,1657891226,1657892003,777,172
3175295329,3880439495,1645892053,1645892365,312,2235
3224128562,3066750826,1651844365,1651844557,192,2376
3620985435,3044483301,1662408889,1662409527,638,232
3701214753,3536219260,1652063049,1652063365,316,1217
3311871585,3065482463,1663238849,1663239342,493,2341
3479359145,3498707377,1646613531,1646614468,937,1674
3952107057,3866414868,1653397686,1653398301,615,2039
3176252124,3113423573,1667669580,1667669832,252,1739
3510318605,3988539489,1666479795,1666480004,209,1527
3892142252,3644531526,1655180864,1655181272,408,1178
3439129317,3873554599,1667769526,1667770092,566,204
3486793392,3868440818,1665042648,1665042867,219,84
3800239896,3573975780,1665242876,1665243192,316,1767
3351218513,3640756400,1665878985,1665879476,491,609
3512935575,3451285207,1663368166,1663368744,578,1363
3617757019,3449352254,1642753613,1642753648,35,2000
3890448806,3693102953,1659886899,1659887052,153,1464
3688790539,3594853846,1651221661,1651222504,843,1855
3642498039,3612973191,1642197254,1642197882,628,320
3842677051,3798833025,1665702141,1665702627,486,1973
3722578408,3351786927,1644744375,1644744837,462,789
3910029798,3081057659,1660054053,1660054523,470,1171
3724455974,3632101943,1647222855,1647222990,135,1128
3939768853,3660468597,1654021161,1654021313,152,513
3523305140,3905969199,1667739066,1667739390,324,1356
3153831709,3322083266,1643254667,1643255250,583,1079
3505197900,3623974243,1658028231,1658028607,376,56
3267968478,3414898500,1650153534,1650153556,22,577
3610782760,3100239217,1644254811,1644254975,164,1644
3666579485,3266828046,1641304078,1641304445,367,192
3832265812,3658910038,1654955419,1654956255,836,1233
3445023517,3933845116,1664708266,1664708794,528,631
3945358150,3662023903,1650939805,1650939949,144,211
3443384698,3268225181,1660453417,1660453479,62,219
3892686083,3234064099,1648712503,1648713016,513,1875
3971588399,3439303987,1660440531,1660440558,27,2015
3073474496,3065350513,1661325303,1661326262,959,802
3390416640,3928685907,1641225089,1641225106,17,2057
3457390239,3959504618,1652897255,1652897474,219,989
3643276679,3389560959,1666149380,1666149757,377,1834
3214698363,3533172784,1668203700,1668203950,250,1882
3298879351,3298857826,1647749138,1647750030,892,882
3621969167,3475897333,1649670781,1649671486,705,1246
3643276679,3332797032,1667052808,1667052902,94,1692
3302455172,3419117613,1647976344,1647977316,972,1971
3714203425,3008609242,1654898522,1654898918,396,866
3763453899,3293504206,1650240822,1650241019,197,2496
3262379384,3267650986,1665784511,1665785125,614,1625
3578655079,3739320901,1654287616,1654288216,600,1787
3582033850,3409055122,1643264876,1643265864,988,1972
3968297784,3945905688,1641312656,1641312814,158,415
3841170833,3663871563,1665211086,1665211275,189,191
3704568536,3949841652,1665899499,1665899499,0,1902
3174705393,3887108152,1660771030,1660771794,764,1266
3113760926,3653429754,1661951845,1661952679,834,1674
3329751201,3043153412,1668665113,1668666004,891,1791
3176317370,3766186320,1654533678,1654534105,427,1910
3961420550,3820885067,1656875569,1656875656,87,1564
3075465136,3267151775,1641871366,1641871918,552,1328
3090804084,3697650296,1663702951,1663703381,430,953
3143689256,3835601308,1667492682,1667492791,109,2446
3469648387,3328589697,1644546816,1644547153,337,993
3143741876,3190035679,1651569974,1651570078,104,874
3880139481,3022256617,1651624207,1651625176,969,973
3993572792,3576100130,1669401297,1669402102,805,299
3976346769,3053693777,1658801862,1658802538,676,62
3561336684,3191414403,1669316625,1669317000,375,1809
3816921514,3516547882,1652282948,1652283225,277,1151
3153989234,3412109130,1651864824,1651865790,966,2328
3421772590,3595049641,1649229074,1649229386,312,394
3039198774,3568404894,1669123110,1669123600,490,89
3355910238,3263239497,1647733401,1647733418,17,357
3201276259,3343260379,1643577449,1643578380,931,1745
3270395343,3329190028,1659043862,1659044213,351,2497
3344143432,3680453323,1661984493,1661985194,701,564
3990037235,3369469616,1665486524,1665487486,962,2437
3317318302,3522444883,1646996551,1646996928,377,1721
3311015405,3271278790,1654673253,1654673470,217,165
3026293367,3438188875,1658068407,1658069017,610,382
3239020709,3740090157,1653992905,1653993370,465,1465
3219435736,3519269683,1649825756,1649826131,375,355
3346012606,3558848518,1660181131,1660181877,746,1863
3015715378,3485526833,1659630892,1659631021,129,1603
3781580109,3578075354,1663707420,1663707557,137,420
3277372807,3804773972,1653883658,1653884327,669,718
3545188902,3918812791,1667358830,1667359222,392,1247
3480424657,3605706184,1667358317,1667358402,85,567
3005809519,3450893865,1643309342,1643310248,906,1429
3507338655,3540550798,1663136103,1663136252,149,2169
3037984793,3154553765,1646676248,1646676434,186,1063
3250108907,3693581710,1661431432,1661431807,375,956
3110482626,3862122399,1645319556,1645320461,905,1783
3705601482,3039035602,1659030987,1659031425,438,45
3806936803,3841459327,1651860695,1651861576,881,874
3087700946,3210337290,1664726181,1664726236,55,1269
3171731237,3744737373,1645507729,1645508686,957,1005
3189435516,3952654862,1664966027,1664967019,992,319
3651847351,3228574805,1653007152,1653007695,543,801
3963303057,3692904228,1652893344,1652893412,68,1158
3672524498,3604757184,1652455902,1652456293,391,1691
3770061469,3522623156,1664240999,1664241387,388,1111
3340125949,3537151295,1667599701,1667600574,873,495
3179280029,3072276713,1666630518,1666630688,170,693
3006388757,3488280503,1653526894,1653527709,815,1272
3925496970,3714535860,1662988733,1662988875,142,6
3123815439,3343249545,1643898494,1643898508,14,2218
3398865388,3746969288,1660395226,1660396157,931,2211
3880580622,3832144696,1668072553,1668072893,340,655
3608512295,3747046698,1649555015,1649555632,617,250
3546954605,3798447157,1653054471,1653054631,160,2309
3985620157,3205988899,1649918353,1649919127,774,1133
3604755020,3270923168,1663419463,1663420160,697,531
3070588700,3640571571,1660745262,1660745412,150,303
3402543059,3742012582,1652631408,1652631424,16,540
3761584126,3325735696,1648713642,1648713651,9,1626
3331554085,3546866871,1661618102,1661618588,486,533
3364586923,3825971737,1652309673,1652310192,519,2307
3388159268,3271278790,1662797628,1662797925,297,1823
3946614568,3499541432,1665361902,1665362157,255,1226
3088132769,3302992244,1645297758,1645298201,443,2291
3137594486,3017559077,1652874685,1652875549,864,595
3233920789,3906903088,1656238851,1656239392,541,1425
3428763205,3720475877,1667692077,1667692436,359,2293
3898012654,3102526783,1654504538,1654505481,943,398
3758695244,3641618845,1664610653,1664611204,551,346
3424884440,3878177076,1666330429,1666331330,901,1788
3987979637,3164410972,1658452187,1658453030,843,859
3163202728,3742145726,1668862919,1668863339,420,2380
3587727278,3933607460,1651817983,1651818112,129,131
3284159385,3886709661,1645783748,1645784541,793,1975
3271885744,3400684585,1643365958,1643366711,753,1492
3537138552,3934199220,1662363921,1662364769,848,1167
3069523420,3453511353,1643721838,1643722318,480,579
3457468984,3654899608,1653917301,1653917892,591,2291
3239377872,3276771725,1654642260,1654643217,957,453
3034040451,3667528236,1663219942,1663220556,614,306
3678425549,3052438592,1669694014,1669694084,70,1583
3720475877,3480115115,1660981114,1660981529,415,1008
3813511439,3278827891,1644756575,1644757403,828,1585
3769767823,3975504102,1653308574,1653309185,611,1434
3914926954,3211839563,1643391548,1643392093,545,75
3958733956,3256807270,1662101429,1662102354,925,50
3378613925,3376552382,1658663554,1658663729,175,1893
3035838196,3315854812,1644051669,1644051952,283,2201
3188717499,3119702215,1653196658,1653196663,5,153
3231517158,3057201124,1647578555,1647578631,76,344
3970886019,3105679045,1663890827,1663891719,892,1460
3300015174,3744788361,1650626481,1650627142,661,957
3682608460,3689518345,1664135812,1664136275,463,363
3817548425,3546284533,1644386208,1644387100,892,2398
3556848299,3333543321,1661631888,1661632422,534,1034
3511397819,3782741533,1646388486,1646389216,730,1791
3678152024,3936292699,1663330500,1663331202,702,1751
3314901091,3710786724,1645584070,1645584155,85,1987
3227246451,3859976372,1646938475,1646938665,190,1177
3173034893,3082108681,1648954890,1648954942,52,1837
3955219063,3253589940,1645865871,1645866157,286,343
3630330540,3254496907,1663112314,1663113312,998,1907
3086653619,3885026939,1660513634,1660514633,999,1066
3458645622,3476728930,1666333415,1666333610,195,168
3222563704,3977043818,1663540458,1663540472,14,668
3477522732,3637518238,1659963692,1659963942,250,1642
3542827244,3515044837,1649910686,1649911158,472,1760
3150582711,3980087695,1666314929,1666315000,71,266
3744563835,3118425000,1651741516,1651741755,239,1583
3284284605,3021683395,1656796032,1656796380,348,922
3578002057,3864143186,1654361507,1654362129,622,308
3527269010,3464330947,1646476360,1646477192,832,246
3523654557,3066990756,1666824388,1666824689,301,948
3462412055,3460678842,1663270670,1663270981,311,2006
3037984793,3946409673,1650921847,1650922375,528,1448
3199563620,3526365568,1645941493,1645941554,61,1458
3091008161,3036448305,1662919549,1662919659,110,871
3636132038,3995850572,1645185316,1645186295,979,1154
3586776572,3908893546,1642343911,1642344559,648,318
3855261620,3442408044,1662835476,1662835561,85,1466
3298770258,3748061416,1660307596,1660307996,400,1214
3858150562,3984215552,1666006393,1666006666,273,645
3617746688,3741413739,1664275152,1664275856,704,2354
3908312889,3949133704,1660594810,1660594917,107,257
3734331528,3646687421,1659456579,1659457374,795,685
3981210682,3415124478,1650092389,1650092575,186,1678
3077238667,3880439495,1647358314,1647358386,72,205
3958050741,3282839568,1661686009,1661686558,549,998
3912916652,3098276544,1654084900,1654085774,874,1445
3818508802,3716461226,1641715681,1641716172,491,2187
3112615469,3086273441,1650891849,1650892752,903,875
3274208430,3548511640,1642377418,1642377830,412,1802
3324611610,3005809519,1645254083,1645254905,822,1591
3231988469,3398865388,1645107626,1645107977,351,1595
3993814137,3767912489,1643458908,1643459072,164,1433
3185611253,3822126164,1659844336,1659844555,219,1351
3776685300,3638233110,1665470772,1665471254,482,425
3191398794,3172305265,1666126240,1666126636,396,1901
3648257100,3000383745,1655393609,1655394588,979,937
3081369661,3129034897,1647725776,1647726204,428,50
3367915131,3417298701,1642391188,1642391942,754,2268
3183507473,3394220993,1651585940,1651586223,283,2051
3203691315,3201479561,1643689141,1643689267,126,1298
3927284839,3505196729,1663389361,1663389989,628,796
3473399101,3480308437,1655881552,1655881770,218,1288
3946409673,3336991621,1654142275,1654143160,885,256
3784808734,3276341369,1660570618,1660571582,964,376
3755085868,3308256167,1643769027,1643769819,792,497
3381900638,3634624974,1655199758,1655200517,759,1641
3502554871,3210078490,1650671132,1650671453,321,1264
3087123320,3202460554,1653443486,1653444033,547,1387
3651421358,3805826972,1648622576,1648622686,110,1404
3842844573,3591088164,1661294681,1661295665,984,456
3199411589,3830975217,1653925915,1653926563,648,214
3421730413,3990379463,1651157523,1651158321,798,55
3563738755,3470446722,1656295634,1656296438,804,1150
3352729606,3674335911,1651737121,1651737729,608,1022
3320841904,3695411154,1669200192,1669200669,477,814
3776685300,3669018473,1649230518,1649230599,81,1844
3587633750,3310037244,1667696560,1667697240,680,2296
3278980230,3464235741,1641342735,1641343156,421,494
3776939860,3346261120,1654066995,1654067270,275,811
3183740417,3771588829,1645295498,1645296365,867,1599
3244969283,3658099781,1641756658,1641757333,675,280
3284628242,3967015655,1653252293,1653252825,532,983
3035245517,3652304615,1667765833,1667766537,704,1103
3318577605,3925344243,1667566468,1667566509,41,26
3066426534,3339611423,1641736374,1641736907,533,2061
3553471050,3363097423,1654937955,1654938013,58,1082
3336376139,3055918856,1647493248,1647494046,798,1604
3997397652,3079013365,1667211795,1667212742,947,1426
3135556195,3037301537,1647196881,1647197717,836,160
3353956873,3038644033,1665626590,1665627179,589,76
3834011879,3468703620,1659778875,1659779560,685,1316
3145669202,3106732056,1642925998,1642926624,626,2228
3152555864,3587440298,1641913210,1641913262,52,1768
3023254734,3468703620,1644660895,1644661075,180,1550
3252973419,3329848036,1660045744,1660045935,191,1971
3608843912,3695411154,1659695193,1659695386,193,1492
3473394094,3973226891,1652500599,1652500818,219,846
3622978712,3460687455,1663971942,1663972189,247,822
3687215472,3521217476,1644908876,1644909373,497,1886
3795609815,3643615690,1656902162,1656902404,242,2270
3490430582,3442330693,1669307619,1669308059,440,1294
3635854686,3086444841,1644003913,1644004076,163,898
3927657297,3432364009,1658807214,1658807869,655,1186
3332797032,3059447105,1658274640,1658274888,248,221
3903588940,3225857817,1645049816,1645050087,271,553
3276341369,3634871077,1663571551,1663572533,982,1326
3914601322,3382943055,1662102960,1662103315,355,794
3090588645,3451370887,1644740040,1644740098,58,2035
3653757569,3375290121,1657455773,1657456377,604,383
3492629459,3363944559,1653905864,1653906152,288,1982
3096386556,3223313152,1642691417,1642691953,536,38
3604881190,3156210736,1656469015,1656469625,610,2459
3652480299,3183165788,1666893343,1666893810,467,1181
3447257561,3271201418,1644242885,1644243694,809,1408
3494498890,3431000503,1663289267,1663290011,744,2407
3455209070,3037844343,1644978328,1644979002,674,1901
3769868188,3102526783,1657594128,1657594563,435,1433
3344285047,3105903246,1658356677,1658357187,510,202
3834152797,3630318253,1660501121,1660501489,368,451
3531642816,3714105777,1659987312,1659987604,292,18
3817000379,3833679984,1645371124,1645371608,484,1314
3191970772,3690350377,1653947075,1653947930,855,2244
3218686367,3783325820,1663466302,1663466892,590,1162
3642771281,3851540721,1645411551,1645412169,618,405
3118554894,3737809844,1648789570,1648789993,423,1871
3116751960,3138539283,1655795179,1655795474,295,373
3475846394,3551884757,1648516748,1648517040,292,2141
3880290667,3023980378,1642143197,1642143197,0,572
3564592902,3406509436,1650228392,1650228970,578,1791
3045302814,3704437148,1659646851,1659647823,972,1864
3426565803,3885719823,1657801629,1657801643,14,1938
3298505096,3025581381,1667688816,1667689422,606,73
3766196716,3701370209,1648652942,1648653241,299,1336
3973401658,3827851972,1646974865,1646974990,125,1790
3834152797,3434182192,1660837170,1660837200,30,2029
3829874150,3185977048,1655558332,1655558360,28,1854
3209748014,3416076001,1641621880,1641621935,55,807
3883812439,3927666827,1656656855,1656657463,608,2023
3496617169,3372334548,1666997426,1666997934,508,265
3560015501,3294446147,1653390607,1653390631,24,104
3133655192,3807924634,1641609008,1641609018,10,1019
3393156673,3871509767,1666959022,1666959221,199,164
3791302710,3194712532,1659427579,1659427629,50,1375
3607580736,3045070182,1656607192,1656608124,932,604
3198338148,3034325039,1646449263,1646449788,525,2195
3368734939,3109284478,1647192414,1647192506,92,239
3265895976,3689231617,1665311144,1665311904,760,1307
3410513846,3238081511,1665736528,1665737403,875,397
3846477373,3103627338,1665196042,1665196852,810,329
3952107057,3807887781,1665293160,1665293528,368,912
3528505546,3645868952,1661068014,1661068213,199,32
3289630313,3284943687,1660281176,1660281670,494,1364
3544133682,3128318593,1665983185,1665983947,762,2407
3970444667,3648593799,1666348288,1666348290,2,213
3987162833,3272623699,1669459409,1669460289,880,504
3604435641,3009688248,1652182113,1652182380,267,1755
3175118084,3833618667,1641663808,1641664249,441,2305
3657251975,3968076690,1659495122,1659495316,194,2452
3452920322,3089962675,1659107042,1659107684,642,2447
3018612279,3166284447,1661701114,1661701335,221,1023
3293615945,3876829785,1647106976,1647107453,477,2290
3408048729,3061366261,1653843960,1653844764,804,1534
3636879699,3791419861,1641134915,1641134998,83,178
3900911220,3561562385,1665160559,1665161221,662,1781
3215453691,3514498367,1664516323,1664517317,994,654
3907635993,3328024680,1650929385,1650929531,146,137
3399479391,3439905167,1646232853,1646233401,548,1628
3710756423,3852731262,1642634432,1642634568,136,1860
3045127324,3955219063,1665548606,1665549266,660,1077
3450689808,3808415962,1647142810,1647143452,642,2386
3615362859,3133655192,1641064747,1641064897,150,2322
3988957478,3292507015,1662078906,1662079906,1000,1827
3871137970,3677300151,1662454480,1662454780,300,1
3350017208,3426433476,1659232988,1659233667,679,1736
3090910630,3416719967,1654741413,1654742031,618,941
3927329503,3799624292,1644602600,1644603130,530,483
3328544337,3439827305,1644548025,1644548063,38,795
3057201124,3034919553,1642668494,1642668626,132,97
3793298032,3415185806,1650286959,1650287451,492,1046
3667258476,3861717658,1648929983,1648930233,250,2303
3235586138,3791633858,1645630775,1645631109,334,1188
3624294521,3621726953,1662225111,1662225307,196,930
3771788181,3537107415,1656613694,1656613877,183,111
3835701186,3443455036,1669266455,1669267203,748,553
3158209281,3321312190,1643201911,1643201958,47,261
3210337290,3443297756,1643951318,1643952218,900,1512
3973948700,3051642574,1658096883,1658096897,14,965
3016482005,3721226798,1641486970,1641487782,812,2163
3773830646,3361167735,1665315828,1665315974,146,481
3156942626,3909168020,1654443800,1654444344,544,288
3163921304,3981657344,1662952137,1662953102,965,2475
3744575844,3244514632,1665027292,1665027967,675,690
3384255827,3154680228,1661175019,1661175766,747,560
3473525108,3782266220,1666218471,1666219316,845,551
3812481438,3328245802,1641793994,1641794957,963,1828
3115343467,3612642563,1657448720,1657448743,23,1266
3904874839,3148256129,1661858254,1661858589,335,654
3187779586,3637993177,1668308771,1668309016,245,968
3217494787,3069313994,1641429255,1641429382,127,40
3301471485,3126417218,1659882510,1659883379,869,1120
3965000413,3220690215,1664315406,1664315442,36,135
3772340083,3956194935,1649384855,1649385277,422,1254
3108805085,3133655192,1648760556,1648760759,203,2176
3470102638,3573583612,1652743783,1652744353,570,135
3599604382,3640957872,1655820197,1655820213,16,361
3165845148,3837481005,1642050740,1642051272,532,601
3160061122,3872626198,1665566584,1665567373,789,1946
3266121254,3787817814,1651279991,1651280407,416,867
3423782681,3248900308,1657352114,1657352590,476,2212
3926815435,3217857851,1656953192,1656953616,424,901
3993994586,3670387440,1646635725,1646636272,547,1879
3741907389,3738981251,1668759099,1668759742,643,288
3067539427,3931294653,1646353322,1646353532,210,1859
3073474496,3102992210,1641127531,1641127685,154,1701
3995299995,3207210781,1667313598,1667313790,192,322
3898229065,3549752945,1643298614,1643298900,286,331
3029578425,3994844749,1641196690,1641196926,236,1752
3976405875,3847638658,1649775186,1649775710,524,2261
3596247005,3823650698,1645082557,1645083026,469,694
3113760926,3493447321,1642303286,1642304006,720,1744
3868936645,3013064040,1660282544,1660283348,804,128
3406332128,3744293001,1658263522,1658264513,991,332
3445226012,3689231617,1644937397,1644937495,98,1778
3315544584,3364855872,1662498259,1662498717,458,1210
3011690678,3761636372,1646003536,1646003707,171,292
3905744284,3442447509,1659412773,1659413144,371,1324
3986016860,3790402339,1653653934,1653654534,600,1112
3269629374,3506345760,1642916458,1642916561,103,253
3301708925,3447051833,1644598100,1644598225,125,765
3016616906,3384200089,1657600658,1657601179,521,2466
3062704523,3949841652,1667320383,1667321312,929,132
3942273552,3546782886,1646210277,1646210667,390,720
3755473771,3704437148,1660878308,1660878833,525,1856
3658782272,3402349073,1664917771,1664918431,660,1322
3963787394,3601562567,1655727611,1655727955,344,743
3806629780,3286555567,1665365394,1665366201,807,272
3522444883,3870320323,1647795656,1647796091,435,1939
3136707992,3198999623,1658542783,1658543591,808,2208
3493040979,3478362234,1648493960,1648494292,332,2137
3050817805,3014462663,1651165442,1651165789,347,2120
3382396122,3806520351,1669102827,1669103070,243,63
3047001138,3565052722,1652246983,1652246994,11,498
3545032372,3586776572,1653123004,1653123892,888,378
3620303845,3420733881,1665051359,1665051920,561,1861
3081803809,3006738164,1648305288,1648305921,633,1913
3575576911,3995428703,1644005222,1644005837,615,1609
3994651874,3973401658,1647619266,1647620014,748,1496
3993923271,3653335612,1647306189,1647306959,770,1068
3411708498,3646286885,1645407748,1645408193,445,1506
3291780380,3537294800,1659765920,1659766584,664,1661
3922066704,3512215996,1664188767,1664189628,861,817
3241021396,3057159511,1659772171,1659772241,70,1167
3057756725,3475352970,1650673695,1650674650,955,914
3581207584,3276666399,1644688435,1644688819,384,1184
3984050382,3403389913,1658492550,1658493531,981,1066
3396154732,3514458890,1645303207,1645303533,326,124
3744726408,3569578952,1644403283,1644403598,315,310
3202225412,3161243271,1660678142,1660678355,213,48
3259430206,3226298244,1663443851,1663444393,542,603
3653218860,3255149739,1646744536,1646745163,627,2313
3804478597,3789727449,1667936159,1667936748,589,372
3340933137,3882254802,1650225743,1650225872,129,1407
3832370690,3917067097,1648560840,1648561230,390,427
3813697780,3906065558,1664741768,1664742666,898,1288
3495420849,3570747542,1660114441,1660114668,227,1507
3981817077,3944476586,1666696225,1666696317,92,1032
3363279084,3113427537,1656707321,1656707764,443,799
3150067482,3039198774,1645151094,1645151456,362,683
3879766152,3925365269,1668396128,1668396645,517,782
3876344592,3498685499,1658574812,1658575200,388,86
3504911583,3110639083,1668956557,1668957408,851,2011
3364661787,3577990920,1657920596,1657921186,590,2424
3366845170,3435224460,1664030855,1664031411,556,1735
3098342545,3772910484,1649947376,1649947935,559,2253
3298879351,3464595898,1645922984,1645923453,469,1746
3446952845,3098165935,1641484280,1641485032,752,1215
3261447619,3683739941,1651912543,1651913093,550,997
3327253070,3974065082,1643578237,1643579206,969,803
3795326002,3254496907,1647116873,1647117621,748,2273
3702439685,3723784545,1666545691,1666545938,247,2170
3324041559,3501568597,1648763400,1648763698,298,2183
3134117241,3864930473,1661049927,1661050399,472,695
3787714854,3551884757,1645140852,1645141634,782,1556
3058951367,3358959910,1653368249,1653368784,535,2144
3128248749,3237697952,1646172761,1646173375,614,555
3359296227,3574773588,1641771555,1641772080,525,1127
3239575265,3833594316,1656625006,1656625878,872,1934
3626824650,3646596750,1646493716,1646494498,782,518
3288496623,3382133724,1659190533,1659191083,550,138
3908153195,3742012582,1659075321,1659076070,749,1493
3547429967,3335355155,1663187695,1663188057,362,2269
3843917747,3414898500,1663076639,1663077060,421,52
3522549719,3070241461,1649835080,1649836077,997,936
3333103680,3848866443,1664739945,1664740832,887,2342
3335355155,3042836639,1660935269,1660936144,875,2229
3340125949,3343855888,1642039453,1642040444,991,1213
3793032912,3632284739,1647219835,1647220097,262,1339
3239792198,3354999072,1654239958,1654239994,36,1509
3451227417,3460572652,1657856650,1657856963,313,1830
3091108616,3473355243,1661262892,1661263876,984,2240
3731399462,3197660189,1661067561,1661067880,319,957
3034601276,3159950284,1649879583,1649880129,546,1663
3481149583,3196975901,1659423537,1659424237,700,361
3592471391,3840953967,1642944978,1642945832,854,267
3907872554,3454851350,1661155217,1661155413,196,836
3732795074,3473355243,1646584823,1646585754,931,64
3243018622,3241341174,1648932540,1648932912,372,1284
3056726479,3083388257,1664066646,1664067568,922,1863
3308015697,3604376955,1644157278,1644158175,897,1565
3563343479,3218964640,1667395551,1667396168,617,2123
3162947685,3345733128,1644570403,1644571362,959,1611
3241500636,3486059916,1646426045,1646426916,871,2040
3703548595,3641460659,1666029481,1666030300,819,1154
3979558738,3364247623,1659947561,1659947725,164,1523
3501508123,3681993008,1657151023,1657151722,699,1941
3451307942,3988539489,1663588322,1663588360,38,1123
3524482926,3142101976,1657183230,1657183923,693,1906
3598576303,3215443177,1656231934,1656232872,938,2430
3158291556,3194204306,1661268374,1661268980,606,0
3123522446,3308256167,1647160894,1647161813,919,939
3128532251,3923692475,1657777874,1657778220,346,1495
3902739418,3757518149,1646373353,1646374005,652,613
3378221943,3058064037,1655522184,1655522399,215,2187
3730684727,3960633649,1652761504,1652761547,43,562
3084882941,3403471618,1651289152,1651290068,916,861
3254174311,3835784338,1653662189,1653662476,287,1666
3093599187,3353422891,1666968452,1666968919,467,2332
3172524712,3649252503,1652906219,1652907095,876,132
3280046501,3866431229,1661686279,1661687158,879,1449
3860422016,3654861844,1650244166,1650244321,155,2269
3810320285,3204081712,1662707825,1662708799,974,277
3661369487,3748988849,1649452526,1649453155,629,2151
3105558193,3696716300,1656529784,1656530393,609,298
3950433378,3112615469,1664404993,1664405174,181,22
3799287196,3215443177,1659840862,1659841269,407,2029
3940310287,3736911154,1665461697,1665462253,556,2267
3657340310,3010819705,1650345940,1650346855,915,387
3311871585,3033349787,1662964901,1662965016,115,471
3105630699,3583859826,1659031857,1659032632,775,119
3549635553,3309767670,1647661918,1647662886,968,2484
3404200137,3085136451,1656671753,1656672097,344,2327
3915315003,3692772256,1667876860,1667877698,838,814
3660732427,3245247493,1653153903,1653154173,270,1713
3823288349,3216665855,1661104367,1661105320,953,1795
3759967696,3128805218,1643920412,1643920977,565,151
3522861132,3941986034,1641309577,1641310177,600,899
3480308437,3400542216,1641294214,1641294811,597,1176
3531859919,3090441115,1646047650,1646047980,330,1822
3469740343,3939098308,1655172300,1655172832,532,93
3903709933,3554977739,1642934910,1642935597,687,954
3673524018,3315759953,1642317353,1642317536,183,188
3150582711,3114812192,1645543177,1645543931,754,475
3841170833,3269690639,1642900766,1642901275,509,1889
3837904800,3785256634,1669494788,1669495396,608,597
3361529884,3868701805,1663449236,1663449237,1,1935
3244398882,3334207071,1643979051,1643979774,723,707
3639376136,3745289284,1660837502,1660837637,135,1418
3834166808,3367510444,1660607099,1660607737,638,1999
3189038779,3563840007,1644347896,1644348236,340,1165
3667258476,3406332128,1656790533,1656791344,811,427
3987431029,3658659669,1641615933,1641616365,432,2248
3012339110,3641542734,1660400421,1660400811,390,778
3493752989,3109465057,1663384674,1663384726,52,207
3589366986,3273059265,1663303499,1663303553,54,184
3937197371,3760224151,1649351588,1649351857,269,1779
3125314664,3556803718,1646772948,1646773575,627,2324
3411993487,3271864656,1666601828,1666602658,830,1488
3875008839,3308028752,1652127625,1652128184,559,637
3458815526,3791389559,1655429354,1655430331,977,1788
3890580849,3723780339,1659041584,1659042160,576,1889
3569573616,3719744431,1660043527,1660044056,529,1501
3645585393,3262379384,1651582243,1651582732,489,720
3617757019,3612612273,1647472005,1647472369,364,351
3585553252,3141688992,1657493460,1657493592,132,2210
3992924141,3577530061,1657126619,1657126657,38,215
3264079501,3620787716,1654521757,1654522472,715,1288
3070054244,3407156969,1645135005,1645135061,56,1400
3290844621,3335462055,1665131894,1665131926,32,2028
3351218513,3918491301,1657431706,1657432335,629,1397
3403911906,3178749877,1655836213,1655836814,601,1592
3148763328,3306619417,1660136126,1660136193,67,897
3258050916,3470286872,1655882295,1655882527,232,553
3398795724,3439660528,1660518829,1660519065,236,430
3917067097,3402543059,1668028715,1668028834,119,803
3963370859,3098108231,1651957250,1651958115,865,726
3838136289,3156962564,1654326438,1654327311,873,2307
3694349997,3180051747,1668491343,1668491902,559,638
3352376449,3346254669,1656038204,1656038644,440,582
3909558934,3232342525,1662925640,1662925687,47,1106
3221031593,3481672220,1659378169,1659378899,730,1529
3168576951,3878695242,1652328673,1652329022,349,164
3471221302,3599694754,1656252876,1656252960,84,988
3233938614,3159240548,1653339711,1653339759,48,1742
3851747907,3950047958,1649823619,1649824078,459,836
3205864966,3477363517,1659185151,1659185603,452,1120
3624748073,3385246088,1657802792,1657803078,286,856
3677300151,3553328177,1651115242,1651115872,630,1385
3028364856,3707892765,1664640128,1664640462,334,1107
3045427279,3455808094,1653148592,1653149540,948,2014
3404934353,3222563704,1650060606,1650061323,717,999
3595469152,3211003582,1662330337,1662330629,292,2034
3890638606,3220405755,1641192403,1641192550,147,1616
3314495556,3760972512,1664056551,1664057132,581,1921
3664381582,3593553797,1660637023,1660637444,421,1510
3054606477,3845338893,1661622827,1661623227,400,498
3275649997,3077683954,1650018904,1650019370,466,137
3340331761,3463405011,1652474041,1652474717,676,1060
3065434950,3379296882,1651163075,1651163510,435,717
3570423127,3481689842,1657869897,1657870264,367,2314
3632155506,3189300345,1665049589,1665050103,514,657
3323797477,3470488588,1646816683,1646817302,619,94
3181032246,3112217806,1647484473,1647484716,243,1637
3829986472,3132959520,1661239035,1661239914,879,680
3172018366,3159669419,1655057260,1655057596,336,828
3548028995,3829729960,1648263505,1648264260,755,1442
3596076085,3576317139,1663943959,1663944212,253,2033
3751022139,3549752945,1647406042,1647407026,984,1455
3288016190,3983162503,1646200903,1646201072,169,1715
3786322776,3916226073,1655451979,1655452432,453,716
3924607271,3560977513,1668863080,1668863555,475,2081
3124044009,3675703241,1668768315,1668768546,231,1929
3127565673,3154729703,1644171998,1644172552,554,465
3792253761,3924960579,1649299394,1649299862,468,1942
3604769442,3090441115,1653839838,1653840728,890,1381
3207013037,3720223108,1653666679,1653667456,777,1028
3467810757,3620223775,1656618234,1656619206,972,2493
3735691730,3310935085,1660440182,1660440347,165,1521
3518079213,3451771672,1644493188,1644493540,352,1197
3007911826,3730984573,1660467465,1660468212,747,1004
3631455637,3013814400,1665262376,1665262885,509,1566
3318466045,3050800748,1657979755,1657979879,124,1816
3050701199,3157308488,1659702156,1659702679,523,2325
3630318253,3877638741,1648649955,1648650884,929,1654
3588728644,3311113773,1646622303,1646622406,103,1053
3829084330,3150730013,1651138694,1651139067,373,580
3346860393,3958275419,1641103154,1641103196,42,1539
3657305306,3581470040,1660250141,1660250411,270,1924
3912106632,3768558350,1662834224,1662834568,344,1528
3854906546,3560967248,1644091653,1644092084,431,1476
3352759849,3127142463,1651671732,1651672673,941,2185
3935936621,3041155430,1658459698,1658459894,196,119
3377911201,3145039731,1643183564,1643183990,426,1015
3892848585,3545701656,1664730414,1664730836,422,699
3981019442,3686641761,1643070500,1643070694,194,363
3125911793,3481584783,1664061963,1664062949,986,1042
3852810875,3829209875,1659858542,1659859148,606,444
3353855658,3952889735,1644764785,1644765284,499,41
3457317780,3620700244,1669619454,1669619534,80,830
3188643066,3241549340,1658605747,1658606062,315,2072
3953444491,3216241275,1655394932,1655395189,257,438
3535631980,3833342718,1644566280,1644566636,356,1293
3549482615,3913984749,1648474562,1648475425,863,2370
3879322451,3561254848,1652201579,1652201857,278,910
3586128295,3162524259,1648283614,1648284218,604,1578
3941489594,3442330693,1665366939,1665367523,584,795
3763804073,3886917024,1646665969,1646666591,622,1648
3448459810,3447257561,1655461994,1655462725,731,1095
3619800237,3762856505,1646634055,1646634266,211,2225
3791547480,3112270906,1641880597,1641880614,17,2082
3307926705,3621969167,1668012035,1668012718,683,1315
3965164080,3906964033,1665481919,1665482873,954,644
3288261603,3553436680,1649235321,1649235940,619,765
3449114289,3066007042,1643807623,1643807825,202,1571
3412047712,3454276568,1660561424,1660561831,407,912
3515138485,3930909418,1651156488,1651157191,703,1624
3685049252,3550218169,1642831286,1642831546,260,1190
3563738755,3663871563,1667201142,1667201374,232,2325
3130134092,3000254515,1654371526,1654372159,633,358
3835601308,3420489464,1663474866,1663475255,389,1624
3381060534,3862456223,1667519748,1667519868,120,847
3720941666,3017407853,1657771883,1657772039,156,263
3099984232,3488551185,1642309566,1642309674,108,1408
3465064732,3682006274,1648324040,1648324684,644,58
3867101565,3649036884,1643675868,1643675976,108,668
3878876305,3936329512,1653444568,1653445090,522,258
3611025093,3728160519,1666929068,1666929465,397,2420
3557325531,3864249446,1644876259,1644876417,158,1832
3351802314,3932002704,1653567761,1653568343,582,2021
3248167631,3150582711,1645976755,1645977032,277,2179
3744759130,3050701199,1663265972,1663266962,990,1632
3583591867,3813690540,1643562631,1643562960,329,2395
3049307137,3674037967,1647860298,1647860797,499,995
3489466063,3623782659,1658905266,1658906216,950,1493
3724116295,3939973483,1668463808,1668464025,217,1393
3975075818,3208215579,1654191210,1654191749,539,1212
3408104715,3818508802,1645623292,1645623569,277,1111
3585042042,3921754282,1651335815,1651336010,195,2185
3643615690,3343941091,1652323253,1652324066,813,1842
3492727050,3021679982,1668133961,1668134770,809,522
3124723265,3320767438,1663238417,1663239184,767,2404
3071810518,3227368879,1654920698,1654921555,857,84
3828713812,3778575442,1660005701,1660006200,499,772
3614179985,3436199937,1642875728,1642875774,46,1464
3216092524,3507939773,1641876820,1641877316,496,585
3141134453,3983490056,1648879642,1648879761,119,2277
3670267009,3651421358,1664222495,1664222549,54,1687
3743569811,3350067994,1651007200,1651008064,864,1146
3979899306,3508718004,1648220315,1648220449,134,353
3050434345,3408108471,1661959107,1661960100,993,2130
3694591547,3070810251,1664221027,1664221731,704,1260
3470446722,3197545162,1668204363,1668204409,46,181
3962617141,3476903669,1647146575,1647147314,739,2002
3249512921,3250359001,1665057864,1665058065,201,1117
3460842972,3604762599,1663219817,1663220604,787,2387
3135951344,3434864548,1665743236,1665743265,29,17
3862583365,3642946322,1659607826,1659608078,252,1954
3261265769,3577718759,1668241298,1668242196,898,1417
3501568597,3047713943,1641160065,1641160771,706,1165
3282166903,3521302995,1658296361,1658297008,647,1113
3136564426,3324003851,1644859018,1644859688,670,190
3001509229,3976223971,1658465238,1658466116,878,1781
3054906475,3991859515,1655982217,1655982361,144,265
3357247840,3205988899,1666081786,1666082104,318,2227
3345543859,3722817789,1654297061,1654297780,719,396
3894844173,3206149175,1667545560,1667546412,852,1367
3780808964,3522103750,1653526298,1653527263,965,169
3795817960,3282168599,1650200358,1650201178,820,1590
3785721693,3815462032,1655882824,1655883823,999,2247
3426666423,3041386590,1656671801,1656672653,852,303
3305299292,3282587673,1664805171,1664805663,492,723
3995428703,3269680998,1647495475,1647496465,990,1672
3332914132,3960215733,1648158004,1648158087,83,2164
3939725219,3422106507,1644848632,1644849006,374,262
3191414403,3052499026,1653448005,1653448231,226,2307
3367510444,3903193601,1652874734,1652875084,350,1690
3438247915,3661705197,1649987015,1649987343,328,2315
3132863382,3665714575,1648514556,1648515233,677,1680
3548132533,3231899706,1657408837,1657409134,297,1993
3977539783,3372442199,1658413079,1658413593,514,2302
3933332705,3368387959,1665994262,1665994787,525,1873
3139126728,3905999483,1653549864,1653550588,724,357
3442081758,3313975664,1654863926,1654864699,773,11
3301994647,3929638122,1651718261,1651718740,479,744
3719929552,3645314586,1652198284,1652198462,178,775
3929794333,3241007838,1656247821,1656247895,74,828
3691607111,3424897066,1651383644,1651384005,361,1223
3007446724,3337738889,1665441694,1665442338,644,2158
3098083694,3934953223,1665904529,1665905504,975,1100
3244997486,3819405521,1669040089,1669041072,983,1315
3106804099,3266498789,1656105372,1656106334,962,800
3415124478,3431909978,1665678370,1665679048,678,2218
3280328195,3126940487,1662763179,1662763367,188,1225
3447555067,3542688397,1646103354,1646104126,772,974
3280372392,3548351680,1642566662,1642567657,995,223
3896982954,3817667121,1649755978,1649756743,765,1707
3129034897,3534910343,1664900938,1664901707,769,2054
3319583055,3901360663,1643844759,1643845658,899,2254
3312203382,3262596597,1660910099,1660910566,467,361
3870243569,3580178697,1656593620,1656594551,931,559
3055603453,3855218155,1655676715,1655677622,907,453
3815718297,3975379893,1646407595,1646407640,45,452
3466494394,3238443990,1645427280,1645427855,575,2003
3004708023,3662788693,1656980297,1656981095,798,113
3105789496,3928867307,1658796597,1658796996,399,1148
3175676853,3423593448,1650831418,1650832103,685,1033
3611286809,3455537522,1652402172,1652402832,660,770
3800392649,3780182766,1646821405,1646821904,499,38
3254181971,3623869570,1661918752,1661919638,886,1246
3876696308,3736118442,1660319365,1660319926,561,190
3431909978,3165536332,1660638512,1660639430,918,2479
3055169776,3275494433,1658198488,1658199274,786,976
3161063958,3005773066,1651329436,1651329772,336,171
3102588374,3777022057,1663233034,1663233632,598,1943
3239158180,3229321048,1648189327,1648189712,385,1294
3035245517,3631455637,1658243119,1658243321,202,1195
3594066575,3926815435,1643111865,1643112844,979,1283
3168818004,3776398060,1642036445,1642037245,800,100
3255776587,3128009914,1655685713,1655685817,104,2070
3408604990,3654922401,1645906725,1645907689,964,593
3783723078,3839454838,1651274577,1651274898,321,1695
3336525489,3937698731,1655269300,1655270168,868,346
3476971345,3345875910,1665070832,1665070991,159,1461
3293387588,3069316815,1645809744,1645809841,97,85
3495147813,3433835303,1658856512,1658856844,332,1216
3093146280,3762690279,1669049930,1669050517,587,438
3474376744,3047400344,1643898330,1643898381,51,1411
3879766152,3048788442,1662188075,1662188982,907,2131
3071341023,3096274177,1665425636,1665425875,239,1999
3211541773,3206149175,1648276038,1648276468,430,1858
3880290667,3560015501,1660835260,1660835704,444,1117
3396453607,3988264152,1659395373,1659395908,535,2370
3557734825,3415788314,1650335558,1650336402,844,1127
3331882759,3677300151,1662423827,1662424193,366,853
3813034205,3436916222,1658105781,1658105895,114,1051
3128009914,3589441972,1646991099,1646991452,353,1866
3051253299,3124044009,1648454390,1648454924,534,2330
3150289965,3292172583,1664088540,1664088880,340,2347
3718375865,3881206954,1661744811,1661745467,656,143
3373512814,3173667762,1659707468,1659708318,850,503
3594038673,3573915559,1655936684,1655937035,351,1155
3397397223,3277978979,1661014079,1661014126,47,286
3808900684,3457284809,1656211427,1656211699,272,483
3026035554,3578974875,1662042327,1662042532,205,126
3870475008,3738761840,1667651550,1667651958,408,1723
3022252567,3125813072,1652949260,1652949378,118,1987
3108139225,3188567155,1663340020,1663340768,748,349
3415041326,3227310314,1650147572,1650147821,249,1964
3796343532,3783064521,1661647612,1661648038,426,1772
3934453508,3497171741,1658288597,1658288997,400,567
3428501033,3713520914,1645848587,1645849336,749,1966
3902777743,3010673027,1662769203,1662770116,913,746
3733649713,3997162156,1663767724,1663768504,780,1505
3702064029,3018325807,1652071120,1652071353,233,2488
3805921576,3141689539,1652092906,1652093311,405,2095
3463135439,3189673990,1666213757,1666214555,798,1713
3448373235,3209462413,1666736307,1666737246,939,1298
3821299576,3005771350,1648773587,1648774076,489,338
3557325531,3516865615,1660044419,1660044617,198,2240
3152200344,3507952797,1663701542,1663701602,60,520
3920028342,3690586350,1657790357,1657791002,645,1173
3070241461,3614741796,1648895634,1648895829,195,1891
3143293050,3146634302,1649214300,1649214397,97,163
3930909418,3313192018,1662115356,1662115933,577,1929
3507376482,3904825547,1651569158,1651569853,695,847
3324113509,3206243555,1647730156,1647730960,804,1318
3961721758,3814620482,1667479928,1667480197,269,764
3561543601,3337108824,1663893347,1663893405,58,65
3349626057,3073474496,1661992466,1661993301,835,2363
3003321686,3402690548,1643807712,1643808361,649,346
3538410031,3858951131,1651718003,1651718436,433,1570
3040742963,3919478201,1643145811,1643146516,705,519
3823161778,3704871253,1669727863,1669728045,182,2244
3190544941,3361319934,1647330221,1647330899,678,548
3561113748,3722859316,1669019996,1669020486,490,646
3893475632,3250528764,1651769618,1651769650,32,2035
3175298013,3492247995,1662589983,1662590484,501,974
3955776304,3977107209,1665387397,1665387617,220,490
3262379384,3771146763,1655659712,1655660190,478,1044
3242622170,3321391869,1668569726,1668570187,461,242
3580310329,3657597585,1668390521,1668391313,792,319
3877811036,3854737938,1669684281,1669684365,84,2371
3830975217,3077145114,1644328249,1644328891,642,1551
3671054235,3842362489,1648169078,1648169784,706,2426
3349666443,3337305693,1651429395,1651429914,519,2006
3201957142,3827867076,1645864209,1645865152,943,432
3880948714,3662040060,1668354218,1668354597,379,18
3872626198,3657699213,1642732271,1642732580,309,2105
3067403592,3751780241,1668763187,1668763766,579,908
3091275117,3282079727,1667499724,1667500446,722,1792
3845363108,3310512172,1662782915,1662783089,174,1567
3624103484,3281753784,1649138270,1649138707,437,1766
3863922323,3749379310,1663039419,1663039509,90,155
3986311619,3436636953,1669213377,1669214343,966,1708
3710943716,3804978604,1660398181,1660398977,796,1206
3863676573,3514680311,1645100987,1645101137,150,2003
3692498377,3887564578,1657583151,1657583839,688,617
3366896849,3642377610,1657024937,1657025199,262,1089
3529056509,3994721189,1669348486,1669348874,388,1165
3377798373,3486802233,1641305511,1641306059,548,1218
3467933841,3997050001,1641640447,1641641333,886,2486
3098891437,3125289160,1662989074,1662989892,818,452
3247959785,3533290388,1649518767,1649518800,33,1685
3361051044,3099785418,1650201186,1650202051,865,1053
3234064099,3020106315,1648592154,1648592179,25,2115
3921754282,3190544941,1650582718,1650583214,496,2248
3153413554,3347896915,1641261720,1641261949,229,719
3845010730,3362796099,1669669875,1669670533,658,929
3272563093,3797182963,1660092547,1660092847,300,2026
3133902865,3328024680,1651083791,1651083934,143,2031
3496807015,3227652803,1647427715,1647428000,285,686
3249627758,3560967248,1659261963,1659262331,368,1390
3004100055,3071602516,1669610430,1669611065,635,2075
3009635817,3269622220,1666744765,1666744848,83,1449
3798509385,3567126985,1669109368,1669110271,903,1192
3659285822,3415145597,1642755160,1642756087,927,1125
3641983006,3508858140,1665438282,1665439062,780,2009
3746979257,3126653341,1664201507,1664202146,639,353
3910839994,3026701207,1652009743,1652010139,396,1346
3938154365,3900911220,1660687879,1660688842,963,1577
3743682237,3287082352,1649719148,1649719216,68,1551
3356302136,3552958954,1667784977,1667785618,641,2030
3939477257,3055169776,1644207288,1644207550,262,2316
3655498745,3587171844,1643570290,1643570636,346,1725
3976970303,3840449491,1654504691,1654504809,118,1744
3829377486,3846628868,1661341660,1661341999,339,1921
3686704798,3035838196,1653900943,1653901069,126,246
3722726470,3165423009,1656905389,1656905844,455,1024
3429074631,3527349190,1668942352,1668943261,909,967
3987510303,3533274758,1642411123,1642411573,450,790
3048497124,3658017612,1651366288,1651366703,415,72
3553712893,3416196153,1656094101,1656094642,541,285
3148366567,3381313507,1647369894,1647370698,804,850
3633856416,3974326867,1641699262,1641699484,222,525
3316952075,3857215319,1664406749,1664407333,584,127
3624171160,3300994471,1650555693,1650556341,648,695
3962034507,3383006906,1655291259,1655292094,835,2299
3104396432,3773996198,1660397001,1660397934,933,2114
3201446016,3736483863,1644766788,1644766945,157,1831
3498758411,3244763805,1650378790,1650379201,411,1311
3383348505,3289061595,1654027493,1654027636,143,1295
3915175620,3705306826,1641611290,1641612280,990,1804
3805772843,3364586923,1667701629,1667702543,914,630
3362405611,3081641451,1648905080,1648905428,348,498
3841314189,3089574886,1668078784,1668078824,40,2398
3190267458,3555186812,1651574917,1651575238,321,2056
3784808734,3772910484,1642098330,1642099056,726,527
3098934820,3007087811,1652840536,1652841295,759,2438
3616890026,3053134032,1645812605,1645813138,533,1069
3381845607,3098083694,1661113386,1661113608,222,1649
3156261740,3269502320,1651545437,1651546372,935,1261
3909309427,3491272857,1650927310,1650927986,676,2308
3037984793,3150730013,1660722970,1660723952,982,439
3096412109,3127783768,1666681651,1666682173,522,2153
3578655079,3314528450,1661463201,1661463680,479,82
3019576854,3549431178,1657103005,1657103800,795,591
3513847916,3421294150,1644880396,1644881344,948,271
3365615023,3182878730,1641555370,1641556173,803,1201
3045691620,3822187489,1648235118,1648235638,520,351
3447926518,3757693725,1664942954,1664943361,407,682
3417411117,3400786498,1649744776,1649745614,838,1488
3208243335,3461938856,1669390514,1669391450,936,109
3097563397,3675061175,1654428392,1654429310,918,68
3198520645,3323783108,1657988087,1657988324,237,2415
3805283132,3434182192,1646459325,1646459424,99,821
3746550027,3871345895,1667427092,1667427273,181,865
3061924533,3080195715,1660056190,1660056485,295,855
3160349110,3782730026,1661236696,1661236962,266,2283
3835355277,3395782360,1649284610,1649285294,684,1380
3014646091,3668625909,1651323784,1651324055,271,2249
3296919195,3654381548,1643743999,1643744481,482,614
3170537714,3776954666,1644931009,1644931779,770,312
3928361511,3955825968,1657418759,1657419042,283,1887
3469437983,3902705203,1646097866,1646098369,503,223
3854906546,3003861546,1657359252,1657359775,523,1500
3507338655,3300983140,1658149995,1658150356,361,102
3940391939,3375782922,1649219638,1649220438,800,699
3135556195,3930662723,1666057525,1666058358,833,846
3466494394,3249261763,1647567515,1647567673,158,401
3582033850,3128449335,1653196268,1653197185,917,1454
3859864317,3094940809,1659654599,1659654933,334,554
3798447157,3692345317,1666821231,1666822017,786,329
3306669471,3588728644,1661252284,1661252516,232,1994
3218746999,3632283664,1642384710,1642385312,602,2164
3008372630,3062410888,1654962576,1654963402,826,569
3003116947,3518202698,1646109402,1646110390,988,875
3070241461,3205418435,1655108467,1655109211,744,2037
3643939596,3082108681,1668526182,1668526549,367,2276
3614179985,3160242179,1648321655,1648322026,371,2442
3177951035,3635921511,1641274942,1641275885,943,1639
3404785260,3069313994,1666894303,1666894323,20,884
3526166184,3310294122,1645349425,1645350274,849,1945
3312656348,3055710852,1659882946,1659883334,388,1487
3081369661,3433374325,1657229343,1657229451,108,1919
3675683512,3990109853,1643626950,1643627036,86,1626
3178529360,3005231138,1662074806,1662075659,853,2162
3424768768,3242752835,1647878752,1647879716,964,272
3179547560,3925504452,1653174396,1653174613,217,1056
3748837929,3269889273,1651207874,1651208785,911,236
3955825968,3413984037,1653898546,1653898714,168,2193
3449395269,3771028638,1643039676,1643040651,975,2320
3746351822,3923137418,1645974941,1645975851,910,1296
3005700539,3377826578,1641630422,1641630626,204,1816
3424431005,3215815915,1653482328,1653482571,243,2248
3310496626,3193830008,1657763998,1657764180,182,1861
3721060604,3053166522,1668888112,1668889073,961,1510
3130594039,3666782310,1661326337,1661326349,12,2491
3672699331,3164355501,1643665746,1643666458,712,759
3792708367,3626015702,1658559012,1658559457,445,32
3934911409,3348770994,1654456104,1654456199,95,335
3492215792,3962034507,1650526689,1650527145,456,1006
3548545695,3474742534,1661990752,1661990927,175,1600
3083388257,3526239660,1643897188,1643897491,303,1672
3083235668,3079415495,1646974361,1646975042,681,1274
3371790369,3809458973,1667125728,1667125900,172,1012
3249261763,3394999152,1658866169,1658866692,523,2084
3450074680,3147047674,1644102910,1644103653,743,871
3469812263,3499182342,1650861079,1650861564,485,1495
3325944344,3760817382,1641530715,1641531351,636,1220
3892469874,3865200739,1652292763,1652292973,210,551
3618532396,3925504452,1643510329,1643511279,950,76
3927864902,3742746848,1641690086,1641690411,325,801
3621938271,3652177742,1666957659,1666957669,10,462
3693000511,3662788693,1664423825,1664424560,735,2304
3750543433,3506971803,1651413009,1651413155,146,1932
3981331110,3599104606,1651316457,1651317316,859,2416
3827810459,3414669089,1666744574,1666744588,14,1894
3870998298,3792012199,1651742840,1651743333,493,926
3410972917,3796065026,1661859075,1661859642,567,1657
3127412666,3482235012,1645129270,1645129464,194,1384
3601562567,3542215276,1662642250,1662642881,631,961
3734099449,3178749877,1666712728,1666712796,68,366
3673524018,3746890721,1651299083,1651299374,291,1476
3596841713,3377774902,1666175843,1666176356,513,1808
3787654868,3316318605,1657018191,1657018415,224,2214
3239620599,3758849561,1656459818,1656460615,797,907
3277978979,3229321048,1651251408,1651252061,653,2143
3491718080,3268826534,1642110113,1642110479,366,1990
3620939715,3266828046,1643715557,1643715948,391,1607
3242235161,3257492375,1641767313,1641767892,579,1713
3176346935,3357247840,1653055739,1653056687,948,109
3659204779,3824478322,1668677096,1668678044,948,1984
3639307843,3920482918,1645245614,1645246112,498,701
3252421501,3185210514,1657930500,1657931345,845,1393
3771788181,3439510951,1643707169,1643707271,102,1253
3855165548,3880439495,1668392029,1668392622,593,780
3948833001,3813666053,1665228794,1665229553,759,1429
3343752753,3123815439,1662582381,1662582678,297,1916
3133153956,3278854404,1663135568,1663135577,9,604
3228073924,3367685887,1642234978,1642235741,763,1053
3091275117,3551884757,1664351474,1664351977,503,71
3279351560,3029263333,1645673439,1645673771,332,2058
3826823415,3060522981,1665471350,1665471568,218,948
3029758309,3120419076,1641586159,1641586348,189,2281
3662763316,3027870588,1661420650,1661421499,849,1077
3658260972,3154833958,1643456442,1643457228,786,1706
3352986307,3537031182,1656884221,1656884288,67,2377
3487406679,3472820961,1650990403,1650990776,373,1129
3823161778,3881861537,1644412532,1644412539,7,1580
3590831664,3948260526,1660215492,1660215918,426,1485
3894247542,3993866389,1669558379,1669559304,925,2281
3175832070,3470102638,1659058955,1659059506,551,2209
3080200257,3413320652,1663972272,1663973081,809,2286
3464235741,3307225202,1669583634,1669583946,312,322
3354574342,3133030435,1649569189,1649569773,584,1187
3156683897,3957803611,1665760998,1665761300,302,129
3228366627,3189435516,1644400550,1644400813,263,1931
3509047408,3854390772,1648186004,1648186174,170,1004
3457284809,3933874233,1642667809,1642668207,398,2120
3160135389,3387311534,1651231519,1651232055,536,867
3460669513,3341300979,1645515377,1645516151,774,1716
3970444667,3742746848,1654326647,1654327350,703,1220
3527269010,3098369438,1665005828,1665006277,449,1517
3304497399,3892469874,1669472505,1669472787,282,2002
3708922840,3867860336,1662879656,1662880376,720,1179
3079219552,3692095366,1664552321,1664553084,763,2105
3611100286,3423909447,1667854355,1667855304,949,1401
3404563689,3128529900,1651504513,1651505429,916,233
3574285791,3231517158,1646913612,1646914373,761,1495
3099934862,3142899759,1644495292,1644496008,716,846
3785586097,3705601482,1669372561,1669373507,946,1244
3865282317,3697085492,1646101570,1646102014,444,292
3051776472,3152555864,1661721842,1661722177,335,131
3041385548,3049424358,1658747686,1658748025,339,629
3843331100,3060757458,1650251667,1650252063,396,2192
3038014403,3895542691,1648467937,1648468673,736,360
3626118668,3722323538,1657343361,1657343806,445,1439
3943947223,3211839563,1641668026,1641668074,48,1566
3991727598,3399503261,1662062322,1662062780,458,321
3303986609,3392271707,1668099841,1668100613,772,170
3211514286,3882412784,1666771121,1666771953,832,609
3830243698,3221031593,1650990158,1650990423,265,328
3339312980,3913645530,1669508536,1669509164,628,1522
3937077335,3710756423,1659014833,1659015005,172,1842
3605278552,3257187145,1649502811,1649503365,554,698
3884346810,3024228189,1650653788,1650654071,283,288
3241007838,3626156541,1645024012,1645024281,269,125
3973440480,3122002940,1644588598,1644588896,298,452
3330817237,3340511048,1642254440,1642254770,330,43
3021253966,3143226144,1649043214,1649044110,896,2253
3472820961,3286078112,1666094720,1666094959,239,880
3750277600,3783515345,1645423623,1645424160,537,0
3912672075,3881942272,1651913828,1651914727,899,2351
3495420849,3564395523,1667414440,1667414527,87,641
3442854678,3905744284,1667280111,1667280924,813,37
3885694482,3476060971,1656309800,1656310520,720,2173
3169898520,3843347515,1667464582,1667465302,720,2045
3725979769,3422046745,1660542945,1660543680,735,297
3588936901,3352316809,1661194026,1661194568,542,665
3410613004,3014275222,1655173897,1655174130,233,1695
3246759301,3348620933,1647554877,1647554881,4,2033
3003617799,3255460937,1641699295,1641699762,467,1662
3449504551,3257034858,1655946971,1655947602,631,2354
3378522829,3426433476,1648333668,1648334137,469,2077
3734754514,3194618871,1648150535,1648150893,358,769
3129993467,3736104902,1668582124,1668582423,299,1122
3277550058,3697028347,1654336426,1654336452,26,1255
3442293538,3647549073,1642550920,1642551000,80,1703
3835202206,3015593061,1657603126,1657603935,809,1812
3875908590,3988546259,1645152353,1645152969,616,2259
3654344198,3491346910,1642008787,1642009625,838,2428
3332206707,3864239870,1658089614,1658090185,571,1392
3452564658,3593437920,1660229143,1660229163,20,2035
3658910038,3720248207,1661595820,1661596506,686,64
3505270174,3489083203,1669716987,1669717739,752,512
3642377610,3799480079,1662248989,1662249467,478,2147
3834706710,3134425396,1656048549,1656049048,499,1673
3677674125,3565781990,1667998112,1667998878,766,774
3798223043,3353257973,1649502566,1649503527,961,1225
3832265812,3353295219,1655788106,1655788847,741,1584
3885026939,3128449335,1651260372,1651260776,404,1611
3329117199,3279538648,1647381940,1647382610,670,2495
3386628594,3599299457,1653208922,1653208993,71,2368
3244071979,3833618667,1656399197,1656399805,608,159
3957798687,3378814600,1647305316,1647305558,242,266
3029016525,3890194122,1661433685,1661433988,303,752
3331882759,3293865251,1663453691,1663453716,25,2108
3976405875,3199119655,1646526525,1646527083,558,2496
3867857893,3239517474,1649561343,1649561712,369,2474
3304973317,3218117875,1658992293,1658992686,393,1970
3284829365,3404008086,1648747502,1648748233,731,257
3637686903,3911588238,1665380492,1665381296,804,1844
3471587065,3702932977,1664241990,1664242116,126,108
3238270210,3597251704,1642244964,1642245041,77,1964
3077552507,3181578884,1652918710,1652919689,979,1918
3875570780,3403925711,1645655174,1645655550,376,1205
3676592387,3650675743,1668657934,1668658054,120,1406
3921930806,3710888381,1657277896,1657278547,651,2395
3145312014,3587171844,1659092440,1659093271,831,1129
3592487083,3185250646,1667871331,1667871707,376,1326
3798563042,3739048247,1656661945,1656662944,999,796
3460687455,3418276734,1652296656,1652296875,219,652
3935601127,3211541773,1661012490,1661013074,584,192
3848866443,3549768940,1651995257,1651996185,928,1494
3364925703,3625691221,1656336702,1656337014,312,1783
3923683467,3424453686,1668514976,1668515413,437,1315
3670291498,3523546928,1647097378,1647097729,351,2141
3478741068,3448135160,1668870019,1668870975,956,548
3968682824,3297123407,1651953875,1651954548,673,1413
3548609816,3256317082,1658371923,1658372401,478,1779
3835922991,3399055713,1647885864,1647886040,176,2236
3810320285,3110360947,1644659861,1644660507,646,1724
3696607958,3991859515,1641380965,1641381039,74,1711
3592471391,3401582775,1650807774,1650808445,671,2015
3316287541,3828921434,1653825440,1653825940,500,1484
3469887287,3428593255,1645035473,1645036189,716,213
3883497013,3994783794,1666644271,1666644947,676,2241
3671154785,3740376361,1651022538,1651022921,383,2348
3758577708,3087394554,1646369173,1646369975,802,214
3311921613,3939711103,1645237975,1645238381,406,1484
3544227988,3729553337,1649180182,1649180249,67,107
3284443787,3287175350,1648127700,1648128435,735,1347
3623191811,3664264570,1664814210,1664815202,992,1657
3481308282,3128009914,1652173134,1652173855,721,823
3801736024,3914275771,1655470496,1655470791,295,2049
3537107415,3674335911,1645200017,1645200482,465,842
3037042091,3909292537,1646325387,1646325812,425,9
3591101388,3956836647,1648036846,1648037036,190,469
3243018622,3511192827,1646680583,1646680726,143,2457
3176818286,3219509030,1644016459,1644017326,867,2282
3284380221,3418662987,1660371616,1660372099,483,1671
3928852706,3992909356,1643231957,1643232764,807,2230
3507992647,3956878212,1651914919,1651915850,931,621
3602829591,3882903150,1656412425,1656413253,828,398
3947879014,3436888201,1659405913,1659406750,837,1199
3561692706,3802823421,1650651687,1650652097,410,1580
3609804397,3748850384,1645910866,1645911412,546,2205
3714203425,3936360658,1656208763,1656209063,300,1918
3932212405,3352316809,1645635567,1645636231,664,708
3249252169,3533403208,1649992450,1649992911,461,229
3840003483,3837366084,1649082095,1649082511,416,361
3626015702,3757507821,1661508223,1661508806,583,485
3822307865,3597459911,1650932205,1650932712,507,506
3685977300,3072734804,1654763256,1654763912,656,778
3922675517,3013814400,1656701299,1656701751,452,318
3072834944,3691032308,1653703632,1653704218,586,358
3824649355,3172825605,1664258910,1664259554,644,932
3216582576,3624298459,1653835840,1653836424,584,2280
3040528605,3393458100,1646896542,1646897330,788,1582
3929464797,3748950684,1664210395,1664211083,688,1145
3145772897,3795508879,1649764022,1649764635,613,2353
3634089207,3145039731,1652691639,1652692470,831,1360
3227446097,3213400022,1655527200,1655527332,132,1914
3332797032,3358374850,1663023455,1663023515,60,853
3566347637,3763093748,1649554041,1649554854,813,1445
3132594209,3567368088,1648413085,1648413497,412,238
3909078383,3280491285,1669719090,1669719436,346,443
3146555014,3889544424,1668745972,1668746569,597,620
3922827209,3693925345,1661053347,1661053673,326,185
3000725837,3036527901,1655273389,1655274323,934,2189
3524131973,3014462663,1664627974,1664628202,228,1210
3377473764,3964637208,1658339421,1658339581,160,1576
3513847916,3855548589,1653308895,1653308985,90,498
3794524447,3906065558,1660467583,1660467933,350,2166
3873840731,3640349880,1662218887,1662219116,229,1131
3348406323,3233425442,1662883184,1662883456,272,648
3207875764,3722380765,1657492042,1657492185,143,1153
3537151295,3845256746,1666207176,1666207437,261,267
3301994647,3872928406,1657883470,1657883952,482,260
3842445140,3896867161,1668143283,1668143365,82,666
3831255967,3917526154,1669395617,1669395815,198,1707
3977359273,3609664184,1649043174,1649043949,775,1859
3819791378,3524217572,1653961745,1653962120,375,489
3805953085,3762890946,1644353766,1644354567,801,2054
3723110330,3133902865,1653588495,1653588670,175,812
3335210480,3341283434,1649726440,1649726660,220,850
3696432858,3020683788,1668053126,1668054111,985,296
3267045921,3316496524,1667701967,1667702393,426,1738
3689828648,3006508919,1644754639,1644755569,930,1671
3938272679,3288106394,1669122937,1669123318,381,1552
3040866975,3767508362,1657789376,1657789715,339,753
3185977048,3887036201,1656859908,1656860142,234,438
3376673600,3833679984,1654699060,1654699536,476,1217
3816538905,3159525512,1662987818,1662988641,823,2490
3023980378,3625684557,1668984113,1668985017,904,1805
3043310672,3132863382,1664091200,1664091287,87,503
3386961417,3142765587,1666195889,1666196136,247,1974
3576100130,3901616267,1663048968,1663049220,252,453
3531898771,3981379416,1650884012,1650884813,801,973
3304499678,3409352040,1653175708,1653176512,804,1035
3189085834,3922927380,1649493868,1649494008,140,944
3766274699,3939973483,1653528927,1653529207,280,2025
3707403309,3319601888,1648015529,1648016317,788,643
3107199564,3306838717,1644282073,1644283020,947,88
3389497658,3850906711,1644583705,1644584685,980,1070
3621462507,3651900802,1659872481,1659872583,102,1378
3506148228,3555186812,1651595682,1651596312,630,1345
3173788210,3129860388,1669674924,1669675309,385,1816
3784123884,3927657297,1660554711,1660555413,702,2303
3113321914,3398583773,1668987020,1668987916,896,2116
3413898378,3742220718,1645755205,1645756113,908,223
3004160380,3797237179,1659881628,1659882465,837,1654
3230836206,3091817310,1662319562,1662320401,839,155
3451329310,3442674561,1653024430,1653024467,37,1835
3623294630,3948743692,1661639842,1661640768,926,862
3525377731,3225741855,1649269767,1649270221,454,2355
3310462353,3324611610,1643393437,1643393775,338,2411
3281923852,3124562368,1664114272,1664114391,119,39
3716461226,3824860461,1662889383,1662890365,982,1861
3627503494,3436234030,1660263882,1660264510,628,399
3160938941,3766274699,1649699669,1649699930,261,1497
3867126446,3880638655,1661329684,1661329747,63,1026
3265895976,3933460964,1649068179,1649068332,153,134
3157600969,3474723005,1645308494,1645308907,413,2399
3008850935,3495858842,1656551272,1656551597,325,1109
3868630067,3764175850,1641126504,1641126776,272,415
3292010262,3635624917,1645387331,1645388211,880,810
3135665687,3404200137,1669043036,1669043955,919,650
3090441115,3662935617,1645005066,1645005402,336,639
3114277786,3062506508,1667531303,1667531750,447,1496
3718714231,3050271924,1646945691,1646946471,780,1769
3555731884,3776334300,1642042358,1642042551,193,2208
3256566881,3862854265,1658286140,1658286150,10,1341
3385007362,3110339164,1654555314,1654555348,34,453
3558733181,3404468022,1661138408,1661139191,783,2260
3998209085,3038067120,1643400806,1643401301,495,1470
3233375810,3958375464,1658756975,1658757225,250,1241
3088571651,3561062307,1666665056,1666665993,937,29
3956058747,3467211844,1660974923,1660975058,135,4
3045070182,3131131112,1665445794,1665446421,627,1931
3794074656,3343855888,1651159308,1651159947,639,1873
3884750087,3028886204,1662674335,1662675272,937,1325
3119345546,3106371588,1658310214,1658310283,69,427
3158291556,3851747907,1659458774,1659459475,701,1345
3884018587,3964613907,1664873187,1664873903,716,786
3481085072,3607580736,1641297002,1641297592,590,1750
3039176873,3039106188,1643953949,1643954834,885,1226
3880298832,3839200168,1658220928,1658220974,46,2388
3936135558,3035402024,1667115465,1667116008,543,1499
3307730398,3357247840,1653040454,1653041377,923,786
3098422570,3816690173,1655257196,1655257447,251,554
3703615574,3295020761,1666976058,1666976305,247,1252
3480115115,3548545695,1653497067,1653497577,510,2049
3931624174,3038823274,1650655369,1650656044,675,1502
3894413849,3478771172,1660787631,1660788161,530,2017
3408903285,3434182192,1645475999,1645476353,354,2159
3783622486,3880948714,1650682177,1650682712,535,731
3295278768,3375879417,1654246177,1654246978,801,256
3976730264,3028063669,1662174344,1662174670,326,1641
3292797747,3507871733,1661171108,1661171209,101,1883
3411340387,3088155289,1650514366,1650514620,254,2311
3387774254,3549482615,1644559150,1644559185,35,29
3157765022,3067985831,1654719009,1654719687,678,2218
3701196344,3032018734,1657698740,1657699105,365,1371
3428593255,3172429422,1658054434,1658054488,54,736
3859360549,3101265323,1652912079,1652912620,541,11
3310953839,3653031568,1651491187,1651491866,679,965
3561037966,3092925867,1659677739,1659678248,509,579
3723870491,3702983168,1645766433,1645766830,397,1220
3052822229,3256859026,1648493435,1648493499,64,1858
3936042616,3008550397,1653015765,1653016048,283,892
3267107046,3485695895,1665786769,1665786915,146,420
3392213771,3623936873,1648235534,1648236167,633,2215
3898959510,3462714323,1655263653,1655263718,65,563
3187644022,3359601528,1646279793,1646280470,677,1155
3934383056,3934890046,1659294791,1659295502,711,963
3144405714,3434864548,1645927261,1645927560,299,1705
3657305306,3038832798,1668098477,1668099459,982,1681
3029403229,3827851972,1651573598,1651573842,244,75
3895196680,3197352308,1641185319,1641185390,71,2170
3030630339,3870463011,1656056592,1656056593,1,1193
3424431005,3383791217,1669420121,1669420995,874,860
3359895223,3485644295,1652347543,1652348197,654,2276
3594471575,3098891437,1655622910,1655623360,450,2397
3470482542,3804773972,1663019515,1663020421,906,744
3207258694,3557559741,1656945040,1656945692,652,2230
3711576021,3210136888,1651792771,1651793419,648,2251
3864956185,3290794282,1646724709,1646725685,976,532
3199563620,3829597039,1669177999,1669178555,556,442
3370701718,3049913617,1653937227,1653937391,164,2088
3265611656,3166492454,1663149129,1663149476,347,976
3647685310,3925364546,1657686941,1657687671,730,2097
3634018428,3028803724,1650994040,1650994429,389,1250
3468922263,3064961160,1652895254,1652895765,511,2230
3425803609,3308877364,1657338908,1657339640,732,806
3227246451,3673810421,1656049713,1656049838,125,1140
3524480094,3011015055,1668987974,1668988919,945,232
3059022884,3832880789,1655948414,1655949184,770,1220
3536954029,3934911409,1667162813,1667162824,11,949
3639618179,3980207883,1661370637,1661371139,502,30
3070810251,3667718430,1647649799,1647650484,685,403
3313619618,3752297066,1643447173,1643448015,842,1453
3112314644,3401382792,1667764636,1667765137,501,1830
3294357161,3046043182,1645181041,1645181756,715,6
3860268588,3159240548,1657901656,1657902409,753,2456
3098165935,3409568191,1642856882,1642857848,966,905
3053166522,3310935085,1666063383,1666063786,403,955
3546192493,3850474820,1654901745,1654902676,931,2147
3555108136,3887409378,1663448709,1663448780,71,2035
3724157579,3915206176,1657711755,1657712577,822,1005
3309767670,3787048351,1654139054,1654140036,982,2165
3956054666,3061366261,1653478810,1653479350,540,1169
3507431231,3181074947,1656069354,1656069870,516,672
3860422016,3706560099,1664717186,1664717811,625,2396
3581026789,3365289656,1660971482,1660971668,186,1302
3651286291,3217719618,1660867708,1660868427,719,77
3451263201,3253568318,1659648040,1659648527,487,686
3415145597,3649252503,1643051084,1643052081,997,1812
3119802700,3405110319,1662467024,1662467937,913,903
3580280923,3773996198,1665582202,1665582314,112,2223
3391118279,3663871563,1653546301,1653546795,494,1702
3868348947,3506345760,1653942154,1653942177,23,639
3227584428,3389546736,1651883673,1651883983,310,48
3083235668,3993756491,1664784874,1664784885,11,2230
3779998740,3833594316,1641685925,1641686081,156,2389
3508809990,3609003771,1660237967,1660238629,662,1393
3353956873,3401597507,1655117485,1655117751,266,2479
3820585135,3497271227,1650807057,1650808055,998,785
3143226144,3389443435,1650596578,1650597148,570,1974
3743687544,3190778281,1665524454,1665524585,131,956
3575784654,3542688397,1666718216,1666719064,848,1688
3304490341,3845886572,1646092689,1646092870,181,2449
3340337106,3678452420,1652336523,1652336986,463,2457
3052861028,3816533759,1657617449,1657618198,749,1846
3620939715,3181086026,1656151532,1656152437,905,54
3284829365,3824625919,1649630918,1649631391,473,2184
3527106895,3223459561,1664963322,1664963345,23,1078
3624090791,3439510951,1649762928,1649763245,317,396
3264018414,3355798436,1646049341,1646049478,137,436
3810798932,3711059561,1643249451,1643250113,662,2292
3013681789,3990264315,1652013352,1652014254,902,2337
3923137418,3264281080,1664247743,1664248310,567,969
3655981198,3832438123,1651380872,1651380955,83,2154
3471463543,3009635817,1666188558,1666189065,507,2364
3696947299,3557559741,1646831764,1646832166,402,1637
3744734019,3183299670,1654449040,1654449652,612,1004
3211795832,3230843282,1644797048,1644798017,969,2281
3831039944,3301202561,1650280885,1650281717,832,569
3968795612,3981778568,1646458618,1646459478,860,558
3489858368,3364855872,1654255308,1654256210,902,15
3299821745,3020429639,1645269034,1645269167,133,579
3399479391,3556000533,1651479067,1651479095,28,1520
3388844626,3672274616,1669101953,1669102214,261,2268
3316237227,3919478201,1641071999,1641072496,497,567
3695545980,3515550503,1663672613,1663672883,270,2281
3329618048,3866541862,1648522729,1648523404,675,741
3415185806,3081057659,1661613698,1661614672,974,2262
3338154846,3219869001,1667767725,1667768224,499,578
3946911182,3838250910,1662351860,1662352259,399,1843
3924960579,3482576542,1655342913,1655343571,658,304
3656158144,3452275962,1642196716,1642197645,929,664
3935125903,3108230028,1657415745,1657415828,83,1423
3957411858,3993756491,1643009664,1643010620,956,1625
3748812993,3999314182,1664802197,1664802802,605,1827
3450806791,3313782821,1644465313,1644465428,115,2160
3294703062,3713062516,1654547373,1654547886,513,641
3187291408,3890781778,1656060378,1656061295,917,738
3437593879,3205809646,1669228432,1669229094,662,1267
3975462879,3816647849,1654427403,1654427941,538,1097
3463540687,3355184225,1642194886,1642195261,375,1444
3889112055,3066093153,1647017662,1647018624,962,797
3069536467,3528271389,1641687051,1641687151,100,1270
3148691436,3538823780,1649838486,1649839203,717,2291
3743934334,3280223679,1648201030,1648201843,813,587
3592487083,3957689713,1658348042,1658348623,581,1115
3891850013,3861160074,1642109693,1642110319,626,1746
3412675211,3916928531,1664202248,1664202743,495,2142
3504796283,3894616795,1654613644,1654613811,167,776
3685665978,3995358434,1645071778,1645071960,182,2105
3195214383,3069332103,1655084280,1655084471,191,2112
3784959270,3057756725,1654840998,1654841052,54,992
3446289365,3700287335,1664939273,1664939721,448,1222
3855013110,3989208740,1641011671,1641011826,155,141
3428557602,3089126812,1654484302,1654484732,430,1292
3213836945,3154139372,1659135782,1659136504,722,1961
3282261851,3034985161,1669266709,1669267406,697,1829
3195629628,3052376951,1649944320,1649945294,974,842
3320488617,3139935588,1663965587,1663966361,774,940
3056053831,3362972722,1645579159,1645580033,874,2437
3290912062,3331882759,1646492260,1646492329,69,1614
3985901910,3748944220,1664262744,1664263348,604,2173
3683246538,3257821708,1669647380,1669648327,947,1818
3422703729,3348735740,1655011310,1655011883,573,663
3659158165,3371707067,1667357856,1667358011,155,1996
3599007187,3336494171,1666930811,1666931429,618,1176
3533497399,3462483679,1655353003,1655353044,41,589
3515038349,3413320652,1665978577,1665978968,391,1361
3388257945,3501946724,1666879027,1666879247,220,1866
3159873313,3211839563,1652432029,1652432887,858,1283
3382974723,3560967248,1644513772,1644514489,717,794
3657699213,3063714742,1650101010,1650101466,456,880
3868440818,3907764491,1669122823,1669123770,947,249
3565805050,3163012662,1651256317,1651257236,919,286
3074395717,3125911793,1641305843,1641306529,686,1132
3542293606,3899858422,1646303398,1646303954,556,420
3814278185,3967372197,1646402142,1646402360,218,574
3272250396,3153750267,1666965992,1666966936,944,2282
3655923753,3023772977,1656207994,1656208974,980,932
3765660727,3489538095,1649948121,1649949109,988,2287
3476971345,3574957979,1649805274,1649805946,672,465
3431892611,3143452523,1651527796,1651527992,196,2128
3834954155,3795503592,1660871855,1660872474,619,705
3276350975,3574460900,1642092704,1642093439,735,314
3793738776,3562875112,1642445153,1642445514,361,1146
3592235229,3911316683,1648962050,1648962840,790,2290
3213995449,3288329354,1648325191,1648325305,114,1599
3730368703,3502050886,1647714206,1647714595,389,2038
3351087116,3222438717,1664423486,1664423845,359,2449
3882603510,3846060378,1661485171,1661485952,781,544
3450806791,3485801867,1669245397,1669246178,781,591
3288347905,3934911409,1668133005,1668133363,358,1935
3514218549,3199892178,1644787047,1644787348,301,23
3375585327,3097457183,1644841062,1644841819,757,97
3153085443,3599299457,1644569701,1644570202,501,1133
3139882519,3471587065,1663748853,1663749421,568,670
3501770020,3398795724,1652603582,1652604089,507,608
3721541321,3453227348,1645014132,1645014568,436,2333
3750756562,3573826666,1654316454,1654317447,993,2498
3324455158,3904352989,1668438189,1668438723,534,188
3334030228,3609804397,1667443016,1667443136,120,1421
3287116319,3500948971,1650670427,1650671322,895,2172
3129927926,3419336769,1662884142,1662885049,907,2109
3594795944,3575512492,1641057828,1641058249,421,52
3279351366,3668235327,1654452761,1654452852,91,1068
3090441115,3550218169,1660597567,1660597626,59,1198
3860883669,3516089114,1660332975,1660333627,652,122
3988976739,3348006171,1648929687,1648929693,6,1640
3113005024,3565803867,1650301348,1650302272,924,1727
3220432369,3585097526,1646830796,1646831156,360,1041
3437665905,3757518149,1642432731,1642432749,18,585
3399552669,3646079529,1664181243,1664181294,51,1105
3569743064,3821998886,1669266709,1669267150,441,1140
3019773309,3202625372,1665396765,1665396776,11,1122
3818276871,3981065835,1656317747,1656318001,254,843
3726520685,3687239883,1667482186,1667483064,878,1018
3299362427,3478502336,1655653408,1655654137,729,2114
3707476548,3906396830,1662848293,1662849174,881,301
3215342018,3923137418,1656079140,1656079199,59,425
3636948225,3149688689,1655529175,1655529236,61,2430
3532021354,3192940759,1652560860,1652561470,610,2413
3918397944,3397940369,1666099986,1666100605,619,2438
3936468941,3105357126,1666780520,1666780607,87,1399
3861263764,3620985435,1668270301,1668271049,748,1343
3930118877,3023254734,1664271659,1664272162,503,2494
3620013325,3282166903,1655274138,1655274434,296,680
3653069495,3011593291,1669539704,1669540241,537,368
3959783422,3834720743,1641749810,1641750417,607,450
3442735570,3927864902,1669236660,1669237088,428,1380
3516743828,3008576449,1666476303,1666476752,449,1308
3980841914,3211064928,1659931873,1659931997,124,1809
3791389559,3989563375,1664745670,1664745882,212,845
3247948931,3017484229,1659219895,1659220109,214,1745
3624484272,3748492935,1664580473,1664581184,711,1503
3668552386,3859360549,1651466753,1651467532,779,1671
3428142421,3945633602,1643586447,1643587375,928,1123
3314495556,3189673990,1661231518,1661231999,481,1334
3079013365,3535941316,1648429073,1648429291,218,476
3278297907,3358578228,1654393899,1654394540,641,355
3456811507,3677674125,1653186253,1653186791,538,1112
3952663430,3711048943,1660240559,1660240560,1,1567
3695478448,3145378445,1641083193,1641084187,994,1640
3043310672,3360115986,1667294620,1667295511,891,1964
3055644463,3457451540,1666855405,1666856154,749,691
3069225011,3431000503,1653589934,1653590506,572,44
3190226527,3265364405,1662847952,1662848109,157,1513
3313192018,3810861883,1656655758,1656655827,69,1672
3912916652,3643372353,1663933645,1663934148,503,1864
3501568597,3759986276,1645531044,1645531350,306,795
3049579265,3128449335,1658782770,1658783377,607,2138
3481689842,3959629367,1654779763,1654780615,852,1633
3353257973,3752297066,1657493068,1657493218,150,1659
3831009076,3175418311,1664962599,1664963106,507,1068
3266666808,3369913868,1647277717,1647278268,551,2325
3648593799,3457998128,1667573369,1667573987,618,862
3115777637,3978728021,1648282486,1648282617,131,2145
3937197371,3743687544,1665384668,1665384837,169,426
3527164294,3070404759,1642062310,1642062595,285,985
3216667034,3981049957,1655476081,1655476108,27,694
3389309088,3586489382,1642519652,1642519845,193,1188
3329463543,3998987664,1669006296,1669006489,193,1885
3308001923,3402354750,1663356227,1663356235,8,141
3559615011,3975379893,1646678745,1646679374,629,2339
3233222399,3034985161,1641333562,1641334560,998,2286
3653031568,3390134392,1646963287,1646963392,105,1000
3835112188,3617545187,1658124370,1658125145,775,1161
3864414449,3325944344,1662247318,1662248069,751,210
3643276679,3123302108,1666064302,1666064341,39,473
3797484306,3502484697,1651598885,1651599011,126,1621
3962798581,3813403697,1651974164,1651974884,720,2467
3540737045,3155835978,1658030421,1658030818,397,2401
3261527870,3228319450,1652748543,1652749114,571,205
3501508123,3166274990,1657993482,1657994096,614,94
3822126164,3789279639,1651764486,1651765025,539,1986
3343855888,3035737560,1662298454,1662298729,275,887
3887002610,3337108824,1665489969,1665490270,301,768
3813511439,3408108471,1650109042,1650109339,297,2027
3646797040,3246159564,1659367566,1659367699,133,2212
3592235229,3407770585,1656386048,1656386442,394,1562
3112270906,3588728644,1661341037,1661342037,1000,1729
3094418033,3258577325,1664745845,1664746408,563,1835
3037867406,3672194570,1650545446,1650546153,707,1604
3795342940,3528278695,1642978341,1642979177,836,1295
3005771350,3888764578,1646967988,1646968560,572,1200
3723870491,3620236387,1669080547,1669080939,392,602
3924879744,3779998740,1654682156,1654682847,691,2296
3524315738,3959651432,1655067916,1655068863,947,2124
3471707938,3799014776,1647590842,1647590920,78,795
3151554851,3127812666,1662676062,1662676926,864,164
3329496705,3659771853,1651441586,1651441955,369,435
3730368703,3107530825,1645084284,1645084309,25,840
3520511256,3657115450,1659095305,1659095571,266,769
3115344578,3208346862,1655293014,1655293821,807,1745
3701501875,3131753608,1660937306,1660937941,635,21
3134872743,3035946381,1657272777,1657273663,886,2460
3570429285,3866921322,1658416189,1658417044,855,784
3367849829,3744147238,1648968711,1648969565,854,1130
3456603950,3637457925,1665050887,1665051200,313,1076
3326881805,3721977473,1662950256,1662950376,120,908
3502947486,3641682706,1650641605,1650641765,160,2292
3668491789,3964613907,1644189165,1644189802,637,39
3482473663,3540735539,1662744272,1662744494,222,1273
3248724095,3820374377,1667441924,1667441942,18,1652
3011686027,3881206954,1641751355,1641752104,749,1244
3386490201,3571348230,1650048225,1650048615,390,1886
3005809519,3923907099,1667957319,1667958101,782,1479
3346254669,3943947223,1649467343,1649467569,226,1706
3889854774,3930142533,1666068433,1666069286,853,546
3586524207,3478219461,1651593794,1651594790,996,163
3085311533,3391262941,1641475887,1641476586,699,2192
3463509445,3356690610,1645758252,1645758919,667,2407
3660732427,3651421358,1664018461,1664019087,626,1857
3143226144,3903709933,1655767997,1655768073,76,346
3387938632,3370867881,1663244866,1663245058,192,2267
3248724095,3699533383,1664694081,1664694715,634,439
3184608724,3835976086,1668715895,1668716258,363,1418
3868701805,3671869525,1668370766,1668371719,953,1699
3214817416,3252421501,1660634573,1660635562,989,1445
3909002163,3946409673,1651264211,1651264997,786,2473
3332797032,3319506258,1661634236,1661635015,779,1013
3805665502,3211064928,1653949592,1653950578,986,496
3884018587,3782673553,1643056105,1643056986,881,1588
3256873642,3597661669,1643144937,1643145801,864,1758
3532190519,3120105783,1647445534,1647446265,731,2488
3302917137,3485046222,1651481746,1651482559,813,2423
3751300388,3025223556,1652679832,1652680162,330,1844
3850214790,3266681677,1667474029,1667474432,403,1522
3826257607,3703056224,1641567323,1641567519,196,2409
3153040217,3428142421,1665312515,1665313275,760,2016
3948260526,3372442199,1644782839,1644783562,723,1106
3264434341,3073924620,1659041179,1659041585,406,863
3619490574,3094759406,1655772776,1655773257,481,286
3120823401,3155044579,1668503919,1668504721,802,941
3409332035,3346860393,1667032313,1667032689,376,1660
3522211010,3928867307,1667761280,1667762162,882,1349
3705809622,3609058442,1668088026,1668088823,797,742
3363768036,3300479839,1668780697,1668781689,992,1776
3434729931,3148763328,1648433670,1648433968,298,773
3665591394,3987979637,1660136920,1660137608,688,774
3658451605,3040742963,1660551496,1660552089,593,424
3233507128,3916680089,1641681524,1641681971,447,37
3361365460,3914796719,1647316354,1647317250,896,1787
3307185651,3607354151,1667877815,1667878144,329,233
3533290388,3733619028,1657099400,1657099781,381,1269
3614399988,3437254567,1644321137,1644321640,503,1508
3730845439,3957430800,1668561564,1668562305,741,901
3084940745,3505272067,1659147741,1659148496,755,1890
3823761286,3006085284,1646101184,1646101684,500,199
3600015858,3395609056,1669024914,1669025101,187,1404
3060757458,3906244265,1641374053,1641374081,28,1153
3094759406,3889498156,1664119396,1664119997,601,2238
3339719117,3510634049,1665870603,1665870813,210,1690
3564440153,3006603067,1659188728,1659189463,735,895
3879766152,3672524498,1650822586,1650823096,510,404
3831009076,3463734539,1668179166,1668180080,914,1541
3321202962,3201629659,1661904677,1661904933,256,477
3387840253,3640587334,1656530648,1656530796,148,2205
3327504995,3767453896,1645333579,1645334509,930,1926
3798369315,3199395221,1649328973,1649329699,726,473
3606331231,3149545838,1642461701,1642462270,569,1893
3645523523,3512631937,1650185037,1650185071,34,1279
3002931773,3804657904,1650505531,1650505627,96,2267
3108427765,3306515955,1665455160,1665455506,346,286
3163202728,3826737259,1646181606,1646181797,191,1251
3529898997,3400211756,1656719753,1656720326,573,226
3380303288,3437707461,1654890353,1654891352,999,1541
3857400676,3843917747,1661319203,1661319976,773,271
3673524018,3338154846,1650042278,1650043100,822,1789
3755243698,3506750759,1650979208,1650979250,42,512
3273059265,3605316405,1656682348,1656682457,109,1892
3088604045,3055169776,1667880327,1667881312,985,2347
3496040749,3682793223,1641060610,1641060764,154,1567
3439905167,3084592361,1651997445,1651998340,895,954
3731257404,3232285701,1647486028,1647486787,759,1436
3192367201,3211514286,1655232042,1655232436,394,1581
3890159677,3228073924,1653316532,1653316749,217,651
3916261675,3031560160,1649694578,1649695351,773,240
3553712893,3914006102,1650152939,1650153451,512,376
3409949315,3730106432,1660449935,1660450301,366,474
3708337100,3282950540,1660490595,1660490719,124,2486
3287440691,3852212988,1652495734,1652495934,200,281
3498685499,3498989393,1665493529,1665493751,222,1397
3029807207,3660162411,1668555513,1668556285,772,341
3085001659,3141048645,1669665011,1669665022,11,1871
3725989619,3462862340,1663812467,1663812743,276,1645
3503453854,3154991935,1661328620,1661329087,467,1330
3229318915,3800201060,1665993976,1665994406,430,1439
3500455630,3356332328,1663317752,1663318172,420,1468
3979522310,3421294150,1647859508,1647860441,933,96
3734565675,3256317082,1642082465,1642082696,231,504
3363611494,3729553337,1665364048,1665364861,813,2236
3285030317,3215815915,1662952201,1662952421,220,2154
3367915131,3339312980,1645097213,1645097276,63,1805
3864301593,3057756725,1663533625,1663533885,260,903
3039081980,3216243579,1653764127,1653764382,255,768
3474666564,3699730203,1650449198,1650449631,433,328
3841108033,3227446097,1651268488,1651268721,233,2325
3372093069,3106584115,1642143619,1642144064,445,2251
3747046698,3043753185,1650506771,1650506802,31,887
3414834461,3829377486,1657839734,1657840311,577,1619
3029374380,3140971443,1650822497,1650823007,510,2118
3159900056,3796587240,1642934680,1642935612,932,1655
3996963058,3325842490,1652654763,1652655039,276,460
3080007856,3658099781,1662241360,1662241537,177,1567
3800861252,3963841091,1664841610,1664842562,952,1834
3828738126,3342009927,1649944956,1649945029,73,2
3290681709,3811482837,1652135711,1652136074,363,220
3175418311,3521112560,1665389040,1665389368,328,1181
3779590261,3100176230,1644162276,1644162996,720,1393
3770061469,3537629569,1650946199,1650946895,696,2062
3473399101,3100572176,1662201103,1662201679,576,2086
3756722426,3628956600,1643719009,1643719927,918,423
3410261725,3805283132,1662223248,1662224092,844,337
3503489321,3000254515,1666241589,1666242229,640,1030
3091882022,3227951880,1657028395,1657028508,113,1320
3852685738,3953768846,1651357816,1651358280,464,43
3685505113,3661976391,1656450775,1656451265,490,287
3402439234,3692691710,1666077485,1666077829,344,1505
3084030782,3474088124,1668396977,1668397935,958,1282
3297963936,3127565673,1667809668,1667809872,204,1217
3077346044,3219181477,1660453860,1660454696,836,2343
3272506285,3450023391,1655190860,1655191142,282,256
3917601622,3239158180,1659516380,1659516676,296,2050
3824545323,3205418435,1656781146,1656781210,64,1494
3824517920,3790402339,1646794144,1646794968,824,160
3659158165,3333037570,1657550564,1657550782,218,2399
3019204329,3948219301,1647100909,1647101363,454,1210
3696716300,3818039978,1642008369,1642008469,100,368
3402259490,3553467860,1665724835,1665725440,605,205
3952316985,3192142540,1651023485,1651024450,965,1367
3743687544,3482933937,1657422164,1657423131,967,132
3530157274,3351803423,1645160994,1645161250,256,580
3083144170,3708922840,1658256095,1658256513,418,101
3896019652,3033692011,1644488135,1644488581,446,2198
3280818938,3540799664,1653935954,1653936757,803,1442
3730684727,3967425379,1641891783,1641892424,641,125
3141198072,3865781327,1652052794,1652053534,740,2129
3089525434,3902705203,1656250298,1656251220,922,1849
3284159385,3791460437,1658084411,1658084500,89,1107
3748944220,3168434098,1654736602,1654737482,880,1105
3455941777,3669880471,1669083598,1669083999,401,1129
3218964640,3254503569,1651776083,1651776117,34,1055
3353257973,3520344153,1642910405,1642911365,960,312
3183259139,3314953470,1649146975,1649147717,742,875
3279538648,3033692011,1651542896,1651543436,540,1441
3121932256,3145312014,1657239784,1657240157,373,1938
3962211697,3478288963,1660228780,1660228905,125,491
3711589639,3536633962,1661059644,1661060288,644,827
3777684793,3975864053,1653391494,1653391554,60,285
3083791573,3505753274,1655003792,1655004373,581,1329
3501729913,3149688689,1659910284,1659911032,748,128
3500455630,3015814199,1650716991,1650717894,903,47
3696211720,3567656858,1657955480,1657956155,675,1643
3520324090,3802614854,1641003342,1641003442,100,1042
3834011879,3657699213,1666234409,1666234578,169,348
3890580849,3558733181,1660786665,1660786943,278,199
3124051904,3040521946,1662261781,1662262097,316,945
3074385503,3332144974,1664309505,1664310439,934,1598
3485578733,3207258694,1664539292,1664539902,610,592
3018262582,3408978529,1661087882,1661088257,375,1455
3317961564,3058141936,1660546226,1660546988,762,654
3816863310,3342708435,1661396459,1661396626,167,1374
3612460883,3106465076,1651665391,1651665950,559,1274
3907713562,3273289104,1644857001,1644857126,125,1173
3815507952,3558312644,1668662232,1668663187,955,1405
3092292487,3708101315,1657976785,1657977311,526,1415
3328373210,3034142016,1661536714,1661536781,67,695
3249261763,3357247840,1668796382,1668797170,788,2019
3852818295,3324473595,1662144592,1662145394,802,920
3077827896,3885696227,1643956062,1643956067,5,1893
3642314622,3040866975,1644904558,1644905361,803,1716
3294526671,3419751912,1642532917,1642533000,83,1876
3217250826,3035803277,1646030425,1646031124,699,772
3249261763,3190969092,1668695571,1668695880,309,1233
3123781164,3906065558,1657221290,1657222043,753,1698
3214817416,3258782646,1654665090,1654665228,138,2154
3097161771,3334102064,1641120494,1641120965,471,516
3807922855,3379937268,1653613638,1653614258,620,161
3066053770,3446156273,1657438504,1657439336,832,1566
3707867178,3099976032,1650711354,1650711708,354,875
3870243569,3306457934,1655519910,1655520287,377,1668
3233938614,3328699609,1645266587,1645266851,264,1939
3811648493,3733484132,1643205291,1643205844,553,1846
3994967281,3735817368,1644447558,1644447863,305,1292
3786540807,3832719894,1651341721,1651341781,60,557
3896281957,3679578513,1654164422,1654164966,544,434
3702932977,3206422081,1646527925,1646528776,851,211
3914888679,3350852842,1656933494,1656934415,921,457
3788717673,3304282571,1658741708,1658741960,252,313
3399235044,3143741876,1668114353,1668114978,625,581
3193991721,3200875282,1667649556,1667650367,811,1374
3579921083,3306144283,1666568819,1666569434,615,2272
3156942626,3956836647,1661934896,1661935500,604,436
3553960271,3866431229,1652302149,1652302550,401,1077
3165129580,3475686271,1654099887,1654100596,709,1722
3545188902,3066007042,1641388864,1641389095,231,420
3929497543,3123999917,1644807542,1644808196,654,1710
3380313835,3232835207,1655744808,1655745468,660,349
3337845468,3981173642,1642812814,1642813316,502,1911
3630614328,3723944830,1659926350,1659926367,17,1339
3175979112,3168434098,1664125651,1664125988,337,1999
3722817789,3044967578,1667973925,1667974065,140,2466
3026701207,3383751042,1642111039,1642111515,476,161
3018325807,3759909818,1662632959,1662633567,608,27
3592974208,3679141266,1664901104,1664901958,854,928
3136707992,3526166184,1658471123,1658471868,745,93
3416230781,3407513744,1668741687,1668742254,567,2213
3286476251,3506971803,1655606116,1655606713,597,2206
3613021322,3194379247,1647039170,1647039400,230,1588
3455537522,3720240255,1650063152,1650063397,245,695
3550874434,3549703546,1656163089,1656163583,494,1593
3721977473,3830015015,1655186380,1655186823,443,608
3496617169,3143226144,1647211778,1647212075,297,740
3738761840,3115669693,1651925598,1651925741,143,8
3875243979,3328544337,1645977933,1645978253,320,1432
3186584232,3963370859,1645307024,1645307024,0,118
3671147965,3281369687,1660356604,1660357548,944,442
3300104659,3611100286,1652435352,1652435511,159,1357
3128839608,3720381616,1647491070,1647491989,919,133
3435319506,3732456028,1669475364,1669476261,897,1442
3344637531,3707362025,1653497751,1653497842,91,379
3880290667,3990037235,1651049900,1651050323,423,1849
3708101315,3971524060,1641508543,1641508697,154,1395
3997177535,3294278402,1646866323,1646867322,999,2377
3009365802,3142454040,1642209380,1642209774,394,1716
3545067538,3774413169,1661358137,1661358221,84,817
3407746149,3928727074,1658840076,1658840440,364,625
3888764578,3413111275,1660251117,1660251197,80,1587
3438756008,3196704660,1668048010,1668048640,630,896
3260174905,3819584735,1644238268,1644238804,536,1861
3664627036,3931229167,1649357344,1649358333,989,835
3264345880,3234064099,1662833293,1662834121,828,1445
3290176410,3048721189,1645353983,1645354697,714,2281
3611967437,3925344243,1651307852,1651308486,634,374
3721060604,3550261012,1669315989,1669316121,132,1617
3577798894,3866993832,1668841400,1668842271,871,1789
3414719919,3828196026,1647283317,1647284131,814,1340
3915111520,3936029875,1649847190,1649847851,661,1796
3445647826,3638297718,1661427776,1661428042,266,26
3195451932,3045127324,1667382758,1667383507,749,1992
3413305965,3733619028,1643490781,1643491101,320,460
3998987664,3655250241,1665783195,1665783274,79,46
3296419150,3356034290,1655374950,1655375379,429,1674
3524131973,3856160688,1649294428,1649294613,185,36
3269357443,3550299952,1654908291,1654908592,301,15
3374692305,3239620599,1654240792,1654241062,270,2198
3263488499,3629225227,1644791750,1644792011,261,2087
3866158221,3734576015,1649224484,1649224612,128,1827
3217857851,3739320901,1643989524,1643990255,731,1169
3822736402,3211795832,1648342571,1648342674,103,23
3716524134,3355078629,1657524316,1657524380,64,1659
3243840165,3643730317,1662348867,1662349505,638,250
3003858315,3176346935,1659764466,1659764845,379,1314
3610577318,3432942151,1645609982,1645610788,806,627
3473852885,3681399132,1663392038,1663392972,934,1614
3124574350,3005771350,1666813182,1666814061,879,708
3624103484,3328993418,1652113345,1652113717,372,701
3735700656,3886521997,1654269585,1654270225,640,9
3521258004,3885893310,1663393180,1663393424,244,167
3322656350,3991859515,1652698953,1652699215,262,1779
3897756969,3433374325,1641979797,1641980413,616,2236
3310037244,3980824960,1653037204,1653037674,470,368
3783622486,3879182220,1658794372,1658794554,182,778
3106705860,3086135849,1644272248,1644272960,712,698
3817513264,3667718430,1666271418,1666271720,302,1602
3492773808,3085851145,1652856632,1652857014,382,905
3828196026,3107530825,1651604168,1651604216,48,1321
3563738755,3184270447,1658717243,1658718234,991,87
3992818695,3324473595,1657013910,1657014562,652,592
3048405710,3298505096,1641070703,1641071032,329,1093
3105250340,3143318519,1645750015,1645750550,535,302
3137412000,3168818004,1669368710,1669369284,574,1409
3418998927,3196616254,1667823353,1667824248,895,494
3949522552,3658260972,1645679607,1645680164,557,1229
3534545428,3128401376,1644183884,1644184009,125,1052
3811827366,3042943074,1661081302,1661081813,511,537
3377457710,3482473663,1641186703,1641187122,419,2312
3969960450,3373239702,1666466344,1666467268,924,1844
3790039057,3114036217,1641657923,1641658772,849,1143
3176653619,3228073924,1668075433,1668076393,960,1272
3446490643,3832995595,1664846035,1664846734,699,1975
3945055663,3204359619,1650948798,1650949405,607,2033
3625179175,3347990376,1646782831,1646783139,308,2353
3262864867,3130462571,1641567887,1641568674,787,12
3052233179,3517449502,1666280474,1666281392,918,378
3006456611,3039962870,1662756778,1662757395,617,1061
3885583347,3526327974,1664453214,1664453997,783,2102
3645585393,3079031370,1647369536,1647369800,264,854
3768846820,3161243271,1662226063,1662226499,436,500
3594853846,3801205465,1653479844,1653480758,914,440
3351087116,3292010262,1668455632,1668456206,574,1208
3237224664,3139035952,1641419911,1641420278,367,1775
3524942512,3523829341,1651682199,1651683069,870,806
3204735172,3880298832,1664075120,1664075752,632,339
3551771231,3456660113,1665831394,1665831814,420,1284
3122246747,3254144288,1658172242,1658172879,637,1825
3180062640,3664426298,1669519054,1669519897,843,30
3907665331,3954297181,1656386978,1656387228,250,2429
3350872529,3513576000,1660069604,1660070477,873,167
3867101565,3104396432,1649707039,1649707772,733,843
3582531330,3067220098,1651133826,1651134374,548,348
3755243698,3861160074,1645968713,1645969573,860,2076
3748556962,3388628484,1649907693,1649908000,307,488
3333037570,3102992210,1658011497,1658011503,6,1686
3669789756,3939722468,1652576562,1652577193,631,972
3300015174,3192375486,1648054277,1648054756,479,1124
3516624109,3286473367,1663402488,1663403366,878,596
3760304580,3641542734,1650737364,1650737671,307,952
3157546931,3564444579,1651737508,1651738209,701,1964
3021129414,3968433032,1667465802,1667466199,397,892
3977699882,3437221963,1642795601,1642796549,948,450
3471703914,3739420445,1661975120,1661975729,609,2092
3995428703,3983391279,1659018096,1659018647,551,309
3840155828,3423073970,1641342464,1641343107,643,1724
3096471933,3411181030,1650901687,1650902095,408,1433
3880295026,3698633384,1645317035,1645317651,616,2326
3729325351,3833553454,1666962044,1666962406,362,2481
3740274448,3701103798,1658711126,1658711499,373,2315
3265078616,3622978712,1665468130,1665468779,649,1718
3820225206,3840962989,1667609759,1667610623,864,253
3820070209,3852184769,1642568246,1642568344,98,524
3987162833,3829986472,1653248082,1653248453,371,505
3695411154,3564667780,1642441296,1642441654,358,1480
3406042920,3684926586,1661974296,1661974337,41,1199
3259260257,3895542691,1656888203,1656888986,783,889
3098907787,3370164589,1648409254,1648409900,646,2336
3343543154,3738887934,1648229300,1648229656,356,882
3296519089,3723780339,1646180074,1646180587,513,2086
3820885067,3174544371,1649757112,1649757330,218,2248
3120490643,3178728299,1664382224,1664382235,11,470
3003005378,3428987981,1662382494,1662383180,686,1538
3137195290,3509864353,1654409596,1654409834,238,1610
3225901381,3962031345,1646553886,1646554211,325,1684
3788819111,3734035375,1661555480,1661555526,46,407
3062435759,3705306826,1659544271,1659544293,22,297
3194069746,3806167216,1643646890,1643647598,708,753
3284840023,3233375810,1642389413,1642389438,25,777
3192612662,3081701001,1655066770,1655066871,101,248
3779459643,3839788123,1643062669,1643063133,464,972
3985159412,3452564658,1663558663,1663558691,28,1992
3328245802,3110733657,1654235189,1654235418,229,1813
3005472311,3615666134,1641537824,1641538305,481,640
3224960669,3277577090,1648318570,1648318959,389,152
3494498890,3521112560,1644808510,1644808667,157,568
3745513680,3457468984,1652853537,1652853796,259,169
3447310943,3508202949,1647744221,1647744242,21,961
3043310672,3092800496,1645001638,1645002607,969,56
3351182329,3657380279,1664092913,1664093178,265,48
3998221237,3353855658,1646240597,1646241170,573,1236
3679617161,3277298737,1643161120,1643161937,817,2463
3600856738,3321202962,1650417914,1650418143,229,1966
3479401831,3192194263,1658299753,1658300634,881,291
3606998838,3031249180,1653530590,1653531264,674,2445
3795792181,3839688715,1663540951,1663541153,202,891
3355976871,3890335277,1652741316,1652741441,125,40
3291267409,3581011004,1642717366,1642717866,500,100
3855165548,3862890852,1643603493,1643604490,997,285
3709665583,3333543321,1662121569,1662122125,556,2499
3197201691,3084030782,1653298256,1653298755,499,1744
3701501875,3106781266,1667411509,1667412370,861,719
3165039316,3890117007,1647678804,1647678968,164,2184
3151564731,3796198742,1665337805,1665338236,431,2224
3300694030,3502815865,1647086966,1647087362,396,806
3358968371,3364390232,1660963649,1660963834,185,1169
3545394112,3103943430,1663639254,1663640138,884,529
3965960711,3652304615,1660587528,1660588521,993,1715
3924577071,3102672864,1663773242,1663773952,710,1567
3147089920,3192836427,1667698805,1667699262,457,2438
3912672075,3729325351,1651396054,1651396287,233,1672
3010767150,3689464410,1651605938,1651605994,56,2231
3205423909,3303973335,1651313643,1651314382,739,833
3366321387,3710769510,1644233095,1644233690,595,1862
3626156541,3080007856,1641311045,1641311436,391,2133
3867158050,3248733503,1643913261,1643914194,933,427
3184539687,3379937268,1647596722,1647597142,420,1367
3869495480,3849977339,1663545662,1663545854,192,1903
3387938632,3157765022,1655882658,1655882736,78,2437
3550677109,3761584126,1658830452,1658830719,267,1651
3918581818,3515933745,1665461840,1665462155,315,1486
3480308437,3425720812,1654447717,1654448378,661,2094
3877464299,3069523420,1666854223,1666855220,997,439
3148041041,3664242822,1658184758,1658185438,680,33
3154551351,3334030228,1663424511,1663424522,11,1057
3722078855,3012032774,1657341931,1657342201,270,2328
3575715668,3170325894,1654732686,1654733544,858,2178
3644100988,3434324683,1652161348,1652162253,905,560
3587508502,3242785599,1645595872,1645596184,312,2028
3020683788,3445031830,1652571428,1652572286,858,1598
3003402470,3088553332,1650053597,1650054115,518,2451
3935022176,3133788020,1661982568,1661982737,169,792
3887342054,3046510463,1643550406,1643550435,29,2140
3127565673,3406979800,1664276102,1664276729,627,2389
3344394548,3585495750,1665259632,1665259869,237,570
3185444969,3569686431,1658996047,1658996639,592,1689
3809387134,3243840165,1650106858,1650107600,742,786
3470286872,3927646653,1649864822,1649865378,556,2093
3348802129,3248733503,1651368278,1651368398,120,781
3681399132,3861247260,1661430431,1661430682,251,617
3055603453,3559615011,1669686980,1669687002,22,1057
3106788261,3294526671,1661974598,1661974969,371,1730
3761201412,3042943074,1659017486,1659017785,299,1100
3928852706,3046380642,1665234036,1665234496,460,1551
3081005801,3962676436,1664730214,1664730707,493,421
3118305321,3663474230,1650809818,1650809994,176,2372
3331866261,3942325631,1651515940,1651516198,258,1431
3327166880,3150627841,1653625220,1653625349,129,1113
3768558350,3650041115,1645212585,1645213096,511,762
3741413739,3832438123,1644963327,1644963698,371,1380
3958507465,3010488834,1646385744,1646386426,682,121
3730368703,3424897066,1663959499,1663959921,422,915
3369731959,3624748073,1650614488,1650614989,501,1146
3373806425,3885194706,1662919884,1662920312,428,437
3894431064,3239575265,1643763040,1643763351,311,697
3503011690,3618013844,1645790036,1645790689,653,1261
3555560595,3328798665,1645924170,1645924599,429,2258
3122246747,3342199267,1666020160,1666020605,445,922
3627730665,3297001171,1641358279,1641358665,386,1080
3884949094,3715231431,1655938804,1655938905,101,1601
3058789362,3451249074,1649602977,1649603298,321,1657
3486802233,3729389785,1658277222,1658277713,491,573
3477889008,3604308622,1641551735,1641552080,345,425
3956500972,3858519840,1646125666,1646126067,401,991
3852685738,3725480364,1656806250,1656806508,258,1257
3583585259,3709263457,1669525108,1669525133,25,1874
3633239646,3672059189,1668680881,1668681530,649,478
3209097023,3903978752,1641091154,1641091973,819,1115
3142899759,3900571767,1664628833,1664629302,469,361
3290912062,3110753111,1645072769,1645073029,260,89
3339649448,3013814400,1647122050,1647122264,214,1546
3054160201,3696359426,1661720245,1661720984,739,644
3223154180,3759165741,1667803746,1667804157,411,913
3015715378,3454297726,1654484511,1654484790,279,398
3746229411,3047372637,1659188538,1659188629,91,4
3474625275,3640915578,1664459295,1664459894,599,2371
3535631980,3644100988,1653678044,1653678130,86,1926
3841050085,3222282745,1668907610,1668907696,86,1823
3909523201,3370350588,1667294935,1667295442,507,1965
3117531188,3882438892,1649024923,1649025265,342,147
3048402049,3794548376,1665966932,1665967786,854,1594
3424884440,3700896206,1663663977,1663664876,899,1565
3678336055,3599795440,1650407223,1650407614,391,2028
3227310314,3415145597,1653954085,1653954106,21,1209
3766966794,3195598526,1648493041,1648493122,81,1145
3828531030,3154079557,1664624342,1664624460,118,107
3164789962,3331904172,1650943088,1650943559,471,11
3599354804,3731437059,1664282837,1664283426,589,720
3939722468,3253931464,1667504511,1667505192,681,1495
3030630339,3658562439,1655346155,1655346285,130,2062
3369792484,3019204329,1645612568,1645613205,637,1512
3049869003,3813034205,1650733812,1650734006,194,654
3668491789,3925754107,1652679716,1652680151,435,237
3417328370,3604260104,1651827858,1651828244,386,1325
3382526428,3172773924,1651818716,1651819563,847,1862
3800392649,3371289776,1653928994,1653929558,564,1323
3953002004,3672123230,1650169073,1650169485,412,587
3671154785,3002829154,1662756141,1662757034,893,293
3779998740,3166518187,1658507273,1658507666,393,979
3604759141,3495919793,1647110004,1647110739,735,1612
3353878603,3964524277,1650112528,1650113463,935,965
3282261851,3763449384,1669035790,1669036144,354,1849
3651753987,3887290680,1657031711,1657032272,561,1088
3028705386,3467686942,1663852449,1663852730,281,1287
3104459009,3752858965,1653055101,1653055777,676,2037
3443435826,3020106315,1650142743,1650142767,24,848
3713129998,3158988425,1646769100,1646769224,124,67
3083791573,3336947163,1654636548,1654637393,845,2267
3423965711,3928354041,1667744791,1667745505,714,1985
3563103144,3414669089,1666841927,1666842862,935,769
3409804938,3927214415,1648343773,1648344318,545,776
3800312034,3360436723,1660661186,1660661607,421,1556
3644961840,3868397809,1658116721,1658117138,417,519
3679141266,3096412109,1666142638,1666143573,935,969
3412989654,3385183586,1651434439,1651435210,771,669
3031386210,3442330693,1666508628,1666509026,398,2083
3913680174,3477522732,1655930199,1655931066,867,1916
3937728696,3197323395,1663849161,1663849481,320,680
3303561746,3922851964,1659110759,1659111609,850,332
3309468510,3811482837,1668120467,1668121449,982,1692
3842431875,3135134317,1645192642,1645193325,683,1345
3029451399,3862583365,1647285870,1647286299,429,2009
3620725243,3994348053,1653632771,1653632810,39,289
3665798527,3703457098,1651531280,1651532135,855,269
3870779720,3828555703,1644282804,1644283499,695,1361
3468682335,3979558738,1661923082,1661923643,561,172
3401134518,3880295026,1663639699,1663640070,371,1218
3708809295,3870779720,1666071571,1666071931,360,809
3206549691,3963547295,1657837693,1657838542,849,215
3362972722,3618101679,1653163811,1653164291,480,1113
3878683407,3255751346,1644062479,1644062504,25,1790
3072080605,3167074299,1651998389,1651998530,141,671
3100176230,3068296722,1666658148,1666658757,609,506
3564026629,3307933176,1660365679,1660365894,215,1875
3893709526,3551884757,1644155528,1644156088,560,2374
3210331889,3413810353,1644292785,1644292957,172,1798
3422728078,3033925963,1642410400,1642410518,118,1685
3563840007,3943221472,1664769452,1664770346,894,906
3822404633,3669647019,1653772982,1653773714,732,1012
3298770258,3952283751,1659420966,1659421341,375,1346
3830866959,3853258306,1668285258,1668285513,255,585
3838850701,3935936621,1644603070,1644603888,818,1075
3370164589,3271182009,1645166998,1645167085,87,1726
3097145374,3219265850,1665637196,1665637512,316,2166
3197201691,3350566867,1652714305,1652715067,762,595
3721136961,3166343569,1645567520,1645568253,733,2324
3524545245,3323936820,1664613003,1664613469,466,2058
3342538148,3074837048,1653289215,1653290141,926,941
3977987504,3614741796,1665410119,1665410877,758,2473
3157308488,3190226527,1663052370,1663052496,126,1769
3005854023,3986955632,1649982345,1649982598,253,812
3666072303,3642377610,1658184232,1658185089,857,1272
3964690423,3911849911,1643362702,1643363613,911,2048
3862371205,3736085476,1645704702,1645705263,561,1092
3609310097,3959783422,1648197955,1648198882,927,1978
3249145163,3886158471,1646262155,1646262611,456,2307
3216665855,3543150979,1664842919,1664843180,261,1942
3355266666,3241584825,1644510783,1644510919,136,1310
3443773400,3649154395,1669406555,1669407109,554,262
3679983127,3485644295,1655760298,1655761292,994,485
3952654862,3384536407,1668711263,1668712214,951,1498
3375021204,3407909365,1653864139,1653864662,523,39
3307306078,3409055122,1655610732,1655611432,700,1105
3515837186,3913645530,1656338565,1656339351,786,416
3656158144,3050244048,1645349920,1645350410,490,1322
3253913009,3045925838,1650134882,1650135562,680,434
3036194601,3278190233,1650740870,1650741843,973,1723
3198731476,3763449384,1656959494,1656960314,820,2460
3601590462,3170102962,1646462009,1646462956,947,1485
3970820689,3850474820,1653433344,1653433539,195,634
3198195956,3809010705,1669412873,1669412991,118,424
3850178015,3770771031,1657315087,1657315418,331,1444
3783992161,3870998298,1642566990,1642567306,316,968
3360040841,3928354041,1669191104,1669191948,844,1506
3585042042,3365289656,1661729241,1661729436,195,2249
3501287522,3028886204,1653709401,1653710184,783,1493
3705752007,3233507128,1653765276,1653766259,983,284
3027064938,3057300178,1650265585,1650265865,280,163
3016068435,3149191705,1666409322,1666409739,417,1762
3416076001,3600015858,1647224680,1647225246,566,196
3988337484,3263168418,1654794640,1654795459,819,847
3907299052,3084592361,1654864631,1654864862,231,1655
3034216304,3409949315,1650889080,1650889829,749,1878
3069989068,3569686431,1663275575,1663275985,410,1866
3248730765,3972294801,1645354202,1645354835,633,31
3391056146,3207309302,1668463118,1668464013,895,1393
3257449240,3637980358,1644175481,1644176328,847,10
3281146609,3256231811,1650266778,1650267585,807,374
3344787204,3751560053,1662540646,1662541097,451,1095
3618941109,3590228003,1662918186,1662918700,514,205
3134380066,3611286809,1645896438,1645896781,343,1519
3933196862,3253059691,1656646198,1656646639,441,636
3289696366,3955064333,1650608868,1650609636,768,55
3277327180,3501946724,1650032262,1650032284,22,1006
3338154846,3713006411,1647364015,1647364312,297,2248
3229368997,3404432145,1650252278,1650252371,93,1447
3020452542,3693028654,1643948806,1643949510,704,802
3267360802,3350783192,1663311200,1663311302,102,2290
3236522609,3173667762,1659163434,1659164015,581,1414
3252790120,3804914454,1647731417,1647731660,243,1244
3626824650,3353422891,1661818286,1661818470,184,2376
3426585956,3524109178,1658505842,1658506707,865,974
3012892515,3197176680,1669365052,1669365151,99,680
3901026791,3656027442,1650230207,1650231207,1000,2430
3016068435,3993756491,1652758780,1652759403,623,1692
3938973292,3162405135,1641140756,1641141165,409,1049
3563103144,3904546701,1645678537,1645678733,196,156
3623351962,3237339326,1666378370,1666379222,852,2210
3899117968,3729321195,1662911670,1662912231,561,883
3462072699,3537138552,1648479248,1648479760,512,2144
3881578299,3976970303,1659209905,1659210880,975,777
3914275771,3230277243,1643379019,1643379423,404,2361
3604881190,3404034127,1644738112,1644739015,903,2205
3727859047,3661767118,1652169421,1652169998,577,381
3345413125,3569600936,1644600128,1644600609,481,2086
3196403466,3022256617,1643294462,1643295268,806,2294
3665557228,3695360424,1650659315,1650659557,242,145
3356332328,3088155289,1644733331,1644733505,174,1581
3284284605,3061362091,1654243649,1654244146,497,1715
3703548595,3912916652,1655935345,1655935645,300,967
3756722426,3475897333,1648479719,1648480530,811,1093
3564667780,3467383586,1649323673,1649323820,147,164
3761775611,3918121469,1654156405,1654156616,211,105
3476820014,3890940747,1667476406,1667476900,494,1151
3468324129,3395670756,1660648971,1660649785,814,741
3066451739,3979352608,1659837959,1659838950,991,2160
3493040979,3604345045,1647489640,1647490521,881,292
3120081486,3422374987,1656648324,1656648977,653,1647
3744575844,3219869001,1658691412,1658691663,251,1721
3795342940,3668456327,1653406688,1653407177,489,2213
3462224632,3556425071,1655780998,1655781837,839,997
3517149250,3940310287,1664108979,1664109274,295,2342
3026209549,3957053810,1660533594,1660533614,20,1405
3445226012,3816935536,1641746526,1641747177,651,1600
3764343778,3969650128,1659284784,1659284875,91,1852
3717406689,3768814245,1656022663,1656022717,54,1417
3787058440,3160906988,1647245269,1647245547,278,658
3404785260,3816935536,1651668221,1651669043,822,924
3545188902,3618013844,1658912350,1658912472,122,243
3087603397,3696243779,1665505276,1665505954,678,290
3553328177,3663038239,1652436717,1652437126,409,2387
3408115806,3342190885,1647685715,1647686592,877,1839
3625691221,3946306714,1644827791,1644828534,743,1135
3572018229,3531820891,1662694063,1662694895,832,907
3918383192,3025310934,1660846571,1660846643,72,1497
3784698616,3461263871,1650951023,1650951108,85,792
3829901682,3462743550,1664863659,1664864450,791,2368
3052861028,3264865965,1664729804,1664730672,868,1213
3805314214,3996587507,1655460398,1655460794,396,234
3682793223,3555731884,1642187760,1642188009,249,1182
3997167780,3680255689,1651439435,1651440279,844,1685
3237674968,3352389016,1649859277,1649859762,485,2418
3712869836,3527067023,1663370015,1663370369,354,2183
3967372197,3511593307,1648927902,1648928870,968,195
3617340911,3772853715,1641054972,1641055922,950,209
3521258004,3647263296,1651750215,1651750515,300,2455
3276010368,3710769510,1647508236,1647508914,678,648
3118443532,3401582775,1650386166,1650386913,747,1251
3435252882,3623374020,1668177979,1668178317,338,1254
3415761431,3274507247,1663142666,1663143504,838,1861
3834174227,3134166826,1655266851,1655266931,80,2089
3751411767,3274452346,1648627791,1648628228,437,1257
3618352797,3307730398,1668733159,1668734122,963,1992
3523465225,3963546042,1653738000,1653738599,599,2032
3149688689,3166518187,1662571380,1662572293,913,827
3000011580,3436198180,1644905249,1644905931,682,1539
3618101679,3907299052,1656174965,1656175033,68,1155
3372271387,3689453273,1645933789,1645934297,508,718
3420676198,3918121469,1643249043,1643249580,537,2033
3690539115,3574486853,1666623399,1666624241,842,2392
3845256746,3679615343,1649008454,1649008610,156,1136
3424897066,3415892236,1646191250,1646192131,881,2013
3740807524,3554778587,1657451014,1657451193,179,1184
3364586923,3112298724,1646780902,1646781755,853,55
3414901923,3717406689,1654207716,1654208267,551,1043
3203128336,3276771725,1661067943,1661068753,810,91
3595336393,3914166761,1653006960,1653007841,881,259
3056053831,3040219251,1651283324,1651283674,350,834
3722948390,3066362135,1656641520,1656641916,396,1992
3199255829,3986970365,1654775072,1654776068,996,920
3444349973,3232737784,1668781338,1668782234,896,359
3029578425,3750474676,1659106143,1659106403,260,177
3408903285,3595670942,1646870252,1646870517,265,2475
3994007098,3585674939,1666839531,1666839880,349,1642
3529732289,3981348782,1663613306,1663613633,327,2143
3784912315,3936914064,1667664534,1667664819,285,1845
3840846518,3274208430,1653556782,1653557059,277,2462
3695419353,3848936636,1655834554,1655835067,513,824
3293416862,3002350398,1656937439,1656938092,653,1014
3098083694,3246024635,1665575463,1665576459,996,2220
3804978604,3363279084,1661159886,1661160815,929,2440
3054979282,3862528538,1658076451,1658076501,50,244
3391118279,3135707503,1654716305,1654716976,671,355
3400211756,3915154684,1654720443,1654721315,872,2419
3288261603,3248250292,1650537692,1650538309,617,2129
3530162623,3395753607,1649680174,1649680557,383,1753
3148589566,3272187328,1655291537,1655292122,585,341
3706560099,3561572123,1665731310,1665731642,332,2302
3388490960,3311244386,1643697610,1643697635,25,277
3564089463,3164550059,1650862526,1650862558,32,411
3456435173,3471797400,1660012654,1660013316,662,708
3288937566,3260802289,1658080257,1658081217,960,540
3080853733,3608843912,1666854587,1666854651,64,102
3658516535,3115343467,1641795491,1641795519,28,1661
3818023164,3488551185,1656710602,1656711146,544,2357
3307033178,3624947127,1652307160,1652307696,536,477
3020108220,3955055535,1659867534,1659868278,744,352
3528505546,3678482446,1660615455,1660615711,256,301
3295262122,3463973561,1658952060,1658952613,553,1696
3292507015,3106788261,1651204071,1651204548,477,1798
3711490719,3274208430,1660232212,1660232628,416,567
3129677855,3747630644,1663699067,1663700007,940,471
3297626110,3997167780,1643133446,1643134444,998,2194
3986955632,3659620596,1658277456,1658278317,861,22
3306188967,3248892530,1654332845,1654333732,887,266
3081005801,3828485006,1659211536,1659211635,99,1888
3885084129,3963615140,1647249123,1647249318,195,710
3402878567,3597661669,1662319087,1662319120,33,2069
3949947697,3245354614,1652098470,1652099323,853,361
3722578408,3856756422,1654184240,1654185057,817,1196
3069313994,3863080370,1656722807,1656723625,818,168
3620311248,3078628091,1649351635,1649352503,868,995
3942852295,3734579045,1666728016,1666728193,177,790
3663228098,3395679954,1656612998,1656613948,950,2469
3788819111,3897293094,1661419410,1661420110,700,961
3595713931,3432209746,1664547755,1664548043,288,1506
3702302181,3862829462,1645702348,1645703303,955,2428
3537214664,3494009953,1667261208,1667262057,849,1529
3295518987,3389472671,1661648627,1661649362,735,720
3081641451,3367849829,1652372041,1652372413,372,1302
3411993487,3481881323,1657193207,1657193798,591,1696
3659326501,3309053474,1642695105,1642695872,767,292
3896281957,3901736828,1648474514,1648474904,390,828
3733619028,3377528840,1663069144,1663069915,771,570
3549209951,3486208738,1650024698,1650025204,506,804
3864045087,3185745995,1649618354,1649618505,151,1868
3995270744,3776906254,1652982250,1652982362,112,2121
3737772457,3085921604,1665027212,1665027821,609,2379
3224644594,3486262024,1651065703,1651066289,586,782
3739233756,3785584501,1669262725,1669263123,398,1904
3610101662,3765475472,1642125956,1642126041,85,2159
3965118569,3722247979,1648999663,1648999880,217,1260
3247959785,3133030655,1647449517,1647450041,524,478
3443161524,3977924189,1644226116,1644226317,201,1373
3755473771,3795508879,1668006548,1668006781,233,333
3487387362,3313252249,1651068065,1651068144,79,762
3542129823,3413592003,1655970871,1655971073,202,1085
3928685907,3501520918,1651224463,1651224646,183,809
3675418278,3845496977,1667586489,1667586561,72,2485
3245906837,3655250241,1669009175,1669010042,867,2062
3295146156,3608512295,1652984431,1652984501,70,64
3093146280,3845256746,1643837749,1643838180,431,2187
3447407380,3246571420,1656565665,1656565705,40,111
3929774793,3335383594,1662336005,1662336416,411,2206
3310512172,3655135775,1666539001,1666539162,161,958
3150730013,3388328160,1646093318,1646093568,250,2030
3567637602,3595984663,1647779671,1647780189,518,1155
3291780380,3576425783,1658147664,1658148649,985,2207
3462714323,3102119693,1660883675,1660884346,671,707
3925481419,3955750752,1664391566,1664391794,228,435
3980824960,3551771231,1664883932,1664884548,616,1825
3651803323,3532756620,1663351195,1663351280,85,947
3980501547,3404468022,1664416275,1664416793,518,1268
3205543673,3940520472,1646112277,1646112718,441,884
3624103484,3977539783,1648177281,1648177599,318,572
3362405611,3984818292,1653707945,1653708504,559,202
3249145163,3354574342,1656844728,1656845544,816,524
3556823098,3929887239,1645994972,1645995612,640,1399
3502554871,3052951476,1648232396,1648232945,549,48
3569051470,3548609816,1654388700,1654389009,309,2
3822404633,3978330638,1669229940,1669230469,529,233
3409949315,3980050310,1642517600,1642517614,14,2477
3952185527,3708309303,1668949948,1668950619,671,443
3725042810,3639819433,1649576546,1649577060,514,505
3254144288,3177190923,1650974530,1650975118,588,142
3568488180,3657044188,1655576653,1655577299,646,2387
3207407283,3936914064,1662986666,1662987414,748,608
3242857629,3016971363,1657293290,1657293595,305,1804
3902501623,3666380447,1663397649,1663398013,364,2036
3994388981,3645310975,1661623442,1661624055,613,600
3478280943,3310953839,1648037610,1648037899,289,465
3829874150,3180836532,1641637146,1641637172,26,1645
3344205602,3485526833,1651837366,1651837758,392,1721
3823802882,3705919583,1659870783,1659871577,794,1135
3264081641,3458645622,1642815735,1642816145,410,2442
3608893234,3748556962,1653432028,1653432949,921,1235
3671830270,3188936143,1643581698,1643582072,374,572
3102588374,3457542537,1647817069,1647817380,311,2486
3855777399,3560020610,1647561475,1647562031,556,986
3776918350,3450672463,1655846628,1655846868,240,992
3968412854,3039932020,1648029785,1648030752,967,463
3994383813,3355266666,1665606389,1665607228,839,2085
3357966828,3626672801,1663413475,1663413556,81,1051
3412715210,3040037607,1647725724,1647726011,287,2296
3363125076,3669018473,1645720900,1645721883,983,2321
3857215319,3845338893,1648458361,1648458373,12,801
3549703546,3279351366,1651149532,1651150042,510,190
3818823702,3436888201,1655125085,1655125496,411,2149
3959783422,3095594016,1653547987,1653548491,504,128
3793232281,3761775611,1658114794,1658115178,384,241
3188643066,3186569725,1641428775,1641428904,129,1381
3291984936,3650199111,1658276103,1658276546,443,1271
3085851145,3516624109,1653150137,1653150481,344,828
3694762938,3779459643,1650985931,1650986702,771,70
3013484024,3615359439,1644219814,1644220053,239,1687
3005771350,3763385597,1652461736,1652462411,675,939
3054906475,3052376951,1643058118,1643058399,281,1104
3639307843,3558492617,1649662503,1649663498,995,956
3287901684,3488878461,1655428987,1655429098,111,1379
3748841094,3558139345,1642355018,1642355271,253,1651
3401382792,3449365489,1659046504,1659046994,490,2463
3521302995,3586489382,1642357719,1642358079,360,1411
3293615945,3970444667,1653107225,1653107444,219,161
3942852295,3890033502,1642117801,1642118016,215,102
3471797400,3751826055,1642882900,1642883185,285,997
3166517941,3846493363,1669119601,1669119726,125,1384
3654381548,3936179181,1654886102,1654886458,356,801
3123302108,3102089102,1648686888,1648687327,439,2347
3388218000,3976147939,1647181912,1647182326,414,390
3795269127,3411586996,1661841320,1661841707,387,517
3211945942,3066750826,1649217031,1649217606,575,49
3389497658,3046006152,1662654409,1662655062,653,2244
3309684706,3071602516,1663375183,1663375480,297,929
3269283315,3860430252,1643956217,1643956940,723,997
3566824993,3276618988,1651371552,1651371927,375,84
3865847882,3369356299,1669214988,1669215940,952,5
3365340586,3978330638,1651567615,1651568152,537,789
3066426534,3233425442,1643570394,1643571105,711,663
3721060604,3142869544,1661202483,1661203116,633,612
3374174584,3925365269,1651963412,1651964323,911,769
3452258976,3604308622,1645282323,1645282710,387,686
3350812449,3023980378,1657461295,1657461405,110,176
3722199706,3714535860,1657230463,1657231011,548,2057
3289684726,3245522058,1651861341,1651862202,861,2015
3866268396,3524831718,1667788223,1667789181,958,1764
3471221302,3476903669,1656288276,1656288443,167,408
3797182963,3107530825,1663996997,1663997682,685,1305
3474402148,3261685435,1667942804,1667943258,454,1827
3759986276,3556848299,1652393165,1652393863,698,2312
3736459302,3399180008,1658211936,1658212570,634,2111
3125717667,3127142463,1660656980,1660657413,433,879
3149336644,3525751984,1651950232,1651950933,701,438
3023880168,3569443529,1644731862,1644732146,284,847
3833553454,3942520090,1649611458,1649612064,606,1012
3276763839,3961677423,1658641453,1658642287,834,753
3604596896,3410258020,1656551411,1656552366,955,600
3574285791,3484264209,1653813193,1653813668,475,2408
3719273348,3450672463,1654960272,1654960985,713,69
3709075485,3063566522,1667775045,1667775510,465,1577
3388328160,3797484306,1653185423,1653185506,83,2096
3175118084,3901579796,1662101705,1662102154,449,92
3190064020,3498461454,1658884568,1658885222,654,2420
3950428741,3562104036,1665348492,1665348989,497,777
3154009016,3971180079,1663205078,1663206022,944,110
3827937024,3468914867,1655534310,1655534411,101,2167
3388814364,3890026377,1667141014,1667141330,316,1138
3169265310,3993623323,1663077047,1663077886,839,1064
3368204842,3125008218,1664055722,1664056243,521,851
3886720244,3913984749,1644753652,1644754306,654,1719
3551371020,3633856416,1654742775,1654742910,135,140
3283059949,3676634608,1643248134,1643248584,450,886
3767409219,3331977197,1646708303,1646709067,764,161
3816493730,3770061469,1656593970,1656594606,636,634
3015246686,3943892886,1669338090,1669338477,387,336
3169601604,3225909236,1645915794,1645915987,193,687
3934453508,3048296949,1649018819,1649019338,519,2120
3034159032,3490381305,1662256143,1662256978,835,879
3809059026,3107199564,1660592007,1660592052,45,1445
3520392773,3047713943,1652303329,1652303654,325,1596
3436888201,3583345509,1655274167,1655274951,784,1510
3456019436,3371767777,1661931290,1661931635,345,1010
3696856656,3333665805,1643634508,1643634543,35,639
3274208430,3062486954,1654482712,1654483196,484,662
3276617814,3148256129,1645501996,1645502145,149,1981
3183313787,3408604990,1656373936,1656374766,830,537
3591834837,3124004516,1649588026,1649588618,592,80
3195138141,3835976086,1647294678,1647295357,679,692
3927329503,3335383594,1665738695,1665739145,450,1443
3526747987,3211956216,1641976704,1641977391,687,1004
3722114463,3811472324,1657846298,1657847091,793,660
3666494756,3406357109,1649426108,1649426548,440,2394
3042432058,3046640828,1655324253,1655325013,760,1246
3022594569,3894593426,1646849027,1646849865,838,801
3341283434,3127812666,1654321470,1654322189,719,1996
3415917688,3286696325,1654628385,1654629166,781,231
3749529134,3660489961,1649379876,1649380575,699,1728
3009688248,3184608724,1656571532,1656572306,774,2128
3647994845,3822126164,1646794073,1646794938,865,1147
3403786938,3263328793,1666627990,1666628120,130,638
3900101700,3656448203,1645204859,1645204983,124,1675
3329463543,3531256735,1668400363,1668400730,367,1088
3048402049,3233507128,1646846452,1646847182,730,2140
3374636126,3209462413,1647708382,1647708532,150,2109
3467391664,3893475632,1649288632,1649288837,205,1103
3456660113,3682747704,1669465707,1669465773,66,2069
3322226292,3198731476,1649359868,1649360001,133,1073
3019512245,3942862085,1661663038,1661663469,431,1204
3784040148,3734533600,1662779616,1662780031,415,561
3770771031,3698133773,1644560024,1644560561,537,2292
3347832946,3960633649,1649656151,1649656173,22,1982
3011466658,3423825173,1663087440,1663088152,712,1239
3278190233,3778402105,1646145527,1646146487,960,1598
3612778107,3993923271,1667619260,1667619635,375,1249
3372271387,3352262794,1642972496,1642972741,245,176
3029016525,3299362427,1648048665,1648049287,622,936
3557643641,3389560959,1651247288,1651247681,393,1041
3438084709,3283171763,1656467239,1656467666,427,1019
3402019498,3110733657,1660930032,1660931015,983,622
3928894030,3311860866,1642978028,1642978516,488,137
3509999399,3860422016,1653235669,1653235752,83,397
3276341369,3404873411,1645822702,1645823134,432,618
3772749656,3287210562,1658031837,1658032598,761,416
3369040211,3945633602,1657592788,1657593587,799,1922
3074795505,3408240731,1666416496,1666416858,362,1057
3154551351,3066750826,1656583498,1656583695,197,509
3900101700,3959093613,1652689173,1652689715,542,372
3250824932,3860446106,1660641150,1660641517,367,1033
3365939940,3347317107,1642606489,1642607356,867,674
3530491537,3284284605,1647559407,1647559472,65,1988
3521258004,3563407459,1646789675,1646790460,785,187
3371289776,3595336393,1658083030,1658083848,818,322
3684926586,3828713812,1646177061,1646177250,189,583
3849910709,3546034581,1644690519,1644691328,809,2152
3696096099,3679522128,1657977776,1657978278,502,1467
3923692475,3863676573,1641022910,1641023701,791,2146
3106630738,3857081560,1666839072,1666839996,924,1213
3822307865,3299389436,1655543112,1655543528,416,1454
3286129059,3424211722,1645001926,1645002795,869,781
3748988849,3011158212,1643274591,1643275506,915,1281
3984533628,3400211756,1653280481,1653281137,656,296
3407460146,3300456889,1659844456,1659845228,772,2443
3978667945,3839369127,1642678716,1642678913,197,110
3666079547,3472474698,1669712827,1669713325,498,910
3785883615,3390976131,1653221367,1653222043,676,2155
3725989619,3322801895,1648896612,1648896717,105,2026
3411128747,3722380765,1644681493,1644682213,720,2093
3962062858,3568289450,1645774134,1645775064,930,2055
3928951547,3685473604,1643297530,1643297617,87,2311
3211521816,3551792540,1662396819,1662397445,626,1708
3878698797,3506937925,1663407560,1663408173,613,786
3867115890,3564395523,1653978530,1653978683,153,1635
3921816397,3804657904,1667336512,1667337235,723,2484
3810861883,3393528919,1650238348,1650238991,643,29
3249642950,3866681013,1663394025,1663394710,685,1383
3067150549,3272623699,1656290372,1656291015,643,2028
3391658891,3565128218,1641889150,1641889976,826,902
3476882609,3119477442,1645361566,1645361615,49,416
3361482296,3929312426,1667189466,1667189949,483,92
3584309667,3177951035,1661579654,1661579924,270,2221
3775753518,3273701051,1666205143,1666205680,537,2204
3991673197,3862939959,1641161335,1641161703,368,616
3585919417,3791894034,1653682371,1653682866,495,876
3034325039,3893829650,1652137598,1652138268,670,1271
3757507821,3355976871,1655842899,1655843080,181,831
3873840731,3763991129,1657145979,1657146161,182,567
3993623323,3749379449,1659130467,1659130570,103,2409
3987510303,3916226073,1641548086,1641548642,556,112
3521023027,3259880338,1653587661,1653588171,510,1817
3787048351,3026025743,1661010020,1661010821,801,206
3037867406,3997312859,1659964307,1659965296,989,2254
3806737055,3143226144,1658787552,1658787891,339,2236
3918602291,3730920499,1641303693,1641303923,230,1214
3697322167,3440372055,1648098192,1648098233,41,987
3861160074,3993122275,1657223391,1657224078,687,1350
3941689381,3468963532,1644148247,1644149081,834,2404
3919162177,3447527130,1661958636,1661959131,495,1012
3207994528,3493489568,1659088533,1659088599,66,2457
3168625610,3800861252,1641181038,1641181777,739,1504
3604755020,3755236966,1666761073,1666761757,684,320
3872574112,3784629786,1649214205,1649214921,716,76
3727794902,3562463361,1648955863,1648956690,827,1320
3728950700,3464595898,1641586144,1641586336,192,1998
3679519826,3291819950,1662429279,1662429696,417,2424
3152438109,3113938510,1654230120,1654231031,911,171
3478166190,3177491349,1642382978,1642383528,550,881
3579642249,3173969437,1666837619,1666837696,77,1241
3166754795,3348735740,1659530169,1659530579,410,158
3860519596,3376287193,1665670809,1665671055,246,309
3351786927,3449395269,1657036518,1657037036,518,1553
3124147703,3570480973,1656346915,1656347312,397,877
3678149544,3885926991,1663687958,1663688069,111,347
3969046292,3733619028,1658649745,1658649915,170,428
3866534454,3329496705,1649249762,1649249898,136,882
3624103484,3067229796,1641400470,1641400905,435,267
3393724727,3478921948,1649050345,1649050472,127,1133
3457284809,3398443861,1662577865,1662577928,63,1381
3418364050,3834166808,1664459248,1664460104,856,1269
3719763865,3287210562,1665132744,1665133736,992,2254
3043656500,3123795999,1659188901,1659189816,915,284
3581399447,3381060534,1662900399,1662901270,871,464
3782878084,3953655387,1660347266,1660348126,860,1173
3939973483,3257449240,1645781513,1645781679,166,243
3992924141,3489273340,1641528704,1641529536,832,1049
3343249545,3773532257,1665625971,1665626697,726,673
3431909978,3120737114,1658014389,1658014486,97,72
3716257088,3187779586,1653575620,1653576559,939,702
3687691090,3261333996,1666923364,1666923445,81,1796
3107199564,3666268915,1649100971,1649101882,911,1885
3137441705,3022767670,1659455916,1659456839,923,1650
3189211545,3561562385,1650385013,1650385401,388,2132
3964565126,3624139591,1643025830,1643026669,839,1846
3296066748,3953483372,1659656949,1659657314,365,2418
3840003483,3740438273,1646476090,1646476561,471,1807
3347776562,3083519927,1645435515,1645436392,877,2443
3445714649,3110733657,1659374429,1659375409,980,2403
3459090367,3608485872,1655295641,1655296299,658,2031
3001037251,3382974723,1647392894,1647393270,376,1685
3698989053,3532270724,1664862588,1664862971,383,572
3037583613,3575816255,1666111114,1666111908,794,283
3752347758,3840502377,1661891102,1661891986,884,2043
3250867562,3340511048,1643173463,1643174447,984,2451
3518607253,3685977300,1655509096,1655509521,425,2420
3476728930,3771841105,1659074862,1659075269,407,431
3291286959,3585097526,1661228714,1661229257,543,1458
3266751679,3569557301,1667968220,1667969212,992,864
3481308282,3696716300,1651121360,1651122290,930,2011
3419465829,3146645864,1658498905,1658499023,118,384
3786861325,3519375692,1665039264,1665039361,97,463
3057300178,3066546417,1641772913,1641773014,101,572
3904007370,3698965715,1661082288,1661083169,881,226
3486793392,3045925816,1661902037,1661902402,365,97
3544365476,3983162503,1664945443,1664946351,908,1564
3695161514,3128449335,1649145237,1649145515,278,1160
3743886187,3196304056,1661888056,1661888981,925,1299
3354395496,3911619189,1650661462,1650662313,851,1342
3119718471,3816567987,1655301569,1655302002,433,1839
3352316809,3568141696,1646077822,1646078219,397,479
3419809319,3153446106,1643035218,1643036002,784,1260
3844966905,3041386590,1643441395,1643441847,452,1854
3718375865,3183640403,1662737988,1662738693,705,1808
3567906153,3745248673,1658249746,1658250237,491,2016
3563246157,3510247235,1643768227,1643768735,508,2393
3578068647,3820585135,1667511505,1667512037,532,113
3453736515,3786480807,1656450178,1656451171,993,1120
3925690262,3272623699,1664285106,1664285934,828,334
3111965011,3936914064,1652822695,1652822918,223,2074
3640605424,3024431618,1649204746,1649205146,400,122
3936042616,3158209281,1667101327,1667101684,357,1585
3880835949,3506585658,1669476483,1669477313,830,1484
3564883937,3299362427,1664924828,1664925373,545,687
3704498751,3351803423,1641746255,1641746470,215,1879
3364199338,3987813210,1662937356,1662937965,609,138
3193991721,3936154124,1660026450,1660027371,921,2060
3043753185,3711048943,1642997492,1642997738,246,2120
3887586447,3105815944,1666939049,1666939824,775,2249
3018262582,3563488722,1660292988,1660293559,571,590
3349692109,3648118736,1654579137,1654579259,122,2208
3119698939,3295020761,1654752247,1654753147,900,1998
3553721378,3911364139,1665252818,1665253739,921,1842
3078500208,3264148498,1664768436,1664768679,243,2176
3853256957,3113423573,1652894031,1652894982,951,8
3578974875,3676100322,1652580895,1652581033,138,839
3040715509,3891258957,1643984441,1643985229,788,1973
3405352606,3757624193,1663909802,1663910449,647,1474
3506148228,3051863550,1653022320,1653022580,260,1882
3383110959,3311252249,1649323919,1649324011,92,344
3922251351,3658428855,1643931349,1643931561,212,2365
3606270024,3102251970,1655835651,1655836252,601,866
3895274115,3902501623,1664405000,1664405811,811,2163
3366410496,3833618667,1654770900,1654771418,518,2344
3901360663,3518717396,1656595555,1656596221,666,169
3808604912,3582683989,1644001913,1644002611,698,480
3771146763,3232141615,1666574281,1666574490,209,331
3518717396,3695360424,1661251212,1661251248,36,2262
3943947223,3289684726,1647926958,1647927316,358,378
3985513037,3103871966,1658664063,1658664268,205,384
3383110959,3831770571,1661020387,1661020772,385,161
3569552798,3178235505,1660336457,1660337182,725,2034
3398443861,3825900664,1665943169,1665943995,826,535
3997167780,3258926142,1666824689,1666824993,304,615
3409352040,3713006411,1668998954,1668999932,978,649
3269699819,3562105236,1642059547,1642060512,965,1483
3868116298,3693797946,1667226103,1667226207,104,542
3016299339,3993623323,1652937063,1652937270,207,12
3057725565,3434363944,1666179053,1666179512,459,511
3593553797,3957695947,1658477180,1658477958,778,1775
3202625372,3030630339,1643499482,1643499958,476,1620
3385846184,3278038835,1650179388,1650180142,754,2432
3759608318,3083519927,1650082109,1650082777,668,525
3132376039,3569743064,1662290127,1662290268,141,1628
3955307397,3569743064,1648777464,1648778327,863,1842
3948964302,3708032127,1658212075,1658213014,939,825
3541560120,3980867331,1644959109,1644959916,807,2342
3997162156,3079219552,1644413582,1644413738,156,352
3223174482,3784594026,1657527687,1657528318,631,31
3487992433,3106584115,1646466779,1646466779,0,1820
3241007838,3335976452,1646867963,1646868665,702,2242
3997758248,3952286494,1641926262,1641926849,587,1292
3951158399,3614952111,1667031702,1667032291,589,2137
3932212405,3800460824,1665834086,1665834340,254,46
3651803323,3201933010,1665366571,1665367478,907,1999
3447407380,3162405135,1642673410,1642673858,448,1800
3550261012,3312656348,1647803984,1647804029,45,1641
3568645029,3604755020,1664231062,1664231950,888,2230
3769269484,3751475341,1658668195,1658669049,854,2258
3977860015,3278038835,1656593228,1656593232,4,1306
3132592220,3998200859,1660522053,1660522404,351,602
3125019722,3087333030,1646837681,1646838518,837,545
3018946311,3534192041,1658392478,1658393248,770,1012
3599714580,3621452884,1656325187,1656326182,995,1398
3695558824,3750277600,1651389425,1651389878,453,107
3205282165,3877483900,1650247761,1650248671,910,1741
3273752842,3659732080,1662833372,1662833648,276,2383
3217060058,3539402223,1646670217,1646670793,576,62
3086324092,3322226292,1666815059,1666815662,603,693
3175979112,3653757569,1659198314,1659198449,135,233
3088604045,3253759705,1664364155,1664364574,419,1425
3812481438,3119523311,1664313729,1664314722,993,960
3921930806,3445469609,1667198222,1667198448,226,955
3084855451,3727801252,1666919383,1666920220,837,1132
3220577762,3351786927,1642392485,1642392889,404,972
3040563913,3400211756,1647812985,1647813556,571,1556
3870349696,3768814245,1661845812,1661846432,620,1832
3197661010,3636621583,1659437293,1659437313,20,2225
3902437090,3985037610,1658763240,1658763877,637,433
3310262408,3382110972,1653369151,1653369796,645,141
3643173963,3971203354,1661454634,1661454795,161,1360
3836855857,3773830646,1664969515,1664970025,510,1532
3964711138,3006085284,1650384754,1650385684,930,2433
3663100834,3463875425,1666141410,1666142237,827,671
3883257601,3397940369,1650306473,1650306762,289,1635
3129860388,3277577090,1643750564,1643751145,581,1352
3794575914,3730106432,1654339320,1654339754,434,1841
3198527442,3034147055,1656709986,1656710830,844,812
3991673197,3619045997,1648671235,1648672219,984,2444
3642318884,3556450605,1657064366,1657064650,284,432
3405319002,3387568587,1656875429,1656876406,977,33
3909078383,3776148003,1641134547,1641135343,796,1123
3598409790,3303561746,1649950200,1649950611,411,467
3585982995,3047400344,1643612849,1643613627,778,14
3155797946,3797294746,1664241195,1664241848,653,2207
3735286926,3448459810,1657247689,1657248687,998,895
3173791920,3262864867,1649158172,1649158368,196,1992
3875483766,3151386327,1643027741,1643028055,314,1024
3841050085,3407150254,1664078445,1664079233,788,1963
3757518149,3539402223,1656881013,1656881243,230,1859
3601240692,3135707503,1657847231,1657847920,689,328
3956194935,3553950534,1665566122,1665566959,837,2045
3828530052,3664337365,1658970982,1658971241,259,1910
3731828976,3408048729,1650083663,1650083912,249,1308
3624911947,3927660473,1663942923,1663943404,481,40
3173642675,3164467795,1642350274,1642350502,228,1387
3587903968,3959872101,1665172392,1665173183,791,2445
3277327180,3194560289,1652960579,1652960873,294,2347
3581216621,3118128782,1654901295,1654901358,63,230
3442408044,3877299439,1644260050,1644260798,748,1847
3048328762,3315544584,1664616663,1664617194,531,1073
3290844621,3712804229,1642349962,1642350479,517,796
3240435560,3521271030,1655457932,1655458236,304,1913
3312805786,3269622220,1645638428,1645638836,408,2330
3933874233,3035946381,1643416761,1643416941,180,1711
3995053047,3159562411,1659494326,1659495029,703,1320
3218798966,3842677051,1645624746,1645625029,283,1173
3694618653,3788034142,1661028932,1661029897,965,1790
3640587334,3095661578,1669759980,1669760757,777,2380
3948002281,3646151081,1651432524,1651433344,820,1485
3066305343,3218738751,1648380993,1648381895,902,213
3161586578,3512502358,1666340790,1666341134,344,1893
3211795832,3639515059,1645201378,1645202169,791,1162
3128248749,3593967802,1657242144,1657242343,199,516
3672164838,3881519714,1642944534,1642945337,803,1704
3462033895,3297826818,1653325793,1653325849,56,787
3284838720,3800312034,1641108427,1641108669,242,2085
3886158471,3479087219,1644003398,1644003752,354,1037
3868116298,3924607271,1657909125,1657909793,668,716
3919792223,3592026567,1653088418,1653088848,430,1181
3807440065,3892848585,1650102692,1650103136,444,1263
3637663893,3508224327,1655767905,1655767960,55,1070
3362405611,3751588241,1661356256,1661356403,147,789
3269966376,3908727190,1655861668,1655862221,553,2250
3019576854,3918988651,1657361645,1657361757,112,1181
3519269683,3044854518,1647830808,1647831157,349,1404
3206399216,3098369438,1648717252,1648717898,646,2111
3289615980,3802592493,1652099825,1652099953,128,1859
3863827466,3257690557,1654251350,1654251575,225,1589
3470128186,3949620827,1657157288,1657157776,488,328
3191265442,3120490643,1661651375,1661651610,235,154
3870475008,3478097925,1647288477,1647288798,321,1985
3119036139,3594471575,1650338379,1650339229,850,459
3292172583,3206243555,1669503517,1669503521,4,554
3968337751,3979550486,1665227823,1665228326,503,1695
3569578952,3554409625,1646726297,1646727000,703,1648
3881554146,3263328793,1655827016,1655827955,939,852
3831338864,3421178618,1666916654,1666917578,924,131
3462026511,3158291556,1653765710,1653766249,539,1405
3066053770,3590621650,1651225405,1651226069,664,352
3457451540,3671296032,1643590709,1643591004,295,952
3252981510,3160135389,1648343085,1648343410,325,2028
3909859344,3152518339,1656346008,1656346516,508,1985
3528271389,3693041370,1648854129,1648854783,654,0
3324073911,3561562385,1651227424,1651227894,470,2289
3903091311,3958920817,1643400489,1643400677,188,1175
3816561204,3109127825,1645748256,1645749104,848,256
3642377610,3560977513,1650231210,1650231829,619,713
3518202698,3829856490,1656814430,1656814707,277,2241
3521271030,3951158399,1664164176,1664165045,869,1502
3682803273,3673948643,1646068472,1646068791,319,2441
3510936211,3726117061,1649069527,1649070265,738,1974
3103158328,3283037458,1662938255,1662938703,448,1169
3083235668,3142848483,1664935886,1664936843,957,138
3771028638,3335915365,1644120736,1644121140,404,2258
3666179764,3942520090,1642029024,1642029709,685,1079
3813632607,3806015172,1655227929,1655228085,156,2238
3214068022,3479725709,1647282942,1647283482,540,200
3216582576,3534715157,1651480207,1651480483,276,432
3311280180,3506971803,1659289614,1659290179,565,1818
3760365434,3428557602,1642539816,1642540707,891,894
3922927380,3984274810,1668945784,1668946505,721,1453
3247948931,3282261851,1668780739,1668781396,657,1469
3210071519,3604759141,1667862920,1667863277,357,929
3331335383,3206512870,1642200137,1642200227,90,390
3827122083,3772406671,1662752951,1662753474,523,1442
3163986082,3744759130,1669415997,1669416371,374,641
3934326645,3447812768,1656809972,1656810817,845,935
3557559741,3948833001,1659798143,1659799016,873,513
3922927380,3206422081,1654062597,1654063430,833,1515
3727794902,3522549719,1667991214,1667991622,408,2284
3104210284,3201968141,1654989100,1654989689,589,897
3003005378,3601519220,1666326154,1666326730,576,1414
3948515015,3391262941,1647638993,1647639987,994,1046
3393032827,3690667222,1668436070,1668436104,34,2433
3515170949,3811730419,1645297247,1645297907,660,2475
3046132590,3540735539,1664406023,1664406494,471,288
3689032543,3780039563,1653379471,1653379828,357,1612
3572325072,3271039091,1641770376,1641771135,759,2393
3434010912,3966525848,1658692338,1658692908,570,1117
3474558723,3484699376,1668143637,1668143857,220,1286
3858052316,3633830454,1651661460,1651661576,116,1852
3548670552,3161805415,1660982313,1660982721,408,565
3265712439,3751975877,1660796143,1660796176,33,1838
3549431178,3260085949,1664504233,1664504318,85,313
3534852421,3607622692,1651421975,1651422119,144,1075
3290844621,3835355277,1650376591,1650377021,430,148
3767508362,3448866192,1659757506,1659758435,929,1033
3582683989,3504258562,1661315860,1661316192,332,1525
3325360523,3591551688,1644654195,1644654967,772,2001
3303358502,3816567987,1646826034,1646826116,82,589
3651803323,3278566573,1642233874,1642234427,553,1063
3880476189,3991477345,1647589391,1647589964,573,2012
3080703553,3445743049,1664972376,1664972628,252,156
3620787716,3499541432,1651782885,1651783051,166,1599
3577878798,3887342054,1647086864,1647087595,731,2194
3790157838,3160963185,1652806095,1652807036,941,1291
3661135703,3567237541,1646514864,1646515446,582,585
3687239883,3980139195,1641999602,1641999771,169,1119
3746971515,3716757245,1653702698,1653703695,997,219
3141196312,3514894244,1650247252,1650247452,200,1938
3282166903,3885849262,1650838130,1650838863,733,600
3779192515,3264460374,1658042090,1658042857,767,717
3680810431,3413810353,1653232131,1653232336,205,1921
3409055122,3682793223,1662661490,1662661868,378,2408
3026727334,3023140319,1649212812,1649213572,760,570
3235825340,3485046222,1649861933,1649862797,864,842
3051253299,3736911154,1664668709,1664668989,280,1294
3017484255,3130612494,1653286820,1653287382,562,241
3599551667,3648975076,1642316296,1642316371,75,691
3016068435,3545544203,1651592768,1651593741,973,351
3913243283,3678152024,1648132300,1648132847,547,968
3217250826,3473355243,1664097191,1664098183,992,1669
3066531358,3887032656,1653308952,1653309068,116,456
3588936901,3944198123,1643940562,1643941243,681,56
3569563212,3201968141,1661149821,1661150820,999,29
3975504102,3935656272,1645513183,1645514130,947,647
3249305465,3197497279,1669733739,1669733909,170,402
3619175296,3602238630,1655662457,1655662896,439,992
3003641311,3032834107,1659558698,1659558944,246,1596
3671869525,3122109326,1660063350,1660063553,203,1632
3023530031,3954255558,1659958786,1659959676,890,1248
3875008839,3094940809,1669012764,1669013718,954,957
3095834081,3056252574,1643507528,1643507803,275,130
3529576659,3653218860,1651100267,1651100324,57,1127
3721374677,3685049252,1665469745,1665470478,733,2311
3339962549,3113760926,1642354478,1642355296,818,644
3945881377,3498770747,1667523658,1667524129,471,2316
3418662987,3410513846,1655681033,1655681845,812,911
3302455172,3419336769,1650590049,1650590609,560,1047
3784828021,3824625919,1669629991,1669630877,886,1041
3346530861,3711943152,1646025084,1646025514,430,2056
3431117217,3129500635,1657568383,1657568711,328,692
3089574886,3404934353,1661553436,1661554072,636,15
3408396410,3725117905,1659550494,1659551383,889,843
3147210428,3467810757,1665615553,1665616418,865,2200
3534201448,3769767823,1660376878,1660377336,458,2206
3306753571,3139551539,1647184021,1647184218,197,573
3233938614,3394220693,1641901947,1641902002,55,1478
3335462055,3368294774,1653061480,1653062463,983,1364
3970970054,3507939773,1652562411,1652562956,545,408
3351441481,3152933136,1650539387,1650540109,722,1456
3837062335,3719084637,1655335839,1655336597,758,342
3811318665,3285757325,1644046822,1644047348,526,771
3431909978,3905167655,1657799615,1657799648,33,884
3650172161,3748556962,1668147272,1668148205,933,1679
3947083981,3728498046,1641217588,1641218116,528,483
3222871111,3904352989,1647323908,1647323992,84,1490
3518246885,3149804005,1652668730,1652669585,855,912
3258057377,3259430206,1646121383,1646121796,413,1107
3526793212,3086653619,1659129906,1659130202,296,1075
3833046871,3145045320,1657374957,1657375230,273,1433
3646797040,3703881738,1642619333,1642619494,161,528
3201630796,3049567508,1649196952,1649197562,610,2397
3447946570,3653031568,1661234081,1661234353,272,2397
3165307890,3401611149,1657381253,1657381347,94,2186
3593967802,3197201691,1666488608,1666489453,845,1637
3208490048,3210986714,1669013742,1669013933,191,352
3352005808,3542293606,1650631925,1650632704,779,2027
3235155985,3959783422,1665390022,1665390150,128,444
3280328195,3470049551,1651675635,1651676135,500,2253
3449993526,3359046521,1643379604,1643379629,25,2284
3601499230,3582046255,1669643761,1669644503,742,2023
3331554085,3385007362,1654470907,1654471263,356,378
3338882756,3781789585,1668148434,1668148533,99,2397
3344285047,3927920093,1646221223,1646221775,552,2246
3971722824,3145328663,1659518741,1659519378,637,566
3592320524,3003861871,1641017881,1641018042,161,1664
3588936901,3046380642,1658761191,1658761360,169,1813
3849028830,3040037607,1666924428,1666924640,212,1848
3185469541,3702671465,1645437704,1645438233,529,1986
3071667890,3942965206,1647868927,1647869588,661,212
3365663032,3638595264,1668396214,1668396641,427,919
3248452729,3037984397,1648092902,1648093292,390,228
3748110496,3276666399,1649039430,1649040067,637,526
3693797946,3545544203,1655259947,1655260582,635,294
3630982131,3865200739,1647886272,1647887108,836,1198
3850474820,3902329320,1654846423,1654847195,772,1245
3798509385,3059068631,1650127172,1650127831,659,217
3863485115,3369175849,1650985895,1650986610,715,1684
3268670465,3651571335,1650574481,1650575324,843,1804
3600901232,3784646522,1661315187,1661315492,305,43
3210136888,3424944206,1656110572,1656111431,859,934
3167985603,3710782213,1649900560,1649900680,120,1846
3819235768,3970645989,1653715456,1653715464,8,784
3100027110,3098179768,1646830678,1646831130,452,2003
3753863307,3750765878,1665153242,1665153662,420,2399
3986963711,3793901427,1653198951,1653199111,160,1564
3393528919,3479359145,1665719192,1665719455,263,2305
3753180150,3022767670,1659958812,1659959807,995,923
3099785790,3741983763,1657653772,1657654016,244,994
3086551217,3887036201,1669175808,1669175814,6,2458
3250528764,3265611656,1665403734,1665403806,72,731
3755236966,3767983934,1663325544,1663325990,446,778
3569244680,3827954829,1651527634,1651527681,47,387
3116451556,3133788020,1648715186,1648715445,259,376
3725989619,3831699015,1659270282,1659271138,856,2204
3464734783,3565700391,1653607016,1653607263,247,524
3666494756,3443190053,1659508162,1659509073,911,2388
3442927979,3672350582,1665239806,1665240182,376,637
3693920569,3375655129,1658568151,1658569132,981,1030
3664898256,3252593307,1642557218,1642557603,385,864
3790407401,3647951580,1661280033,1661280859,826,200
3456435173,3872928406,1668135680,1668135688,8,1549
3160071792,3015156809,1651612215,1651612318,103,1250
3032970317,3200116756,1644081052,1644081719,667,2076
3743860568,3718176139,1665219785,1665220523,738,2408
3002876565,3848995096,1663988383,1663988539,156,1395
3957665117,3811308890,1641488739,1641489709,970,1976
3591724433,3773408264,1653179843,1653180055,212,265
3545730764,3391898268,1648449722,1648450235,513,1207
3694206371,3979550486,1663625359,1663626125,766,921
3685049252,3109941959,1653415344,1653415572,228,1348
3738887934,3509999399,1642699752,1642700740,988,1453
3463965663,3066360181,1647509456,1647509494,38,210
3270325529,3645484554,1658485172,1658486159,987,913
3336494171,3898391169,1644694448,1644695132,684,881
3177915558,3391118279,1650997773,1650998389,616,1048
3351205685,3711442352,1651562585,1651563078,493,1806
3287082352,3479401831,1651476263,1651477193,930,1752
3800861252,3054188296,1669599380,1669599546,166,1663
3031816428,3692568210,1648430158,1648430552,394,304
3328245802,3762744269,1652312442,1652312673,231,1381
3298042916,3409978701,1650826926,1650827858,932,1342
3390723607,3055918856,1652874541,1652874815,274,2009
3123815439,3948193261,1660150620,1660150965,345,893
3198022110,3476403398,1650300942,1650301512,570,1758
3090441115,3550299952,1646955892,1646956371,479,1845
3597794683,3269690639,1654407680,1654407833,153,700
3701196344,3883864322,1644883693,1644883999,306,2488
3046707177,3904203375,1662527582,1662527690,108,2428
3069431080,3853258306,1658367254,1658367406,152,439
3658910038,3715766296,1644060409,1644060744,335,4
3089471552,3405155234,1655305889,1655306843,954,4
3997050001,3865239822,1661135600,1661135984,384,2468
3790648941,3793772897,1660371834,1660372131,297,795
3268446099,3789999187,1643646417,1643647275,858,980
3711048943,3883976824,1663419447,1663419888,441,1193
3531345844,3617453316,1641267818,1641267994,176,674
3378325026,3656674833,1646736325,1646736356,31,1048
3389812297,3375125376,1648009815,1648010126,311,2087
3910502945,3040037607,1649268340,1649269246,906,546
3849701361,3000011580,1652755994,1652756094,100,958
3397397223,3730337290,1658321838,1658322350,512,1285
3209464030,3604593541,1646482318,1646482706,388,1101
3042838406,3252021647,1646383842,1646384060,218,2075
3392156471,3564444579,1647678640,1647678778,138,670
3021515419,3300015174,1658470311,1658471303,992,109
3671437138,3154139372,1641989141,1641989857,716,989
3553436680,3928894030,1647837190,1647837421,231,1551
3413319616,3896982954,1651533443,1651533877,434,591
3212095735,3722726470,1652241896,1652242862,966,1539
3755236966,3505100409,1656395311,1656395544,233,663
3487030175,3193991721,1655723064,1655723529,465,1482
3140488273,3264879958,1652937951,1652938894,943,1100
3421645346,3568965374,1649310620,1649310936,316,2062
3607393629,3478362234,1650391524,1650392010,486,2287
3485995293,3502554871,1641912402,1641912789,387,1034
3454546723,3975405530,1643856187,1643856828,641,2053
3904012023,3016340117,1651584550,1651585418,868,1760
3199395221,3056252574,1662626366,1662626836,470,1856
3166492454,3695235867,1641741367,1641742213,846,1801
3199322269,3039962870,1648527614,1648528336,722,759
3832880789,3658477943,1649836968,1649837604,636,1108
3451307942,3092003105,1669318282,1669318659,377,896
3835621921,3648370843,1660217267,1660217619,352,1565
3508398331,3021515419,1649835855,1649836582,727,906
3462072699,3101161243,1648529208,1648530025,817,1933
3640587334,3148284665,1663606649,1663607537,888,1830
3440969146,3040866975,1647209858,1647209933,75,2006
3010368174,3773505782,1649339579,1649339752,173,457
3634871077,3393458100,1669049175,1669049383,208,422
3066645531,3269726483,1660323332,1660324265,933,1363
3156928973,3504457520,1667890481,1667891258,777,1692
3224644594,3839610928,1656583685,1656584243,558,1881
3270935026,3692095834,1641260669,1641261209,540,1447
3697291064,3839947308,1655636121,1655636141,20,2206
3592026567,3347226466,1657222412,1657222861,449,1598
3791510494,3606643671,1660824312,1660824934,622,2038
3252021647,3037577001,1661087266,1661087744,478,1153
3647398701,3498989393,1669664834,1669665121,287,1825
3093534312,3197545162,1667836310,1667836954,644,1649
3528146911,3867115890,1659705258,1659705620,362,2227
3771826410,3447743170,1652164901,1652165549,648,1894
3301119536,3437122732,1665200176,1665200340,164,634
3358968371,3688790539,1658489721,1658490132,411,2027
3001889220,3163551629,1655624691,1655625067,376,2362
3625979408,3417532235,1656028148,1656028628,480,496
3532569602,3977699882,1669066827,1669067641,814,2489
3006738164,3898699023,1647567952,1647568200,248,1202
3293201387,3314901091,1642984153,1642984770,617,2417
3504446959,3955219063,1668274104,1668274915,811,2279
3985491144,3506143492,1644177659,1644178271,612,450
3149046961,3533172784,1645347228,1645348189,961,2057
3956394849,3028710587,1655778808,1655778972,164,1798
3569443529,3587633750,1665938817,1665939678,861,1662
3041652512,3686967459,1661757684,1661757814,130,279
3490435539,3486832676,1643525618,1643526598,980,4
3490155787,3192193744,1642586126,1642586646,520,1675
3794251958,3252973419,1663593121,1663593366,245,1423
3443773400,3811318665,1654455899,1654456578,679,784
3761147252,3959497834,1652878260,1652878321,61,385
3586950573,3574740304,1662497680,1662498455,775,1361
3227567293,3810952134,1648937615,1648938183,568,1982
3254695387,3424453686,1662937970,1662938698,728,389
3963995256,3446699030,1651578692,1651579101,409,277
3749529134,3244071979,1663149257,1663149491,234,1118
3980675077,3693041370,1653749304,1653749647,343,682
3149046961,3288529545,1646825291,1646825298,7,2378
3536156667,3096475097,1644862150,1644862217,67,1918
3835701186,3883537438,1647641147,1647642040,893,1285
3943221472,3066426534,1654742198,1654742278,80,2405
3918812791,3893671286,1665708391,1665708554,163,59
3917984429,3582046255,1661345053,1661345072,19,674
3553712893,3363944559,1648451146,1648451285,139,736
3311871585,3398840886,1665103594,1665103641,47,406
3718882981,3432910993,1667703262,1667703581,319,1217
3448726123,3143274658,1665494306,1665494690,384,1755
3915154684,3952316985,1647266705,1647266909,204,1353
3664426298,3053855376,1661529338,1661530111,773,395
3601590462,3171214894,1663422210,1663422363,153,2455
3032834107,3974092782,1649979506,1649979856,350,136
3151938386,3351216955,1641570948,1641571127,179,1923
3127412666,3312203382,1648264837,1648264993,156,1707
3794408677,3556549065,1664417299,1664417846,547,689
3201068600,3640349880,1646967331,1646968282,951,681
3012032774,3553950534,1650542459,1650542642,183,751
3553950534,3136172164,1665734961,1665735559,598,2230
3876927357,3364938815,1656448971,1656449132,161,1178
3717926703,3433937560,1649548122,1649548404,282,100
3220800349,3593437920,1648138374,1648138567,193,2319
3903947013,3664930564,1644574706,1644575119,413,2476
3748085058,3222563704,1668791738,1668791764,26,2091
3885194706,3310520005,1643507924,1643508630,706,504
3233920789,3797484306,1664089333,1664089620,287,1666
3191970772,3401463703,1643738757,1643739590,833,1819
3994721189,3751600788,1656495256,1656495323,67,253
3567126985,3113214024,1644340567,1644340652,85,2054
3117322872,3867554012,1664955223,1664956173,950,1135
3693581710,3307462662,1641143438,1641143842,404,265
3049869003,3667414511,1669022584,1669023515,931,1517
3161999632,3784646522,1644419608,1644420058,450,1705
3330924198,3555966791,1659019268,1659019378,110,402
3790157838,3196616254,1656873775,1656874438,663,2476
3457108498,3200059644,1658627751,1658627898,147,490
3666380447,3832880789,1653511552,1653512163,611,1672
3639090741,3353257973,1652159389,1652159738,349,1844
3442593383,3129594470,1668727688,1668727909,221,497
3343249545,3903709933,1648787264,1648787655,391,2036
3109702081,3964524277,1647661009,1647661077,68,2168
3315182095,3070676307,1646065797,1646066466,669,2323
3025611145,3697028552,1662863107,1662863381,274,1283
3595738872,3231988469,1641709731,1641709856,125,190
3397910828,3223094463,1641945171,1641945727,556,980
3321202962,3734331528,1642961850,1642961983,133,2439
3351205685,3682279970,1652474567,1652475206,639,64
3604236901,3160938941,1656836892,1656837776,884,1485
3472474698,3885084129,1645573509,1645573890,381,803
3617715231,3194871172,1659242029,1659242455,426,2325
3260571568,3576961863,1653187967,1653188866,899,453
3359722926,3924141950,1663977979,1663978911,932,1022
3685678285,3507871733,1659107556,1659107914,358,1464
3698706740,3356034290,1644280849,1644281392,543,414
3693102953,3346986628,1642685318,1642685470,152,1785
3189435516,3546799061,1645453213,1645453937,724,323
3298770258,3641911946,1667881339,1667881571,232,290
3920261171,3755294305,1661086962,1661087593,631,2302
3478741068,3457191473,1645362587,1645362630,43,10
3397940369,3635487786,1667060155,1667060434,279,1505
3368860003,3611353561,1653295713,1653295864,151,1429
3787071341,3903947013,1664151454,1664152447,993,341
3148256129,3962798581,1655246012,1655246313,301,1035
3354330082,3865503383,1658209272,1658210252,980,2166
3363902315,3213039478,1651818301,1651818679,378,2437
3592264904,3127142463,1648435083,1648435506,423,1096
3105679045,3312661854,1658963054,1658963527,473,2388
3790039057,3132584801,1649016120,1649016688,568,955
3301119536,3131548243,1651373301,1651373872,571,1624
3582204843,3114128222,1658529998,1658530417,419,1630
3800271865,3210078490,1656652997,1656653902,905,2230
3217384934,3554832209,1641593191,1641593674,483,1104
3618532396,3434351368,1664276216,1664276446,230,847
3795326002,3649658953,1641211904,1641212498,594,1542
3352751731,3423043196,1664219281,1664219658,377,1507
3264879958,3015246686,1659433741,1659434375,634,1088
3858459394,3277810331,1654263554,1654264197,643,1395
3854737938,3600334566,1663546067,1663546398,331,1136
3965563922,3968682824,1641742573,1641743206,633,1844
3131683456,3179547560,1641149285,1641149662,377,1911
3567656858,3021613958,1663038187,1663038811,624,1324
3281753784,3086273441,1664509871,1664510625,754,324
3977043818,3192472683,1645086972,1645087053,81,499
3065482463,3962798581,1650316512,1650316905,393,1633
3507952797,3671539226,1650657541,1650657728,187,253
3801847517,3248308163,1648619546,1648620059,513,152
3648975076,3895196680,1667812402,1667812572,170,1441
3200875282,3739439527,1647414969,1647415673,704,2110
3016568360,3504796283,1645472082,1645472273,191,1713
3499514081,3450503481,1648109697,1648110053,356,688
3562472924,3815537815,1646464565,1646465251,686,2333
3238270210,3739595528,1643435193,1643435865,672,790
3223094463,3207994528,1658613670,1658614554,884,754
3309196902,3324073911,1656446107,1656446364,257,1638
3768311968,3856756422,1662333434,1662334217,783,2409
3967972556,3926088173,1645405844,1645405863,19,83
3686704798,3148589566,1655635607,1655636210,603,2123
3686530724,3604759141,1646543709,1646544339,630,1676
3318654389,3807440065,1642624872,1642625337,465,1131
3844939526,3920261171,1668984633,1668985157,524,2221
3260157601,3027110508,1663078717,1663079624,907,353
3352751731,3216665855,1658538633,1658539023,390,2021
3953444491,3936029875,1665161269,1665161623,354,729
3701214753,3955685340,1662063329,1662063438,109,473
3787333178,3037130270,1647286162,1647286522,360,862
3760142759,3241847877,1664455297,1664456268,971,1599
3501287522,3515837186,1652942220,1652942815,595,1609
3315650808,3243018622,1642506388,1642507171,783,1243
3362898304,3042838406,1648022331,1648023223,892,347
3068982966,3925364546,1655270720,1655271579,859,1936
3734621671,3641372344,1653829273,1653829371,98,44
3834954155,3733102461,1649596226,1649596391,165,2242
3486802233,3886917024,1661382212,1661382343,131,1989
3455537522,3075765827,1641865954,1641866344,390,141
3956500972,3692954946,1669116503,1669117248,745,2367
3251854206,3282166903,1658482892,1658483628,736,1269
3795299092,3413056504,1656194536,1656194845,309,1193
3838774657,3697066162,1642875033,1642875861,828,714
3281725583,3223174482,1662649693,1662649696,3,2336
3802614854,3549475344,1644453247,1644454043,796,208
3864045087,3007686100,1664783852,1664784830,978,814
3704871253,3050800748,1642767094,1642767853,759,533
3316398180,3619660501,1654470624,1654471249,625,2364
3945397961,3587727278,1646084330,1646084636,306,1576
3866832484,3674037967,1669352607,1669352795,188,1494
3612460883,3350872529,1659837756,1659838356,600,1545
3317431311,3685233592,1657289428,1657289510,82,1785
3486727273,3052822229,1642689789,1642689873,84,390
3321105707,3492657889,1662487625,1662488055,430,298
3246044882,3080734335,1649774990,1649775797,807,502
3882879531,3291667893,1660409784,1660410727,943,1712
3991046503,3195214383,1666831901,1666832393,492,19
3981065835,3923683467,1645926451,1645927193,742,1679
3733051386,3690586350,1667736136,1667736207,71,1531
3014983064,3612612273,1666874604,1666875431,827,982
3183867254,3105946115,1642862448,1642863382,934,713
3693920569,3752000675,1649376125,1649376270,145,583
3011981503,3445647826,1645369012,1645369283,271,1270
3904352989,3462072699,1642964113,1642964625,512,427
3578075354,3852017463,1645584477,1645584650,173,2421
3294094629,3256807270,1668492240,1668492335,95,997
3541413511,3921317746,1653939561,1653940301,740,645
3557643641,3143452523,1651887128,1651887560,432,2431
3357034260,3863676573,1655365865,1655365930,65,677
3350852842,3379756257,1641300427,1641301296,869,798
3468654589,3774816472,1661433540,1661433866,326,807
3425548171,3481881323,1669431081,1669431381,300,1746
3412501516,3891053268,1654645617,1654645722,105,1677
3104306511,3018612279,1656926262,1656927078,816,1739
3332797032,3032018734,1656272571,1656273305,734,1031
3707892765,3355195985,1642917295,1642917939,644,90
3933940005,3446289365,1658148399,1658149191,792,2297
3258352640,3973226891,1648578368,1648578626,258,1038
3165492854,3993122275,1658698786,1658699514,728,1533
3297123407,3821064356,1657011292,1657011470,178,2116
3993513856,3493752989,1661730889,1661731054,165,441
3906145952,3456295243,1664770432,1664771209,777,2388
3097982496,3333103680,1644801259,1644802099,840,1387
3645523523,3294094629,1646395500,1646396250,750,1602
3361365460,3958507465,1668721730,1668722543,813,1542
3511325003,3019669727,1642674821,1642675104,283,127
3920028342,3867026366,1660383148,1660383463,315,909
3890054358,3816567987,1649489523,1649490188,665,2251
3745248673,3657464089,1666593079,1666593388,309,1611
3319506258,3733484132,1652626606,1652627037,431,200
3058290794,3476882609,1659534385,1659534566,181,823
3134890095,3105357126,1644566545,1644566684,139,907
3965000413,3048781539,1665928169,1665929047,878,1505
3577216621,3542285714,1643741941,1643742709,768,2323
3132863382,3195629628,1643351316,1643351495,179,940
3620223775,3496470143,1649869894,1649870328,434,1792
3124476593,3787590278,1665062788,1665063191,403,1322
3475352970,3845980646,1656132141,1656132441,300,2384
3166284447,3060989519,1667264038,1667264802,764,2233
3040627958,3814355412,1660516421,1660516953,532,2315
3269629374,3273289104,1649495712,1649496427,715,375
3712211736,3243840165,1664488377,1664489266,889,513
3126778118,3705943924,1666967497,1666968200,703,1267
3605587138,3139928298,1655247636,1655248554,918,2224
3661037098,3039864595,1657579613,1657580527,914,981
3939973483,3625684557,1649335484,1649335913,429,1960
3755243698,3820885067,1667802718,1667803285,567,2203
3810573183,3472458500,1662126340,1662126768,428,780
3012272703,3249554278,1654821007,1654821257,250,2485
3223094732,3784629786,1644762606,1644763539,933,484
3832336338,3507338655,1655116496,1655117079,583,1758
3819541125,3985879853,1648130802,1648131062,260,1078
3123815439,3149046961,1664234698,1664235258,560,1165
3757624193,3630750697,1668085632,1668086175,543,1804
3645523523,3348113823,1648429390,1648429500,110,120
3637269987,3936292699,1657280214,1657280517,303,2164
3310169810,3532756620,1659373835,1659373874,39,847
3556577780,3403925711,1643443067,1643443142,75,2339
3876427301,3639695113,1642427706,1642428168,462,425
3549033213,3347462301,1664474243,1664474827,584,1653
3877299439,3154288650,1653961033,1653961922,889,1965
3036953061,3164789962,1649891941,1649892442,501,200
3818467247,3172130228,1648870604,1648870942,338,848
3375585327,3896594746,1658313548,1658314503,955,1256
3284832227,3876829785,1657352614,1657353345,731,1821
3031827531,3358374850,1646858753,1646859234,481,2130
3070117232,3569177433,1646749026,1646749219,193,33
3229321048,3113760926,1664701437,1664701659,222,2393
3408115806,3294635633,1663729673,1663730290,617,1369
3578655079,3786148014,1653998108,1653998523,415,1455
3232667530,3619660501,1657678762,1657679092,330,1494
3409568191,3582168015,1667797927,1667797993,66,42
3797259426,3356728242,1669444435,1669445050,615,94
3752289852,3243086924,1654653551,1654653957,406,583
3798563042,3011225738,1660594671,1660595304,633,1236
3152200344,3524482926,1651153061,1651153221,160,2176
3689020840,3333872407,1641582411,1641583408,997,908
3300994471,3143689256,1656122081,1656122210,129,913
3974758009,3259071830,1661281456,1661281821,365,1374
3176432386,3306378570,1645490535,1645490883,348,449
3313426081,3807887781,1642602603,1642602722,119,1303
3285303154,3870778205,1668115833,1668116158,325,2317
3968412854,3240324089,1643698566,1643699037,471,437
3293865251,3393314546,1659410707,1659410949,242,1128
3881578299,3806664868,1661684967,1661685141,174,949
3912803496,3926612159,1653674069,1653674952,883,1602
3129138715,3837904800,1658850635,1658850657,22,720
3336302831,3776939860,1654184936,1654185109,173,1120
3713404433,3412989654,1666679826,1666680548,722,2299
3514498367,3319601888,1653138988,1653139187,199,2176
3448378304,3463734539,1663025603,1663026319,716,287
3041386590,3683460040,1667541488,1667542114,626,1288
3625651694,3403933668,1649187105,1649187720,615,1893
3662040060,3865387894,1669014005,1669014628,623,2390
3673935826,3640949933,1655559558,1655559804,246,2451
3959497834,3728506494,1663852605,1663853545,940,2339
3133601374,3320187187,1666334459,1666334720,261,260
3223459561,3639090741,1657181683,1657182594,911,942
3244198823,3294783182,1641505398,1641505565,167,473
3753985186,3281445213,1653378884,1653379087,203,1608
3651271289,3407770585,1659594856,1659595424,568,204
3748085058,3536633962,1646635217,1646635599,382,1649
3837904800,3857931113,1668896374,1668896448,74,967
3660998516,3110591514,1660706448,1660707229,781,557
3627730665,3422703729,1647665313,1647665464,151,1754
3000254515,3124384203,1645804642,1645805510,868,2352
3682922389,3849701361,1660644020,1660644421,401,1261
3313782821,3749379310,1655821175,1655821500,325,821
3425804563,3491346910,1651770317,1651770989,672,1264
3307305290,3710786724,1668750056,1668750056,0,2178
3050229164,3255978821,1656976488,1656977394,906,1571
3657391976,3420137628,1650356482,1650357315,833,569
3023421632,3718882981,1644956907,1644957057,150,2220
3816561204,3480100868,1668279391,1668280343,952,1554
3244969283,3024431618,1652688173,1652688535,362,601
3863948017,3306871271,1660329379,1660329844,465,1315
3608512295,3903978752,1662221277,1662222162,885,2395
3956491451,3299821745,1649793530,1649794119,589,1663
3712630492,3897659334,1644740556,1644741255,699,318
3112357538,3918397944,1656126752,1656126832,80,1347
3955219063,3507952797,1665292225,1665292344,119,15
3412047712,3358571434,1666921006,1666921646,640,1176
3572276937,3180836532,1667721935,1667722854,919,2420
3911290843,3449114289,1651703669,1651704117,448,307
3407579711,3197466224,1664012792,1664012892,100,314
3858876644,3493393225,1651338787,1651338845,58,454
3607717009,3887342054,1644546428,1644546676,248,765
3490415118,3181047536,1664514044,1664514733,689,449
3194721041,3176753600,1643756064,1643756266,202,1359
3508340066,3536421569,1651907342,1651907413,71,615
3319782337,3159240548,1650331324,1650331623,299,1703
3430387951,3285303154,1646015048,1646015073,25,102
3485995293,3551810435,1658285939,1658286850,911,225
3733486808,3964637208,1648610551,1648611498,947,852
3473102313,3400211665,1659853782,1659854724,942,2208
3552101140,3033692011,1654081244,1654081949,705,1205
3891270072,3371818930,1646751417,1646752135,718,167
3415917688,3287399418,1645048406,1645048502,96,1260
3918602291,3077590635,1666006511,1666007081,570,1735
3258098890,3380313835,1669701069,1669701269,200,2114
3825900664,3718026583,1668844603,1668845228,625,809
3057756725,3557400406,1653401831,1653402220,389,1841
3457468984,3261837009,1667816949,1667817557,608,21
3201933010,3898494020,1654057359,1654057997,638,270
3094852425,3802823421,1666194266,1666194266,0,594
3629090721,3050244048,1650017935,1650018197,262,2027
3365340586,3024551635,1657441341,1657441727,386,64
3512662328,3642377610,1660077593,1660078542,949,497
3981817077,3720012234,1652435344,1652435472,128,1955
3423965711,3954185607,1654639854,1654640529,675,681
3546605941,3640571571,1648107072,1648107628,556,353
3464754983,3503393955,1652032076,1652032295,219,1754
3836535079,3365663032,1654665885,1654666474,589,2323
3682006274,3776942930,1658705536,1658705854,318,267
3159950284,3377086230,1664748059,1664748648,589,732
3857211245,3139928298,1659054387,1659054698,311,2472
3748492935,3086871623,1660217663,1660217676,13,1903
3962617141,3601240692,1642570720,1642571197,477,1094
3934489625,3215342018,1646765448,1646766005,557,228
3713520914,3788018778,1657417262,1657417566,304,1676
3921962724,3406332128,1648221210,1648221357,147,385
3112070783,3623294630,1659442784,1659443220,436,382
3604376955,3739490721,1650021518,1650022410,892,1588
3843576243,3003116947,1643523110,1643523230,120,575
3655786063,3271648296,1657950318,1657950501,183,1819
3304499678,3649774117,1669633063,1669633331,268,175
3414669089,3494372287,1659117465,1659117509,44,231
3664426298,3081641451,1666055448,1666055781,333,759
3206119800,3064804156,1651008539,1651009494,955,1603
3623206706,3732796331,1662081497,1662081826,329,1833
3551810435,3885893310,1647034604,1647034740,136,1880
3866158221,3408115806,1662665359,1662666113,754,2273
3004100055,3729787496,1650141095,1650141164,69,2043
3980207883,3642318884,1660625236,1660625649,413,2252
3000890083,3786724835,1668272111,1668272754,643,2199
3012822525,3625938415,1662116292,1662117270,978,539
3763300182,3731828976,1653018277,1653018890,613,1581
3568676955,3653183152,1652841457,1652842375,918,2175
3700737923,3449352254,1657867702,1657868664,962,509
3267600229,3913071555,1654193251,1654193950,699,2208
3874626130,3969355995,1646591340,1646591576,236,1029
3797295915,3133788020,1660164384,1660165164,780,261
3060310842,3150793263,1658656490,1658656933,443,1436
3481149583,3891235779,1650432980,1650432987,7,917
3358736286,3316952075,1667438475,1667438701,226,1300
3640508439,3344891111,1651742963,1651743048,85,1671
3115245083,3042461816,1668531299,1668531345,46,1553
3730984573,3675703241,1662868598,1662868629,31,318
3667528236,3584139105,1641774071,1641774834,763,2139
3581216621,3522963106,1649255405,1649255966,561,1770
3885194706,3671789954,1657339600,1657340567,967,30
3526798607,3683038464,1668575780,1668576206,426,756
3194070207,3170102962,1666088069,1666088844,775,634
3177851224,3232436630,1643614797,1643614857,60,2116
3494179125,3549431178,1649986193,1649987125,932,2129
3046526062,3490286406,1646162440,1646163121,681,1739
3114128222,3168984273,1649826613,1649827549,936,2403
3269699819,3003858315,1668742662,1668742683,21,1087
3637129082,3815718297,1666591087,1666591507,420,1900
3895332326,3145344208,1656609084,1656609757,673,826
3449504551,3415351222,1663085482,1663085483,1,409
3100440036,3397970538,1669608463,1669608709,246,616
3943927246,3757507821,1654247171,1654247721,550,681
3993504996,3795794957,1668991612,1668992577,965,684
3174639274,3771263439,1664776917,1664777448,531,2460
3171569619,3942399353,1658613666,1658614460,794,2224
3244599174,3081803809,1664448726,1664448842,116,653
3998728915,3619704547,1661697567,1661697987,420,880
3267045921,3506384176,1645667942,1645668218,276,123
3871971681,3562021711,1658877912,1658878186,274,1887
3645310975,3755243698,1644270533,1644271393,860,129
3887409378,3800392649,1651680375,1651681289,914,1977
3311252249,3952346496,1658441743,1658442610,867,112
3163986082,3278038835,1657204383,1657204433,50,1620
3117141664,3379937268,1659233338,1659234060,722,913
3188162412,3797930164,1654714704,1654715042,338,2230
3399552669,3521302995,1646589203,1646589407,204,1095
3361290885,3604757184,1666541595,1666541694,99,1766
3355942761,3953258545,1666116575,1666117094,519,273
3857590396,3346254669,1643849638,1643849870,232,1194
3744196402,3875243979,1663647089,1663647865,776,2296
3997050001,3989550849,1666994145,1666994778,633,1086
3456811507,3205554156,1648168679,1648169072,393,2279
3832252723,3366385571,1643945996,1643946245,249,760
3414719919,3429445014,1667717308,1667717988,680,1597
3587497382,3898391169,1669484766,1669485344,578,2225
3985513037,3439221238,1668576167,1668576256,89,1186
3661016961,3823206701,1655537029,1655537750,721,1102
3494544431,3116777827,1641027574,1641028206,632,2487
3321835417,3309242036,1649828237,1649828962,725,1261
3673743780,3680804477,1656145006,1656145967,961,715
3820070209,3699258770,1666422412,1666422429,17,5
3038630181,3248452729,1650976394,1650976470,76,2006
3900535275,3415788314,1641915799,1641916687,888,629
3077827896,3690633750,1642846976,1642847202,226,1208
3033523546,3473037406,1643734883,1643735259,376,1424
3620748135,3293615945,1644143264,1644144066,802,2495
3657464089,3796255141,1656307287,1656308015,728,1121
3985308319,3243873593,1649225063,1649225269,206,456
3331539245,3831426674,1644567524,1644567683,159,1575
3155044579,3210331889,1658913098,1658913558,460,2455
3670154961,3133788020,1655207471,1655208291,820,867
3018612279,3085429140,1664484948,1664485650,702,1583
3724977571,3256807270,1652677621,1652678015,394,1044
3482148686,3157765022,1649023655,1649023738,83,1112
3846493363,3348802129,1659179057,1659179411,354,120
3856160688,3688405055,1658318864,1658319318,454,1787
3783325820,3453431236,1649974158,1649974891,733,18
3154309446,3085136451,1659214248,1659214857,609,887
3233318289,3362148197,1657207223,1657207945,722,576
3020106315,3952425376,1650036168,1650036247,79,1088
3188726102,3471651838,1658554638,1658555188,550,955
3355418256,3036527901,1642724246,1642725080,834,2232
3003134699,3070557341,1645169548,1645170368,820,384
3445031830,3592974208,1643128270,1643128832,562,998
3205543673,3717899735,1649874250,1649874357,107,1684
3928685907,3064701445,1658121819,1658121900,81,2156
3464595898,3314872000,1641866239,1641866761,522,187
3374688375,3394220993,1651299778,1651300380,602,2147
3867115890,3159897010,1642886694,1642886940,246,145
3636808827,3029956642,1662912534,1662913147,613,657
3424453686,3516488694,1667315962,1667316493,531,2314
3649265606,3915336029,1658546658,1658547377,719,2021
3366189965,3066892936,1656380294,1656380488,194,1923
3930474522,3104164320,1660840774,1660841214,440,824
3791547480,3895332326,1645979312,1645980087,775,142
3002013720,3969744786,1660236820,1660237005,185,307
3380053573,3699152541,1663914757,1663915416,659,1949
3543256939,3204333859,1652367569,1652368179,610,912
3412715210,3682928814,1664128361,1664128725,364,1684
3143189190,3656878544,1649434038,1649434563,525,1864
3501972053,3948310967,1644171977,1644172616,639,1496
3100440036,3893227652,1651141667,1651142606,939,267
3622656083,3220903356,1655918495,1655918574,79,1704
3875343154,3336376139,1649285512,1649285777,265,505
3254473094,3957411858,1657277907,1657278636,729,1791
3836762535,3132584801,1645347276,1645348198,922,135
3398876044,3457417743,1659819532,1659820499,967,785
3986979175,3366558556,1667641569,1667642562,993,711
3030551637,3931230284,1664056701,1664056832,131,1624
3675429073,3102588374,1642747780,1642748755,975,1048
3294094629,3506733308,1666455119,1666455549,430,633
3889498156,3280372392,1645657221,1645657921,700,226
3187257156,3778824939,1659142762,1659143602,840,1945
3863697907,3039106188,1657441687,1657442416,729,2136
3979352608,3733051386,1652117488,1652117658,170,623
3370889279,3180051747,1657508815,1657509659,844,928
3272912522,3300063136,1659513150,1659513686,536,1161
3458243810,3043310672,1650596391,1650597116,725,1737
3149313426,3137594486,1641701651,1641702431,780,979
3195274844,3368423726,1642287876,1642288755,879,1188
3998329857,3976970303,1664862133,1664863052,919,1732
3150627841,3337967165,1644744418,1644745189,771,2328
3645625556,3921816397,1661896583,1661897377,794,1376
3257203631,3095559156,1646610640,1646611394,754,761
3154833958,3838250910,1647206693,1647207379,686,1712
3299821745,3524589150,1668808711,1668809606,895,1502
3430090428,3483254795,1652095209,1652095287,78,694
3347942747,3239620599,1662547147,1662547418,271,2362
3361508949,3153413554,1642079101,1642080018,917,937
3585495750,3430375744,1661368205,1661368223,18,1613
3440322150,3019512245,1667331378,1667331662,284,723
3862854265,3683326795,1669406894,1669407866,972,657
3602891052,3434090231,1663376870,1663377808,938,2343
3385413048,3489811088,1649334505,1649334525,20,1981
3697085492,3365289656,1658445318,1658445916,598,1074
3976730264,3427342650,1645517709,1645517804,95,886
3328146266,3512575951,1652678823,1652679257,434,2139
3499541432,3930124385,1658467222,1658468104,882,1980
3879605776,3692861248,1641460608,1641461020,412,54
3631152825,3486442976,1663138897,1663139691,794,1084
3487778655,3307949630,1641060726,1641060943,217,277
3071929787,3280491285,1662533376,1662533741,365,2341
3284829365,3574740304,1656778292,1656778690,398,1324
3741692259,3485695895,1643614303,1643614748,445,1127
3946911182,3553530817,1653656525,1653657117,592,2236
3081057659,3916456426,1647631595,1647632307,712,838
3721374677,3271876104,1656054325,1656055193,868,738
3604376955,3829597039,1667669477,1667669746,269,1067
3972294801,3995270744,1649507426,1649508114,688,179
3045570288,3069841199,1642442416,1642442502,86,1119
3492657889,3362091170,1648236639,1648237246,607,1977
3691834770,3853163109,1656980061,1656980071,10,1932
3509619062,3587833146,1644252045,1644252866,821,1970
3072734804,3035737560,1646377105,1646377474,369,2112
3462410204,3487778655,1653642192,1653642640,448,2065
3087700946,3182243157,1643509148,1643510068,920,1174
3815605229,3673550835,1665969831,1665970818,987,542
3087603397,3066053770,1652297217,1652297264,47,1445
3975198652,3660732427,1658208967,1658209932,965,1707
3767868249,3867115890,1669150245,1669150500,255,144
3702541874,3591834837,1668934238,1668935144,906,337
3697571838,3072911780,1662517686,1662517781,95,319
3310169810,3524109178,1660340441,1660340824,383,1279
3928852706,3061850950,1666222601,1666223545,944,2080
3184168205,3534517997,1664491485,1664492127,642,1826
3452920322,3408604990,1648446447,1648447256,809,610
3162405135,3175976694,1649822388,1649822643,255,1231
3491718080,3638803969,1643520443,1643521359,916,1736
3336657547,3048409719,1645960596,1645961428,832,1737
3458209928,3200468398,1644730501,1644731013,512,2468
3066305343,3187291408,1667732183,1667732783,600,2480
3672371563,3832144696,1669456827,1669457585,758,2180
3044483301,3267151775,1646176633,1646177071,438,1020
3137441705,3771841105,1656065907,1656066375,468,2138
3611777140,3069313994,1660954896,1660955056,160,1896
3287901684,3000600578,1660418078,1660418364,286,558
3462224632,3225989431,1653227678,1653228655,977,1741
3148259657,3558370114,1667535554,1667536352,798,444
3819547274,3278689627,1660669745,1660670132,387,194
3626672801,3994721189,1654834683,1654835310,627,1204
3549604297,3865781327,1667347260,1667348048,788,2230
3063744739,3365676412,1661846708,1661847605,897,263
3785657136,3218946191,1660811492,1660812311,819,525
3668174777,3327504995,1658763031,1658763230,199,1272
3359724083,3611982999,1653921988,1653922707,719,248
3768013956,3282950540,1655528222,1655528482,260,1899
3280491285,3082075242,1656719805,1656720336,531,1695
3763188005,3230843282,1666834326,1666834842,516,785
3880011397,3000725837,1668398992,1668399353,361,2382
3562104036,3641729236,1661077867,1661078106,239,1774
3057721767,3322801895,1652819753,1652820465,712,1738
3445095607,3246796194,1650046469,1650047181,712,447
3850474820,3193403424,1656540558,1656540954,396,1785
3159638305,3034288673,1642396269,1642396645,376,1
3435540149,3370779634,1649864744,1649865656,912,2198
3327795374,3991859515,1663807747,1663808582,835,2411
3569244680,3798447157,1664359314,1664360095,781,948
3090179745,3660575608,1650527965,1650528023,58,1846
3223313152,3867868879,1646234737,1646235703,966,58
3800239896,3298993308,1657173166,1657173989,823,1154
3615359439,3959093613,1646090341,1646090821,480,1890
3292572977,3130973015,1655217956,1655218455,499,1014
3522861132,3168655636,1648032926,1648033879,953,1865
3847638658,3767912489,1669627778,1669628731,953,1745
3790356065,3531574623,1652880434,1652880458,24,632
3871845792,3039081980,1661807394,1661807427,33,663
3887791096,3445530012,1668523993,1668524869,876,88
3035803277,3512720372,1650326608,1650326846,238,1713
3375966339,3785728567,1660716015,1660716771,756,989
3379285136,3149046961,1646130706,1646130953,247,1170
3904183865,3072219388,1666614506,1666614964,458,578
3672751607,3493489568,1657943002,1657943131,129,450
3250484759,3173230685,1647424079,1647424155,76,1916
3478362234,3679617161,1662532242,1662532352,110,138
3832703867,3175979112,1644536994,1644537933,939,739
3204508195,3195138141,1655776773,1655777756,983,679
3364586923,3643412582,1655526686,1655527503,817,153
3292869706,3888895982,1664505844,1664506690,846,1163
3980867331,3232285701,1667720260,1667720511,251,1706
3061619114,3042432058,1645267053,1645267982,929,1742
3498740809,3141137322,1662173232,1662173323,91,2397
3522715448,3207407283,1642922387,1642922555,168,574
3340486436,3940520472,1646905013,1646905515,502,2251
3147376468,3885026939,1648955987,1648956451,464,770
3210422873,3162641272,1645169402,1645169811,409,2147
3286129059,3741929805,1641612305,1641612561,256,645
3249305465,3084430345,1653392883,1653393115,232,2172
3232781077,3780546851,1656503974,1656504205,231,2488
3309468510,3638822670,1658623544,1658624395,851,1640
3726117061,3149818961,1656329889,1656330533,644,2146
3021006721,3172429422,1645008703,1645009098,395,76
3735098036,3197362399,1644096786,1644097000,214,510
3894030912,3771826410,1666395639,1666395911,272,785
3760047951,3289850617,1644541178,1644541197,19,1769
3879564460,3254991122,1653119677,1653119818,141,619
3981846169,3599104606,1648541680,1648541829,149,2415
3909281743,3515170949,1665400571,1665400931,360,829
3807440065,3304728211,1645159969,1645160875,906,1891
3024551635,3323109920,1642878127,1642878609,482,199
3005700539,3615595663,1649790602,1649790735,133,1335
3832640445,3749593178,1666384985,1666385606,621,2340
3777022057,3584704567,1668752402,1668752838,436,331
3223313152,3008968100,1652083525,1652083954,429,74
3253436330,3208770010,1669646524,1669646602,78,85
3927920093,3837904800,1662683094,1662683367,273,1484
3670112572,3019694538,1662312891,1662313887,996,1048
3253827804,3029807207,1653359990,1653360640,650,712
3945086462,3179354869,1647958936,1647959212,276,1409
3277372807,3505753274,1663996034,1663996062,28,839
3177879837,3724157579,1643975637,1643976519,882,1349
3211839563,3289850617,1652346437,1652347192,755,159
3391711118,3556061704,1643345746,1643346381,635,561
3632156948,3832370690,1660105648,1660106335,687,559
3218686367,3769269484,1654912835,1654913575,740,1171
3552494506,3916776869,1660671547,1660671627,80,1802
3913608544,3731828976,1654133954,1654134521,567,825
3428987981,3774264905,1660390346,1660391149,803,732
3913071406,3443190053,1647885874,1647886480,606,2355
3292010262,3008417861,1645009841,1645010557,716,531
3623802234,3608535655,1653630724,1653631135,411,2472
3470482542,3292797747,1644301663,1644302114,451,556
3018013930,3880046311,1660406249,1660406319,70,2114
3790635482,3089574886,1655621196,1655621212,16,1269
3222375785,3183672525,1648900726,1648900851,125,1789
3391324219,3366321387,1664775356,1664776106,750,2307
3878573707,3139882519,1648776482,1648776655,173,34
3088602459,3171731237,1666225717,1666226599,882,1296
3744726408,3665557228,1666637409,1666638240,831,1136
3124927662,3802790977,1653955737,1653956049,312,1904
3242622170,3952425376,1658858366,1658858590,224,1630
3762890946,3828810890,1647340892,1647340983,91,120
3008850935,3270935026,1665048376,1665048485,109,2231
3935936621,3169601604,1660758030,1660758236,206,1433
3126778118,3040563913,1666367796,1666368527,731,227
3124044009,3777597419,1642903232,1642903629,397,2358
3593487418,3551771231,1655753190,1655753285,95,171
3693862073,3596454426,1650242325,1650242497,172,504
3917709571,3584309667,1647537051,1647537473,422,1692
3367457506,3990233750,1667999696,1667999781,85,399
3359724083,3316496524,1648727265,1648728168,903,1387
3666174374,3092956442,1642281382,1642281388,6,409
3334207071,3137412000,1658447020,1658447498,478,431
3118533471,3200468398,1662079220,1662080062,842,2299
3084334078,3431883681,1666079447,1666079604,157,1919
3281397783,3968143962,1659281709,1659281792,83,1656
3890580849,3110649041,1665835186,1665835816,630,1326
3303418943,3822458181,1653895244,1653895310,66,172
3414719919,3367279073,1656476056,1656476454,398,2193
3018651462,3942862085,1647909042,1647909962,920,1694
3261403182,3292010262,1646950890,1646951675,785,1386
3254695387,3956887611,1657709251,1657709864,613,2014
3719084637,3443384698,1641864184,1641864284,100,1597
3327681313,3329463543,1646361684,1646361972,288,2146
3905999483,3407770585,1653669984,1653670683,699,1579
3395782360,3433261355,1665749750,1665750351,601,685
3955685340,3437665905,1668262383,1668263089,706,324
3011015055,3346261120,1650745670,1650746401,731,1726
3545188902,3595270507,1646867862,1646868758,896,1395
3371707067,3483666747,1647118549,1647119284,735,1855
3771028638,3522365623,1651663837,1651663903,66,1423
3058750967,3171307709,1646203969,1646204768,799,2406
3878810894,3498758411,1656601894,1656602018,124,628
3408978529,3102588374,1663524291,1663524320,29,1422
3098907787,3804768140,1657452822,1657453059,237,704
3494680258,3562472924,1645615960,1645616019,59,2488
3034601276,3616218859,1653430266,1653431215,949,938
3082912574,3051395031,1649690577,1649691558,981,384
3996469603,3823288349,1651450375,1651451078,703,2099
3210331889,3881578299,1664623350,1664624291,941,783
3353527086,3562110382,1643023154,1643023777,623,2045
3184270447,3954185607,1652716097,1652716849,752,40
3976992294,3280818938,1647588909,1647589714,805,1965
3225857817,3870779720,1642897283,1642897809,526,1139
3570747542,3436198180,1658029865,1658030674,809,1432
3152456543,3536954029,1656603531,1656603811,280,1103
3595469152,3151697582,1659646364,1659646926,562,222
3164122941,3169559952,1665302332,1665302455,123,622
3600901232,3235586138,1646865410,1646865961,551,178
3098891437,3881942272,1647444129,1647444174,45,1147
3195598526,3615595663,1650306750,1650306972,222,2462
3520872962,3181181141,1657854995,1657855308,313,804
3989646368,3511325003,1641779548,1641780196,648,2143
3501508123,3536903033,1663259174,1663259919,745,1974
3862138776,3116451556,1654865040,1654865897,857,2314
3059416141,3413334821,1665062120,1665063074,954,903
3853256957,3078216798,1647370185,1647370692,507,1132
3222438717,3447470600,1660275975,1660276808,833,824
3247590827,3543926712,1666115456,1666116184,728,757
3264879958,3713455058,1668980089,1668980664,575,1401
3086530794,3023259214,1668053722,1668054594,872,1835
3003861546,3823206701,1663912854,1663913160,306,2204
3527349190,3327253070,1643399023,1643399558,535,223
3506822540,3634885711,1662701306,1662701500,194,1294
3973440480,3800014504,1662800454,1662801161,707,2169
3794103075,3520511256,1644332791,1644333710,919,235
3250867562,3851327758,1653939029,1653939450,421,2434
3202625372,3888392286,1655092413,1655093394,981,1571
3747929255,3293504206,1648788041,1648788817,776,947
3365440817,3473394094,1650145576,1650145878,302,1769
3190969092,3024431618,1657449217,1657449999,782,2394
3273289104,3508514571,1646429057,1646429899,842,2466
3746969288,3227246451,1663936498,1663937319,821,639
3387785849,3477363517,1657856692,1657856722,30,1990
3617757019,3980781580,1650506346,1650506819,473,2451
3801736024,3132959520,1650846686,1650847455,769,707
3346012606,3838823979,1656146289,1656146997,708,1973
3411181030,3336300808,1649983230,1649983424,194,1577
3255149739,3645537857,1651998642,1651998826,184,2493
3553328177,3801768919,1667793626,1667793649,23,348
3729787496,3825824228,1659676812,1659676824,12,583
3487166896,3729340640,1662568157,1662568653,496,456
3652728312,3229881750,1644526666,1644527082,416,904
3206149175,3084855451,1656890527,1656890765,238,281
3508718004,3863665550,1662310874,1662311007,133,1729
3143293050,3696149430,1643289115,1643289919,804,173
3610930903,3510318605,1657826307,1657827103,796,927
3653285237,3903261473,1647889209,1647889796,587,58
3548351680,3611685224,1645640197,1645640854,657,1012
3118128782,3938272679,1668434834,1668435095,261,791
3129860388,3174425370,1663237487,1663237605,118,761
3022403169,3147512839,1646603771,1646604635,864,2098
3840962989,3522132687,1669192617,1669193477,860,2443
3391622565,3783051630,1649551900,1649552288,388,1876
3991087724,3435224460,1652880858,1652881822,964,1862
3663985085,3095661578,1655825713,1655826429,716,1759
3096471933,3413810353,1664651589,1664651931,342,91
3788911315,3441581446,1663994990,1663995479,489,2373
3786861325,3247163175,1647247235,1647247452,217,689
3786540807,3752133167,1657839566,1657839889,323,1575
3858150562,3306910493,1646356992,1646357244,252,1594
3494179125,3503489321,1651112245,1651113132,887,2129
3462026511,3451131159,1661152688,1661152820,132,2035
3218798966,3690633750,1662683954,1662684718,764,2244
3820855275,3749161560,1668912021,1668912217,196,1745
3122109326,3840422094,1655065485,1655066220,735,658
3205153391,3920875021,1651162516,1651163003,487,1226
3763270952,3342009927,1644263039,1644263725,686,1864
3895277580,3321105707,1668621243,1668621792,549,679
3031249180,3661642309,1657532856,1657533447,591,671
3595726436,3145344208,1652577217,1652577318,101,444
3933332705,3809041613,1646751007,1646751535,528,2066
3935383578,3767724034,1669591913,1669592376,463,2380
3401582775,3464770966,1656114082,1656114238,156,20
3980851662,3897433648,1664801458,1664802221,763,2246
3233938614,3364911803,1663241622,1663242622,1000,1353
3435319506,3183256246,1668940631,1668940713,82,1283
3840764880,3334483625,1657855289,1657855856,567,624
3171307709,3776944992,1664252740,1664253559,819,1008
3297963936,3232835207,1667357673,1667358455,782,2466
3014646091,3809965750,1652722232,1652722831,599,446
3879322451,3153541916,1651954394,1651955061,667,826
3910427189,3452181736,1648231012,1648231636,624,2249
3308891574,3974630210,1654880487,1654881375,888,1759
3949841652,3049869003,1663579112,1663580091,979,288
3681719344,3215453691,1656601268,1656601405,137,74
3246159564,3247551122,1666753614,1666753634,20,26
3411636309,3066067288,1641289049,1641289808,759,1161
3148691436,3373729748,1651183180,1651183352,172,598
3340933137,3948710872,1655467445,1655467777,332,1231
3655566080,3863676573,1644109930,1644110288,358,2042
3011593291,3073540574,1669108659,1669109522,863,1970
3972056646,3811164522,1643466950,1643467673,723,2302
3241549340,3596179079,1666155220,1666155231,11,2093
3284958290,3594795944,1664359969,1664360182,213,134
3651812819,3814577253,1644656359,1644656848,489,629
3575375841,3381060534,1668591312,1668592257,945,1260
3211839563,3898699023,1667633466,1667633488,22,649
3224864814,3193095337,1654475651,1654475779,128,1045
3878925459,3857852370,1649572940,1649573577,637,2490
3731588710,3446699030,1668713887,1668713982,95,1801
3097031283,3229060690,1648500335,1648501144,809,1844
3459090367,3786811867,1648475928,1648476336,408,1032
3269690639,3189038779,1669486040,1669486591,551,2091
3242912660,3722972444,1663025366,1663025962,596,1187
3687617825,3206119800,1650020465,1650021234,769,271
3677539420,3951158399,1649112166,1649112298,132,410
3381845607,3142777936,1641467349,1641467495,146,243
3002438521,3377855107,1659960460,1659960831,371,762
3129594470,3470570814,1665008778,1665009699,921,1204
3690349378,3683038464,1641285985,1641286975,990,1566
3550107804,3962746969,1662814024,1662814461,437,794
3192375486,3152537793,1643714033,1643714342,309,586
3774991953,3144175285,1643117920,1643118517,597,1988
3238270210,3077683954,1643514201,1643514240,39,2171
3797769846,3936122118,1653976773,1653977588,815,1638
3952620083,3271605522,1649091756,1649091915,159,341
3361652898,3790783685,1664355932,1664356704,772,2487
3928354041,3346778916,1654782011,1654782147,136,1906
3635854686,3772910484,1659057851,1659058058,207,153
3404945581,3459115924,1665405487,1665406404,917,1922
3470112947,3278612503,1654651428,1654652358,930,990
3540029077,3402804885,1655230186,1655230756,570,572
3679983127,3531842620,1660876920,1660877443,523,2080
3118807144,3441581446,1655319156,1655319592,436,1093
3544965463,3571793713,1656830464,1656830518,54,1309
3409949315,3970124384,1651974461,1651974548,87,770
3830408109,3216582576,1642409935,1642409988,53,774
3115928790,3549038219,1649077751,1649078709,958,1698
3223064733,3354912831,1654931786,1654931998,212,381
3583591867,3251409316,1644513656,1644514584,928,955
3940387270,3625979408,1654358498,1654358540,42,1942
3287175350,3798343786,1667325533,1667326084,551,2118
3446741935,3982268438,1645831753,1645832687,934,2466
3825023321,3526088150,1662948195,1662949013,818,564
3050817805,3152438109,1645583374,1645583458,84,353
3170844702,3573961768,1661452277,1661452290,13,852
3729553337,3484634326,1641683383,1641684156,773,2065
3662935617,3223518905,1660055117,1660055453,336,1108
3319446954,3910585793,1652817793,1652818018,225,1120
3058750967,3644164788,1664304750,1664305596,846,2443
3477243904,3087603397,1660028095,1660028214,119,2227
3313608055,3269865212,1661064456,1661064857,401,851
3539364028,3464625158,1667082265,1667083090,825,155
3603096470,3155835978,1665567562,1665567712,150,1114
3521217476,3094414065,1646209271,1646209825,554,1001
3749529134,3010531134,1668786688,1668786803,115,1996
3459115924,3347152834,1656719891,1656720115,224,2429
3981932099,3532756620,1642373731,1642374300,569,934
3937429867,3897712112,1658508500,1658509310,810,2342
3277521554,3413810353,1668176539,1668177143,604,1376
3449993526,3551344746,1659338277,1659338487,210,1001
3364540592,3140608489,1648556164,1648557000,836,2295
3383754736,3739555068,1662048527,1662048642,115,2242
3882134877,3364600039,1662708373,1662709252,879,1475
3261333996,3542078032,1650961483,1650962126,643,921
3145669202,3252187190,1657053416,1657054099,683,1557
3573961768,3806647877,1644193814,1644194410,596,334
3755085868,3444067052,1651484747,1651485138,391,514
3916928531,3644164788,1644182486,1644182631,145,652
3551104975,3271314900,1667511630,1667512541,911,2011
3183340735,3249261763,1666996407,1666997395,988,1222
3827170233,3188936143,1650557881,1650558250,369,2249
3347990376,3339962549,1643969255,1643969385,130,1062
3672070606,3750896410,1643152499,1643152642,143,2257
3723110330,3018838603,1662848298,1662848905,607,1249
3478280943,3881578299,1660841804,1660842766,962,1861
3278077270,3748988849,1651477044,1651477190,146,634
3112622637,3775948778,1648822453,1648822495,42,821
3316398180,3594269515,1668495901,1668496591,690,1658
3764724451,3864044700,1645916643,1645917105,462,1922
3641666820,3805665502,1661797207,1661798070,863,464
3343855888,3725611236,1659957259,1659957934,675,1129
3244918124,3085921604,1653851838,1653852481,643,821
3617958907,3683460040,1661370199,1661370347,148,95
3570906118,3886780901,1644141280,1644142017,737,2356
3758849561,3837877764,1664663791,1664664519,728,326
3925754107,3136707992,1656821561,1656821575,14,1643
3066053770,3256615260,1650660498,1650660836,338,697
3607393629,3556819852,1658904338,1658904717,379,2240
3118533471,3506143492,1662859426,1662859481,55,2367
3999228111,3200646968,1645844635,1645845268,633,1078
3782878084,3932002704,1659957773,1659957780,7,1119
3293761762,3425856728,1651258833,1651259220,387,406
3617795950,3396154732,1666748218,1666748451,233,863
3473571389,3819791378,1664077141,1664077397,256,475
3898118371,3349879521,1667352748,1667353025,277,1811
3840906120,3071322324,1660554026,1660554082,56,111
3512353520,3040219251,1646544973,1646545566,593,1866
3705247337,3165129580,1654754231,1654755224,993,1995
3046127876,3791510494,1663731594,1663732504,910,2030
3901459563,3487387362,1653894900,1653895112,212,2203
3923137418,3315951327,1662212133,1662213027,894,1688
3291667893,3343048708,1667571323,1667571575,252,49
3985734621,3070520574,1641795442,1641795695,253,898
3202745117,3650444993,1647766267,1647766448,181,589
3066757468,3887305908,1648025006,1648025561,555,2122
3814620482,3135665687,1650137494,1650137867,373,2103
3389472671,3649774117,1669732546,1669733347,801,787
3687724937,3550677109,1649273063,1649273423,360,213
3324618357,3349301564,1662386169,1662386803,634,250
3951158399,3108139225,1652204974,1652205758,784,2298
3928572443,3445023517,1641892346,1641892872,526,938
3790039057,3971926686,1641452585,1641452880,295,260
3474242977,3309922968,1665048164,1665048823,659,1111
3944247629,3109959336,1650796843,1650797589,746,115
3268916307,3637412110,1666977999,1666978201,202,1621
3616094004,3403786938,1668710499,1668710808,309,2291
3347990376,3361319934,1668337103,1668337970,867,112
3716257088,3254194915,1647928782,1647928864,82,887
3911671645,3019750416,1660983412,1660983570,158,219
3333872407,3038035861,1649652421,1649653054,633,2195
3718026583,3328544337,1662931720,1662932299,579,99
3667684695,3658910038,1645678402,1645678404,2,1908
3910760009,3040627958,1652000997,1652001768,771,1610
3903886201,3541413511,1647781321,1647781970,649,162
3336965818,3115344578,1663414872,1663415535,663,2194
3730984573,3774823325,1662298485,1662299032,547,2418
3112859411,3405388298,1667531627,1667532240,613,2192
3300104659,3070810251,1665408390,1665408752,362,1292
3909278547,3434351368,1669662185,1669662994,809,2398
3522623156,3256628168,1643407279,1643407519,240,2080
3891235779,3798343786,1662922242,1662923142,900,1479
3957798687,3265434991,1649357925,1649358555,630,1336
3620787716,3616094004,1648681421,1648682001,580,138
3926699428,3501732936,1661282560,1661283188,628,1305
3640571571,3140488273,1660462241,1660463177,936,2186
3672694122,3112357538,1668711722,1668712102,380,1853
3105259495,3450102071,1645671389,1645672196,807,2448
3414834461,3419783275,1651700941,1651701843,902,1871
3756020689,3795494127,1667693098,1667694044,946,1809
3792117640,3446812207,1663707874,1663708524,650,2408
3732472752,3133153956,1642363184,1642363920,736,379
3084531614,3459115924,1644664873,1644665065,192,1925
3830053941,3003617799,1657515342,1657515960,618,960
3488962022,3087662482,1648177343,1648178135,792,365
3638281686,3770061469,1658659810,1658659841,31,1907
3598841094,3920436432,1650823278,1650824156,878,1495
3650444993,3016616906,1665576389,1665577178,789,390
3211965606,3993066194,1642670356,1642671328,972,1456
3878177076,3501308694,1643424152,1643424362,210,860
3774413169,3185444969,1652246424,1652246586,162,2321
3217029107,3891258957,1658119726,1658120602,876,505
3456660113,3066451739,1662572780,1662573445,665,2299
3433439185,3895861447,1642896462,1642897373,911,1537
3535575355,3304490341,1651436633,1651437534,901,287
3904825547,3375359100,1641011458,1641011625,167,355
3737809844,3282950540,1658829606,1658830467,861,743
3655498745,3244918124,1645579616,1645580552,936,1492
3840953967,3728924033,1651129032,1651129437,405,318
3091108616,3807440065,1647439914,1647440214,300,499
3114812192,3297001171,1661118932,1661119287,355,829
3114183830,3506187447,1668405076,1668405754,678,1578
3665075758,3167074299,1647431981,1647432225,244,596
3913905115,3388814364,1660593165,1660593289,124,1237
3253436330,3310953839,1661672407,1661672571,164,1223
3275494433,3731116644,1655066028,1655066054,26,878
3540737045,3484264209,1649677906,1649678436,530,366
3564198089,3059151355,1649670668,1649671170,502,675
3556848299,3825426771,1657722343,1657723114,771,2329
3731206373,3082075242,1665876668,1665877121,453,1994
3639121807,3633544934,1657932260,1657933022,762,1601
3970049421,3703534908,1644927970,1644928751,781,634
3632156948,3133788020,1653286853,1653287368,515,843
3943622737,3871851890,1650445859,1650446804,945,80
3420520626,3830975217,1651351548,1651351687,139,463
3460552791,3764318951,1650374712,1650375677,965,1382
3273258651,3379076226,1658605707,1658605877,170,271
3773996198,3344549344,1664641515,1664642183,668,312
3725611236,3407150254,1656659390,1656660313,923,1922
3323217825,3046510463,1667164396,1667164855,459,1673
3655566080,3612556887,1656699716,1656700398,682,16
3424431005,3479778946,1651595528,1651595758,230,47
3307926705,3573158941,1658631476,1658631731,255,1709
3188384391,3735547050,1641118041,1641118682,641,996
3207309302,3900571767,1665427801,1665428179,378,652
3132376039,3826502515,1653396460,1653396762,302,443
3289255457,3035158102,1647638964,1647639217,253,99
3161784330,3391441349,1663747931,1663747986,55,1408
3995299995,3405346555,1644071141,1644071223,82,2302
3342315965,3294478149,1661706762,1661707104,342,834
3595738872,3403925711,1661675876,1661676534,658,1639
3257690557,3878573707,1665416347,1665416463,116,374
3036470049,3816538946,1642560873,1642561398,525,1423
3043736420,3934988354,1650766842,1650767427,585,2344
3969110896,3050341848,1653570659,1653570802,143,2003
3406868680,3366896849,1667347820,1667347939,119,628
3581324538,3629207282,1643095946,1643096304,358,765
3932613929,3487740667,1643275365,1643275719,354,988
3243231806,3404034127,1660175628,1660176282,654,1034
3188588023,3809041613,1655172633,1655173046,413,717
3456546904,3829606187,1642097119,1642097246,127,2166
3707767360,3897212070,1652683900,1652684788,888,1114
3187523092,3705217157,1668467692,1668468405,713,1655
3583864167,3917500425,1667138237,1667138263,26,2448
3122293667,3322801895,1662535687,1662536509,822,1260
3740009683,3685715658,1654908270,1654908529,259,433
3678624517,3360040841,1658931221,1658931376,155,1312
3298993308,3822143503,1668766539,1668767099,560,125
3700167321,3595270507,1642145812,1642146483,671,1699
3135211724,3521410258,1655388931,1655389930,999,2275
3804458349,3713482005,1662534219,1662534721,502,1737
3748988849,3910837040,1664912383,1664913207,824,11
3108566218,3198527442,1664129489,1664129998,509,302
3502316165,3772340083,1654645707,1654646437,730,664
3845010730,3890161181,1647421090,1647421413,323,1660
3852633699,3325735480,1658728073,1658728214,141,911
3828890005,3492215792,1648641278,1648642211,933,1605
3702671465,3343153937,1662620943,1662621758,815,1142
3567637602,3805826972,1665908034,1665908998,964,1008
3404200815,3070199722,1655079354,1655080271,917,875
3233823273,3506822540,1644972172,1644972612,440,2000
3152518339,3072347750,1654051645,1654052188,543,543
3139126728,3010767150,1650764331,1650765196,865,2465
3569443529,3153518026,1664166488,1664167101,613,1944
3277978979,3645868952,1666620996,1666621122,126,1021
3794575914,3034643506,1653722423,1653723046,623,866
3115344578,3057085790,1665365392,1665365393,1,1269
3357034260,3210071519,1655093419,1655094325,906,1690
3816026938,3971180079,1644382107,1644382895,788,1108
3721977473,3145045320,1665526678,1665527155,477,2489
3054758455,3802614854,1669098807,1669099457,650,2193
3500201376,3719744431,1653935434,1653935470,36,1350
3537294800,3573915559,1657864064,1657864226,162,1601
3429328367,3925523737,1659238834,1659239420,586,1589
3701103798,3828322397,1645879352,1645879684,332,2241
3454276568,3148256129,1656453301,1656453844,543,1233
3261128926,3991046503,1666680766,1666680931,165,2382
3349666443,3378948752,1650237061,1650237359,298,1799
3041296119,3220690215,1655062531,1655063457,926,1056
3569006301,3753483202,1651709878,1651710207,329,774
3512575951,3831838984,1643906189,1643906422,233,725
3710708040,3344455273,1666716699,1666717470,771,1549
3170579908,3390431277,1649715475,1649715732,257,261
3919489244,3565287194,1650448323,1650449213,890,992
3414669089,3041652512,1644624019,1644624919,900,596
3310582583,3754292816,1668811626,1668812419,793,67
3232781077,3421730413,1662826261,1662826597,336,1985
3537787770,3181236848,1660338370,1660338799,429,1832
3158894896,3104164320,1648991364,1648991854,490,1178
3100670764,3263488499,1647900037,1647900647,610,1788
3171413650,3514498367,1658497159,1658498089,930,380
3915206176,3013073909,1655393088,1655393390,302,1231
3457361080,3172773924,1650738020,1650738664,644,1523
3822693340,3082434177,1652277045,1652277882,837,140
3861496190,3586734200,1653727969,1653728040,71,957
3080454518,3324395012,1663512646,1663513610,964,1608
3439129317,3776429592,1650327378,1650328050,672,2430
3266666808,3277372807,1665821379,1665822217,838,1221
3849201069,3542078032,1653987775,1653988037,262,407
3022428512,3746979257,1659637566,1659637663,97,2024
3232835207,3894036055,1657171068,1657171209,141,35
3290176410,3278297907,1665767757,1665767875,118,100
3936821313,3985159412,1643230793,1643231046,253,1585
3106584115,3988546259,1642730135,1642730775,640,1940
3937077335,3711314965,1646129018,1646129687,669,378
3302455172,3143189190,1659110072,1659110927,855,1398
3979696807,3673550835,1669747390,1669747471,81,1193
3911632634,3671971306,1668872879,1668873232,353,2368
3947461796,3847957207,1656871642,1656872205,563,916
3287714636,3807922855,1661110757,1661111015,258,1607
3715231431,3264753140,1666723631,1666723816,185,643
3156942626,3643939596,1651288926,1651289113,187,2280
3663814997,3978925529,1665314482,1665314619,137,1255
3819770312,3385806632,1656066153,1656066153,0,1304
3698025795,3500097822,1642893167,1642894026,859,1797
3002396640,3620639101,1645745798,1645746458,660,2047
3750949753,3565278029,1649752369,1649752740,371,730
3156483651,3459115924,1656614631,1656614778,147,1669
3190906256,3799078288,1661288742,1661289468,726,943
3098179768,3784046500,1663091689,1663092298,609,500
3679065090,3576100130,1666395489,1666395968,479,1795
3051654064,3434010912,1642200825,1642201736,911,1010
3241392393,3617533561,1656466421,1656466422,1,444
3104396432,3289402711,1664814483,1664814903,420,210
3284137438,3662526382,1645548032,1645548692,660,2200
3993066194,3721751204,1646109264,1646109808,544,1182
3715894883,3111823829,1654828558,1654828897,339,1721
3035476619,3674335911,1644645985,1644646715,730,2454
3571897260,3740102481,1667295847,1667296155,308,1556
3908443461,3225477579,1666231752,1666232442,690,631
3113427537,3129792187,1642021187,1642021518,331,1030
3267968478,3948946969,1659804610,1659804926,316,1026
3809332572,3642691052,1662640452,1662641137,685,2312
3485815053,3888260346,1646000881,1646001751,870,1899
3885194706,3700737923,1641448905,1641449250,345,1666
3428325312,3924577071,1641263852,1641264215,363,1010
3377798373,3011593291,1649249755,1649250579,824,1261
3260861147,3404904674,1642276542,1642277498,956,1787
3375279811,3381398230,1661801244,1661802178,934,1200
3390532209,3492215792,1664203440,1664204056,616,2234
3437309077,3070795112,1663656206,1663656829,623,1098
3523508617,3633080652,1644789857,1644790225,368,161
3674349184,3530286335,1668467635,1668468397,762,225
3178643457,3328993418,1667245288,1667245803,515,1910
3630744403,3195274844,1651661492,1651661951,459,1250
3096854657,3647640857,1647343670,1647344293,623,1154
3226298244,3852017463,1654518700,1654518839,139,41
3967147343,3798563042,1662418093,1662418573,480,971
3006085284,3965434074,1660706863,1660707586,723,1887
3576386271,3897293094,1657567752,1657568181,429,298
3795264165,3127783768,1651200183,1651200515,332,2331
3690171214,3380053573,1644287507,1644287612,105,2089
3244398882,3009781198,1665173099,1665173839,740,1702
3620700244,3993994586,1665811451,1665811680,229,823
3682803273,3791107997,1659434586,1659434931,345,1548
3087123320,3452275962,1642198464,1642198903,439,2417
3625691221,3564198089,1654615605,1654615866,261,2362
3267479523,3331336589,1662596437,1662596895,458,401
3876829785,3248395971,1658308775,1658309385,610,2105
3829201459,3591834837,1650941107,1650941505,398,288
3257034858,3377798373,1644715846,1644716122,276,183
3521112560,3465064732,1654647286,1654647564,278,1411
3069841199,3097145374,1662377076,1662378073,997,1233
3578298884,3879898101,1655256807,1655257422,615,583
3066588932,3719763865,1648697166,1648697528,362,45
3047922240,3832438123,1659063505,1659063600,95,1902
3571145656,3314240169,1666552365,1666552496,131,25
3117816089,3929305160,1654577868,1654578797,929,2204
3937618865,3816567987,1667543407,1667543967,560,516
3114605564,3373962186,1650854896,1650855663,767,1247
3267248595,3506090868,1644454795,1644455677,882,378
3237245622,3772910484,1661987098,1661987932,834,1950
3537294800,3125008218,1664580815,1664581703,888,1326
3597403559,3063782933,1669410199,1669410372,173,148
3150793263,3012845933,1646386324,1646386391,67,1404
3747929255,3142160799,1650242126,1650243033,907,2392
3594009328,3167074299,1653333052,1653333378,326,2057
3983711613,3382840804,1668449259,1668449611,352,2456
3741273371,3308256167,1661596189,1661596764,575,1631
3756806050,3307949630,1667195074,1667195531,457,1266
3022403169,3793298032,1643402009,1643402516,507,1878
3915772795,3413305965,1656797951,1656798804,853,837
3790180006,3938776287,1659710606,1659711407,801,1834
3979550486,3434833146,1643263810,1643264352,542,401
3359046521,3192472683,1650475325,1650475445,120,1961
3627902900,3641959079,1664142059,1664142869,810,533
3389097842,3094940809,1653985654,1653985658,4,2412
3432910993,3290481654,1644544647,1644544909,262,2404
3028886204,3979558738,1655427766,1655428600,834,613
3166274990,3075519908,1661602035,1661602694,659,1605
3105357126,3538823780,1660596721,1660597262,541,1514
3666931632,3677306151,1666573001,1666573422,421,436
3989991456,3150067482,1662935369,1662935974,605,1016
3123781164,3264993323,1649093212,1649093524,312,559
3050867171,3719146348,1649536753,1649537635,882,2271
3128839608,3011158212,1669742491,1669742660,169,1202
3046080865,3014275222,1651019741,1651020147,406,1786
3167142908,3011459628,1642402675,1642402846,171,1727
3018756378,3066639403,1653883655,1653884175,520,204
3452391459,3818453534,1653472342,1653473089,747,557
3800271865,3077346044,1652293327,1652293754,427,283
3724116295,3101161243,1656369956,1656370710,754,125
3888856112,3126995401,1663382545,1663383096,551,263
3233425442,3666486477,1642551930,1642552603,673,1991
3848272906,3359895223,1646847683,1646848172,489,1765
3092564684,3223174482,1660196236,1660197055,819,470
3637993177,3514152633,1653401297,1653401973,676,1004
3730845439,3544772636,1667651385,1667651468,83,718
3653286489,3318227153,1657821336,1657822231,895,1753
3573975780,3285333536,1660892648,1660893264,616,723
3645666563,3590627159,1653423694,1653423914,220,1368
3048402049,3687307113,1660526654,1660526966,312,2426
3003861871,3389560959,1648741027,1648741581,554,660
3240839516,3690518174,1668802355,1668803007,652,1192
3604881190,3628963667,1655324629,1655325491,862,1795
3358374850,3024554792,1650280910,1650281866,956,2152
3468324129,3968564476,1656053185,1656053745,560,354
3250824932,3261128374,1659472813,1659473055,242,895
3064574238,3181048786,1666906252,1666906349,97,2035
3694006679,3727981782,1659069460,1659070262,802,1291
3814572709,3341897848,1654496420,1654496625,205,2143
3663038239,3774413169,1650467096,1650467697,601,983
3216667034,3863485115,1644231566,1644231847,281,833
3151923668,3365807352,1660295937,1660296425,488,788
3542832965,3609029368,1644029272,1644029641,369,451
3117141664,3160963185,1667997426,1667998168,742,1340
3639035607,3067220098,1648768510,1648769362,852,928
3985825297,3385760763,1652414736,1652414740,4,2396
3439129317,3066892936,1660864010,1660864250,240,699
3641493201,3586405616,1647427037,1647427193,156,1930
3155835978,3157546931,1665017893,1665018821,928,50
3815779833,3897293094,1644202103,1644203005,902,609
3552305242,3994844749,1644766916,1644767527,611,1504
3701979416,3896091695,1650386091,1650386144,53,1594
3637518238,3615137704,1648909519,1648909967,448,1274
3264865965,3882134877,1663307442,1663308272,830,1401
3141196312,3087850405,1662012911,1662012981,70,115
3392121294,3058951367,1642313254,1642313937,683,142
3770388331,3524508110,1659883395,1659884348,953,180
3520324090,3938973292,1656713367,1656713536,169,1444
3215443177,3833230225,1645399317,1645400032,715,1397
3451249074,3242912660,1663125135,1663125904,769,1787
3683361867,3347896915,1666137344,1666138240,896,91
3123999917,3280717680,1666758881,1666759098,217,2176
3840807781,3389926670,1662088792,1662089763,971,2137
3080007856,3513193858,1654272878,1654273501,623,1553
3915344164,3521944506,1667784155,1667785025,870,1987
3211064928,3414719919,1652512791,1652513417,626,84
3939755962,3367865740,1654132218,1654132393,175,591
3457191473,3691367177,1657437101,1657437702,601,943
3622596133,3494179125,1666084171,1666084719,548,820
3580280923,3064522150,1669234464,1669235370,906,1848
3504258562,3835355277,1657520685,1657521210,525,2162
3739555068,3463135439,1647968665,1647969121,456,1679
3855900879,3093364150,1660120715,1660120897,182,752
3417820101,3144405714,1667251705,1667252202,497,1306
3074928223,3114733025,1667614546,1667615247,701,1274
3559023463,3892142252,1666822387,1666822843,456,1525
3318466045,3734579045,1667220242,1667220809,567,2254
3012929490,3827461144,1659426359,1659426401,42,1269
3823692648,3682993605,1666298976,1666299583,607,2228
3859249968,3644100988,1666543498,1666544190,692,720
3224309877,3748850384,1643519548,1643520331,783,84
3370164589,3426004964,1667466175,1667467101,926,853
3927388172,3508514571,1663004971,1663005052,81,1692
3888757366,3056267922,1661945869,1661945921,52,1878
3319583055,3744871116,1665630848,1665631323,475,276
3880298832,3204359619,1660474772,1660475139,367,910
3528288695,3350345176,1662360626,1662361508,882,1910
3675418278,3354200745,1660718982,1660719827,845,240
3957824946,3211015636,1664820987,1664821853,866,1171
3315218003,3911316683,1662206322,1662207001,679,2144
3051654064,3084882941,1641292684,1641293564,880,588
3755243698,3082255761,1661889092,1661889188,96,1121
3536080615,3276142713,1656048078,1656048238,160,1187
3040563913,3310882037,1641948070,1641948346,276,1190
3457361080,3118533471,1666346023,1666346253,230,1512
3897293094,3435698448,1658245008,1658245396,388,1702
3585674939,3427405967,1648539048,1648539970,922,26
3276771725,3416196153,1664892876,1664893638,762,659
3426617058,3822143503,1646654767,1646654790,23,2322
3507338655,3086084685,1651816264,1651816502,238,1983
3427342650,3759867623,1668015595,1668016231,636,2252
3565056675,3975096180,1650251908,1650252389,481,258
3905969199,3675093452,1669651864,1669651939,75,1385
3561562385,3508311968,1647970851,1647971821,970,634
3749619105,3700896206,1641449984,1641450627,643,1128
3270395343,3801736024,1659267925,1659268863,938,847
3063714742,3641983006,1654527893,1654528540,647,225
3497079704,3670709726,1644037774,1644038145,371,387
3888312656,3702178313,1654601926,1654601988,62,951
3661494924,3220424979,1669506558,1669507405,847,2124
3537943189,3672699331,1641657476,1641658347,871,2089
3328922333,3233375810,1661872468,1661872618,150,380
3677574672,3829986472,1647065224,1647065875,651,652
3729340640,3829729960,1668275259,1668275904,645,1005
3071850041,3255149739,1649762165,1649762631,466,2281
3448459810,3141635102,1642193986,1642194392,406,2161
3231501792,3608200385,1644783008,1644783251,243,2194
3318227153,3336376139,1643760280,1643760723,443,1090
3906024837,3981273706,1647759581,1647759592,11,1571
3759510872,3773505782,1649411961,1649412370,409,46
3401677898,3292812509,1644385614,1644386273,659,1539
3403223215,3368654717,1663210336,1663210473,137,526
3868873330,3112217806,1669408273,1669408623,350,418
3932077086,3104816625,1649357576,1649358096,520,412
3967727550,3879520142,1657030157,1657030533,376,736
3766160943,3644961840,1641431220,1641431513,293,1611
3867214487,3163470555,1669425462,1669426113,651,181
3752522830,3747621620,1648424258,1648424777,519,849
3528467648,3499272388,1660991925,1660992910,985,54
3741681613,3663884600,1662458845,1662459258,413,1852
3963134791,3514498367,1663796684,1663796932,248,1194
3885849262,3037577001,1650337651,1650338403,752,2088
3890852478,3164122941,1651047651,1651047779,128,648
3520523282,3911364139,1652348672,1652348916,244,1476
3345413125,3511397819,1662712963,1662713784,821,380
3651055879,3830330372,1668660428,1668660438,10,1789
3002316212,3715994986,1655786981,1655787093,112,2433
3515941468,3564026629,1660512976,1660513020,44,1403
3877299439,3983988321,1666549152,1666550008,856,289
3786322776,3673735088,1655634111,1655634655,544,1669
3810861883,3064701445,1654016989,1654017738,749,1173
3399235044,3471797400,1642487603,1642488200,597,2331
3049579265,3295262122,1645286447,1645286901,454,1841
3585982995,3867860336,1662058915,1662059111,196,1733
3104719783,3000275416,1668413304,1668413834,530,2310
3670291498,3554862003,1660266994,1660267751,757,1896
3597661669,3911290843,1653901969,1653902462,493,2448
3511569871,3849977339,1664432985,1664433974,989,393
3553096192,3841660750,1647394478,1647395297,819,2084
3298770258,3687724937,1659278056,1659278714,658,1038
3942965206,3941548978,1667917247,1667917555,308,259
3406595083,3842413213,1659123521,1659124444,923,550
3026209549,3895855296,1664346098,1664346918,820,2298
3172293659,3291394293,1662943964,1662944514,550,1272
3415761431,3654861844,1647038630,1647039533,903,1902
3799776825,3630966486,1669251844,1669252731,887,1631
3047126246,3114348300,1647623622,1647624005,383,2016
3185210514,3255751346,1668829409,1668829419,10,419
3242857629,3255460937,1657229871,1657230153,282,1298
3191460519,3616803531,1663610220,1663610310,90,2092
3798343786,3547923552,1653538788,1653539382,594,1091
3660754603,3280717680,1645619887,1645620641,754,107
3761584126,3814029511,1669073373,1669073590,217,1055
3641682706,3876927357,1661530280,1661531140,860,2240
3278792522,3419422052,1648667741,1648667909,168,549
3208802379,3307636200,1641500386,1641500500,114,1409
3572896327,3960908616,1643415774,1643415965,191,654
3599869347,3507644528,1646521259,1646522234,975,618
3342054027,3365094410,1646863190,1646863591,401,999
3783304213,3777022057,1666224834,1666225611,777,1299
3912183552,3571348230,1641397448,1641397569,121,1854
3517260537,3019572992,1650818956,1650819643,687,1622
3459708884,3797484306,1667951010,1667951755,745,1092
3791894034,3291667893,1660572935,1660573413,478,930
3903321481,3721374677,1646018661,1646019344,683,2076
3862528538,3963841091,1645135029,1645135568,539,32
3611657912,3412989654,1650964396,1650964462,66,1565
3091595739,3256628168,1661948910,1661949607,697,1687
3880353584,3895842487,1643875118,1643875203,85,1440
3320039544,3549482615,1669361018,1669361590,572,1128
3255904598,3976223971,1657289878,1657290799,921,1113
3676132016,3709736172,1668197818,1668198498,680,1697
3982058383,3339385127,1659520961,1659521179,218,1233
3408300554,3469583371,1654209408,1654209863,455,2477
3595984663,3649252503,1654838737,1654839101,364,1374
3445469609,3807785088,1645405895,1645406502,607,704
3567368088,3966770982,1660595632,1660596247,615,473
3303025505,3952185527,1653208397,1653209096,699,1755
3829597039,3649649514,1662473656,1662474228,572,1190
3487475790,3750765878,1653416801,1653417690,889,26
3767508362,3538692457,1649725183,1649726137,954,446
3055050795,3668625909,1644802033,1644802264,231,102
3028710587,3532355049,1651285104,1651285803,699,1095
3892336923,3802816973,1660551706,1660552015,309,1937
3647263296,3178235505,1647324537,1647324881,344,1399
3516865615,3508858140,1647287578,1647288573,995,400
3034147055,3213995449,1654194323,1654194797,474,1031
3786478382,3080853733,1657596451,1657597180,729,523
3710851755,3684926586,1644282970,1644283168,198,705
3131156982,3169072505,1661958188,1661958615,427,1399
3077552507,3450023391,1655330041,1655330809,768,742
3310037244,3670291498,1659628238,1659628587,349,2154
3250208944,3473571389,1668424645,1668425459,814,821
3414258502,3295020761,1667566339,1667566536,197,1912
3934890046,3824845857,1653747023,1653747256,233,2061
3285243887,3976335280,1657175218,1657175554,336,1238
3882603510,3319782337,1649594474,1649595121,647,826
3696432858,3800566657,1663300197,1663300580,383,122
3805921576,3197201691,1648922634,1648923207,573,2214
3487526777,3381821132,1662970550,1662971275,725,1928
3002971802,3099424302,1656043081,1656043742,661,1237
3752652141,3939768853,1668873610,1668874346,736,394
3142869544,3093523046,1659088806,1659089427,621,1538
3079219552,3744955044,1646827864,1646828517,653,893
3862939959,3334965309,1662054052,1662054909,857,92
3418662987,3299211422,1661916107,1661916793,686,955
3840558415,3104164320,1651400236,1651400439,203,1135
3166483466,3242752835,1662114074,1662114947,873,136
3979552361,3669386720,1667168677,1667169513,836,875
3913071406,3437983939,1644299418,1644300079,661,980
3980675077,3164942448,1644664843,1644665275,432,2374
3241007838,3414224162,1660246487,1660247052,565,1038
3393552322,3562004989,1667667940,1667668560,620,474
3178732875,3387170357,1655096676,1655096736,60,552
3433418040,3054865222,1660051426,1660052207,781,2299
3422703729,3442967650,1657283347,1657283924,577,2452
3713520914,3105460297,1664360681,1664360863,182,2304
3126987673,3946815972,1653517687,1653517870,183,1020
3600692380,3620013325,1664798402,1664798663,261,1614
3693129961,3103740757,1658318811,1658319219,408,649
3940914301,3695161514,1652296419,1652296485,66,1280
3060522981,3271885744,1650792151,1650792976,825,869
3539571109,3351277781,1658519778,1658520633,855,60
3579921083,3802410450,1653460420,1653461255,835,2186
3313252249,3063744739,1666588725,1666589364,639,1128
3098513510,3312580754,1645704442,1645704843,401,1681
3012034151,3047629830,1651794383,1651794693,310,256
3469583371,3042943074,1660844662,1660845167,505,1734
3003321686,3035838196,1659558910,1659559247,337,71
3386490201,3720475877,1648488809,1648489466,657,1923
3463003824,3219440900,1666608770,1666609725,955,1687
3804657904,3785256634,1651808660,1651809012,352,2444
3045016501,3442725932,1659708029,1659708651,622,2184
3549482615,3012032774,1642962746,1642962876,130,1129
3823790407,3750949753,1664349834,1664350368,534,1747
3194142427,3534726913,1652872441,1652872743,302,218
3191792012,3471587065,1655186963,1655187617,654,1673
3956027073,3124964775,1642517416,1642517418,2,1155
3592026567,3749266673,1643633637,1643633709,72,2201
3616173127,3666380447,1653384397,1653385268,871,311
3197362399,3668552386,1655451156,1655451907,751,1048
3788498920,3072734804,1667478792,1667479582,790,1836
3518932161,3644334498,1666600666,1666600697,31,1590
3271182009,3014392598,1661349991,1661350757,766,874
3403512366,3984414020,1641562985,1641563433,448,597
3147792323,3705752007,1654390563,1654391438,875,1583
3097834756,3382526428,1660559753,1660560525,772,1058
3055545326,3130899709,1669474501,1669474573,72,2248
3573158941,3329154834,1661148113,1661148806,693,2243
3037375725,3158209281,1661139524,1661140199,675,1212
3640957872,3758323845,1644326178,1644326844,666,1222
3565128218,3239158180,1667291272,1667291588,316,582
3729321195,3709665583,1649900966,1649901592,626,1079
3335565751,3524131973,1660771588,1660771681,93,1460
3551884757,3184669033,1657512652,1657512661,9,1668
3209288149,3070520574,1652115857,1652116521,664,1377
3310262408,3456546904,1667284517,1667285105,588,2454
3882415224,3383006906,1659076037,1659076063,26,439
3120705176,3213995449,1649047939,1649048389,450,55
3695360424,3361365460,1647280628,1647280953,325,83
3191792012,3306838717,1657879506,1657879981,475,785
3368734939,3187644022,1660892708,1660893059,351,88
3167058279,3070117232,1662077440,1662077774,334,1701
3099224416,3780991625,1666677728,1666678224,496,480
3804478597,3831338864,1653460144,1653460687,543,323
3152176779,3278819973,1658929873,1658930092,219,4
3313079052,3821120962,1666100620,1666101452,832,973
3991963732,3367865740,1667204274,1667204307,33,952
3678482446,3217137285,1667578907,1667579847,940,1826
3372471333,3099013723,1662766275,1662766858,583,1684
3986353377,3587727278,1657658114,1657658496,382,1374
3585989542,3522211010,1661118649,1661118843,194,56
3029451399,3176252124,1651810504,1651810884,380,994
3931679805,3461017113,1641286931,1641287366,435,1971
3307636200,3984533628,1666644299,1666644462,163,2148
3715200176,3823917098,1656025491,1656025505,14,1354
3097469330,3796875669,1660262616,1660262700,84,512
3648975076,3351610798,1656255922,1656256200,278,180
3473055855,3192505750,1666857999,1666858954,955,1796
3249145163,3333223237,1668992451,1668993188,737,343
3600015858,3322663101,1642828684,1642828973,289,1871
3858951131,3200875282,1641905590,1641906279,689,214
3756806050,3350345176,1647717415,1647717545,130,1566
3953444491,3881143383,1660707729,1660708028,299,163
3641493201,3750949753,1650406660,1650407481,821,2466
3677300151,3345650412,1661107506,1661107912,406,549
3112356239,3465796988,1664557770,1664558658,888,503
3232141615,3003723782,1653970400,1653970841,441,1348
3246260241,3812231046,1647164719,1647164776,57,1743
3663554395,3113423573,1650729379,1650730069,690,2263
3846866111,3727618645,1657169983,1657170592,609,2032
3104870555,3728419832,1652161761,1652162396,635,111
3144068102,3718652649,1660965005,1660965367,362,943
3946306778,3880353584,1651165040,1651165592,552,1867
3555272427,3268570857,1640996926,1640997918,992,669
3273219526,3517449502,1657425629,1657425959,330,1170
3420298161,3091008161,1649802409,1649802805,396,58
3656158144,3977699882,1658769714,1658770556,842,350
3625034951,3910585793,1648286941,1648287571,630,93
3573826666,3549549632,1653360063,1653360937,874,2135
3928044191,3893849847,1657661569,1657661597,28,69
3298521381,3890638606,1667586010,1667586030,20,282
3106788261,3863190883,1657195042,1657195202,160,2276
3112859411,3769391036,1645635127,1645636053,926,581
3507871733,3515550503,1646292251,1646292388,137,1718
3454753343,3783916284,1660005421,1660006316,895,2107
3107482740,3957051129,1658476787,1658477729,942,1289
3996989799,3896922629,1659991370,1659991496,126,1486
3450806791,3341573446,1668605221,1668606115,894,1505
3210136888,3760535935,1647809186,1647809414,228,1830
3060989519,3815236635,1658069811,1658069903,92,1997
3592379849,3883703576,1645165525,1645165575,50,2261
3307462662,3469359731,1649962676,1649963204,528,1281
3515933745,3846493363,1668259440,1668259808,368,1001
3162947685,3948710872,1653513879,1653514825,946,2121
3029943531,3499787925,1648189620,1648190111,491,2061
3008372630,3967439884,1653340994,1653341719,725,1284
3151554851,3612556887,1644549246,1644549576,330,269
3105460297,3485644295,1654523159,1654523640,481,2386
3630982131,3341241551,1649908739,1649909089,350,633
3278703976,3707342422,1653164186,1653164234,48,653
3099559880,3106276005,1647982227,1647982803,576,721
3857852370,3396524452,1656853224,1656853453,229,2387
3852704822,3762525964,1646530020,1646530525,505,1499
3867026366,3108805085,1641389270,1641390229,959,1933
3604853226,3615897427,1654317385,1654317639,254,1861
3036846628,3845334081,1661082342,1661082963,621,2217
3482509515,3054659800,1660458446,1660458643,197,825
3586600196,3223094463,1650381670,1650382034,364,2174
3778381574,3935656272,1655957353,1655957884,531,839
3428287409,3804328787,1668393398,1668393912,514,979
3682006274,3599915754,1652730777,1652730977,200,1495
3091418450,3687552718,1643877967,1643878615,648,112
3573915559,3059602794,1656712429,1656712661,232,2108
3678720106,3073762858,1666343208,1666343947,739,1549
3973853235,3059322626,1642207072,1642207545,473,1477
3925365269,3933845116,1666946170,1666946672,502,835
3172773924,3033079935,1645418353,1645418916,563,2037
3516488694,3040219251,1669396147,1669396422,275,2023
3069818047,3313079052,1664845343,1664845715,372,1163
3875008839,3324618357,1643250059,1643251000,941,900
3703548595,3823288349,1642273881,1642274235,354,1249
3793232281,3900356013,1642812933,1642813922,989,2482
3540735539,3421505883,1658295459,1658295961,502,1620
3177370273,3581216621,1642190690,1642190752,62,1338
3938776287,3907213401,1662667525,1662668143,618,1638
3635324805,3499514081,1660627232,1660627295,63,1444
3143452523,3188468802,1657270918,1657271555,637,2385
3379829698,3772762015,1648999412,1649000384,972,1202
3153851884,3845511281,1654259392,1654260346,954,695
3719503327,3199797181,1664808986,1664809876,890,1819
3926467866,3052279761,1659184502,1659185013,511,899
3610101662,3961721758,1652360008,1652360567,559,1340
3096746005,3915772795,1653626757,1653627192,435,1218
3241425701,3502599631,1644806439,1644806830,391,2032
3663884600,3862468039,1641026311,1641026859,548,968
3091275117,3906964033,1659249396,1659250391,995,841
3926200409,3112356239,1645911221,1645911362,141,421
3355078629,3091008161,1650244979,1650245775,796,833
3203153576,3892469874,1654359258,1654360094,836,1021
3741681613,3069332103,1667523600,1667524379,779,858
3406979800,3707584091,1666326965,1666327591,626,2053
3543696190,3446572964,1652207518,1652208434,916,1744
3556620301,3778848529,1654321276,1654322044,768,1554
3086551217,3319946083,1666411146,1666411247,101,52
3889537515,3534182480,1646694886,1646695765,879,2182
3924960579,3916557399,1648501260,1648502087,827,2436
3942862085,3650172161,1669651351,1669651661,310,564
3227652803,3195274844,1648270875,1648271497,622,2080
3561692706,3812239613,1642421089,1642421385,296,176
3336657547,3046351455,1658751572,1658752397,825,85
3785586097,3547483148,1646085356,1646086330,974,502
3428325312,3734381035,1650191299,1650191787,488,1783
3784828021,3534726913,1657098419,1657098496,77,2474
3189358030,3411636309,1663022667,1663023290,623,765
3793840002,3117821060,1642241207,1642241347,140,118
3332206707,3896997211,1647651742,1647651998,256,104
3235155985,3426004964,1664747862,1664747919,57,420
3784123884,3110360947,1644521036,1644521362,326,2092
3024228189,3344664961,1645830786,1645831079,293,438
3743136976,3809965750,1653492291,1653492633,342,1969
3549752945,3481811999,1652377135,1652377364,229,1650
3573826666,3482473663,1659054596,1659055437,841,2251
3231971396,3982644241,1645841258,1645841572,314,1877
3587497382,3510323514,1653974164,1653974275,111,1044
3319506258,3124277484,1657110756,1657110988,232,1211
3481467544,3256648307,1641081136,1641081866,730,982
3625201370,3249705811,1645244118,1645244202,84,855
3043604048,3112270906,1654084770,1654085060,290,1826
3728498046,3423971586,1641020035,1641020740,705,2123
3877811036,3510528970,1648261566,1648261792,226,882
3924607271,3159669419,1662099609,1662100305,696,1801
3346288809,3580280923,1646700475,1646701405,930,560
3443490373,3995654203,1645855960,1645856946,986,1065
3400121766,3935379393,1654150932,1654151904,972,1477
3594707374,3948862720,1665979479,1665979937,458,297
3718375865,3840502377,1654643450,1654643710,260,1146
3786478382,3841672169,1642119364,1642119889,525,250
3422046745,3269966376,1654390746,1654390995,249,299
3828530052,3159240548,1665806410,1665806694,284,542
3403389913,3137350861,1666186027,1666186163,136,1564
3432563578,3970444667,1645533362,1645533380,18,409
3624139591,3587440298,1658263269,1658263360,91,2318
3222871111,3415892236,1657570275,1657570411,136,679
3444668733,3178981589,1661185745,1661186599,854,123
3251382188,3037090215,1655649727,1655650341,614,1556
3184916120,3032970317,1650951930,1650952762,832,1278
3351216955,3658513045,1662481975,1662482245,270,101
3659299466,3701214753,1656693641,1656693801,160,1930
3543239972,3321312190,1646960308,1646961188,880,2122
3759510872,3839454838,1654477258,1654477306,48,2163
3110395191,3649465172,1656376050,1656376317,267,907
3835069955,3217060058,1648562494,1648562850,356,1389
3658516535,3856658213,1661512822,1661513090,268,829
3686944200,3608297293,1655865320,1655865962,642,2204
3375253810,3498441448,1651615445,1651616417,972,1236
3219869001,3929407612,1651242297,1651242439,142,823
3390431277,3125730442,1666669794,1666670128,334,24
3038014403,3320742371,1665201629,1665201638,9,1276
3010546611,3734311859,1649126322,1649127175,853,1802
3086583569,3771028638,1648011546,1648012169,623,2135
3724157579,3962045766,1668339678,1668340019,341,40
3522715448,3051876837,1661792765,1661792797,32,2075
3918121469,3592561930,1664228044,1664228944,900,2268
3143226144,3558281313,1669304080,1669304930,850,296
3759656646,3714698686,1647331529,1647331796,267,1763
3196403466,3948695100,1651953892,1651954733,841,238
3437309077,3865387894,1658509541,1658510229,688,2274
3480905975,3008283469,1659465101,1659466019,918,1229
3513368682,3395782360,1653343250,1653343941,691,2437
3660548799,3469879706,1652216292,1652216607,315,2437
3014354609,3658910038,1667570037,1667570379,342,815
3686207600,3459599732,1644824376,1644825182,806,1836
3551810435,3741344192,1645741897,1645742388,491,1480
3257865090,3645537857,1647490462,1647491150,688,2127
3029807207,3740728884,1651439782,1651439857,75,1914
3720934127,3261128926,1658473577,1658474259,682,159
3462714323,3476312823,1657521005,1657521754,749,373
3690586350,3230775095,1662511916,1662512162,246,852
3564444579,3476450845,1658634894,1658635179,285,1371
3556803718,3610782760,1669529314,1669530225,911,583
3131753608,3207210781,1656838991,1656839468,477,373
3565805050,3228277648,1648493060,1648493382,322,1723
3418635865,3961189789,1644795643,1644795657,14,25
3624139591,3261333996,1660321248,1660321350,102,361
3198240429,3162524259,1649685222,1649685539,317,30
3470404771,3086534991,1653559083,1653560066,983,2332
3205282165,3800201060,1652797019,1652797627,608,414
3257732454,3298993308,1646427501,1646428438,937,1063
3276666399,3375177760,1660175110,1660175295,185,464
3003402470,3790896269,1663868318,1663869227,909,798
3098316380,3332506866,1657630014,1657630577,563,1740
3774164657,3830388213,1656821899,1656822604,705,1514
3195138141,3814029511,1642597739,1642598717,978,390
3204081712,3806466784,1652514028,1652515016,988,1495
3500053511,3501786397,1658961384,1658961631,247,552
3406239480,3503011690,1664740404,1664741284,880,1553
3313252249,3763912599,1667494188,1667495134,946,1573
3680060067,3835601308,1643826710,1643827332,622,1506
3561336684,3918397944,1641033113,1641033445,332,1344
3819812955,3880439495,1666024318,1666024749,431,387
3417143667,3424453686,1656451581,1656452087,506,157
3930852270,3189002771,1642251435,1642252286,851,511
3624085921,3490942401,1667721326,1667721363,37,528
3928867307,3162844882,1642244688,1642245341,653,2433
3128318593,3288016190,1653269502,1653269887,385,1109
3506822540,3791894034,1666612990,1666613204,214,2431
3120208739,3266620552,1664273935,1664274032,97,2017
3123999917,3309767670,1647343317,1647343535,218,272
3912410470,3706304663,1649015090,1649015415,325,2419
3556000533,3166518187,1642087201,1642088156,955,1984
3273379502,3691834770,1643801811,1643801927,116,96
3852818295,3513399148,1665064327,1665064597,270,1966
3705752007,3062789212,1669088581,1669088733,152,845
3046617108,3868440818,1664714465,1664714901,436,1324
3750474676,3663718795,1662477144,1662477812,668,1046
3124051904,3664337365,1651216498,1651216707,209,1555
3400000869,3468682335,1646727302,1646727468,166,2084
3140608489,3282587673,1658953149,1658954004,855,1845
3695411154,3173369021,1660353939,1660354024,85,2043
3594471575,3570872297,1667206694,1667207200,506,862
3505480563,3640756400,1658703096,1658703356,260,1752
3169559952,3142106289,1652438450,1652439449,999,288
3941548978,3744002702,1657931423,1657931497,74,1537
3544365476,3549475344,1659875905,1659876786,881,626
3143741876,3724977571,1646452066,1646452756,690,2374
3083479870,3880608911,1660368084,1660368209,125,1959
3260783577,3582060994,1666133129,1666133930,801,2436
3461938856,3916928531,1664199932,1664200264,332,2023
3034807560,3557559741,1666729255,1666729349,94,678
3794524447,3937445570,1655788972,1655789500,528,2273
3630318253,3027110508,1660218351,1660218546,195,2274
3540279517,3632156948,1647202240,1647202333,93,1582
3854906546,3058141936,1657361807,1657362338,531,754
3517149250,3906026429,1669638796,1669639002,206,1072
3150067482,3322287315,1660412124,1660412279,155,1160
3714105777,3153989234,1650092224,1650093128,904,656
3200933791,3735855753,1649013342,1649013978,636,2332
3789380087,3977924189,1664535252,1664536237,985,876
3778405053,3351205685,1642885659,1642886160,501,887
3050271924,3791547480,1660067015,1660067560,545,1366
3432608968,3277875103,1669459472,1669460061,589,2127
3277298737,3604954681,1647226515,1647227330,815,1244
3172130228,3055020688,1667990949,1667991650,701,1059
3133030435,3628830127,1659820728,1659821378,650,350
3552101140,3777872237,1659525861,1659526634,773,225
3380822514,3719455699,1654521642,1654522326,684,1331
3046080865,3867799694,1661630863,1661631433,570,374
3566919425,3206248943,1664223903,1664224200,297,1224
3008576449,3291267409,1668646237,1668646472,235,2493
3832703867,3112298724,1662424746,1662425134,388,619
3293865251,3022401876,1649449870,1649450056,186,1970
3232128014,3785256634,1642946379,1642946446,67,1178
3265181921,3716415183,1647751321,1647752267,946,199
3974318707,3264879958,1645466996,1645467242,246,2113
3894382679,3612612273,1648557036,1648557912,876,173
3472983363,3840003483,1646072124,1646072714,590,1348
3319128889,3109108614,1655769849,1655769980,131,1256
3098179768,3013457125,1660892730,1660893316,586,157
3564667780,3175832070,1662335694,1662336452,758,263
3152537793,3342190885,1652749638,1652750490,852,1520
3470112947,3169688960,1667902889,1667903181,292,2176
3378522829,3562547940,1647911923,1647912447,524,1781
3838851134,3755228064,1660560343,1660560531,188,972
3664267954,3234861737,1660444014,1660444555,541,416
3630982131,3717137928,1644970838,1644971015,177,1636
3365289656,3654861844,1656483951,1656484502,551,675
3419117613,3520699413,1645668760,1645669426,666,599
3009688248,3854351732,1661070444,1661070624,180,986
3449365489,3199315199,1664237208,1664238153,945,472
3460504628,3184608724,1654829222,1654830150,928,1689
3749980168,3052789625,1658942223,1658943030,807,1542
3279351560,3828713812,1655684715,1655685654,939,2018
3623782659,3672164838,1643076878,1643077242,364,2499
3406868680,3753657577,1653150870,1653151865,995,2289
3447257561,3204575281,1667270361,1667271139,778,1843
3993653521,3928685907,1643489498,1643490084,586,1775
3097128642,3823802882,1661187148,1661187960,812,988
3898012654,3103943430,1647263037,1647263643,606,2329
3759867623,3548252436,1664414216,1664415057,841,740
3979845809,3025223556,1651184676,1651185250,574,884
3615387566,3243502165,1666479036,1666479417,381,1015
3131548243,3707584091,1641644979,1641645928,949,1800
3823917098,3066750826,1661860799,1661860894,95,1135
3408529019,3692772256,1667138394,1667138617,223,2233
3676228617,3100239217,1642293039,1642293155,116,181
3655566080,3239265546,1669333863,1669334647,784,1805
3143324065,3813854723,1657048285,1657049100,815,2282
3525751984,3567126985,1661666247,1661666903,656,2239
3621966073,3510761729,1665379473,1665379990,517,1434
3586778995,3002438521,1645714030,1645714836,806,143
3197201691,3869991101,1656048734,1656049129,395,1983
3614627046,3229871774,1652935705,1652936490,785,1338
3930242126,3204359619,1650690790,1650691450,660,1132
3823161778,3167034499,1665860789,1665861453,664,268
3607717009,3103943430,1652391866,1652392014,148,2114
3581399447,3365807352,1641335582,1641335941,359,1099
3828342380,3171413650,1668487076,1668487758,682,695
3316855337,3904881288,1642801305,1642802238,933,1762
3824845857,3711422567,1654997087,1654997644,557,1294
3968000691,3372271387,1667564189,1667564286,97,2163
3289684726,3607393629,1656132860,1656133517,657,403
3282449988,3011690678,1652899366,1652900285,919,2129
3541372095,3931277047,1660865267,1660865669,402,1712
3953927472,3278077270,1665231738,1665232224,486,475
3884256882,3339312980,1654372176,1654373103,927,1663
3334171572,3389926670,1647345031,1647345430,399,260
3720012234,3659299466,1643486859,1643487167,308,1987
3131156982,3715994986,1653083274,1653083828,554,1488
3201276259,3994913668,1661969112,1661969250,138,1307
3609562862,3010488834,1664278874,1664279436,562,93
3928685907,3922766043,1669160170,1669160774,604,760
3640010781,3250023388,1647613935,1647614921,986,2306
3498740809,3666179764,1647411574,1647412340,766,529
3895422097,3858519840,1665701310,1665701392,82,2191
3075780193,3928257298,1647354655,1647354868,213,1373
3732795074,3673850585,1646955572,1646955900,328,454
3150503842,3658099781,1652567838,1652567946,108,563
3550261012,3797294746,1655652536,1655652841,305,228
3760817382,3649298405,1663454063,1663454871,808,1333
3462224632,3399479391,1661993129,1661993730,601,2090
3892142252,3475027844,1668625058,1668625886,828,1636
3381398230,3246900158,1659695200,1659695942,742,1781
3066007042,3793772897,1646938459,1646939215,756,272
3970124384,3762208346,1642342906,1642343143,237,276
3661747291,3451131159,1647775477,1647776143,666,1746
3301708925,3809773923,1669110191,1669110733,542,1860
3930242126,3819791378,1643035189,1643035682,493,941
3990109853,3880139481,1667100017,1667100331,314,1210
3785883615,3378864156,1653826050,1653826735,685,1641
3498989393,3123458167,1652393658,1652394414,756,234
3211945942,3158338043,1648983409,1648984126,717,725
3333103680,3563750578,1648710943,1648711024,81,769
3396149289,3228805720,1647620340,1647620798,458,360
3125730442,3526197227,1649555310,1649555372,62,237
3300983140,3512631937,1642324132,1642324978,846,488
3445469609,3356154602,1645181272,1645181498,226,1692
3979522310,3637944484,1666282735,1666283114,379,377
3247980767,3928212115,1650445591,1650446211,620,575
3171307709,3908727190,1643867236,1643867598,362,1037
3432910993,3587324906,1659172978,1659173883,905,1964
3696512728,3800201060,1646820757,1646821424,667,2139
3201446016,3408903285,1646139829,1646140302,473,1783
3232794733,3177491349,1645906750,1645907191,441,2182
3526968501,3913905115,1669575686,1669576643,957,772
3608048838,3906903088,1658516068,1658516761,693,584
3447310943,3176608983,1660493150,1660493215,65,1459
3236132865,3039176873,1666929156,1666930099,943,669
3419068106,3096662890,1652122707,1652123033,326,2346
3184270447,3972056646,1658879962,1658880711,749,288
3724861653,3136200575,1660776763,1660777665,902,419
3803000258,3864045087,1662365429,1662366402,973,552
3024651290,3906964033,1648067699,1648068244,545,1339
3026769225,3203691315,1654832475,1654833294,819,1635
3165492854,3545781567,1652706480,1652706584,104,2198
3896357807,3712630492,1641508778,1641509049,271,1459
3780808964,3885926991,1665169754,1665169822,68,1903
3725480364,3367279073,1659682580,1659683515,935,2421
3292275609,3276232281,1656385308,1656386272,964,487
3510416134,3478404891,1650617653,1650617914,261,13
3779590261,3569552798,1643832898,1643833177,279,1335
3485046222,3530286335,1655631845,1655632661,816,1254
3524131973,3993332175,1654666394,1654666859,465,965
3284616898,3177370273,1660540266,1660540714,448,1714
3605278552,3149804005,1668545013,1668545744,731,1078
3016995357,3213836945,1645234482,1645234927,445,2368
3575512492,3610101662,1645806879,1645807872,993,1231
3311015405,3623736661,1659288170,1659289006,836,2004
3958375464,3782752586,1660299494,1660299817,323,734
3912858275,3442244098,1656624618,1656624719,101,847
3298436959,3297949666,1658086574,1658086921,347,2369
3666174374,3322801895,1651470867,1651471027,160,1199
3867860336,3079038995,1660273155,1660273405,250,1868
3023421632,3830975217,1647645921,1647646208,287,2326
3064758483,3075465136,1665749965,1665750353,388,2167
3293504206,3092292487,1660862341,1660862566,225,1933
3685505113,3734099449,1669015786,1669016417,631,75
3764173171,3548133562,1665556793,1665557064,271,176
3955219063,3421730413,1644793172,1644793215,43,1706
3852205498,3809965750,1645983029,1645983866,837,589
3342054027,3480314503,1665247262,1665247595,333,788
3680703930,3659158165,1664754648,1664754872,224,1806
3032970317,3023025075,1658176093,1658176907,814,1276
3113793993,3882559155,1656836049,1656836568,519,2105
3958920817,3299362427,1647030899,1647031804,905,1713
3822213532,3767136549,1660622120,1660622395,275,225
3990037235,3331977197,1668036451,1668037299,848,193
3351361711,3836597583,1666634019,1666634715,696,1324
3113427537,3799624292,1645957588,1645958214,626,2370
3992924141,3536421569,1644808760,1644809274,514,545
3821299576,3689741006,1662214300,1662214539,239,457
3071410684,3751780241,1660779629,1660779824,195,682
3356302136,3639035607,1660921026,1660921884,858,305
3447812768,3651110510,1655612075,1655612201,126,3
3828890005,3160515169,1667896551,1667896817,266,1051
3287399418,3410150990,1665858242,1665858942,700,1809
3924583665,3963995256,1647930119,1647930490,371,1513
3598572594,3727794902,1641686577,1641687311,734,2474
3257034858,3206422081,1662775375,1662775607,232,2173
3559301819,3151539194,1648885596,1648886156,560,20
3941783209,3285333536,1657453378,1657454306,928,812
3975405530,3638822670,1657585687,1657586026,339,2171
3752297066,3740102481,1665082529,1665083455,926,5
3733821292,3217719618,1667358867,1667359171,304,1805
3447812768,3664273227,1646851248,1646851887,639,1279
3431354119,3928894030,1651223827,1651224738,911,2423
3391118279,3356728242,1663017992,1663018018,26,312
3000383745,3690667222,1658260133,1658260905,772,1047
3518620219,3757044916,1652116030,1652116298,268,1739
3552335293,3882559155,1655330495,1655331261,766,2301
3012822525,3530462613,1658500374,1658501101,727,1952
3534223960,3176536531,1654311906,1654312875,969,574
3679065090,3894036055,1646993458,1646993527,69,1639
3769198196,3790549304,1641042764,1641042844,80,1011
3055944630,3031299470,1656406024,1656406208,184,2150
3848936636,3687278591,1642625611,1642626006,395,803
3647295073,3566834497,1654836226,1654836368,142,823
3258102756,3098891437,1648368321,1648368699,378,115
3232304638,3695161514,1652624153,1652624733,580,636
3740274448,3524508110,1651323310,1651323630,320,2308
3478288963,3834706710,1657410184,1657411056,872,1898
3845511281,3629942160,1657082132,1657082543,411,22
3095661578,3574285791,1653366431,1653367099,668,344
3705809622,3558848518,1663462731,1663463048,317,2209
3300015174,3265324040,1665311243,1665312206,963,1460
3837065973,3543256939,1656972192,1656972704,512,1827
3987005983,3494746675,1652621718,1652622649,931,1726
3426666423,3556823098,1660934308,1660935051,743,488
3105558193,3954055058,1658183795,1658183922,127,2341
3986814631,3980803977,1642752396,1642753207,811,603
3319365305,3114128222,1653180592,1653181031,439,1361
3929464797,3565083183,1659335213,1659335982,769,1203
3022767670,3112602434,1656714730,1656715525,795,387
3572896327,3808604912,1665725415,1665725695,280,378
3528475061,3227310314,1664207213,1664208039,826,2314
3580178697,3306439333,1644354001,1644354831,830,2074
3741024153,3314528450,1643482360,1643482804,444,1919
3708922840,3952654862,1661672998,1661673205,207,133
3357247840,3377473764,1647738328,1647738509,181,445
3805653360,3846007471,1661290120,1661290412,292,971
3041632417,3946919028,1661488298,1661489173,875,2162
3074044425,3314495556,1656899407,1656900172,765,1794
3910837040,3998987664,1660020146,1660020308,162,2073
3954799831,3144068102,1662658658,1662658877,219,1236
3351802314,3177879837,1649905121,1649905876,755,1276
3643615690,3519233850,1647561613,1647561972,359,1705
3405110319,3901360663,1663493058,1663493917,859,437
3124063685,3749379310,1647200235,1647200895,660,89
3042046828,3368654717,1668508549,1668509171,622,1625
3835976086,3042739113,1649362980,1649363102,122,521
3412053580,3738591594,1662136601,1662136659,58,1955
3608200385,3280657282,1651911460,1651911711,251,111
3762208346,3980050310,1652627583,1652627785,202,1734
3103627338,3269357443,1652009664,1652009972,308,2239
3165845148,3319583055,1658068553,1658068638,85,1652
3999228111,3511397819,1662183906,1662184658,752,1141
3381313507,3990144819,1656931395,1656932271,876,860
3168625610,3315218003,1642529138,1642529612,474,554
3270273033,3343279177,1668785718,1668785989,271,111
3416945471,3603096793,1660133773,1660134627,854,1263
3625979408,3533290388,1653453498,1653454126,628,1848
3413514902,3751600788,1650387841,1650388302,461,826
3640605424,3978925529,1659029938,1659030219,281,37
3013814400,3926426459,1646666358,1646667077,719,1744
3648924087,3642339062,1664458925,1664459636,711,2144
3732456028,3565781990,1643080054,1643080881,827,1517
3889854774,3377457710,1666227739,1666228045,306,2129
3009365802,3289684726,1662044353,1662044831,478,952
3451771672,3903560788,1651882856,1651883573,717,591
3728797277,3513180024,1660255095,1660255850,755,4
3480424657,3820374377,1662365425,1662365903,478,638
3861652282,3311860866,1659368759,1659369006,247,708
3452248216,3722945080,1664032277,1664032296,19,1895
3037844343,3193344217,1655652266,1655653107,841,463
3647479988,3448373235,1667180101,1667180403,302,97
3110691442,3502554871,1652161109,1652161357,248,162
3686743575,3766528617,1662312354,1662312565,211,880
3089699104,3847957207,1656524778,1656525052,274,1633
3318654389,3487526777,1666839690,1666839907,217,1912
3732585972,3656000543,1649871900,1649872606,706,1701
3549431178,3261128926,1661306013,1661306393,380,250
3444149733,3416076001,1645572282,1645572291,9,2223
3571428723,3778068384,1643078730,1643079475,745,432
3388159268,3952389962,1666510016,1666510874,858,1976
3985037610,3896789438,1642731508,1642732127,619,2451
3036953061,3695692085,1643047995,1643048227,232,810
3824083602,3981817077,1660877433,1660878122,689,1329
3016971363,3599694754,1649135480,1649136219,739,1830
3799900837,3707258240,1647378781,1647379306,525,447
3604881190,3222254600,1659987350,1659987699,349,1815
3963547295,3719929552,1647586635,1647587401,766,136
3838136289,3733072964,1660831111,1660831858,747,951
3411495833,3036470049,1661206821,1661207534,713,613
3277284318,3900309643,1663850320,1663851246,926,1894
3650563043,3458815526,1654996814,1654997083,269,2324
3094291821,3073762858,1642320011,1642320395,384,2187
3277875103,3143962586,1654039838,1654040669,831,1891
3122293667,3274985034,1651085397,1651086365,968,1015
3075293628,3849977339,1660540182,1660540612,430,1338
3154653229,3157155319,1641626134,1641626616,482,1316
3386628594,3182243157,1647491624,1647492350,726,489
3285331142,3709518724,1663514325,1663514872,547,2061
3736535657,3841459327,1651646180,1651646198,18,2240
3019302226,3865950417,1653059223,1653059614,391,205
3057721767,3371435731,1649662429,1649662761,332,663
3357966828,3239265546,1667211133,1667211650,517,1047
3700737923,3585832857,1651154510,1651154635,125,1123
3744829701,3047126246,1664251858,1664252272,414,2406
3769198196,3287901684,1641006871,1641007355,484,268
3069523420,3721571243,1661520905,1661521107,202,2128
3480115115,3307933176,1657889938,1657890406,468,2269
3669311789,3461674303,1643758025,1643758349,324,1150
3459090367,3890026377,1643468937,1643469483,546,407
3671748544,3283447626,1665333957,1665334631,674,1406
3624683080,3976992294,1642738032,1642738449,417,244
3265725715,3194721041,1655528821,1655529399,578,1342
3182243157,3256736613,1662390455,1662390761,306,1594
3190906256,3159638305,1660203951,1660204440,489,1268
3562579840,3393528919,1644429206,1644429613,407,133
3954988798,3985901910,1650866247,1650867118,871,198
3222871111,3487740667,1659049673,1659050003,330,815
3401382792,3786811867,1652378667,1652378697,30,1008
3298879351,3439442608,1655817720,1655818467,747,2212
3841106350,3467401235,1645960749,1645961128,379,1197
3428299424,3821039922,1658401680,1658401766,86,818
3693925345,3527067023,1654650450,1654651101,651,1150
3089548621,3014363081,1647059992,1647060785,793,1519
3870320323,3776918350,1662461870,1662462381,511,1087
3355848120,3261169929,1655985875,1655986019,144,2066
3431354119,3633080652,1657059456,1657059842,386,1090
3400329831,3681498352,1658153281,1658153644,363,297
3467211844,3056053831,1663406137,1663406640,503,1635
3280648157,3262811174,1666644389,1666644981,592,296
3843078363,3545032372,1647491136,1647491960,824,75
3603702697,3515845767,1658112397,1658112667,270,1288
3577651077,3771623134,1652928417,1652928914,497,1161
3259430206,3519233850,1659051677,1659052277,600,12
3706178319,3208215579,1657289234,1657289828,594,1051
3166483466,3759656646,1652279052,1652279918,866,2302
3467686942,3963257683,1664527629,1664527647,18,1565
3884750087,3354574342,1651437768,1651438484,716,1582
3720248207,3303698845,1642029414,1642029908,494,3
3956491451,3752133167,1664811894,1664812535,641,2092
3807785088,3124063685,1654628595,1654628941,346,2122
3416076001,3062261092,1666463359,1666463381,22,2148
3781394729,3174425370,1647472467,1647473455,988,2430
3883497013,3446652020,1656442239,1656442878,639,1188
3008283469,3541060382,1657961399,1657961590,191,2425
3573193288,3733770591,1661243518,1661243730,212,497
3873554599,3605195406,1653689587,1653689818,231,1277
3340486436,3719929552,1669092463,1669092918,455,64
3480115115,3099649164,1662457288,1662457657,369,21
3021287506,3730702889,1658323839,1658324193,354,34
3128805218,3265181921,1666035817,1666035892,75,925
3768984387,3664408598,1656442419,1656442542,123,1696
3310542239,3398785571,1654688565,1654688847,282,1091
3949201468,3504258562,1655755307,1655755931,624,551
3428987981,3287784262,1646257983,1646258492,509,1165
3167142908,3536832504,1646187752,1646187860,108,1858
3716461226,3029263333,1651301878,1651301886,8,470
3937445570,3548132533,1649816190,1649817189,999,888
3412955545,3499541432,1642686439,1642686941,502,1982
3226220903,3341211432,1653813458,1653814115,657,1907
3946306778,3682274097,1668208954,1668209898,944,1557
3971926686,3852253700,1652711990,1652712131,141,2251
3085429140,3183259139,1652727926,1652728641,715,1845
3015246686,3446519765,1650672930,1650673550,620,1779
3026769225,3349666443,1666518995,1666519438,443,1659
3581011004,3577990920,1666804453,1666805221,768,1873
3401568650,3894359262,1668683117,1668683839,722,40
3899301205,3003617799,1646902311,1646903009,698,2168
3913680174,3320179826,1659607329,1659607755,426,1375
3793344397,3557751532,1645794332,1645794799,467,2025
3631568439,3095743155,1654782522,1654782649,127,2354
3013457125,3260174905,1651135546,1651136411,865,1870
3659752387,3382777450,1669489756,1669490183,427,284
3562004989,3232304638,1666530646,1666530657,11,2114
3570747542,3585919417,1662280428,1662281087,659,1176
3431595099,3684537058,1664830640,1664830975,335,1869
3883703576,3755228064,1658159683,1658160161,478,1871
3315583401,3423971586,1668072740,1668072885,145,1277
3750474676,3577817989,1655384112,1655384919,807,933
3713116694,3752701792,1645057536,1645058385,849,648
3043047337,3012323943,1654057951,1654058768,817,189
3224960669,3069318012,1644013680,1644013783,103,693
3336300808,3436636953,1641342374,1641343156,782,662
3276840933,3867126446,1641171562,1641171886,324,2348
3930852270,3963702135,1666637936,1666637961,25,612
3828322397,3052376951,1664819591,1664820140,549,2384
3364586923,3922066704,1650338340,1650338664,324,1158
3361223822,3917715509,1656735207,1656735815,608,2454
3027812492,3309196902,1667617554,1667618159,605,637
3879182220,3588728644,1655272449,1655273285,836,335
3012930968,3264121565,1657414783,1657415580,797,615
3938025728,3463973561,1661061719,1661062516,797,2232
3311118815,3344957789,1660547407,1660548372,965,2470
3626345917,3602955685,1664723480,1664723653,173,442
3784168038,3662040060,1655851570,1655852198,628,2477
3199797181,3299362427,1641896267,1641897129,862,21
3500948971,3369913868,1651310744,1651311557,813,1823
3722114463,3172293659,1652310104,1652310356,252,1727
3943413233,3102753256,1643593034,1643593638,604,1042
3447447895,3264079501,1656684999,1656685137,138,155
3793901427,3049567508,1658886152,1658886820,668,92
3965863452,3007911826,1648091406,1648091534,128,244
3041385548,3710189327,1643935757,1643936640,883,105
3332592315,3409332035,1663102826,1663103248,422,1568
3635616513,3059447105,1656232486,1656232527,41,281
3123999917,3168984273,1663196085,1663196232,147,1110
3595726436,3413898378,1655376341,1655376563,222,1806
3495919793,3200646968,1652182214,1652182783,569,847
3045127324,3242064640,1659367835,1659368272,437,1363
3300412448,3286476251,1665598209,1665599082,873,1531
3942520090,3498685499,1663011597,1663012478,881,2056
3232285701,3113207421,1663079384,1663080033,649,160
3270273033,3680810431,1653971924,1653972778,854,700
3733004020,3288490513,1644014485,1644014722,237,531
3804749299,3993623323,1646109555,1646110008,453,769
3692498377,3797182963,1656392769,1656393131,362,1518
3466459383,3359078190,1660319540,1660320081,541,500
3623876940,3323698166,1651288176,1651288222,46,854
3099649164,3986557042,1660320352,1660321141,789,2464
3382856674,3883265629,1647591451,1647591989,538,2305
3328737379,3696149430,1655926342,1655926373,31,1649
3890821469,3369356299,1650317168,1650317664,496,1235
3226280658,3549145976,1664357046,1664357671,625,1523
3312580754,3577651077,1657961874,1657962505,631,2394
3041897048,3125911793,1650208721,1650209257,536,2262
3158338043,3772034355,1653585578,1653585859,281,2142
3571576669,3887743057,1652225527,1652225906,379,2280
3319365305,3388257945,1642507039,1642507952,913,795
3414898500,3266498789,1649686557,1649687476,919,2275
3154653229,3355848120,1657202461,1657203154,693,550
3384460816,3532926054,1646005178,1646005752,574,1942
3747929255,3105829075,1663477197,1663477808,611,1000
3226280658,3145948160,1666642037,1666642481,444,585
3732795074,3464330947,1668553090,1668553714,624,849
3558517913,3447447895,1649639958,1649640834,876,680
3712630492,3307926705,1663033680,1663033715,35,2307
3956878212,3055944630,1659303313,1659304066,753,1494
3500948971,3965563922,1662847724,1662848397,673,85
3431892611,3707778731,1649900082,1649900663,581,1767
3536156667,3537214664,1650438982,1650439915,933,543
3425856728,3346288809,1667944184,1667944324,140,443
3224364206,3170158934,1659159023,1659159776,753,1767
3008609242,3069316815,1641982133,1641982578,445,764
3837062335,3568645029,1643899458,1643899923,465,1611
3899618702,3063782933,1655517793,1655518198,405,933
3579921083,3054803754,1658807177,1658807267,90,2281
3694591547,3084592361,1649852829,1649853391,562,304
3410719383,3749161560,1668021025,1668021485,460,2337
3907700603,3508514571,1663423927,1663424083,156,1128
3827867076,3946815972,1659077442,1659077891,449,633
3306290309,3562875112,1656381439,1656382261,822,707
3173788210,3709788465,1659338861,1659338953,92,1822
3637457925,3589571844,1643422371,1643423324,953,2154
3599915754,3010767150,1667608937,1667609499,562,75
3968000691,3600334566,1651654421,1651655024,603,89
3542215276,3277521554,1663939455,1663940421,966,1098
3460704532,3868215944,1651423856,1651424353,497,2477
3889730114,3873002836,1659190801,1659191450,649,2386
3216439052,3791547480,1669680317,1669680936,619,174
3826956383,3449080412,1655585512,1655585564,52,163
3599551667,3478741068,1656424908,1656425896,988,1402
3142106289,3992817916,1652652356,1652652560,204,1567
3206549691,3932077086,1662824028,1662824608,580,1675
3815507952,3980971387,1651415208,1651416094,886,1744
3956027073,3711016575,1657898749,1657899406,657,2275
3991552312,3983391279,1667945782,1667946473,691,1531
3900876329,3057725565,1657896712,1657897024,312,1820
3536128186,3677965553,1642915783,1642916650,867,89
3536219260,3348006171,1654872349,1654873233,884,2296
3412047712,3951216492,1642174622,1642174825,203,2225
3780117215,3736085476,1669541241,1669541886,645,1425
3414581321,3809458973,1656089303,1656089462,159,1032
3553241769,3744563835,1647984168,1647984966,798,2030
3954055058,3400121766,1652508306,1652508962,656,2129
3057348673,3705247337,1665105882,1665106536,654,567
3827551944,3105054400,1660393259,1660393813,554,1115
3567656858,3094906195,1648194073,1648194583,510,314
3177491349,3996978717,1659962476,1659962924,448,1114
3082912574,3274208430,1644588932,1644589183,251,1024
3288347905,3199717052,1669279059,1669279159,100,782
3925688803,3047388698,1644576539,1644576776,237,1676
3349030618,3331335383,1641828205,1641828681,476,587
3232333937,3077145114,1645200106,1645200997,891,831
3539364028,3554680554,1656010150,1656010497,347,1470
3097475982,3741681613,1643692285,1643692773,488,6
3512100935,3093589416,1652384409,1652384510,101,390
3622230392,3501520918,1665994029,1665994581,552,344
3118305321,3141108539,1653189632,1653190594,962,1112
3250528764,3693102953,1666543831,1666544043,212,1759
3156522255,3246796194,1666598626,1666598880,254,2312
3760930897,3387247558,1668524271,1668525196,925,1945
3688133320,3625201370,1650077206,1650077707,501,1278
3066854514,3435399012,1668994084,1668994190,106,877
3534726913,3493489568,1663486050,1663486512,462,1684
3653757569,3664898256,1649391295,1649392141,846,649
3017559077,3061850950,1652151095,1652151278,183,607
3315218003,3666079547,1657655983,1657656261,278,1762
3760930897,3137412000,1658519673,1658520502,829,115
3021613958,3736535657,1655307273,1655307863,590,1675
3980824960,3847237978,1663532926,1663533147,221,713
3844499309,3882983178,1658933604,1658934513,909,1635
3960727778,3374470605,1657904237,1657904255,18,1802
3656002043,3916928531,1644163279,1644164263,984,282
3865947139,3593603889,1646361228,1646361296,68,1482
3730428171,3863080370,1658574871,1658575508,637,558
3180973124,3949002357,1656139223,1656140020,797,687
3536954029,3806570797,1655551370,1655551903,533,1018
3054906475,3896091695,1661843117,1661843205,88,346
3609043475,3215423327,1663709501,1663709835,334,1562
3275298041,3011993360,1651634048,1651635033,985,1504
3196704660,3767581542,1654292359,1654292966,607,1594
3675703241,3419783275,1644780715,1644781518,803,1897
3707676798,3099424302,1656645651,1656645927,276,1330
3253827804,3836565798,1662569042,1662569839,797,141
3597403559,3964637208,1661491391,1661492240,849,2093
3837481005,3069841199,1653824055,1653824322,267,1365
3532190519,3545214789,1658958218,1658958455,237,2336
3773658133,3832334966,1669451938,1669452874,936,247
3475027844,3420266147,1641438756,1641438900,144,1898
3866414868,3912511626,1659841953,1659842589,636,1242
3423306122,3556000533,1665527226,1665528185,959,858
3997051818,3456799118,1668489656,1668490618,962,2330
3686249771,3545730764,1644346192,1644346420,228,1278
3255776587,3781394729,1641926968,1641927897,929,323
3052063374,3889967886,1642806973,1642807151,178,2296
3513349474,3908312889,1646671321,1646671718,397,1875
3367915131,3583169906,1646447915,1646448805,890,307
3622259711,3885087517,1663230248,1663230728,480,1993
3629090721,3550261012,1663059420,1663060405,985,979
3705809622,3006456611,1644683484,1644684307,823,1564
3686704798,3634089207,1642546977,1642547141,164,1200
3124200545,3097426944,1662890758,1662891390,632,775
3390723607,3496470143,1644070293,1644070367,74,2145
3828738126,3653285237,1663745338,1663746336,998,2211
3078216798,3198999623,1660703340,1660703726,386,2014
3860446106,3328146266,1653914190,1653915035,845,845
3031292798,3841660750,1658198901,1658199867,966,372
3392918310,3199472785,1641499814,1641500213,399,2255
3008760173,3428287409,1669103219,1669104055,836,1340
3856587038,3399235044,1645425342,1645426141,799,1989
3328015314,3550874434,1668648724,1668649603,879,299
3101669976,3256648307,1658140809,1658141125,316,1486
3017758671,3433835303,1649944492,1649945331,839,1923
3157308488,3186367687,1644589530,1644589726,196,1088
3533898881,3202783831,1644054918,1644055575,657,1557
3570230022,3194070207,1667578906,1667578997,91,1411
3962746969,3809332572,1641743202,1641743416,214,206
3662578193,3993917332,1653203082,1653203898,816,1099
3205359825,3070087815,1652513055,1652513392,337,649
3957798687,3145393304,1669268609,1669269533,924,798
3942399353,3882619512,1658690976,1658691851,875,1046
3513180024,3664898256,1656689398,1656690088,690,2281
3447555067,3952663430,1657271671,1657272216,545,489
3942575505,3468654589,1641296146,1641296903,757,1513
3904625406,3811318665,1659736726,1659737243,517,1993
3656878544,3232128014,1655375607,1655375618,11,387
3824168840,3173034893,1652422097,1652422972,875,1161
3206198477,3020285623,1641445591,1641446511,920,1101
3502554871,3620223775,1643224802,1643224848,46,487
3312930717,3880196075,1663369809,1663370448,639,1068
3772406671,3307636200,1646075468,1646076347,879,965
3355266666,3536156667,1652697299,1652697345,46,842
3254144288,3119523311,1663045049,1663045750,701,834
3701501875,3062506508,1665083505,1665084044,539,421
3923683467,3913984749,1648920681,1648921471,790,2317
3642946322,3807576323,1663108918,1663109453,535,1170
3363733362,3913366963,1661019063,1661019940,877,1127
3014798893,3072317138,1653841933,1653842277,344,195
3661136551,3760224151,1666507575,1666508019,444,794
3762525964,3370834194,1649022817,1649023615,798,927
3040889811,3282425868,1649047374,1649047577,203,995
3406239480,3090666521,1661112291,1661112667,376,2261
3390723607,3558912751,1662388840,1662389489,649,1573
3595270507,3026293367,1646798194,1646798881,687,1366
3328148239,3568488180,1665696429,1665696755,326,1059
3934386586,3569525429,1645525911,1645526201,290,278
3054171550,3095834081,1642668740,1642668812,72,2194
3309388750,3053026624,1665458360,1665459074,714,2087
3069536467,3180798863,1666794876,1666794970,94,251
3406215034,3832773624,1656504883,1656505344,461,2175
3555903175,3261174036,1653996909,1653997315,406,1129
3561037966,3102820806,1645801747,1645802071,324,609
3112287858,3914601322,1644132458,1644133178,720,2198
3704437148,3622596133,1650240668,1650241299,631,41
3183672525,3708309303,1664791888,1664792187,299,1210
3981273706,3814608487,1653814398,1653814950,552,1410
3903886201,3885235661,1651015549,1651015660,111,386
3981331110,3514894244,1646020837,1646021029,192,1424
3105259495,3610056283,1645745385,1645746042,657,2326
3890054358,3907665331,1662823460,1662824215,755,1017
3423825173,3897433648,1646728810,1646729068,258,1969
3057090135,3896281957,1650024429,1650025356,927,755
3929638122,3109941959,1642930582,1642930830,248,1109
3868474839,3897421758,1657416902,1657416915,13,2121
3452275962,3668471634,1664865882,1664866811,929,2001
3625586912,3461292351,1657712258,1657712663,405,1057
3506971803,3021968850,1664071904,1664072812,908,2427
3492909923,3541157955,1665059300,1665059860,560,1951
3409332035,3678778706,1652751888,1652752712,824,2188
3178732875,3076570841,1660902229,1660902459,230,349
3145393304,3823206701,1644863137,1644863394,257,1707
3075780193,3378948752,1645255087,1645255830,743,1031
3418007140,3308015697,1652122436,1652122600,164,824
3276840933,3487406679,1648709332,1648710312,980,1489
3442244098,3611967437,1659684046,1659684352,306,2496
3011686027,3178732875,1644471629,1644471634,5,625
3838774657,3777872237,1661224644,1661224711,67,450
3013073909,3095503795,1660025410,1660026037,627,1800
3194259307,3586524207,1659350611,1659351480,869,2384
3689544534,3060989519,1650419727,1650420172,445,1097
3343279177,3744871116,1642750737,1642751006,269,106
3160963185,3442081758,1642676365,1642676991,626,2169
3763804073,3985159412,1657073922,1657074365,443,2006
3745532894,3741681613,1649617852,1649618566,714,145
3426004964,3216582576,1650020825,1650021550,725,578
3049141347,3549549632,1650178782,1650178920,138,535
3871180604,3855769157,1658228952,1658229588,636,1770
3553471050,3776906254,1663301340,1663302330,990,930
3904881288,3640387984,1660862185,1660863112,927,1927
3713520914,3596841713,1659957979,1659958559,580,1765
3182752768,3376579544,1651200153,1651200247,94,477
3987162833,3508143883,1643527586,1643528107,521,1735
3510281371,3753180150,1662000147,1662000566,419,1925
3933045461,3922675517,1641510333,1641510737,404,2034
3818023164,3119345995,1649569530,1649569756,226,1943
3742647803,3670550887,1664910139,1664911125,986,1357
3350812449,3202453519,1657362271,1657362431,160,2336
3181181141,3974092782,1644781344,1644782038,694,2277
3605706184,3533279961,1653602385,1653603325,940,2480
3167034499,3572276937,1657081731,1657082539,808,1004
3178529360,3829149174,1667567055,1667567394,339,1919
3292869706,3414901923,1655750381,1655750605,224,1830
3665931760,3756473550,1642182140,1642182708,568,2017
3722220404,3928257298,1663973574,1663974403,829,2000
3437122732,3711059561,1669473630,1669473869,239,1385
3729299306,3440778681,1642121226,1642121786,560,1051
3005480994,3831255967,1658867730,1658868157,427,348
3194125043,3022401876,1661037306,1661038218,912,198
3339025394,3816309635,1651064965,1651065255,290,534
3734099449,3289330422,1668059504,1668060200,696,396
3948754212,3600247537,1666315109,1666315310,201,1554
3554778587,3312336013,1662418409,1662418641,232,347
3172293659,3854906546,1662647631,1662648406,775,2113
3611025093,3003243547,1659365954,1659366139,185,539
3032779815,3879520142,1668594521,1668594817,296,1905
3081005801,3221885729,1655948184,1655948411,227,2047
3827122476,3990264315,1642730178,1642730810,632,2351
3534192041,3344713569,1645512532,1645513025,493,1593
3166754795,3728160519,1656534619,1656535250,631,2463
3448409263,3791389559,1647890198,1647890622,424,263
3311329069,3591834837,1653522782,1653522945,163,2319
3877464299,3965629952,1651579861,1651580090,229,1528
3036381764,3637412110,1651473306,1651474096,790,2470
3915817603,3225328547,1657501672,1657502245,573,2212
3512935575,3153040217,1668066740,1668067524,784,208
3526798607,3447326124,1655327729,1655328078,349,1673
3682028611,3030290445,1654169638,1654170224,586,1368
3323797477,3646536668,1644580173,1644580619,446,1036
3651847351,3856467502,1668862293,1668862383,90,313
3858225831,3453070428,1646856309,1646857098,789,152
3663228098,3390976131,1645485215,1645485542,327,1115
3138638384,3704604706,1656927782,1656928745,963,502
3262728353,3608775321,1646487720,1646487742,22,2321
3639515059,3863665550,1642235980,1642236148,168,2211
3804657904,3029468613,1648180924,1648181762,838,652
3239418137,3850392190,1651738573,1651738911,338,676
3461451325,3679846649,1666565186,1666565482,296,979
3323198594,3913984749,1659219401,1659220331,930,981
3616901816,3424368056,1661692677,1661692708,31,116
3254194915,3339385127,1641406855,1641406967,112,1239
3563103144,3232737784,1661656693,1661657609,916,1585
3554741157,3368322774,1664506714,1664507580,866,607
3521408145,3753391012,1649002749,1649002908,159,622
3134166826,3671637527,1654254754,1654255698,944,1508
3022348535,3357048496,1647126948,1647127400,452,1137
3273219526,3566534974,1656872304,1656873083,779,459
3805283132,3463973561,1662469166,1662469528,362,1455
3908848133,3507338655,1667881118,1667881932,814,1393
3176653619,3748061416,1664061756,1664062279,523,1045
3479608729,3785725492,1644748961,1644749734,773,1607
3828738126,3754706912,1655467992,1655468099,107,487
3025581381,3037741311,1651816372,1651817295,923,1794
3335383594,3264831577,1653454498,1653454588,90,1488
3366822094,3407909365,1658062567,1658062622,55,434
3690665509,3312661854,1645856773,1645857039,266,629
3336947163,3655250241,1641657272,1641657560,288,894
3273518390,3495919793,1657865128,1657865920,792,891
3772749656,3037279735,1644428674,1644429314,640,272
3727618645,3520523282,1647701534,1647701821,287,281
3885393767,3692568210,1669277356,1669277574,218,879
3489915638,3928521533,1660322060,1660322337,277,542
3115245083,3936914064,1665466965,1665467946,981,1324
3105829075,3390134392,1644359289,1644359692,403,120
3981778568,3794408677,1641842485,1641843387,902,1246
3782730026,3788911315,1658043531,1658044140,609,764
3525192232,3633111737,1660251897,1660252632,735,583
3826827617,3636572173,1643297681,1643298223,542,2239
3766818968,3773196864,1662509254,1662509987,733,257
3066362135,3234861737,1647231963,1647232168,205,841
3590361712,3862829462,1651416590,1651417315,725,2464
3594009328,3196616254,1653736001,1653736657,656,1775
3223094463,3003087336,1664126500,1664126678,178,2216
3196934109,3767581542,1655124543,1655124703,160,321
3594231530,3872170030,1647865278,1647865616,338,759
3957053810,3146378665,1650087618,1650088462,844,335
3337673105,3638527581,1647287908,1647288511,603,2320
3169496287,3386724007,1662849618,1662850336,718,1964
3461017113,3176941664,1669130582,1669131420,838,1539
3232436630,3344285047,1649615909,1649616576,667,2320
3382856674,3034040451,1642947142,1642947619,477,2007
3316625530,3368860003,1643189173,1643189672,499,1578
3915817603,3270273033,1663447972,1663448845,873,2113
3069431080,3283037458,1655849908,1655850723,815,570
3263168418,3090354216,1657260551,1657260633,82,1183
3759165741,3214817416,1642904616,1642905450,834,276
3023421632,3414502284,1652469385,1652470022,637,720
3550107804,3252157235,1652320892,1652321455,563,138
3373656201,3255460937,1666901588,1666902204,616,185
3135139573,3790648941,1657401736,1657401834,98,447
3561572123,3655566080,1647430243,1647430658,415,2407
3320065223,3840026910,1644996116,1644996439,323,848
3537151295,3727706350,1652474567,1652474754,187,778
3249261763,3797617787,1643333938,1643334687,749,1874
3960633649,3036194601,1646604375,1646605173,798,1717
3089325315,3852506516,1641983626,1641983798,172,2355
3175929512,3000165786,1666338405,1666339064,659,2207
3436916222,3895370398,1646572022,1646572337,315,1331
3601187603,3943221472,1654730504,1654731296,792,597
3638803969,3242235161,1652862173,1652862819,646,1984
3733770591,3825023321,1659346087,1659346824,737,1241
3085136451,3567368088,1641173372,1641174279,907,2224
3068723030,3334483625,1661185402,1661186227,825,1177
3824625919,3656467120,1663481403,1663482383,980,1496
3821998886,3516140957,1659257752,1659258546,794,1034
3199315199,3506458720,1663651571,1663652126,555,151
3608071362,3003116947,1659583899,1659584732,833,2062
3469583371,3419117613,1655218644,1655218973,329,2136
3539510682,3070186247,1662468750,1662469140,390,1620
3513180024,3143318519,1658323162,1658323288,126,2449
3061362091,3070186247,1652149663,1652149719,56,1458
3590831664,3078231218,1649199151,1649199311,160,2499
3579728276,3646797040,1646996356,1646997326,970,1172
3494990710,3660513601,1659353439,1659353484,45,1213
3292172583,3184344401,1646910000,1646910280,280,2071
3634539557,3241425701,1647686301,1647686608,307,958
3727618645,3659224437,1662258351,1662258840,489,353
3086322921,3512935575,1661378725,1661378872,147,1638
3866268396,3062015697,1663272351,1663273095,744,932
3183299670,3780014272,1665912795,1665913184,389,596
3694591547,3939973483,1646101651,1646101910,259,1917
3306460846,3075293628,1666207054,1666207115,61,1804
3568488180,3260246509,1649042690,1649043274,584,1
3720307988,3264879958,1668706097,1668706224,127,346
3690665509,3566834497,1665777056,1665778004,948,1912
3634871077,3343033950,1650844757,1650845739,982,818
3150551034,3207389119,1649215900,1649215992,92,871
3871345895,3361670451,1646069437,1646070310,873,1932
3872444916,3600796487,1645224955,1645225831,876,2171
3592320524,3393911160,1646530775,1646531377,602,617
3744147238,3795940241,1647887414,1647887838,424,1116
3729389785,3770771031,1665869563,1665870481,918,1298
3963793916,3081028310,1647783287,1647784112,825,53
3838136289,3187807330,1648141126,1648141974,848,2088
3739595528,3855223575,1665837773,1665838673,900,980
3252760026,3962746969,1656851807,1656852605,798,642
3216171635,3087123320,1647705110,1647705154,44,2496
3951845301,3319946083,1665151587,1665151835,248,376
3306669471,3664381582,1647771019,1647771589,570,1443
3671147965,3771811920,1652691102,1652691765,663,81
3556061704,3574957979,1644792975,1644793970,995,1228
3775753518,3285030317,1658497464,1658497778,314,2345
3500216283,3178235505,1658221439,1658221446,7,1987
3299607426,3651535646,1644055268,1644055519,251,1561
3451370887,3883846613,1666398397,1666398854,457,1032
3195716414,3097469330,1665301515,1665301644,129,711
3014185506,3793298032,1653963671,1653963905,234,237
3622062401,3342215329,1642452851,1642453425,574,2174
3590831664,3097242351,1663381627,1663381800,173,1039
3046787822,3856386170,1667044295,1667044322,27,71
3826257607,3598576303,1641291876,1641292833,957,855
3450628929,3549703546,1649783293,1649784122,829,980
3725042810,3021320868,1648046280,1648046960,680,1714
3115343467,3339611423,1651239350,1651239693,343,358
3098179768,3055145919,1647387156,1647387729,573,1701
3931294653,3999180921,1646608478,1646608770,292,816
3223094732,3170292789,1656357263,1656357622,359,719
3752652141,3516488694,1664806445,1664806899,454,1396
3522365623,3864143186,1645709833,1645710763,930,48
3282275875,3400434269,1645449322,1645449915,593,1994
3744737373,3316318605,1652755035,1652755688,653,2404
3537138552,3271919876,1668686796,1668687710,914,1692
3061366261,3790356065,1653357697,1653358546,849,138
3592906293,3167864948,1664492183,1664492235,52,1637
3388328160,3239792198,1646326326,1646326686,360,1828
3035803277,3436916222,1666566955,1666567387,432,1221
3369356299,3556968717,1655508726,1655509072,346,323
3268916307,3101609490,1661616482,1661616996,514,2373
3931854815,3870243569,1648252933,1648253434,501,649
3888015355,3334237477,1649861777,1649861997,220,1936
3210422873,3409662195,1655091882,1655092460,578,1287
3919196366,3270453709,1648200750,1648201005,255,1768
3944914500,3922925129,1651577801,1651578241,440,1042
3569401888,3870877628,1641422440,1641422793,353,2476
3741134467,3047001138,1645258788,1645259784,996,1145
3257865090,3715231431,1662896251,1662896681,430,2424
3183740417,3885719823,1667241036,1667241535,499,833
3348234563,3243044619,1649062623,1649063561,938,2417
3224644594,3087612913,1651618511,1651618561,50,806
3345543859,3660247870,1655838922,1655839860,938,1576
3187291408,3534726913,1654352159,1654352254,95,868
3898494020,3631340178,1643487801,1643488144,343,1249
3922697372,3666174374,1662367670,1662367857,187,137
3540279517,3113214024,1664522693,1664523595,902,899
3006508919,3038244365,1645757850,1645758416,566,752
3319965397,3391324219,1655183228,1655183286,58,259
3786811867,3472983363,1642119712,1642120552,840,1219
3515550503,3424368056,1661051429,1661051743,314,2030
3744002702,3022428512,1650219794,1650219995,201,1351
3832640445,3729389785,1660301049,1660301420,371,70
3310970237,3556549065,1657436102,1657436702,600,1830
3329825235,3540735539,1660499717,1660500714,997,1678
3765475472,3903068218,1643615603,1643615781,178,502
3640387984,3225909236,1652336961,1652336966,5,1897
3756778635,3938615588,1665137061,1665137733,672,575
3967250644,3121128511,1642167740,1642167956,216,1908
3164942448,3014185506,1649245793,1649246489,696,2283
3790748869,3247688800,1652532132,1652532306,174,170
3828833040,3778381574,1647590841,1647591256,415,1786
3938505582,3956394849,1665115465,1665115656,191,853
3364888618,3660513601,1659490704,1659491042,338,175
3771111014,3334207071,1655225807,1655225810,3,2134
3593861215,3996587507,1645410336,1645410898,562,646
3419465829,3752621490,1649049038,1649049856,818,2164
3933892798,3269502320,1653215106,1653216067,961,669
3653031568,3844822083,1667920143,1667920233,90,2381
3506307976,3026935493,1661890537,1661891298,761,455
3934386586,3307033178,1650377496,1650378221,725,2116
3229975544,3975065378,1663558143,1663558395,252,1686
3266666808,3126499590,1668054374,1668055259,885,329
3416945471,3402155812,1642802259,1642802339,80,507
3938615588,3097469330,1664849563,1664849933,370,1147
3587497382,3114733025,1658364239,1658364643,404,301
3001480546,3399479391,1660652472,1660652965,493,1423
3775753518,3828857457,1664293963,1664294077,114,1796
3565803867,3478288963,1655112151,1655112630,479,1771
3335210480,3585526520,1655051073,1655051133,60,2328
3977860015,3159897010,1657955873,1657955906,33,340
3897433648,3352005808,1663207948,1663208612,664,190
3553096192,3081589831,1669462592,1669463341,749,1204
3050434345,3572594221,1667907069,1667907359,290,1142
3808191596,3566257032,1656522571,1656523088,517,2337
3930118877,3264460374,1645850379,1645850459,80,195
3918234060,3664242822,1657294031,1657294309,278,644
3790406016,3686407290,1661691330,1661691926,596,531
3306619417,3592471391,1648265820,1648265974,154,2307
3916290714,3963351842,1641974794,1641975513,719,2100
3501732936,3569401888,1661384768,1661384791,23,1135
3567520646,3102251970,1641322825,1641323231,406,1890
3109390601,3481467544,1650215164,1650215971,807,590
3819415032,3985418000,1666864344,1666864665,321,1626
3516743828,3005480994,1658884669,1658885010,341,558
3840502377,3449993526,1648948049,1648948741,692,104
3335242048,3474115926,1660919051,1660919441,390,602
3407770585,3283155844,1642009959,1642010931,972,83
3151539194,3624188526,1648164869,1648165325,456,1863
3551243497,3039001408,1648893605,1648894487,882,355
3110733657,3485578733,1669701112,1669702046,934,1778
3288834634,3674349184,1663717714,1663718653,939,947
3203153576,3236132865,1645170619,1645170872,253,1744
3044564753,3718375865,1641921721,1641922178,457,2368
3590656592,3264460374,1656038783,1656039610,827,688
3122109326,3458478056,1650954051,1650954906,855,2234
3055169776,3461263871,1658544731,1658545205,474,2314
3724770746,3907705988,1648412052,1648412189,137,194
3561529281,3604596896,1656604919,1656605137,218,2341
3725283025,3894593426,1657370009,1657370380,371,109
3308071201,3629207282,1661610661,1661611321,660,1448
3804189322,3253589940,1646971601,1646971893,292,421
3335455607,3417742545,1655741054,1655741502,448,1716
3567959060,3380303288,1661566398,1661566891,493,1619
3502217263,3291780380,1657594378,1657594827,449,1651
3400163448,3055944630,1655260007,1655260819,812,1325
3526797183,3468922263,1651510952,1651511268,316,2095
3328854884,3502484697,1642128826,1642129384,558,2027
3333764188,3243534925,1660636691,1660637601,910,2457
3884067849,3246796194,1657628405,1657628953,548,1587
3436888201,3710394011,1666567914,1666568086,172,2221
3372442199,3840306405,1647150591,1647150717,126,736
3332012161,3241210215,1641501697,1641502361,664,2400
3533954093,3181237998,1653764183,1653764188,5,995
3556033785,3747929255,1653623755,1653624112,357,1383
3154729703,3970820689,1660583285,1660583968,683,1546
3288106394,3407909365,1655659127,1655659241,114,341
3980803977,3977924189,1657227170,1657227378,208,244
3119036139,3752858965,1655031526,1655032155,629,874
3316951862,3534200501,1643840062,1643841026,964,2101
3223463387,3997162156,1656124216,1656124737,521,2099
3900571767,3119523311,1666391865,1666392047,182,2006
3954434825,3103158328,1667870179,1667870460,281,1357
3533279961,3446987671,1642000492,1642000983,491,1980
3619714539,3450228800,1661086338,1661086463,125,807
3096386556,3003005378,1658800472,1658801100,628,2469
3556803718,3987732407,1663283639,1663284433,794,625
3933892798,3307462662,1669469661,1669470290,629,282
3886344418,3124147703,1647082630,1647083323,693,144
3891027417,3571145656,1654076966,1654076976,10,834
3786540807,3021287506,1654428918,1654429056,138,516
3436888201,3830388213,1655035957,1655036544,587,184
3035476619,3668753730,1655380531,1655381431,900,1955
3348234563,3721751204,1647412322,1647412498,176,122
3231899706,3269914132,1641316358,1641316732,374,411
3161412125,3090090794,1657547674,1657548351,677,1139
3026935493,3082108681,1647068489,1647068567,78,1470
3797079865,3604694727,1669235784,1669236575,791,570
3845334081,3196304056,1661050798,1661051700,902,2363
3430387951,3659701814,1644147782,1644148268,486,1112
3072317138,3243649022,1656767533,1656767863,330,1900
3228277648,3443773400,1644053000,1644053599,599,1554
3897030063,3080195715,1668493779,1668494582,803,1847
3208490048,3995365519,1646362612,1646362849,237,962
3306457934,3795990774,1652244082,1652244095,13,679
3785361012,3834166808,1664911842,1664912025,183,2229
3567614002,3169496287,1650473699,1650474105,406,1518
3956058747,3430464852,1669323264,1669323633,369,2399
3909173527,3098538909,1651839723,1651840662,939,2169
3682922389,3141688992,1649063019,1649063761,742,958
3482268698,3611062566,1655819908,1655820317,409,195
3759409777,3098276544,1651009840,1651010443,603,1932
3057028614,3501508123,1663691030,1663691745,715,147
3677539420,3740009683,1660512695,1660512722,27,2304
3693183129,3749897140,1668736617,1668737548,931,2096
3905922866,3442779071,1654118375,1654118945,570,2163
3462224632,3722199706,1642100789,1642101581,792,1682
3421728246,3063744739,1644257545,1644257998,453,992
3734035973,3324113509,1644905730,1644905781,51,1729
3350566867,3053134032,1661302415,1661303340,925,221
3674059710,3248892530,1665517390,1665518208,818,1632
3208757755,3853256957,1653472794,1653473047,253,2222
3258399411,3120092137,1650434019,1650434982,963,800
3863485115,3720934127,1650030621,1650030632,11,2497
3637129082,3908727190,1666210429,1666211009,580,2346
3526088150,3148366567,1644268075,1644268129,54,286
3393458100,3912828190,1661575131,1661575850,719,938
3186787984,3562814356,1655482054,1655482592,538,2177
3808397193,3126987673,1664203594,1664204045,451,541
3282261851,3640605424,1644849630,1644850279,649,586
3457284809,3346261120,1657181796,1657182785,989,1477
3360051725,3904203375,1648882857,1648883585,728,1115
3990949387,3432522125,1664195338,1664195719,381,101
3798597128,3990379463,1649461496,1649462317,821,2330
3437603547,3106732056,1663087630,1663088114,484,1704
3367865740,3792253761,1661505919,1661506512,593,1293
3681719344,3623876940,1644853609,1644854459,850,272
3707778731,3804824307,1667885347,1667886013,666,1530
3707940691,3136798128,1645417377,1645417827,450,885
3157308488,3590735151,1644616534,1644616874,340,1303
3625950355,3279069375,1650458865,1650459416,551,1624
3419751912,3870778205,1658068758,1658069271,513,1174
3436916222,3319601888,1668583033,1668583426,393,416
3123795999,3883537438,1656413879,1656414694,815,989
3930347129,3875945215,1658220425,1658220427,2,99
3361319934,3917067097,1651932173,1651932952,779,939
3464770966,3954055058,1665549803,1665550261,458,1189
3780546851,3442967650,1657042750,1657042849,99,1999
3821120962,3439827305,1655073650,1655073927,277,1308
3193830008,3131131112,1654067677,1654068637,960,1872
3218117875,3450502369,1646381747,1646381928,181,1452
3252981510,3034750166,1655339594,1655339639,45,1146
3076307729,3896281957,1668509956,1668510370,414,562
3243831128,3796559738,1660950476,1660950993,517,993
3921189235,3034643506,1665728981,1665729299,318,1687
3815102601,3248892530,1645402498,1645402602,104,2362
3988957478,3209064637,1654566860,1654567412,552,460
3076431464,3269690639,1669673203,1669673334,131,1459
3822143503,3347679085,1667411919,1667412109,190,2302
3516743828,3951216492,1652176318,1652176982,664,45
3436975295,3433557410,1666746301,1666747028,727,73
3338882756,3995288261,1658622964,1658623024,60,642
3498466937,3407778626,1669590689,1669590762,73,833
3516838480,3888312656,1656006095,1656006871,776,1309
3953483372,3210078490,1642646652,1642647023,371,462
3137529896,3105829075,1669446964,1669447432,468,646
3362395200,3996381336,1662672830,1662673483,653,2418
3845334081,3936821313,1669400200,1669400469,269,2224
3569563212,3952654862,1659817572,1659818078,506,529
3223094463,3437221963,1659940458,1659940728,270,214
3884018587,3621452884,1658090814,1658091305,491,234
3895277580,3969650128,1662446992,1662447070,78,802
3946815972,3630744403,1646595429,1646596374,945,2156
3201142543,3478959759,1647870743,1647871312,569,974
3292454121,3226280658,1668769471,1668770085,614,1091
3157600969,3242857629,1669705297,1669706164,867,1702
3553096192,3936360658,1641624916,1641625335,419,466
3224128562,3912183552,1650531421,1650532235,814,2109
3748812993,3404200815,1644113167,1644113476,309,1760
3242235161,3479738009,1642958782,1642959209,427,1967
3551771231,3014354609,1663923747,1663924663,916,425
3215514672,3497507557,1655382045,1655382979,934,2417
3024651290,3604236901,1645308707,1645309007,300,1055
3128529900,3264460374,1657802566,1657802616,50,1888
3319224567,3181181141,1663328930,1663328978,48,921
3675418278,3179280029,1661537892,1661538313,421,1769
3350852842,3222375785,1652356719,1652357565,846,731
3786322776,3431000503,1644364425,1644364764,339,1387
3625504025,3021769525,1646010974,1646011389,415,1644
3249252169,3890940747,1648464591,1648464836,245,708
3830330372,3507992647,1642067596,1642068244,648,641
3272217633,3806466784,1667242459,1667243229,770,2234
3447051833,3952346496,1653036549,1653037173,624,1039
3596841713,3124723265,1648184237,1648184457,220,2223
3458478056,3875570780,1662412112,1662412304,192,385
3939725219,3596076085,1658029025,1658029156,131,972
3751588241,3902705203,1641742256,1641743066,810,2063
3679615343,3687724937,1646356514,1646357110,596,529
3223313152,3950433378,1668905472,1668905615,143,1118
3989550849,3713129998,1644925955,1644926186,231,797
3080454518,3656878544,1644556498,1644556572,74,1028
3668421848,3298770258,1661608277,1661609157,880,419
3411181030,3845980646,1668050083,1668050651,568,675
3204114911,3035464149,1661047876,1661048852,976,1927
3313292041,3629824081,1659347370,1659347762,392,720
3962062858,3520943619,1641678308,1641679002,694,1193
3768814245,3778575442,1648563622,1648564556,934,1599
3011686027,3147245859,1663692260,1663692670,410,2183
3861717658,3700167321,1646933780,1646934237,457,532
3816921514,3602829591,1655204899,1655205453,554,1319
3344553610,3759737476,1645599747,1645600525,778,1614
3401463703,3182643672,1664512198,1664512346,148,1554
3889967886,3608485872,1654246915,1654247899,984,411
3098513510,3612642897,1646036506,1646036758,252,1262
3447527130,3855537172,1664791247,1664791875,628,2075
3254194915,3702064029,1654223200,1654224104,904,590
3997050001,3962773297,1654505629,1654506601,972,1288
3257732454,3600501749,1644234770,1644235572,802,362
3510281371,3653780780,1643980721,1643980828,107,931
3912803496,3907665331,1642220749,1642221536,787,472
3309468510,3752621490,1667510223,1667510513,290,991
3187523092,3428557602,1658919947,1658920705,758,2488
3245354614,3176410131,1655278715,1655279212,497,1061
3357474960,3251948771,1658861110,1658862007,897,505
3533274758,3893227652,1662177242,1662177694,452,1488
3350446044,3744563835,1645023193,1645023414,221,430
3973440480,3734779425,1667060336,1667060422,86,699
3950433378,3074837048,1655084221,1655084259,38,1883
3510805998,3998200859,1644172258,1644172641,383,652
3963787394,3437254567,1663870965,1663871075,110,987
3669380667,3064644311,1656457028,1656457435,407,1138
3767409219,3956796805,1659013351,1659013790,439,1577
3907705988,3740376361,1654943071,1654943515,444,1110
3401962895,3262203147,1669700086,1669700300,214,2258
3738887934,3951751770,1651728345,1651729234,889,563
3623974243,3824517920,1642945285,1642945984,699,902
3163551629,3951354982,1655115457,1655115816,359,1781
3089590512,3921261515,1649382587,1649382752,165,641
3829347049,3407460146,1659111819,1659112094,275,1302
3782878084,3787654868,1650418258,1650419047,789,56
3903261473,3448135160,1657329827,1657330608,781,2224
3930474522,3887305908,1651926996,1651927807,811,762
3215453691,3712332461,1644998903,1644998942,39,2204
3602924213,3577798894,1648284419,1648284937,518,630
3620725243,3960215733,1651958889,1651959179,290,1517
3628956600,3657380279,1642339986,1642340390,404,447
3487778655,3233823273,1659736727,1659737464,737,352
3547334414,3852506516,1647242812,1647242981,169,2418
3526239660,3611777140,1645271708,1645272055,347,2161
3342082281,3811337280,1655738743,1655738979,236,840
3526687041,3818453534,1645093830,1645093983,153,2143
3076767349,3693691265,1661383131,1661383731,600,1975
3342708435,3935210171,1649168005,1649168987,982,361
3079447248,3561573044,1666268076,1666268267,191,1873
3969355995,3531345844,1654752382,1654752552,170,2212
3791315348,3879325408,1665362216,1665363091,875,1300
3277372807,3974481828,1646262037,1646262795,758,140
3597485446,3267248595,1661006067,1661006984,917,375
3105789496,3510660628,1641485899,1641486024,125,238
3971648409,3243534925,1651904496,1651905291,795,957
3772749656,3420733881,1646029312,1646030187,875,1560
3849910709,3360051725,1650561980,1650562511,531,318
3697028552,3783051630,1642069550,1642070512,962,2088
3354912831,3204114911,1656136788,1656137400,612,1031
3003972844,3603594711,1668488973,1668489240,267,1613
3352005808,3802749978,1646457819,1646458796,977,1483
3993438914,3898229031,1654095583,1654096416,833,635
3098108231,3258057377,1659325691,1659325827,136,1218
3952663430,3541060382,1668633902,1668633944,42,473
3959081575,3559301819,1645411744,1645411885,141,2272
3549209951,3877090261,1655708277,1655708979,702,1825
3523236646,3798714576,1657888282,1657889197,915,384
3604260104,3475352970,1642727383,1642728063,680,2275
3629933310,3195138141,1650527483,1650527790,307,2114
3425548171,3205423909,1657584172,1657584308,136,1554
3393000047,3994130271,1641268255,1641268584,329,2284
3609799738,3761218329,1666632120,1666633016,896,1050
3435698448,3126995401,1664315695,1664316537,842,2289
3266828046,3497079704,1655338649,1655339451,802,1122
3314495556,3142869544,1654637060,1654637163,103,301
3145552419,3669880471,1650207883,1650208636,753,536
3247758952,3825900664,1662791984,1662792036,52,1077
3729787496,3107482740,1664859179,1664859692,513,360
3216912897,3861499264,1648407530,1648407670,140,2333
3317411967,3200795190,1666029678,1666029977,299,1253
3913984749,3990144819,1645415366,1645415629,263,120
3702965571,3458815526,1654072756,1654073244,488,496
3975663862,3040037607,1661701385,1661701459,74,1123
3187291408,3243005694,1647829372,1647829618,246,1190
3908893546,3571766829,1641176667,1641176823,156,1539
3672070606,3430375744,1664925728,1664926390,662,1826
3159645889,3925690262,1654168970,1654169915,945,1647
3924583665,3012593677,1650715839,1650716167,328,439
3423825173,3137942933,1659906585,1659907541,956,1538
3277298737,3107541952,1654761125,1654761379,254,1120
3264753140,3550107804,1652283451,1652284348,897,370
3340837702,3888312656,1656822681,1656822742,61,1409
3388328160,3086871623,1669322883,1669323803,920,2311
3624748073,3544365476,1667388121,1667388892,771,2257
3497507557,3671539226,1660904673,1660905388,715,2392
3041809783,3526797183,1668809050,1668809528,478,1088
3197497279,3342054027,1641939927,1641940887,960,1669
3600901232,3601851578,1657804745,1657805031,286,1064
3025135840,3563967528,1667315493,1667316136,643,1948
3722483331,3993866389,1651817586,1651818525,939,197
3520825972,3974318707,1669585271,1669585335,64,1926
3912014286,3011458038,1659840806,1659841700,894,2432
3336127092,3522211010,1662982010,1662982072,62,2496
3342315965,3257973966,1648625933,1648626831,898,764
3215342018,3954490536,1663289553,1663290489,936,2405
3604260104,3568756567,1649805079,1649806075,996,439
3752652141,3909002163,1650721329,1650722067,738,9
3029758309,3768814245,1646461560,1646461725,165,1155
3834826280,3290176410,1648655304,1648655458,154,688
3211641180,3434182192,1659415769,1659416425,656,2020
3481881323,3114744245,1659149336,1659150067,731,624
3811827366,3216810372,1667798342,1667798453,111,1575
3443773400,3175676853,1648402088,1648402979,891,191
3035635016,3835069955,1658859642,1658860553,911,2097
3462543040,3900356013,1660164194,1660164595,401,57
3813287023,3948219301,1666206593,1666207245,652,1157
3769868188,3067179904,1667845981,1667846141,160,175
3052376951,3208243335,1663956500,1663957407,907,330
3678720106,3751694809,1658381972,1658382795,823,1303
3693862073,3577817989,1651229608,1651230217,609,593
3304523843,3992571464,1662839141,1662839847,706,898
3573939226,3709075485,1655591821,1655591951,130,2218
3763991129,3348735740,1653762616,1653763388,772,163
3321819030,3640756400,1648993881,1648994045,164,1906
3973050834,3115669693,1641047677,1641048113,436,1004
3692095834,3126940487,1646494793,1646495371,578,2212
3849977339,3492657889,1654433618,1654434034,416,1147
3231496949,3129792187,1645589460,1645590059,599,1177
3244997486,3243840165,1645234887,1645235454,567,1693
3149545838,3054906475,1659590098,1659590953,855,1174
3965629952,3718882981,1646614283,1646614800,517,502
3844416504,3662040060,1647564109,1647564659,550,2447
3898403925,3269653223,1657980489,1657981449,960,2128
3850214790,3228319450,1655761839,1655762641,802,1859
3107713394,3795503592,1645118860,1645119575,715,488
3401582775,3494613087,1665615700,1665616391,691,1151
3237841242,3664989774,1645802741,1645803106,365,2467
3960908616,3338749992,1664387413,1664387747,334,1934
3864485247,3135119423,1661764114,1661764916,802,2377
3652728312,3095849365,1646107921,1646108122,201,1574
3974804920,3423640116,1667647540,1667648279,739,1507
3792708367,3165129580,1654300258,1654300898,640,1816
3040889811,3616218859,1655466929,1655467127,198,1633
3691367177,3623736661,1641301604,1641302480,876,2408
3333095694,3153040217,1666092314,1666092607,293,650
3994783794,3348234563,1649620551,1649621493,942,267
3606643671,3238081511,1667312774,1667313144,370,1055
3091579646,3205423909,1661595305,1661595393,88,1170
3739420445,3852184769,1647403086,1647404069,983,1269
3579404607,3919489244,1654745907,1654746478,571,1357
3379937268,3652513122,1641513921,1641514854,933,212
3786148014,3414700083,1662121983,1662122301,318,694
3595670942,3881942272,1646338715,1646339385,670,1559
3242785599,3879520142,1659414436,1659414834,398,164
3390445291,3264018414,1642135987,1642136569,582,2433
3979845809,3622933919,1664042941,1664043226,285,2446
3807184369,3444067052,1650761643,1650762434,791,1477
3961830711,3404200815,1643256389,1643257141,752,1636
3057090135,3481811999,1657715078,1657715343,265,409
3383093669,3753596469,1642970913,1642971479,566,175
3220800349,3290860752,1642177363,1642177904,541,1245
3780014272,3719124928,1659176000,1659176062,62,1526
3573915559,3207757416,1669705972,1669706786,814,2297
3351087116,3745419810,1661114742,1661115015,273,1493
3057028614,3164467795,1664691100,1664691336,236,1037
3904445895,3170167097,1649002946,1649003379,433,2
3790751649,3587171844,1642327629,1642328200,571,2186
3195534254,3839369127,1657158252,1657158255,3,1222
3029943531,3973666003,1650595781,1650596201,420,1529
3458335460,3276846453,1660487723,1660488650,927,2488
3294446147,3262377052,1662524453,1662524965,512,955
3506187447,3201957142,1666784094,1666785015,921,1104
3716415183,3092925867,1657492511,1657493359,848,1909
3727794902,3753659944,1665376417,1665377273,856,2024
3943927246,3677064508,1643791701,1643791904,203,50
3152537793,3107501731,1646601835,1646602366,531,67
3184178717,3938583443,1653147343,1653147464,121,1834
3866601790,3248900308,1651842056,1651842200,144,98
3384460816,3056721560,1663754127,1663754556,429,1660
3020446596,3526798607,1644347113,1644347241,128,1668
3903193601,3335040022,1651024606,1651025046,440,706
3339415879,3225857817,1663589235,1663589807,572,1187
3074044425,3399235044,1667260786,1667261279,493,829
3255492165,3973440480,1666330638,1666330996,358,198
3842738399,3915175620,1644245988,1644246423,435,154
3844006658,3882748527,1641225072,1641225378,306,477
3261403182,3499026312,1645722043,1645722133,90,1262
3543732655,3415917688,1643172254,1643172562,308,2341
3658423327,3771931468,1645529528,1645530256,728,1326
3942393978,3962045766,1649989977,1649990746,769,560
3900755896,3147376468,1666751041,1666751799,758,1358
3276576100,3173809486,1656055432,1656056028,596,833
3021515419,3302917137,1663716108,1663716194,86,403
3048497124,3668174777,1668637830,1668638724,894,252
3919489244,3241444105,1641855845,1641856533,688,1948
3267319115,3419117613,1661142145,1661142927,782,738
3288937566,3584037261,1652951597,1652951643,46,2340
3843576243,3725611236,1654769514,1654770319,805,1525
3097145374,3035737560,1661431328,1661431355,27,701
3542078032,3205472801,1669411024,1669411709,685,330
3354912831,3334743610,1644627258,1644627948,690,1319
3876829785,3967372197,1649042415,1649042461,46,115
3573915559,3935259918,1669320059,1669320545,486,98
3142765587,3627191763,1649288326,1649288473,147,1405
3577216621,3533936136,1653444858,1653445744,886,2414
3009688248,3520943619,1649697680,1649697981,301,681
3600856738,3316978783,1641672277,1641672936,659,932
3746351822,3376266236,1660089253,1660089422,169,651
3874913687,3196975901,1653483378,1653483579,201,1130
3212218759,3439325479,1666597771,1666598634,863,1327
3310882037,3546486600,1663256354,1663257101,747,935
3167290048,3077683954,1657112876,1657113645,769,1859
3587508502,3442244098,1661461238,1661462034,796,1315
3832336338,3887743057,1666090812,1666091007,195,327
3056252574,3438553592,1668481464,1668481985,521,1162
3414581321,3470287808,1644096118,1644097055,937,1821
3080287966,3128401376,1660052416,1660052499,83,2215
3025333750,3630330540,1647146210,1647147050,840,1187
3209480732,3701726268,1656711581,1656712109,528,340
3917448920,3283922234,1647281575,1647282383,808,451
3809623566,3891235779,1641048836,1641049782,946,1639
3979899306,3357692565,1663177318,1663177767,449,1566
3000011580,3656000543,1666538313,1666538772,459,892
3540104512,3354479032,1651235484,1651235982,498,1178
3819405521,3421730413,1661419187,1661419481,294,1368
3451263201,3680694926,1654304797,1654305070,273,649
3258399411,3471288672,1646708929,1646709576,647,617
3708922840,3264339209,1667330297,1667330819,522,20
3269699819,3299840986,1650029830,1650029916,86,2395
3868873330,3192005711,1651915875,1651916834,959,826
3428499342,3333872407,1668182650,1668182677,27,1780
3351361711,3402511144,1667153528,1667154509,981,788
3190778281,3534752391,1642293619,1642294371,752,2036
3018760022,3232546504,1665574669,1665575217,548,1689
3869293895,3945370501,1653017658,1653017849,191,2373
3453227348,3805826972,1669441878,1669442111,233,1543
3751975877,3690349378,1662722788,1662723231,443,1427
3749811473,3002350398,1652571830,1652572169,339,1996
3784495839,3224792502,1668056543,1668057201,658,1077
3343741687,3446652020,1660098702,1660099112,410,379
3176753600,3834573240,1659403164,1659403609,445,1593
3736681866,3466473464,1668534563,1668535124,561,1480
3098165935,3170924487,1655063537,1655063776,239,480
3379076226,3204735172,1664343918,1664344216,298,1742
3819380768,3509634549,1667514679,1667514853,174,346
3344787204,3325565610,1641907000,1641907998,998,669
3081028310,3956027073,1649181211,1649182059,848,1502
3066714195,3150027454,1657455918,1657456117,199,1615
3565056675,3622848449,1667960770,1667961592,822,2096
3445469609,3167074299,1644499346,1644500231,885,223
3574957979,3347854994,1668932591,1668932693,102,1126
3760042128,3523052385,1665599263,1665600172,909,1169
3639618179,3371026826,1667081242,1667081994,752,1855
3030174879,3011863548,1667846984,1667847843,859,1229
3533172784,3720248207,1654564472,1654564954,482,2495
3260157601,3656656446,1650144017,1650144192,175,346
3690646467,3797182963,1668413496,1668414213,717,711
3235992794,3574205549,1646741289,1646742276,987,1662
3867860336,3957411858,1647791943,1647792689,746,640
3754631129,3415124478,1667765934,1667766712,778,161
3327857419,3663871563,1666315289,1666316034,745,2490
3280372392,3668645457,1652236531,1652237509,978,1115
3477827867,3113516667,1656214383,1656214750,367,510
3801358344,3048896097,1654153763,1654154526,763,527
3259430206,3462862340,1657794719,1657795221,502,1296
3128287586,3575766470,1643523999,1643524578,579,20
3991299369,3689231617,1650990329,1650990643,314,238
3079219552,3661976391,1669191272,1669192196,924,1348
3872928406,3449080412,1662968168,1662968538,370,1633
3697231480,3348278635,1654477365,1654477420,55,64
3119477442,3261477798,1643979003,1643979145,142,578
3610239794,3905922866,1669272679,1669273553,874,1128
3266991557,3542824458,1649413802,1649414097,295,149
3359895223,3310169810,1658562712,1658563186,474,2067
3715894883,3900356013,1663273269,1663273930,661,257
3818655962,3979550486,1641893072,1641893636,564,756
3986016860,3074837048,1645239706,1645240335,629,108
3807924634,3057837723,1649587989,1649588617,628,1082
3134337442,3758622438,1646678866,1646679631,765,1265
3257594028,3133805973,1645672636,1645672713,77,1293
3875748779,3544353013,1661467196,1661467669,473,1339
3086076310,3286476251,1656750429,1656751132,703,1293
3682419396,3271479070,1641426738,1641427036,298,769
3080214168,3927273567,1655558711,1655558824,113,1563
3428557602,3401962895,1644739208,1644739555,347,147
3895422097,3895861447,1666713762,1666714469,707,1742
3910979746,3295352365,1646156908,1646157002,94,1937
3313431689,3434817228,1666070411,1666071111,700,421
3101137807,3564395523,1655127174,1655128083,909,28
3173108957,3383791217,1644895265,1644895905,640,1314
3399503261,3206549691,1646997296,1646997581,285,137
3098820434,3496921526,1649712617,1649713373,756,200
3951692395,3134166826,1658824631,1658825491,860,2159
3261403182,3266991557,1667717871,1667718373,502,2417
3181778467,3557556781,1657293976,1657294949,973,1226
3791055136,3643372353,1652871988,1652872601,613,2044
3580908290,3969563324,1661278502,1661278940,438,1002
3771616536,3080679691,1667030629,1667031514,885,2107
3318466045,3399055713,1666356929,1666357817,888,1951
3111080178,3723784545,1654420382,1654420469,87,1083
3518179871,3242912660,1665318335,1665319195,860,1660
3093178960,3813697780,1649586077,1649586829,752,1685
3813290629,3058290794,1641953828,1641954008,180,191
3927952722,3896866052,1664828338,1664828887,549,954
3967439884,3791406454,1650618501,1650619488,987,1575
3840422094,3022283384,1648814236,1648814626,390,285
3779331078,3551402272,1667518707,1667519239,532,1780
3985239597,3296895937,1644652893,1644653038,145,2104
3439129317,3208220195,1653951699,1653952092,393,1733
3044226207,3123166182,1653914979,1653915740,761,1635
3089962675,3689518345,1658257091,1658257326,235,1671
3790896269,3085093321,1660695589,1660695994,405,1193
3363097423,3742344076,1664070950,1664071591,641,156
3548609816,3265181921,1651831220,1651831609,389,835
3672874828,3669299007,1641561499,1641562208,709,145
3432522125,3333776110,1641640652,1641641390,738,1467
3161234904,3280630861,1652982108,1652982606,498,2305
3569200063,3672371563,1641636575,1641636770,195,845
3343729897,3208346862,1643020554,1643020969,415,2304
3688076815,3656002043,1654352102,1654352113,11,262
3622062401,3536768410,1664393488,1664393773,285,8
3344553610,3856985099,1662038142,1662038206,64,2097
3355976871,3748492935,1653870715,1653870893,178,1927
3207757416,3526218972,1656204871,1656205065,194,2383
3636572173,3045070182,1669313547,1669313762,215,822
3585982995,3107501731,1654648133,1654648233,100,193
3164550059,3164462099,1648653014,1648653177,163,1236
3378221943,3596951808,1667636614,1667637468,854,1239
3442779071,3500097822,1646915339,1646916267,928,872
3215453691,3508809990,1641742944,1641743535,591,1163
3880290667,3118406319,1668342979,1668343016,37,1139
3289017659,3069992620,1656974798,1656974951,153,204
3497171741,3157496248,1666010263,1666010952,689,812
3421875747,3487547990,1657964244,1657964749,505,1722
3014185506,3483670734,1662473697,1662473886,189,741
3437603547,3426017820,1652121589,1652121670,81,690
3037090215,3576661425,1658790229,1658790384,155,1602
3428501033,3111167324,1651633827,1651634246,419,586
3328471090,3527349190,1661339125,1661339989,864,365
3295020761,3961830711,1650810070,1650810574,504,2493
3687874431,3270325529,1656611517,1656611694,177,675
3786478382,3821064356,1647063306,1647064070,764,2354
3231537700,3328798665,1643579471,1643579613,142,1694
3894247542,3710769510,1647830102,1647830868,766,1359
3918234060,3233536885,1641339112,1641339476,364,1916
3259430206,3356028416,1643804613,1643804690,77,1286
3993122275,3397910828,1641531184,1641531895,711,853
3260695363,3017484255,1664241372,1664241740,368,1934
3019694538,3423298470,1647121917,1647122873,956,1476
3288016190,3530495336,1660560233,1660560743,510,837
3522715448,3286473367,1654910498,1654910802,304,1216
3420298161,3839967647,1668732931,1668733002,71,2338
3124147703,3043256301,1662218677,1662218926,249,796
3255252214,3855762650,1652353644,1652354253,609,535
3424994271,3347226466,1666401157,1666401586,429,1385
3462862340,3758577708,1642292243,1642293068,825,337
3963787394,3768984387,1659867426,1659867488,62,2298
3203904444,3095932716,1661724219,1661724468,249,1419
3931277047,3401138486,1653138666,1653138911,245,2333
3534545428,3822693340,1645640303,1645640611,308,1985
3986825518,3261866390,1657038020,1657038862,842,1575
3148203422,3066645531,1654699471,1654700100,629,1983
3294278402,3845363108,1658806884,1658807343,459,69
3973050834,3935259918,1648090724,1648091040,316,1819
3364842162,3883057669,1653772472,1653772779,307,282
3170740142,3011861880,1658458912,1658459179,267,69
3061299464,3552958954,1649406678,1649406916,238,714
3049567508,3504258562,1653149698,1653149857,159,1695
3785586097,3561254848,1669317623,1669318476,853,198
3303884789,3618313240,1643104134,1643104414,280,778
3627981146,3019576854,1664714630,1664715061,431,1986
3014363081,3369913868,1668406345,1668407154,809,2438
3313079052,3024431618,1661381655,1661382365,710,1848
3141392063,3000780515,1653214844,1653215840,996,1314
3650172161,3666079547,1660481755,1660482544,789,1723
3158873070,3899618702,1647545212,1647545694,482,673
3057159511,3573975424,1658752005,1658752401,396,1476
3040897601,3713308621,1656652305,1656652441,136,808
3020108220,3869794122,1657157611,1657157957,346,1729
3500455630,3410865372,1666665012,1666665100,88,1034
3681795615,3794926978,1659396196,1659396565,369,2182
3352634974,3145389444,1649688112,1649688659,547,94
3293615945,3432321849,1663470519,1663471099,580,1830
3062435759,3218746999,1660011449,1660012195,746,395
3432954312,3354200745,1651929950,1651930834,884,1758
3585674939,3857081560,1649411471,1649412087,616,669
3351691261,3703825153,1654457843,1654458022,179,743
3320187187,3194603908,1644227082,1644227365,283,813
3472052544,3811827366,1642437992,1642438547,555,402
3952654862,3099818927,1650183618,1650183633,15,40
3948946969,3900755896,1658559308,1658559590,282,1817
3692772256,3705752007,1669432396,1669432600,204,1123
3442725932,3752797217,1643254751,1643254985,234,2364
3616901816,3457390239,1649461136,1649461926,790,110
3091112554,3724770746,1645425588,1645426070,482,1964
3928212115,3184955498,1660157808,1660158684,876,663
3055020688,3759409777,1645937309,1645937460,151,940
3661243199,3862939959,1661309804,1661310003,199,1729
3862138776,3486059916,1655930777,1655930929,152,602
3272506285,3365094410,1647374112,1647374308,196,729
3309158757,3980501547,1649692133,1649692640,507,2197
3068400634,3526088150,1651162024,1651162970,946,1191
3836565798,3106437492,1649219793,1649220458,665,2157
3190544941,3809698347,1641845732,1641846655,923,1742
3532634291,3202625372,1661083699,1661083941,242,1809
3363097423,3298993308,1665553244,1665554148,904,898
3894454988,3079905449,1657044077,1657044891,814,1382
3844499309,3301093931,1642260747,1642261107,360,205
3889705477,3599104606,1665347364,1665348129,765,2466
3733484132,3193483812,1645683344,1645684216,872,155
3450806791,3316855337,1658934312,1658934861,549,1164
3926612159,3105946115,1664147160,1664147881,721,184
3415761431,3221850819,1654427840,1654428742,902,79
3059447105,3712869836,1661434923,1661435453,530,1003
3349847682,3521081470,1658003361,1658003815,454,1269
3620985435,3742159503,1658092698,1658093097,399,1000
3241341174,3851879278,1656810887,1656811204,317,568
3143226144,3476405785,1661090684,1661091213,529,199
3643372353,3248324593,1655240774,1655241017,243,2273
3227446097,3516676045,1646808966,1646809130,164,1970
3419809319,3405155234,1659260523,1659260690,167,517
3957973658,3641752896,1648447022,1648447639,617,468
3954055058,3094852425,1668390004,1668390032,28,2473
3714203425,3021129414,1654177250,1654178039,789,1763
3191460519,3175929512,1652508226,1652509083,857,1826
3679939578,3825824228,1663510184,1663510559,375,7
3728631423,3406868680,1658069783,1658070272,489,1680
3728950700,3679522128,1652756464,1652757149,685,1289
3387785849,3885458258,1648217425,1648217963,538,1746
3804257503,3744002702,1645791612,1645792600,988,2181
3675418278,3968433032,1651904964,1651905233,269,1335
3208490048,3007480776,1663754276,1663754534,258,2005
3610577318,3819812955,1657855986,1657856776,790,952
3573975780,3845256746,1650930054,1650930471,417,1350
3280046501,3631703207,1645460070,1645460519,449,1322
3052875832,3237824925,1661328467,1661329242,775,2066
3124363805,3911185524,1644539619,1644540365,746,1789
3007328261,3857841054,1666163886,1666164544,658,2447
3056053831,3453552267,1655840106,1655840393,287,1384
3727794902,3897293094,1657592048,1657592132,84,386
3572164547,3519269683,1657983388,1657983992,604,359
3925393914,3078216798,1643524879,1643525233,354,2212
3359901981,3477770827,1662960486,1662961441,955,2067
3726883867,3528475061,1662677569,1662678313,744,774
3787514151,3663718795,1667347361,1667348183,822,1484
3429328367,3032465570,1650276587,1650276855,268,2458
3929901413,3828531030,1645623492,1645624160,668,1242
3776862606,3874569616,1665593268,1665593961,693,920
3256217137,3950763153,1666235701,1666235945,244,1231
3796343532,3145389444,1668872477,1668872556,79,2048
3649036884,3542996543,1651352254,1651352476,222,717
3250359001,3721060604,1641391504,1641392220,716,2316
3094562402,3963257683,1653528342,1653528686,344,739
3216241275,3403024728,1657966362,1657966950,588,2432
3449622291,3800451074,1660970854,1660971717,863,2197
3046500774,3763093748,1649471497,1649471701,204,153
3832334966,3521217476,1648620855,1648621023,168,1554
3352729606,3631568439,1661629287,1661629288,1,2279
3038644033,3423918005,1663126627,1663127483,856,2158
3265655534,3281562391,1651639199,1651640116,917,853
3327681313,3090139002,1641475669,1641475792,123,1883
3157212376,3223518905,1661539523,1661540473,950,1476
3386918140,3450503481,1661923667,1661924012,345,120
3690646467,3248308163,1661890959,1661891439,480,854
3967147343,3898012654,1655879094,1655879128,34,46
3604759141,3206197726,1659823117,1659823497,380,363
3290912062,3154991935,1652104822,1652105044,222,185
3555538922,3347832946,1644820413,1644820972,559,34
3239162274,3883057669,1641601209,1641601440,231,2422
3610056283,3386846556,1643575939,1643576817,878,1880
3406239480,3677674125,1659219456,1659219585,129,1522
3425856728,3952552328,1666107379,1666108032,653,2431
3069818047,3128514837,1663174427,1663175097,670,171
3070557341,3275027460,1656195353,1656195542,189,549
3841672169,3841174974,1658299486,1658300261,775,197
3054171550,3414834461,1666041203,1666041457,254,892
3924577071,3210036729,1647476262,1647476750,488,493
3194664110,3534517997,1656289300,1656289929,629,1243
3859221152,3733190374,1664844300,1664844482,182,1915
3722422633,3986003303,1643888170,1643888171,1,1297
3409502765,3338749992,1654527098,1654527297,199,81
3410513846,3078216798,1666827687,1666828198,511,1094
3442330693,3896594746,1641471431,1641471833,402,2359
3787048351,3552305242,1656043871,1656044293,422,2422
3414834461,3457108498,1653700085,1653700837,752,1945
3796065026,3205988899,1667386750,1667387404,654,1340
3108427765,3381900638,1643591246,1643591443,197,1251
3790751649,3341300979,1650110400,1650110861,461,485
3986825518,3406332128,1665750182,1665750393,211,427
3905922866,3101137807,1656118786,1656119478,692,113
3800201060,3899247202,1645828526,1645829360,834,525
3239469849,3943184820,1662651986,1662652432,446,1370
3393314546,3575715668,1667658140,1667658963,823,835
3212707122,3236975783,1647225502,1647226142,640,1979
3869991101,3784912315,1667031728,1667032600,872,1790
3535325513,3194140038,1662414444,1662414504,60,1605
3383348505,3052233179,1647395177,1647395982,805,231
3630744403,3510318605,1654603834,1654604612,778,79
3631455637,3686641761,1645335870,1645336097,227,1920
3532355049,3646596750,1660065211,1660065744,533,327
3780182766,3118502732,1650105492,1650105953,461,738
3164550059,3833618667,1650660397,1650660871,474,2327
3165884724,3291780380,1649846879,1649847177,298,223
3065548516,3767868249,1642619420,1642619855,435,2476
3735700656,3941512307,1647172541,1647173471,930,609
3428593255,3415892236,1659000176,1659001146,970,1173
3211795832,3693028654,1663237912,1663238631,719,564
3541060382,3100440036,1648284984,1648285764,780,901
3445666899,3820885067,1651796366,1651796854,488,1690
3333103680,3295402408,1661658831,1661658909,78,2165
3458209928,3518817978,1663814138,1663814310,172,1095
3461938856,3226220903,1641544262,1641544701,439,1848
3286463125,3651110510,1656329893,1656330416,523,893
3038424212,3046080865,1650668699,1650669562,863,237
3147512839,3150067482,1663954167,1663955075,908,804
3321699949,3899585675,1665332428,1665332746,318,852
3295905536,3485578733,1655148643,1655148955,312,497
3680139573,3301093931,1645127983,1645128287,304,2384
3529764378,3122127756,1655142398,1655143190,792,2032
3855754332,3541597384,1655349834,1655349957,123,2275
3976730264,3662745240,1652867661,1652868639,978,383
3520392773,3271648296,1647309741,1647310464,723,1616
3630963449,3630614328,1643552032,1643552637,605,113
3462280366,3838082378,1645402498,1645402537,39,2466
3430387951,3768311968,1662629874,1662630027,153,2287
3695161514,3748944220,1646405176,1646405870,694,1754
3950936299,3523631626,1667515080,1667515737,657,686
3280657282,3991963732,1662705533,1662706068,535,39
3150485567,3186367687,1659593827,1659594577,750,874
3423522480,3581324538,1641874698,1641874762,64,756
3988913212,3611685224,1643841473,1643842262,789,257
3045302814,3287399418,1641662233,1641662690,457,1105
3828196026,3162844882,1649572513,1649572830,317,379
3272535116,3510528970,1657654527,1657655167,640,319
3145393304,3994130271,1665716105,1665717105,1000,816
3583169906,3779299713,1662042592,1662042808,216,1894
3178640485,3288347905,1645240230,1645240495,265,2069
3790180006,3791633858,1648553375,1648554157,782,432
3282231108,3977078930,1653554617,1653555399,782,503
3702932977,3162836777,1666050607,1666050923,316,328
3172825605,3672087645,1652113252,1652114201,949,1344
3041652512,3505322684,1661570370,1661570532,162,590
3631587282,3960727778,1659383371,1659384035,664,1619
3682274097,3522132687,1648259916,1648260858,942,296
3347832946,3534545428,1652386083,1652386786,703,553
3654861844,3924799278,1658413075,1658413915,840,782
3110591514,3009366895,1651520679,1651521442,763,1023
3558539337,3348006171,1663797476,1663797645,169,1558
3215088423,3180051747,1644101714,1644101855,141,2052
3139931020,3517992014,1665737597,1665737985,388,2206
3500097822,3719785520,1656117592,1656118057,465,1169
3582060994,3641928180,1656792182,1656792674,492,565
3522715448,3990109853,1662079675,1662080474,799,1318
3380313835,3994651874,1649739238,1649739978,740,2458
3899932297,3934453508,1668928008,1668928540,532,542
3073540574,3032465570,1643946625,1643946687,62,1666
3128571119,3236308141,1663961353,1663961777,424,2363
3071341023,3273676719,1650430492,1650431162,670,2156
3306188967,3590627159,1647210362,1647210547,185,1324
3954297181,3816995343,1658861478,1658861865,387,599
3807922855,3715231431,1660841165,1660842040,875,1397
3273701051,3524831718,1661708996,1661709115,119,2015
3456295243,3067150549,1655036652,1655037617,965,2421
3642691052,3065810858,1643612858,1643613651,793,355
3052438592,3623620611,1658295744,1658295773,29,2475
3242235161,3618683738,1649093849,1649094413,564,1602
3043047337,3397169008,1643981397,1643981946,549,38
3101161243,3988466264,1659071721,1659072245,524,451
3537107415,3166284447,1663173885,1663174492,607,2448
3260085949,3167290048,1654988781,1654988949,168,1173
3383179408,3692904228,1658200924,1658201104,180,290
3294783182,3749266673,1648297541,1648298036,495,1221
3569244680,3714203425,1651682915,1651683559,644,684
3181032246,3803606691,1644757177,1644757324,147,740
3833345079,3200468398,1651166847,1651166885,38,1465
3773770885,3650172161,1666652803,1666652992,189,344
3034147055,3321441782,1661770437,1661771105,668,1201
3110691442,3034919553,1647034110,1647034633,523,204
3263033338,3726378645,1644200581,1644201153,572,1748
3568162481,3010649870,1653354929,1653355310,381,612
3523394395,3318345517,1651177681,1651178350,669,1919
3834011879,3390976131,1662952723,1662952891,168,1428
3102588374,3668174777,1653131567,1653132210,643,2464
3641041716,3503394389,1651983711,1651983814,103,1514
3039893721,3404468022,1645698762,1645699547,785,1694
3083182515,3725989619,1645720237,1645721066,829,3
3792708367,3623206706,1666182320,1666182436,116,2226
3550218169,3447812768,1665325629,1665326267,638,2119
3194125043,3232285985,1646748023,1646748957,934,483
3881216721,3442293538,1650806821,1650807490,669,1487
3969563324,3335462055,1665086378,1665086846,468,1374
3150884811,3102526783,1649036124,1649036137,13,901
3094906195,3151704655,1649107680,1649108181,501,40
3863922323,3865503383,1660630304,1660630524,220,1128
3786480807,3526797183,1651850548,1651851125,577,503
3748511559,3952552328,1651828592,1651828923,331,955
3007087811,3206119800,1651249511,1651250476,965,275
3212707122,3587171844,1659821495,1659822254,759,999
3228277648,3731399462,1642328821,1642329080,259,370
3012929490,3059022884,1646847064,1646847750,686,2422
3380928920,3052822229,1660305617,1660306470,853,216
3489915638,3329825462,1662742754,1662743427,673,37
3206106614,3633080652,1648866167,1648866903,736,177
3950936299,3006388757,1650932973,1650933887,914,1615
3094361527,3302294195,1644742986,1644743778,792,1256
3885458258,3391037775,1645656241,1645656373,132,960
3742145726,3229448014,1648390008,1648391008,1000,1756
3734035973,3025215569,1650250279,1650251080,801,2452
3409055122,3320381981,1653864829,1653865758,929,702
3224864814,3149804005,1647490490,1647491302,812,103
3442674561,3668552386,1659116338,1659116975,637,1640
3518620219,3523465225,1643245103,1643245855,752,1019
3345186165,3458252541,1667001517,1667001871,354,477
3712869836,3602238630,1654919930,1654920503,573,356
3540279517,3951845301,1667918525,1667919148,623,2057
3813290629,3830303170,1655170262,1655170571,309,1681
3556823098,3481030779,1647555459,1647556195,736,26
3060718787,3144068102,1645710586,1645711325,739,74
3251808759,3714698686,1640994796,1640995081,285,386
3037741311,3180534430,1643606942,1643607566,624,2272
3153858233,3640745969,1656112971,1656113596,625,1380
3303358502,3098907787,1663746057,1663746142,85,114
3393606099,3663155034,1651852343,1651853248,905,883
3176410131,3802267458,1649944324,1649944436,112,1672
3678505160,3392918310,1652263387,1652263816,429,1163
3451329310,3589441972,1650133884,1650134189,305,1925
3825023321,3846007471,1643288860,1643289508,648,1339
3047402472,3498989393,1641818367,1641818837,470,677
3268182022,3591348696,1655474207,1655474853,646,719
3354479032,3111823829,1659316899,1659317854,955,399
3097563397,3840764880,1651282118,1651283081,963,1515
3244946730,3944247629,1655369047,1655369659,612,666
3686944200,3193483812,1653027766,1653028731,965,1104
3624188526,3568097363,1664452932,1664453406,474,1246
3868397809,3398735443,1659313121,1659314047,926,1136
3205077454,3863427189,1653328354,1653328423,69,1815
3919196366,3732349114,1643866110,1643866601,491,83
3609274729,3672350582,1648661317,1648662298,981,464
3258854274,3587633750,1656009479,1656009638,159,407
3582046255,3500097822,1645120411,1645120507,96,885
3555966791,3647640857,1659875561,1659876166,605,2376
3041223311,3968412854,1666789808,1666790141,333,1092
3249071020,3493752989,1644793271,1644793816,545,451
3022428512,3399368823,1656791501,1656792042,541,1357
3997162156,3720248207,1664311087,1664311957,870,2036
3908443461,3384222838,1653507684,1653507805,121,1013
3735700656,3100716894,1653517146,1653517346,200,42
3369356299,3057090135,1648599818,1648599934,116,1688
3457895283,3635624917,1656728588,1656728799,211,426
3781789585,3094147044,1647268482,1647269379,897,1193
3879564460,3485298583,1645350888,1645350950,62,171
3076307729,3884802599,1643828941,1643829894,953,734
3244514632,3476820014,1641971446,1641971475,29,1940
3086950119,3145344208,1648816956,1648817071,115,245
3862918742,3877090261,1661595245,1661595545,300,2403
3183740417,3387264235,1666810019,1666810324,305,512
3505295000,3818823702,1665070752,1665071377,625,1625
3996469603,3340837702,1646745292,1646745463,171,1745
3856160688,3293007803,1641593673,1641594065,392,1784
3880353584,3313619618,1641487734,1641488579,845,335
3211839563,3306439333,1652697607,1652698290,683,541
3929887239,3651058536,1641098995,1641099244,249,2369
3435540149,3333543321,1665374137,1665374632,495,1894
3489811088,3943947223,1649622984,1649623750,766,2065
3150503842,3804978604,1667827146,1667827806,660,2208
3390723607,3353388722,1642357476,1642357688,212,2129
3567614002,3584704567,1651190877,1651191412,535,1090
3246759301,3152537793,1646528074,1646528823,749,1573
3344549344,3938773149,1666668893,1666669747,854,342
3030117347,3791279041,1666909738,1666909804,66,471
3278827891,3493393225,1649930743,1649930806,63,1047
3310542239,3103740757,1667209961,1667210321,360,1411
3510281371,3704604706,1665435080,1665436058,978,1915
3258460512,3516676045,1653076120,1653077065,945,1684
3255182489,3815507952,1664897051,1664897395,344,1710
3142160799,3103497887,1667704073,1667705049,976,369
3324003851,3042120123,1655435090,1655435098,8,2455
3270935026,3427860415,1666379081,1666379575,494,1114
3626457002,3814045699,1653396614,1653397445,831,1724
3002438521,3787673872,1659756906,1659757596,690,418
3056267922,3599694754,1668519099,1668520030,931,1704
3169394495,3511325003,1649798155,1649798416,261,999
3383686911,3183340735,1646967410,1646967995,585,1266
3962138330,3414581321,1642411765,1642411896,131,399
3790748869,3755228064,1641039096,1641039758,662,793
3344664961,3002316212,1660076024,1660076237,213,2181
3400684585,3567368088,1649685778,1649685885,107,243
3404394014,3041296119,1667728440,1667729056,616,2415
3166521010,3271201418,1656784255,1656784470,215,2068
3492629459,3790402339,1647374566,1647375416,850,1515
3713693431,3393032827,1643853037,1643853847,810,1612
3301994647,3470570814,1651585464,1651585518,54,1868
3481584783,3292111100,1657824949,1657825788,839,961
3696184358,3466204914,1653502517,1653503149,632,1174
3852685738,3842413213,1657997891,1657998802,911,1619
3560756539,3097489594,1646338027,1646338032,5,1975
3841660750,3371026826,1661316161,1661316719,558,1972
3708101315,3653429754,1659252245,1659252454,209,2186
3453076338,3239020709,1666489653,1666489871,218,2233
3933845116,3194796707,1647501729,1647502684,955,1736
3549033213,3528271389,1658692752,1658693163,411,1555
3120081486,3604881190,1645197268,1645198214,946,1730
3104405785,3815605229,1649239992,1649240777,785,565
3367510444,3698965715,1645054297,1645055209,912,71
3162844882,3239418137,1652458551,1652459157,606,1690
3657333207,3249145163,1644801821,1644802546,725,283
3477363517,3460572652,1647437187,1647437692,505,1212
3046640828,3192194263,1661121678,1661122109,431,2171
3402804885,3479608671,1656602157,1656602528,371,61
3337624186,3709075485,1667313546,1667313957,411,1924
3950146840,3068723030,1644405262,1644405513,251,602
3879898101,3161999632,1657032996,1657033101,105,942
3618095446,3457361080,1667652979,1667653775,796,1584
3776918350,3055390520,1659610384,1659611299,915,759
3439280560,3168983812,1650357633,1650358431,798,634
3763991129,3814577253,1663272212,1663272458,246,69
3050341848,3787920743,1641602764,1641603226,462,1672
3403223215,3765962960,1661337529,1661337822,293,863
3693652924,3414502284,1669067421,1669067912,491,2223
3823133313,3672274616,1642328465,1642329341,876,2389
3746443510,3177651100,1667903762,1667903891,129,1346
3032465570,3634492534,1656389686,1656390181,495,1408
3879001343,3086534991,1647337767,1647338683,916,304
3581570568,3813811121,1669140339,1669140737,398,1947
3348234563,3853448159,1658845381,1658845711,330,671
3982715838,3596500107,1663763726,1663764276,550,491
3375966339,3105357126,1656480565,1656481109,544,1315
3828857457,3578002057,1668270229,1668270335,106,2177
3527869582,3244946730,1644965295,1644965771,476,83
3188384391,3254030842,1656727661,1656727672,11,1679
3729389785,3317614106,1642623685,1642624232,547,2220
3178643457,3394936535,1663118447,1663118563,116,29
3759787118,3281753784,1657035087,1657035287,200,369
3710943716,3267151775,1661527685,1661527825,140,1092
3792253761,3948769271,1642697462,1642697991,529,1433
3105054400,3735098036,1669218988,1669219720,732,1228
3149046961,3107530825,1656405321,1656405882,561,99
3531256735,3721870717,1646490573,1646491400,827,2436
3778228977,3781446747,1642491856,1642492793,937,718
3677306151,3384222838,1648990583,1648990824,241,1306
3287399418,3661016961,1667249614,1667250081,467,1683
3246159564,3489695411,1662843398,1662844184,786,465
3443385652,3604762599,1656360986,1656361931,945,355
3069992620,3636621583,1667066521,1667067183,662,840
3105054400,3104210284,1644254810,1644254929,119,2445
3967972556,3651847351,1650389560,1650390444,884,1385
3438550737,3312580754,1668809190,1668809431,241,1479
3777684793,3133601374,1669163400,1669163802,402,2327
3104164320,3845338893,1652655478,1652655650,172,61
3488878461,3644127860,1666976275,1666976649,374,479
3428062841,3415522797,1649136169,1649136913,744,1850
3447310943,3253759705,1661897507,1661898128,621,990
3472052544,3210913409,1650967920,1650968430,510,1173
3641911946,3257821708,1669633864,1669634166,302,975
3388490960,3507952797,1654783272,1654783749,477,2144
3917709571,3813632607,1653000123,1653001123,1000,2075
3599604382,3086325930,1662746803,1662747078,275,105
3806664868,3688910009,1651530530,1651530679,149,2344
3424994271,3499994307,1659136286,1659136617,331,1797
3428557602,3822146001,1661375036,1661376027,991,2049
3377901268,3671830270,1644702638,1644703221,583,264
3792012199,3819235768,1652074703,1652075019,316,1538
3094906195,3686424169,1666491195,1666491209,14,1380
3820466728,3103497887,1652056810,1652057718,908,1064
3128613298,3457284809,1662139311,1662139650,339,1287
3257690557,3880476189,1669681200,1669681550,350,693
3965926652,3518932161,1652378032,1652378277,245,358
3255248380,3651058536,1654208966,1654209763,797,716
3121128511,3912106632,1668767622,1668768177,555,1594
3801038758,3604593541,1665254368,1665254599,231,1145
3796255141,3836823852,1669212893,1669213577,684,2154
3763804073,3897491493,1645113452,1645113466,14,212
3695935038,3427127427,1647369338,1647369374,36,329
3152933136,3623620611,1650608202,1650608367,165,910
3339911597,3646159351,1648562496,1648562568,72,1517
3088604045,3702284586,1646305825,1646306531,706,2218
3784629786,3014993252,1645215277,1645215812,535,911
3854184537,3319422840,1648316026,1648316107,81,2436
3804318840,3679141266,1662713431,1662713716,285,2315
3034325039,3574460900,1661414085,1661414712,627,1776
3196407951,3331336589,1656270783,1656271392,609,1789
3518620219,3177651100,1654417866,1654418067,201,1826
3057085790,3428987981,1653930499,1653931424,925,1798
3745532894,3318848700,1663554413,1663554709,296,1526
3644961840,3884949094,1649510234,1649510486,252,1486
3039972849,3450672463,1651224500,1651224917,417,1590
3551771231,3048405710,1644004265,1644004564,299,2185
3649658953,3595560993,1653420392,1653420910,518,1171
3497045946,3896960517,1649418286,1649419045,759,1932
3089962675,3233938614,1656325141,1656325304,163,1123
3561254848,3360158658,1650746242,1650747165,923,2380
3457341479,3572224210,1660722095,1660722274,179,308
3660513601,3164462099,1649732507,1649732510,3,1298
3708777992,3447203087,1668109877,1668110774,897,88
3638822670,3881554146,1647455873,1647456706,833,283
3569578952,3011985525,1651956916,1651956962,46,1259
3404317985,3329117199,1657110650,1657111264,614,1605
3540104512,3813666053,1651461920,1651462618,698,181
3691879230,3773789419,1642643392,1642643806,414,1538
3928257298,3610101662,1649898829,1649898985,156,1589
3636960130,3292010262,1661447863,1661448015,152,1445
3079137127,3346948485,1665364022,1665364326,304,162
3732585972,3300015174,1650335019,1650335863,844,1231
3706206403,3671974600,1657774701,1657775673,972,703
3400684585,3962676436,1656142443,1656142577,134,2498
3635624917,3658477943,1645011103,1645011874,771,1436
3928290954,3903978752,1666749637,1666749752,115,506
3480100868,3631455637,1641423496,1641424287,791,792
3382983805,3284433811,1669093498,1669093875,377,651
3053166522,3683507812,1663737421,1663737571,150,2180
3366321387,3653577731,1652164622,1652165340,718,2068
3906396830,3780808964,1665215189,1665215267,78,2007
3524942512,3665931760,1645068334,1645068496,162,1978
3787880772,3263239497,1655635183,1655636066,883,2364
3173034893,3335915365,1665197849,1665198781,932,1559
3714909437,3255904598,1662157845,1662157856,11,275
3620639101,3448952875,1667642459,1667642792,333,2285
3876927357,3532675680,1657850860,1657851178,318,1504
3704818655,3774816472,1652831838,1652832320,482,1258
3596483616,3915175620,1666557102,1666557195,93,1983
3135116989,3609043475,1645519247,1645519864,617,1536
3156483651,3948710872,1644175448,1644175706,258,1335
3665591394,3397397223,1657367175,1657367760,585,1934
3670267009,3497507557,1650834330,1650834998,668,840
3776429592,3945397961,1641919492,1641919873,381,2129
3029956642,3508718004,1654970545,1654971047,502,1094
3788911315,3400604704,1652415494,1652416082,588,217
3688345244,3093300732,1654730465,1654730817,352,2177
3771588829,3759787118,1644361718,1644362283,565,1931
3858876644,3639819433,1663601141,1663601304,163,1138
3156210736,3703881738,1665188346,1665188350,4,1194
3767868249,3194560289,1654111477,1654111806,329,2380
3834174227,3258050916,1659495446,1659495894,448,2139
3177190923,3701196344,1646051944,1646052189,245,209
3262645455,3534201448,1651585689,1651586468,779,1376
3197660189,3569177433,1648187522,1648187624,102,365
3196822601,3086084685,1651708320,1651708613,293,1485
3586025172,3425803609,1663809168,1663809623,455,1171
3736085476,3775103844,1666715776,1666716401,625,470
3485644295,3263239497,1666722827,1666722917,90,367
3771826410,3757507821,1658766661,1658767610,949,766
3024554792,3804189322,1644842713,1644843399,686,1772
3125350196,3107541952,1649409387,1649409544,157,1211
3043753185,3374688375,1663360894,1663361638,744,1692
3772749656,3689741006,1652669502,1652669800,298,2153
3222375785,3447527130,1661369662,1661369858,196,1996
3335040022,3446519765,1646336803,1646337729,926,830
3334792271,3814851615,1649512388,1649513275,887,874
3699183333,3809041613,1658885383,1658885858,475,292
3304973317,3656829277,1656489969,1656490771,802,1472
3669874673,3704568536,1643708471,1643708482,11,2140
3333776110,3634041831,1644706638,1644707268,630,1944
3129641154,3352262794,1646348971,1646349445,474,921
3178235505,3257187145,1644805722,1644805727,5,1682
3492638245,3956194935,1666134833,1666134844,11,1587
3387568587,3336947163,1642352555,1642353210,655,1698
3486442976,3167074299,1666470937,1666471487,550,1477
3776148003,3289255457,1648297279,1648297892,613,1132
3685678285,3344337283,1643696696,1643697006,310,1268
3106781266,3883812439,1642791579,1642791954,375,293
3183640403,3389097842,1667547454,1667548429,975,654
3184455727,3621966073,1646673247,1646673319,72,1860
3381769309,3165307890,1641158668,1641158939,271,580
3365440817,3161774382,1667849854,1667849871,17,1648
3186371475,3972397754,1657110233,1657111174,941,548
3168434098,3795250558,1648230130,1648230931,801,1894
3449622291,3344077337,1661257322,1661257850,528,1219
3368423726,3202453519,1643030407,1643030465,58,1404
3200827648,3424721457,1657343567,1657344001,434,682
3186367687,3458335460,1645181623,1645182175,552,379
3311921613,3623206706,1664458846,1664459783,937,938
3802072416,3918234060,1662158739,1662159192,453,2377
3669520344,3180252962,1663305096,1663305628,532,2376
3699263886,3990343743,1652528380,1652529236,856,2412
3242857629,3950763153,1645294730,1645295094,364,1588
3934386586,3755473771,1668780168,1668780756,588,230
3769767823,3860268588,1643974561,1643975190,629,742
3363611494,3456285013,1657127104,1657127699,595,1604
3448734872,3588728644,1660358424,1660358683,259,569
3268916307,3852834619,1644998178,1644998371,193,1785
3489380093,3377086230,1658948833,1658948862,29,2480
3571972204,3965434074,1660662720,1660663382,662,509
3352729606,3620939715,1656510834,1656511230,396,1499
3638847705,3774325139,1662520845,1662521089,244,971
3052861028,3725848338,1643843222,1643844081,859,1932
3493393225,3245247493,1652433084,1652433137,53,1808
3078500208,3124384203,1652497452,1652497543,91,2478
3391206046,3387568587,1660266344,1660266391,47,2297
3928354041,3350345176,1666792049,1666792451,402,1642
3268446099,3514680311,1647517363,1647517540,177,2130
3777597419,3125818794,1666995585,1666995888,303,836
3403337910,3715106063,1661426779,1661427451,672,415
3485526833,3200059644,1658278685,1658279484,799,1040
3572214339,3290860752,1647313419,1647313910,491,1275
3530462613,3572276937,1668437315,1668437611,296,1181
3261376049,3734004050,1664415857,1664416598,741,500
3311329069,3123458167,1667443392,1667443920,528,2497
3443384698,3943184820,1653872723,1653873029,306,1897
3353722089,3882315040,1667468622,1667469066,444,1282
3704517188,3522365623,1667855427,1667855537,110,2104
3922827209,3013681789,1657511401,1657511546,145,1046
3145393304,3976992294,1647176682,1647177671,989,2246
3378522829,3845256746,1668520766,1668521163,397,1889
3341573446,3909309427,1658985247,1658986141,894,2357
3346978275,3530491537,1643158153,1643158272,119,2217
3920028342,3532307372,1649557183,1649557946,763,1422
3061299464,3414277030,1664062310,1664062351,41,2074
3741692259,3261419893,1659516998,1659517648,650,2485
3128043317,3088553332,1648822771,1648823335,564,1772
3240839516,3257973966,1652582074,1652582254,180,2030
3206198477,3921560605,1649033901,1649034553,652,668
3989991456,3284550954,1668001601,1668002061,460,1451
3851780195,3474242977,1663887401,1663888208,807,1159
3728797277,3761147252,1669293433,1669293636,203,1262
3694618653,3345458354,1668039241,1668039719,478,2235
3184680353,3957665117,1641233690,1641233934,244,1044
3962031345,3909523201,1654253360,1654254217,857,2119
3103856643,3600901232,1642670413,1642670482,69,863
3623433422,3813811121,1641595044,1641595719,675,88
3802592493,3328373210,1669239548,1669239769,221,944
3442854678,3582544512,1649882532,1649882638,106,171
3903779058,3010488834,1641352989,1641353880,891,1003
3086135849,3319334426,1644699524,1644700524,1000,1444
3527067023,3168535205,1668850193,1668850560,367,1409
3454135300,3003243547,1660789377,1660790352,975,1674
3062261092,3599869347,1652828434,1652829410,976,1459
3445666899,3154680228,1664237248,1664237483,235,900
3829201459,3254991122,1668641390,1668641594,204,1120
3306871271,3928241216,1649422286,1649423150,864,5
3989208740,3801579775,1655673520,1655673551,31,2337
3392121294,3641455530,1665567722,1665568189,467,823
3018325807,3831951487,1653806027,1653806438,411,2098
3920327961,3790406016,1649858491,1649858630,139,1428
3449622291,3256787088,1661933229,1661933941,712,2386
3380928920,3075293628,1655781414,1655781453,39,21
3659326501,3141137322,1667428560,1667429021,461,1065
3666079547,3474402148,1654337519,1654338233,714,214
3061366261,3958375464,1661841413,1661841447,34,2294
3603965318,3698633384,1644686359,1644686714,355,367
3880638655,3985037610,1662367867,1662368170,303,908
3296419150,3470049551,1645530526,1645531059,533,380
3905922866,3199797181,1654463877,1654464797,920,106
3833333678,3247787797,1664368300,1664368414,114,2471
3526798607,3519828744,1662193285,1662194079,794,1861
3108288045,3200795190,1648489796,1648490677,881,1507
3268826534,3739406554,1668200697,1668201144,447,2107
3620616287,3752669447,1655059288,1655059639,351,1670
3880599649,3185373368,1652884507,1652884582,75,794
3530930024,3432765814,1662840968,1662841932,964,253
3565381166,3356690610,1667532075,1667532707,632,1095
3213995449,3155797946,1660660222,1660661002,780,1284
3213400022,3526315797,1664843434,1664843605,171,828
3061362091,3897412947,1658980111,1658980671,560,2419
3527269010,3094291821,1644256649,1644256716,67,2467
3321835417,3590259850,1643652369,1643652788,419,1293
3892800106,3726520685,1643548325,1643548729,404,1548
3948743692,3714105777,1650386068,1650386407,339,2410
3322801895,3400730635,1667201481,1667201812,331,1460
3266127117,3997051818,1643221481,1643222404,923,1619
3143741876,3106705860,1665234933,1665235716,783,1111
3395525819,3749980168,1645975898,1645975945,47,1701
3179405209,3184608724,1657901491,1657902040,549,2274
3247980767,3551243497,1649010559,1649010803,244,1908
3607352755,3232304638,1649204287,1649204852,565,627
3445558523,3124384203,1667189097,1667190012,915,2116
3689518345,3710394011,1664871937,1664872660,723,1804
3617958907,3259039915,1662706782,1662707084,302,1061
3216470508,3377086230,1665328326,1665329322,996,694
3967754963,3388004574,1667250114,1667250751,637,1411
3524482926,3170167097,1648215555,1648216311,756,756
3779192515,3646687421,1654442321,1654442648,327,1845
3428499342,3697085492,1658560992,1658561592,600,2060
3398278082,3429445014,1656650005,1656650546,541,868
3589972665,3042739113,1646611220,1646611580,360,1780
3942393978,3048721189,1649492635,1649492788,153,1519
3659204779,3074886612,1654112126,1654112488,362,510
3133030435,3222254600,1650388864,1650389516,652,2420
3135406478,3801956152,1655617719,1655618632,913,2172
3622848449,3929794333,1649253146,1649253295,149,2492
3880608911,3556549065,1641892151,1641892845,694,804
3581399447,3947788644,1654127378,1654127587,209,1530
3303986609,3088155289,1650163431,1650163604,173,1783
3475686271,3387264235,1651361664,1651362022,358,776
3159873313,3785728567,1650227015,1650227786,771,2079
3982916950,3299389436,1667246391,1667246720,329,2198
3510660628,3821594953,1646706913,1646707673,760,1841
3442854678,3883265629,1664028551,1664028966,415,231
3580280923,3318717113,1643176875,1643177753,878,2159
3321818923,3048781539,1642044108,1642044849,741,588
3813854723,3657251975,1656159309,1656160216,907,2406
3337684100,3328544337,1644927789,1644928447,658,2194
3312661854,3457108498,1641898289,1641899079,790,1674
3288490513,3985879853,1641138520,1641139180,660,1742
3082359035,3315854812,1644992369,1644992877,508,862
3806664868,3049592624,1660953594,1660953740,146,2091
3775501779,3572214339,1666169456,1666169535,79,53
3962440297,3209097023,1641748768,1641749023,255,1504
3346778916,3825645806,1655711327,1655712099,772,2414
3365289656,3682006274,1656081278,1656081676,398,1370
3170924487,3622656083,1669411502,1669412433,931,1861
3406868680,3223313152,1659689537,1659689675,138,931
3825900664,3163973134,1652360911,1652361135,224,2261
3349718189,3368420871,1650141378,1650142078,700,419
3963515530,3088595440,1656769083,1656769600,517,1943
3575576911,3035245517,1663227683,1663227997,314,1371
3208770010,3656467120,1666053934,1666054906,972,1825
3804824307,3821180393,1658019604,1658019632,28,846
3148589566,3066429600,1649714420,1649714836,416,471
3595535977,3260802289,1651113146,1651113574,428,650
3209064637,3845338893,1641667243,1641668111,868,2275
3569573616,3941548978,1667156712,1667157224,512,978
3066757468,3891235779,1650055762,1650056284,522,314
3106328456,3139434250,1665552868,1665553631,763,161
3787880772,3783064521,1658318255,1658319101,846,91
3511192827,3035895563,1663563212,1663563871,659,1594
3806737055,3831255967,1661389586,1661389689,103,2347
3972886254,3841314189,1652549716,1652550012,296,768
3292172583,3227310314,1643654276,1643654277,1,1791
3906772132,3661747291,1665667158,1665667690,532,1398
3269622220,3047400344,1655007953,1655008451,498,562
3048388831,3954285582,1663576001,1663576706,705,1725
3633111737,3071971535,1654578268,1654579266,998,2015
3819405521,3102526783,1651936597,1651936726,129,278
3998763119,3172502658,1664354625,1664355081,456,2212
3425803609,3400000869,1667132295,1667132369,74,829
3389773271,3225068874,1653760773,1653761689,916,180
3905167655,3033692011,1653808229,1653809168,939,1951
3146645864,3111817334,1647757833,1647758640,807,533
3089574886,3611100286,1658643390,1658643432,42,635
3535575355,3624748073,1641020511,1641021119,608,180
3584309667,3516624109,1643901357,1643901472,115,394
3470112947,3411708498,1668303703,1668304077,374,1527
3962518574,3491272857,1646973529,1646973540,11,1563
3444005080,3110482626,1664760011,1664760673,662,293
3163662966,3669380667,1641367644,1641367933,289,660
3882414600,3232835207,1653982674,1653983483,809,657
3607393629,3393406422,1650570865,1650571601,736,264
3354200745,3277284318,1641973935,1641974928,993,1496
3572896327,3776398060,1649072849,1649073616,767,2176
3315593278,3395316132,1653209627,1653210309,682,1906
3011466658,3442674561,1642526177,1642527143,966,1628
3500216283,3869711224,1646766239,1646766943,704,23
3427127427,3496040749,1654703075,1654703229,154,1943
3316318605,3885926991,1647229341,1647229481,140,1723
3222254600,3870877628,1657748143,1657748207,64,2046
3559696066,3494179125,1644862641,1644862872,231,1614
3331336589,3727859047,1652981260,1652982063,803,1064
3291838772,3636621583,1647012812,1647013173,361,2393
3229871774,3608485872,1658064553,1658065082,529,2178
3096076350,3182131313,1659232775,1659232837,62,77
3387264235,3416719967,1668999173,1668999663,490,512
3540717336,3062261092,1646246799,1646247264,465,1939
3373667144,3872574112,1665654374,1665654815,441,1445
3300015174,3864930473,1659713733,1659714516,783,1790
3464983756,3590228003,1651527709,1651528292,583,345
3426617058,3229871774,1657113632,1657114035,403,1696
3775753518,3363097423,1667310500,1667310985,485,2052
3530376538,3622596133,1647234463,1647234748,285,858
3934199220,3858052316,1648928508,1648929295,787,2086
3061594355,3317431311,1665645868,1665646349,481,2079
3527291464,3849028830,1666943916,1666944722,806,1581
3098513510,3804458349,1644097690,1644098385,695,1077
3450806791,3256231811,1645645766,1645646279,513,1150
3654381548,3736483863,1648783758,1648784270,512,1437
3223694966,3141997314,1646616341,1646617267,926,1314
3572792752,3985239597,1662147887,1662148883,996,1275
3273258651,3190064020,1655345843,1655346112,269,456
3958539607,3460428731,1646521671,1646522181,510,1254
3175832070,3546034581,1648974959,1648975821,862,2407
3627730665,3336965818,1654508942,1654509209,267,2151
3517556603,3438574719,1658994818,1658995311,493,2398
3369175849,3017712081,1648633984,1648634611,627,1294
3587324906,3930051071,1652700341,1652700994,653,851
3534450842,3868827867,1668987620,1668987784,164,2300
3079031370,3548145086,1665782981,1665783414,433,66
3799480079,3657101592,1644437850,1644438355,505,1334
3080195715,3411347712,1642951846,1642952032,186,290
3392121294,3755236966,1649418198,1649418388,190,1119
3922675517,3846628868,1662604138,1662604529,391,2208
3289693932,3445530012,1662918351,1662919118,767,428
3194664110,3327857419,1645956659,1645956951,292,322
3052861028,3532675680,1668395272,1668395811,539,433
3380303288,3930591160,1648415272,1648415505,233,735
3052875832,3554275173,1666036209,1666036433,224,1173
3770118341,3991087724,1663148031,1663148324,293,390
3364199338,3848860153,1651209832,1651210703,871,337
3870778205,3585674939,1660652633,1660652980,347,2166
3129667560,3607622692,1643739878,1643740427,549,1015
3569006301,3506822540,1657327441,1657328430,989,763
3824860461,3165845148,1658969051,1658969600,549,96
3797237179,3108288045,1654026062,1654026718,656,1708
3870574001,3422046745,1651026831,1651027315,484,1219
3786516095,3042052031,1651357773,1651358771,998,1322
3557325531,3177628377,1655707178,1655707774,596,1015
3694244943,3903193601,1652534942,1652534949,7,2443
3733975709,3540799427,1663817590,1663817713,123,2164
3917373940,3044967578,1649377668,1649378592,924,2037
3790650118,3023880168,1649977487,1649977860,373,907
3059870015,3957115705,1667317408,1667317543,135,797
3913398460,3731257404,1668942575,1668942906,331,360
3339480960,3212841978,1656828433,1656828840,407,1875
3621000186,3077552507,1658627024,1658627377,353,64
3448734872,3799624292,1649977661,1649978087,426,1320
3240502673,3378814600,1643636073,1643636415,342,2377
3267411650,3949947697,1657166400,1657167265,865,578
3974326867,3911316683,1667875516,1667876148,632,463
3340511048,3784629786,1647663206,1647663791,585,1459
3288347905,3280657282,1648759418,1648759669,251,1147
3643173963,3881216721,1662355367,1662355398,31,1945
3816170686,3059075236,1645880694,1645881558,864,1717
3772762015,3446289365,1644237375,1644237937,562,2457
3807184369,3909330778,1669634003,1669634506,503,1579
3134890095,3176432386,1645470450,1645471024,574,2467
3362598320,3273518390,1644024283,1644024301,18,475
3029149493,3688196978,1661919042,1661919604,562,2415
3057308926,3090139002,1659524961,1659525272,311,294
3535467955,3461508348,1658366418,1658367021,603,1502
3072734804,3124222667,1652182444,1652182617,173,518
3922358932,3163470555,1645825673,1645826620,947,1021
3728974462,3286078112,1652912466,1652912778,312,1554
3824083602,3224644594,1646191262,1646191992,730,1660
3202625372,3686240080,1669448262,1669449023,761,701
3929975862,3390445291,1654952460,1654953137,677,2020
3356034290,3776954666,1654046262,1654047168,906,1115
3912111332,3073924620,1669560380,1669561091,711,1608
3106705860,3034985161,1669402566,1669403254,688,771
3785222888,3831346903,1667790500,1667790625,125,1592
3357579618,3567328601,1657767742,1657768522,780,812
3774958505,3061362091,1653452137,1653452147,10,2085
3183340735,3830975217,1648023175,1648023291,116,1146
3569478966,3335709869,1653291573,1653292449,876,2258
3032970317,3408604990,1663193681,1663194285,604,701
3127467065,3772178120,1668300260,1668300546,286,2060
3790635482,3636879699,1643407469,1643408057,588,2496
3824545323,3418276734,1661150123,1661150308,185,804
3027129249,3950428741,1646289501,1646289848,347,2096
3055402951,3859221152,1653758397,1653758498,101,1121
3215815915,3211003582,1654800521,1654801489,968,599
3276118203,3955750752,1654062662,1654063618,956,249
3555538922,3698989053,1650761559,1650761564,5,1629
3707342422,3925344243,1647258162,1647258938,776,639
3742647803,3137829230,1644664270,1644664471,201,2175
3298038439,3714897535,1648926067,1648926262,195,653
3554862003,3740009683,1662730090,1662730620,530,967
3250359001,3082075242,1667955242,1667955788,546,223
3733440098,3030290445,1641999229,1641999400,171,1379
3744234480,3636948225,1653381297,1653381469,172,1062
3694206371,3330058679,1667192655,1667192700,45,1951
3185558387,3874664424,1651834123,1651834834,711,1409
3582076532,3990379463,1643318433,1643318516,83,2121
3600334566,3321819030,1664666266,1664666658,392,1716
3613188168,3836535079,1643827477,1643828388,911,822
3126653341,3149191705,1660299164,1660299996,832,414
3851778010,3959497834,1651425917,1651426041,124,1726
3901902653,3946409673,1642254741,1642255419,678,31
3762890946,3345875910,1650981338,1650981793,455,2149
3501866086,3012119082,1649194795,1649195613,818,1841
3054979282,3740376361,1643668655,1643668906,251,301
3863190883,3164391025,1666941041,1666941068,27,1115
3934326645,3364600039,1645914126,1645914232,106,1836
3281597338,3939768853,1649524239,1649525175,936,1440
3488757134,3179354869,1649069481,1649070063,582,2051
3755243698,3903886201,1661454300,1661454867,567,1817
3048896097,3736104902,1652046633,1652046947,314,401
3526197227,3407778626,1667435555,1667436422,867,1791
3765827886,3909002163,1666370972,1666371356,384,2194
3521160717,3350891476,1650595833,1650596702,869,2149
3906065558,3989746763,1665756023,1665756744,721,238
3025108334,3796587240,1660449894,1660450604,710,618
3077346044,3691607111,1647215021,1647215517,496,1506
3432942151,3888563902,1648416957,1648417096,139,1674
3938272679,3846493363,1647761351,1647761545,194,2034
3786811867,3832463052,1656938501,1656939321,820,77
3346530861,3541942422,1657705003,1657705787,784,2211
3409502765,3359541123,1650804775,1650805220,445,2320
3939181696,3595535977,1659121433,1659121965,532,2326
3415020400,3781580109,1649193945,1649194892,947,132
3664267954,3175196290,1641431622,1641432113,491,1333
3235476099,3945199219,1663094522,1663095119,597,994
3583029647,3348006171,1644716018,1644716804,786,827
3634492534,3842738399,1654407718,1654408620,902,1521
3036470049,3959081575,1662058748,1662059311,563,2232
3803051709,3349879521,1664147544,1664147889,345,2295
3423073970,3389926670,1668867284,1668867785,501,1954
3419809319,3750083020,1667392539,1667393181,642,590
3993572792,3956500972,1658539689,1658540440,751,2038
3662507847,3108230028,1663637160,1663637809,649,1482
3508809990,3515480973,1643898824,1643899443,619,153
3052789625,3048388831,1657573292,1657573652,360,1792
3561062307,3912672075,1666655291,1666655537,246,14
3460428731,3288309878,1649674453,1649674683,230,2404
3934773931,3268916307,1643491081,1643491449,368,498
3962138330,3865950417,1661520236,1661520976,740,631
3698965715,3373667144,1651432629,1651432897,268,2183
3823133313,3356689959,1653308309,1653309077,768,78
3624298459,3148366567,1662199108,1662199400,292,39
3203319376,3059602794,1664671565,1664671828,263,149
3840764880,3635938446,1660459064,1660459312,248,701
3423965711,3010161936,1649858645,1649859468,823,1553
3065246027,3457417743,1650472984,1650473083,99,2290
3151386327,3356154602,1658307624,1658308239,615,818
3870243569,3361016803,1655059897,1655060143,246,1381
3200116756,3918552618,1647372408,1647373341,933,1270
3907004279,3404904674,1667789969,1667790035,66,1510
3094759406,3647597870,1646264343,1646264800,457,1748
3546006441,3543668840,1662296858,1662297253,395,699
3764724451,3710318693,1643546834,1643547328,494,1200
3690667222,3308531560,1647027446,1647028381,935,2220
3414857456,3698358344,1647298043,1647298221,178,2278
3371430360,3993756491,1641066054,1641066687,633,1332
3916776869,3920436432,1654769261,1654769769,508,1512
3467933841,3595144575,1664412341,1664413098,757,351
3514458890,3335573495,1661219308,1661219728,420,1432
3463734539,3853163109,1642478400,1642478454,54,999
3689464410,3063714742,1645199543,1645199977,434,1764
3906024837,3452248216,1665941529,1665942506,977,527
3680453323,3278566573,1642169951,1642170567,616,1211
3343153937,3911588238,1646295933,1646296375,442,2141
3534517997,3639352352,1646448771,1646449478,707,1788
3022403169,3573941843,1660802556,1660803305,749,751
3840558415,3281907019,1646038525,1646038703,178,1874
3707406950,3691879230,1661715471,1661716171,700,703
3249252169,3773996198,1664470963,1664471081,118,1216
3528278695,3214711870,1647088715,1647089390,675,945
3715118659,3748988849,1657244981,1657245352,371,206
3414748923,3592887882,1655591475,1655591831,356,1784
3608071362,3424621981,1669267742,1669268456,714,662
3269956451,3199892178,1661868902,1661869644,742,975
3858052316,3510634049,1669273457,1669274024,567,244
3263350346,3541579882,1653802015,1653802222,207,417
3229495084,3095151362,1650214506,1650215066,560,1875
3324113509,3142454040,1661089361,1661090361,1000,272
3453431236,3823133313,1652836310,1652836565,255,998
3625611440,3158871377,1641159276,1641159562,286,1817
3536421569,3570747542,1657531942,1657532523,581,2078
3425282516,3611763388,1643073480,1643073908,428,1892
3045302814,3660839110,1661538417,1661539224,807,1322
3961721758,3091062283,1665021223,1665022012,789,2307
3974065082,3129899259,1661434888,1661435407,519,1179
3043153412,3082026010,1668439466,1668440414,948,1332
3716137932,3575766470,1659714073,1659714550,477,2328
3730684727,3516399207,1644539349,1644540268,919,58
3741907389,3000011580,1643910625,1643911417,792,882
3355798436,3261419893,1663709211,1663709263,52,1459
3047372637,3924838447,1658498633,1658499352,719,1154
3332721407,3436422088,1646509150,1646510091,941,1177
3867101565,3687293094,1653805507,1653805647,140,1291
3310255083,3900755896,1657311098,1657311697,599,158
3435518470,3626672801,1645912835,1645913798,963,393
3333347852,3513925385,1652731314,1652732150,836,111
3988466264,3445031830,1650233879,1650234056,177,1675
3298857826,3153085443,1666019267,1666019994,727,1073
3902739418,3601690466,1664852452,1664852454,2,395
3498461454,3908895548,1660970519,1660971448,929,1776
3356154602,3342215329,1641440183,1641440977,794,2261
3687151281,3508514571,1652054877,1652055167,290,1681
3228565452,3463540687,1647128509,1647128827,318,2489
3782878084,3264121565,1641851079,1641851164,85,1782
3419422052,3252070101,1651863754,1651863920,166,251
3122109326,3034147055,1641572016,1641572382,366,107
3615359439,3793344397,1659579066,1659579114,48,2452
3997051818,3791633858,1656578795,1656579517,722,2416
3539510682,3227567293,1661665696,1661665769,73,1776
3632284739,3584704567,1668695300,1668695792,492,222
3628963667,3715118659,1641670754,1641671133,379,538
3569443529,3658461707,1650029391,1650030154,763,114
3638595264,3397376963,1665218143,1665218972,829,510
3744347272,3410258020,1660529527,1660529684,157,1092
3686743575,3492638245,1647529935,1647530339,404,93
3139087074,3040897601,1669345592,1669346033,441,274
3965863452,3129955835,1667628834,1667629645,811,1752
3821064356,3415124478,1656389587,1656390563,976,1753
3998221237,3145312014,1654271396,1654272108,712,86
3241033604,3324113509,1653741223,1653741342,119,1192
3364404145,3296957627,1641472055,1641472818,763,284
3386918140,3290844621,1668223278,1668223747,469,2478
3203904444,3504893701,1648006294,1648006843,549,2205
3090304189,3819541125,1663628883,1663629190,307,2423
3732472752,3365939940,1649390989,1649391169,180,3
3507871733,3455808094,1644827384,1644827877,493,2472
3943622737,3845130884,1659303031,1659303078,47,1828
3976992294,3233932115,1648245817,1648246644,827,681
3631660076,3528069102,1643642480,1643643398,918,1291
3539303536,3481090623,1661199399,1661199715,316,2379
3474975781,3151938386,1656962550,1656962555,5,217
3885583347,3599007187,1648889310,1648889335,25,1396
3725480364,3669311789,1653195323,1653195406,83,705
3276118203,3357034260,1668216829,1668217523,694,2015
3039198774,3855984822,1668826460,1668826680,220,2242
3489695411,3796954140,1657161737,1657162606,869,1351
3262845808,3174712961,1659346365,1659346682,317,750
3114183830,3791633858,1656858682,1656859430,748,559
3829986472,3744196402,1658399330,1658400274,944,1155
3333665805,3109234948,1661638666,1661639491,825,2486
3024447668,3481466662,1646129905,1646129905,0,252
3702302181,3285019414,1641268324,1641268691,367,598
3798631691,3417798594,1644365377,1644365430,53,2085
3951354982,3460428731,1656655650,1656656418,768,121
3301901497,3916928531,1645814991,1645815714,723,1869
3772762015,3890580849,1641613675,1641613721,46,146
3491562484,3918121469,1659565532,1659566489,957,1951
3084555769,3574834673,1643608911,1643609090,179,1360
3095728444,3984977278,1658548389,1658548718,329,2413
3710318693,3549475344,1642749136,1642749506,370,1353
3782377691,3106328456,1646297187,1646297333,146,720
3727859047,3001037251,1660718629,1660718955,326,1793
3443490373,3394695318,1643050193,1643050986,793,83
3759737476,3134425396,1650994607,1650995200,593,1555
3062015697,3550677109,1649626508,1649627378,870,1435
3607608267,3084940745,1647163532,1647163906,374,1838
3850427038,3998987664,1647009574,1647009866,292,1605
3698156103,3886521075,1651160807,1651161526,719,1829
3599915754,3403471618,1659010990,1659011366,376,1717
3050341848,3471993716,1654112381,1654112557,176,1669
3741692259,3637980358,1660212338,1660213249,911,670
3915942384,3903321481,1652039540,1652039865,325,643
3688076815,3795342940,1662976557,1662976662,105,1311
3868936645,3292812509,1666732334,1666732612,278,2354
3626015702,3329496705,1642154798,1642155585,787,1955
3045427279,3095503795,1664722074,1664722976,902,338
3553960271,3084030782,1658489255,1658490226,971,449
3895976556,3621571402,1659715255,1659715327,72,754
3940735440,3667528236,1653112532,1653112816,284,4
3177943874,3346986628,1642753383,1642754194,811,2096
3174712961,3104719783,1641666589,1641666754,165,1679
3948833001,3602891052,1642544288,1642544371,83,1982
3356317749,3785432995,1650843510,1650843642,132,2484
3269294562,3773532257,1646009480,1646009584,104,1961
3823419231,3136448234,1653185507,1653185792,285,879
3758577708,3762422234,1657382579,1657383400,821,2161
3129993467,3825930964,1662795341,1662796091,750,78
3980781580,3462743550,1669134294,1669135212,918,275
3479401102,3205543673,1644266236,1644266651,415,525
3282561101,3993917332,1655976551,1655977405,854,2367
3338812942,3505417530,1669718944,1669719255,311,1138
3081641451,3920910995,1644418386,1644418880,494,152
3734533600,3473355243,1657028892,1657029575,683,2316
3108500091,3155366529,1656093323,1656093454,131,1321
3491333253,3659563225,1645846287,1645846884,597,1015
3712804229,3278819973,1668073457,1668073654,197,2269
3603214777,3687874431,1648246201,1648246962,761,2030
3005449860,3957803611,1651903421,1651904272,851,1147
3337601088,3657101592,1663323152,1663323633,481,656
3187523092,3445023517,1667381428,1667382356,928,2316
3362836351,3787673872,1665969831,1665970050,219,1419
3260783577,3293387588,1642650826,1642651772,946,460
3698633384,3210337290,1644655322,1644655327,5,1645
3724669056,3847561511,1650836636,1650836799,163,2345
3533290388,3216665855,1667879858,1667880418,560,1116
3952552328,3634328779,1648143848,1648144096,248,932
3136396999,3112357538,1668534482,1668535024,542,2460
3501866086,3925523737,1649158295,1649158828,533,686
3014552263,3785813162,1664032336,1664033303,967,976
3887036201,3109284478,1660722683,1660723361,678,836
3240502673,3693925345,1647979906,1647980602,696,547
3625938415,3279550373,1642825900,1642826827,927,737
3869711224,3768099353,1646716161,1646716498,337,1458
3168983812,3875750764,1659962404,1659962518,114,944
3263033338,3352005808,1665546859,1665547307,448,710
3152176779,3718684083,1646151997,1646152419,422,1790
3812997079,3493226566,1651558603,1651559398,795,1967
3922358932,3321819030,1641687619,1641687898,279,2355
3913608544,3749897140,1666426626,1666426679,53,1927
3225616352,3369175849,1664553253,1664553792,539,1618
3599795440,3454297726,1656129694,1656129928,234,1653
3637518238,3885786333,1659733087,1659733278,191,447
3285757325,3963841091,1668235846,1668236771,925,535
3996587507,3333037570,1664626889,1664627081,192,106
3019773309,3878943307,1655312973,1655313714,741,1664
3569743064,3780991625,1662355265,1662355491,226,298
3414370730,3949522552,1656587563,1656588299,736,332
3143318519,3850304083,1667939597,1667940079,482,2163
3338154846,3195159288,1653909622,1653910186,564,1092
3109465057,3149896107,1663665859,1663666832,973,1934
3256217137,3912014286,1655883281,1655883903,622,832
3903886201,3769198196,1655896908,1655897153,245,206
3954185607,3679867888,1659829750,1659830641,891,2058
3388490960,3894801934,1661394350,1661394390,40,809
3468654589,3796275634,1645234104,1645234803,699,428
3788498920,3924577071,1664863837,1664864291,454,1749
3573975424,3689303525,1664380239,1664380656,417,755
3398583773,3609003771,1655113831,1655114537,706,1572
3939181696,3214068022,1655920093,1655920744,651,1602
3195214383,3527269010,1662582647,1662582992,345,2419
3622978712,3093523046,1644696024,1644696971,947,1385
3987735792,3043604048,1648265101,1648265507,406,322
3492103801,3888757366,1669071645,1669072615,970,1132
3123677020,3242622170,1666228189,1666228314,125,1590
3324003851,3152456543,1664026364,1664026633,269,1452
3488151008,3052499026,1657077053,1657077894,841,677
3084592361,3187807330,1657316202,1657316299,97,1907
3658659669,3421728246,1659638494,1659639418,924,2391
3638847705,3267319115,1648836021,1648836952,931,443
3606111278,3910839994,1652463660,1652464426,766,122
3090179745,3010161936,1654306583,1654306979,396,388
3099559880,3863922323,1669111652,1669112383,731,1018
3133427035,3938272679,1649346157,1649346849,692,1456
3718684083,3584309667,1642179910,1642180902,992,1245
3080195715,3627503494,1642093197,1642093546,349,2076
3698906761,3282231108,1641572195,1641572367,172,691
3854859043,3507500782,1660257205,1660257563,358,2416
3034807560,3907635993,1651828837,1651829088,251,2401
3014275222,3080679691,1653793799,1653794437,638,1040
3526797183,3091579646,1650022505,1650022987,482,798
3810952134,3749811473,1644254291,1644255287,996,2344
3066053770,3473394094,1663466019,1663466191,172,608
3855261620,3871851890,1647239490,1647240231,741,99
3262379384,3367849829,1664789421,1664789701,280,2154
3487992433,3963257683,1667899998,1667900883,885,1303
3155807587,3461292351,1643414759,1643414937,178,2106
3705306826,3425490548,1653049553,1653050417,864,1057
3793772897,3371767777,1656085031,1656085965,934,337
3828738126,3239418137,1666452461,1666452811,350,1767
3322801895,3803606691,1669132010,1669132697,687,2144
3924990392,3563103144,1667778577,1667778886,309,1711
3357247840,3712332461,1657499553,1657500359,806,948
3549482615,3257118282,1647749680,1647750670,990,978
3970886019,3645341350,1667384993,1667385854,861,1367
3002013720,3881216721,1664983429,1664984138,709,1705
3708034201,3174658362,1668552944,1668553196,252,1076
3349030618,3199117399,1660661303,1660662166,863,1781
3287116319,3725963743,1643519013,1643519234,221,1741
3357699960,3249305465,1658934118,1658934742,624,13
3903560788,3965629952,1656193975,1656194954,979,2282
3771788181,3682793223,1650449411,1650450217,806,1627
3730684727,3156683897,1659135470,1659136355,885,1695
3081005801,3793901427,1660172300,1660173292,992,709
3672194570,3593967802,1647647096,1647647636,540,1043
3255182489,3243840165,1659619470,1659620175,705,2354
3198999623,3917448920,1643960015,1643960635,620,1276
3026095831,3878059612,1649678670,1649678825,155,179
3328245802,3983988321,1657102065,1657102419,354,1695
3621452884,3732796331,1665139023,1665139478,455,1905
3549703546,3084066396,1656659251,1656660247,996,2090
3412109130,3049592624,1656234553,1656234680,127,1133
3224491185,3806570797,1655212335,1655212885,550,1709
3885458258,3768549498,1667172904,1667173879,975,2431
3634010080,3227246451,1649678911,1649679882,971,1578
3109500957,3350067994,1652844011,1652844049,38,1551
3446946900,3928951547,1649483865,1649484733,868,1534
3012892515,3405319002,1668493454,1668494111,657,1838
3337601088,3787920743,1642751515,1642752109,594,1239
3191462400,3131683456,1663695657,1663696260,603,567
3047477485,3012602506,1665490867,1665491424,557,1708
3556968717,3746872131,1649102311,1649102639,328,237
3440324329,3704498751,1659491496,1659492267,771,156
3081701001,3603096793,1643707133,1643707144,11,1160
3840026910,3233222399,1660109775,1660110738,963,644
3714909437,3597459911,1656401273,1656401659,386,317
3414669089,3814809809,1659663378,1659664054,676,2185
3315182095,3897222406,1647358754,1647359172,418,574
3554275173,3515941468,1645533164,1645533269,105,591
3371063992,3656158144,1645990350,1645990596,246,2142
3056982737,3710331536,1661290839,1661291629,790,206
3844939526,3769786489,1644630681,1644631557,876,492
3173969437,3799078288,1668831584,1668832348,764,1017
3740236087,3707199669,1661589931,1661590244,313,1064
3818508802,3204083684,1647213722,1647214026,304,172
3012155922,3477522732,1657959201,1657959825,624,1365
3192612662,3630966486,1656887024,1656887740,716,600
3069316815,3252187190,1654741893,1654742428,535,457
3703943697,3568965374,1650697232,1650697302,70,1130
3992528955,3446987671,1644426262,1644426737,475,271
3624085921,3479580096,1658925779,1658925974,195,2076
3662935617,3335275571,1654864726,1654865627,901,1318
3840502377,3035803277,1654479149,1654479843,694,1576
3436768933,3814851615,1668844529,1668844742,213,1952
3728878635,3243005694,1662244695,1662245061,366,2482
3200827648,3702983168,1646207834,1646208240,406,423
3209332658,3494971523,1659446702,1659447518,816,2196
3550107804,3821864560,1643516130,1643516284,154,1632
3569200063,3511192827,1668183786,1668183995,209,151
3480523769,3002829154,1645311545,1645312353,808,1306
3063955055,3854184537,1665766146,1665767019,873,254
3637129082,3293416862,1646727892,1646728068,176,1208
3965863452,3463009951,1667260872,1667260948,76,1489
3134337442,3733849983,1662634276,1662635251,975,1744
3321699949,3929282989,1667538649,1667538736,87,2202
3544087053,3092360885,1660168350,1660168365,15,2130
3027870588,3055944630,1643495388,1643495772,384,1278
3987162833,3880835949,1651071123,1651072045,922,1034
3633730527,3784123884,1666842386,1666843294,908,1206
3648975076,3443490373,1652748421,1652748982,561,2430
3824168840,3705247337,1663380015,1663380139,124,2461
3417820101,3555187890,1661140571,1661140980,409,192
3880620233,3148549210,1650682924,1650683438,514,2460
3097563397,3938416139,1651252705,1651252825,120,946
3453076338,3579728276,1656048896,1656048907,11,2327
3507952797,3906024837,1661343668,1661343956,288,1059
3537862606,3547923552,1663942075,1663942525,450,1946
3364855872,3733240502,1650893929,1650894748,819,2359
3118554894,3073332785,1652703305,1652703404,99,220
3880580622,3261255394,1662800024,1662800047,23,177
3447887397,3612878721,1642595956,1642596343,387,2015
3170058626,3038823274,1656733546,1656733602,56,2401
3286466102,3260306978,1667286424,1667286735,311,180
3007480776,3938776287,1657224675,1657225443,768,815
3867799694,3965137487,1642699585,1642700067,482,1134
3715894883,3749702246,1649803212,1649803612,400,1192
3700109325,3547672806,1668872094,1668872856,762,74
3774413169,3387568587,1662563497,1662563700,203,779
3852344377,3115343467,1649151714,1649152086,372,2077
3928685907,3235825340,1651587810,1651588337,527,229
3179180919,3896997211,1660578017,1660578702,685,1470
3119477442,3041792624,1657509239,1657509515,276,134
3186897818,3844964880,1659296887,1659297048,161,105
3965000413,3780117215,1647627821,1647628573,752,2459
3093716530,3928212115,1662558682,1662558834,152,578
3234141140,3696096099,1659208001,1659208852,851,472
3270177744,3347226466,1661066432,1661066845,413,816
3986003303,3335383594,1657369674,1657370422,748,313
3178643457,3400233871,1644057619,1644057924,305,891
3348770994,3655087982,1661364053,1661365006,953,2210
3246024635,3149668198,1662360288,1662361040,752,1066
3641666820,3099682661,1667885794,1667886005,211,2152
3548351680,3059602794,1641755105,1641755331,226,828
3103215750,3752347758,1666264429,1666264741,312,1357
3913680174,3714065380,1641913613,1641914336,723,469
3531574623,3215514672,1648400915,1648401638,723,389
3566825897,3932613929,1662908320,1662908861,541,723
3193095337,3604426149,1653474655,1653474980,325,1424
3736085476,3184680353,1669088794,1669089435,641,2411
3310542239,3711943152,1648443371,1648443543,172,1879
3759415017,3590656592,1662105689,1662106060,371,1100
3331977197,3771504908,1646294386,1646295160,774,248
3995299995,3632284739,1659875362,1659876217,855,1795
3379296882,3670579691,1660042978,1660043736,758,1169
3036527901,3718182841,1644091174,1644091500,326,1453
3407331091,3727859047,1641540275,1641540544,269,1926
3669874673,3944493334,1666657771,1666658514,743,182
3265181921,3900309643,1641569367,1641570313,946,838
3352262794,3490044613,1644735718,1644736596,878,1905
3977924189,3463405011,1659773999,1659774861,862,1116
3766528617,3778068384,1659224898,1659225013,115,281
3210337290,3915154684,1653300339,1653301127,788,1186
3392121294,3190508233,1647024252,1647024773,521,1547
3112960048,3081701001,1657568249,1657569115,866,1811
3830408109,3945299482,1641098897,1641099313,416,701
3427937915,3062506508,1664895244,1664895967,723,518
3839788123,3987318292,1644343793,1644344689,896,1620
3708654413,3823790407,1654669600,1654670498,898,1014
3304596274,3900309643,1644611413,1644611971,558,1639
3531859919,3704305860,1651199937,1651200045,108,1489
3828722911,3239020709,1641963693,1641963726,33,1998
3305480485,3172293659,1652158303,1652158600,297,48
3350345176,3814851615,1659761325,1659761381,56,589
3101265323,3800239896,1648617642,1648618254,612,155
3011015055,3105648731,1667605422,1667605723,301,1900
3645868952,3330058679,1651168030,1651168729,699,380
3232209052,3462743550,1654593257,1654593861,604,703
3682279970,3920261171,1668298730,1668298850,120,2410
3342189600,3569578952,1655192147,1655192456,309,157
3482483232,3918552618,1659972913,1659973159,246,2257
3239527114,3285019414,1655282152,1655283137,985,674
3688405055,3908997041,1652089941,1652090608,667,830
3483354291,3134380066,1667046177,1667047145,968,2411
3035794185,3854906546,1648298970,1648299525,555,1453
3408300554,3609003771,1655644667,1655645500,833,1304
3941548978,3868440818,1668204550,1668204735,185,1897
3614206353,3142848483,1661500420,1661500772,352,1715
3335242048,3290844621,1643068641,1643069044,403,1006
3066426534,3256648307,1657870564,1657870690,126,2082
3726520685,3767453896,1656233092,1656233989,897,1976
3274985034,3382453510,1651816162,1651816413,251,228
3128532251,3129683689,1656896324,1656896485,161,2156
3110016926,3622848449,1656461284,1656461513,229,1221
3158291556,3258399411,1648590354,1648590887,533,1355
3887108152,3322226292,1644131140,1644131456,316,2109
3885393767,3141635102,1668254651,1668255197,546,2081
3283171763,3129899259,1649239970,1649240714,744,1215
3844964880,3359403467,1665961486,1665961611,125,691
3336302831,3414606604,1645345847,1645346597,750,717
3770771031,3127142463,1662654768,1662655477,709,1634
3460047535,3371289776,1658664251,1658664966,715,2124
3261265769,3957051129,1642052288,1642052342,54,475
3882438892,3659563225,1642760739,1642760987,248,403
3691474413,3154833958,1669130910,1669131554,644,286
3072277927,3749529134,1651483866,1651484000,134,2337
3749811473,3501308694,1660871740,1660872014,274,1010
3793298032,3906772132,1661537209,1661538032,823,1760
3233536885,3528418687,1668515367,1668515912,545,1327
3359895223,3344077337,1667455490,1667455644,154,1177
3374636126,3352729606,1662618723,1662619174,451,1898
3058064037,3206198477,1666266397,1666267135,738,1160
3445530012,3283037458,1652475479,1652476107,628,2076
3770771031,3844966905,1657543222,1657544076,854,734
3321819030,3298521381,1641756327,1641756479,152,613
3944914500,3215453691,1662362053,1662362473,420,1074
3405749286,3553939893,1649774742,1649775336,594,2354
3586489382,3415892236,1661194638,1661195479,841,1348
3117322872,3610056283,1663769851,1663770149,298,1250
3639515059,3310523513,1668649117,1668650069,952,1955
3695935038,3837366084,1666556945,1666557039,94,776
3025014828,3852818295,1668706767,1668706869,102,2289
3105679045,3321971009,1663638444,1663638933,489,23
3435036750,3268216928,1646073111,1646073313,202,1993
3578655079,3477827867,1647843163,1647843949,786,1028
3021727735,3877090261,1644953424,1644954375,951,1354
3390723607,3186371475,1655410302,1655410626,324,1931
3953655387,3694762938,1642823579,1642824495,916,1311
3327145204,3499272388,1644205362,1644205575,213,1404
3253913009,3769198196,1658916864,1658917752,888,1870
3653739025,3442927979,1664271734,1664272281,547,987
3668471634,3922341165,1643122714,1643123586,872,1157
3134117241,3651798658,1651909582,1651910334,752,140
3329135548,3335275571,1667741581,1667741951,370,954
3598522904,3196009998,1656722873,1656723116,243,1045
3864301593,3069332103,1654975200,1654975820,620,1378
3796954140,3497271227,1651668115,1651669048,933,949
3124051904,3256615260,1669040392,1669040461,69,36
3704305860,3275827194,1643885150,1643886092,942,1842
3501946724,3228319450,1644709330,1644709486,156,1844
3241444105,3095621927,1646712250,1646713233,983,1225
3405110319,3956027073,1661010003,1661010106,103,2030
3415761431,3555560595,1650096259,1650096621,362,1451
3021338974,3561113748,1658114052,1658114980,928,2464
3986081370,3249759052,1665260708,1665260979,271,605
3279239799,3131938458,1651624913,1651625642,729,1552
3046380642,3046351455,1661452549,1661452798,249,2082
3627902900,3112074335,1656429978,1656430217,239,67
3408944120,3406239480,1660778357,1660778517,160,1643
3146555014,3100027110,1654710321,1654710916,595,507
3884412861,3850089310,1669077528,1669078117,589,1831
3909330778,3156538951,1668958632,1668959101,469,2350
3834166808,3670835955,1649841353,1649841456,103,259
3122109326,3208757755,1642527905,1642528349,444,2451
3078500208,3532307372,1667754710,1667754949,239,1880
3845818528,3672164838,1641888123,1641888575,452,743
3707947874,3805953085,1645778245,1645778600,355,340
3393000047,3800014504,1654749995,1654750445,450,148
3896866052,3175832070,1655268538,1655269283,745,1009
3065482463,3054758455,1641551365,1641552160,795,294
3442209140,3131548243,1642129020,1642129968,948,82
3633382140,3060728062,1669307232,1669307419,187,1463
3198338148,3957824946,1656544916,1656544931,15,1878
3390919111,3612556887,1643933336,1643933424,88,393
3109500957,3303025505,1664763900,1664763999,99,203
3060121211,3939725219,1645148894,1645149795,901,997
3050701199,3532634291,1667179612,1667180368,756,279
3713129998,3771504908,1658065198,1658066047,849,2285
3019631963,3493226566,1666293088,1666293314,226,804
3306515955,3776128581,1665273450,1665273751,301,653
3431892611,3288309878,1660943114,1660943760,646,1970
3551402272,3759165741,1668933076,1668933600,524,2395
3860268588,3515550503,1650434370,1650434890,520,31
3280491285,3777938800,1664552958,1664553274,316,732
3392121294,3185360566,1648791699,1648792049,350,3
3935601127,3588579914,1642050746,1642051413,667,2123
3652728312,3332721407,1659429776,1659430722,946,1662
3209462413,3623685885,1649201462,1649201644,182,1869
3739338939,3377774902,1644111358,1644112010,652,669
3424621981,3998316020,1651896466,1651896579,113,680
3869991101,3705306826,1658156377,1658156516,139,465
3029807207,3894801934,1667000813,1667001515,702,1960
3978330638,3922423821,1661071802,1661072585,783,840
3151982756,3896308173,1654225725,1654226550,825,661
3666579485,3369175849,1663071579,1663071592,13,1538
3828890005,3350017208,1664269617,1664270426,809,2135
3529732289,3528467648,1650259806,1650260186,380,566
3718710270,3318227153,1648206188,1648206196,8,263
3365340586,3798509385,1661917833,1661917869,36,1489
3105558193,3685473604,1648559841,1648559861,20,1189
3178643457,3733821292,1651089753,1651090060,307,272
3319583055,3778228977,1662287182,1662287406,224,581
3337967165,3828555703,1663544859,1663545690,831,556
3373512814,3436975295,1642146401,1642147167,766,1308
3876344592,3631424312,1658224313,1658225188,875,324
3288016190,3766966794,1658467169,1658467850,681,2154
3092118254,3155835978,1659340105,1659340206,101,286
3994130271,3134425396,1648648462,1648649093,631,1970
3656674833,3268916307,1660686043,1660686510,467,314
3242752835,3340933137,1645695360,1645695518,158,1994
3760432849,3532021354,1667454217,1667454907,690,1907
3836823852,3066305343,1661782384,1661782427,43,1000
3030290445,3680255689,1650109473,1650110384,911,1408
3070810251,3062464540,1643706651,1643707613,962,1622
3157190919,3762533949,1667476883,1667477331,448,206
3402019498,3988337484,1649406359,1649407022,663,1064
3831683294,3387774254,1668786248,1668786525,277,1898
3851864688,3003723782,1665587787,1665588019,232,593
3350783192,3887108152,1649153546,1649153689,143,110
3414026708,3353422891,1644611204,1644611989,785,2195
3898641431,3712115076,1656836831,1656837242,411,178
3569563212,3149560686,1646873478,1646874115,637,1556
3307306078,3138411685,1652163953,1652164616,663,1120
3675093452,3710786724,1646375304,1646376150,846,895
3036470049,3706085200,1642641482,1642642180,698,1733
3827122083,3065434950,1658012459,1658012700,241,1007
3324041559,3352729606,1648389842,1648390574,732,587
3934911409,3661494924,1651124955,1651125053,98,1842
3520699413,3485578733,1643596280,1643597279,999,994
3098342545,3630966486,1669641396,1669641876,480,1501
3836762535,3815692931,1641849103,1641849798,695,1153
3165307890,3542927039,1662879088,1662879901,813,2478
3204333859,3114733025,1667130760,1667131069,309,1510
3592026567,3779459643,1667262993,1667263816,823,1745
3035737560,3506952427,1662824749,1662825573,824,1333
3104405785,3070199722,1642658221,1642658374,153,2158
3804748811,3718562533,1650844408,1650844461,53,1950
3590259850,3324473595,1666085074,1666085270,196,887
3871971681,3185360566,1661255159,1661255414,255,445
3957216784,3286065477,1669243299,1669243874,575,2118
3878059612,3908443461,1654508566,1654508937,371,1299
3137324029,3757507821,1654105622,1654106526,904,2170
3276350975,3303358502,1643014415,1643015190,775,2309
3833683293,3487992433,1658164381,1658165294,913,1363
3083235668,3093773162,1654804581,1654805063,482,1899
3886736668,3437705581,1649448263,1649448895,632,414
3606368289,3310496626,1649027693,1649027884,191,2245
3211521816,3795494127,1667132728,1667132909,181,748
3597485446,3250248786,1641498430,1641499204,774,2408
3375359100,3784828021,1663685643,1663685919,276,1232
3142160799,3635988688,1653212908,1653212955,47,2006
3704437148,3705752007,1662923949,1662924712,763,486
3152518339,3689464410,1645107510,1645107661,151,1617
3445281422,3374134461,1667705925,1667706267,342,1296
3166284447,3967015655,1652510700,1652511591,891,1541
3721374677,3403337910,1642187751,1642188328,577,87
3239265546,3162641272,1664507138,1664508126,988,2132
3876829785,3894175918,1667260399,1667260805,406,534
3975504102,3828485006,1660909961,1660910958,997,903
3001889220,3466735449,1656873082,1656873986,904,1596
3526365568,3478097925,1666113927,1666114647,720,1740
3423971586,3223094732,1657709320,1657709371,51,127
3216550436,3494179125,1652116945,1652117321,376,1684
3644272268,3766196716,1644322001,1644322556,555,443
3046006152,3312580754,1642622292,1642623229,937,2428
3590384867,3879898101,1653939813,1653939939,126,228
3599915754,3124051904,1657941447,1657941874,427,1347
3152988371,3887409378,1642822599,1642823257,658,1800
3997810649,3632283664,1668118836,1668118867,31,65
3016971363,3261477798,1665241658,1665242105,447,1873
3479580096,3541920859,1652323637,1652323889,252,927
3389546736,3817960208,1641213975,1641214307,332,1714
3126417218,3532190519,1669147971,1669148290,319,19
3610480358,3100535469,1660285691,1660285879,188,1515
3952107057,3392918310,1643605159,1643605662,503,1992
3506273643,3302455172,1646291695,1646292516,821,341
3217047921,3382159828,1666220265,1666220552,287,2214
3106584115,3471376255,1659923651,1659924133,482,610
3121762934,3618352797,1656088503,1656089284,781,1619
3545652885,3468922263,1657761758,1657761896,138,435
3532450192,3764343778,1658534569,1658535227,658,1040
3422728078,3429328367,1668539084,1668539340,256,1773
3589157304,3289437738,1642557154,1642557433,279,2125
3276846453,3866215730,1657474972,1657474991,19,1403
3802790977,3891053268,1646205668,1646205880,212,321
3500701807,3421600026,1666796769,1666797191,422,1685
3920669948,3284948113,1664545546,1664546301,755,572
3110360947,3377826578,1647603361,1647603875,514,950
3629984961,3717926703,1661981311,1661981634,323,2041
3015246686,3894247542,1645494542,1645495110,568,518
3430916751,3254496907,1657368265,1657369085,820,487
3523236646,3958449916,1643388773,1643388882,109,1999
3364888618,3553436680,1646794552,1646795002,450,986
3840953967,3634044438,1644180978,1644181610,632,96
3199472785,3833230225,1660607942,1660608762,820,1785
3478288963,3750277600,1647904194,1647904634,440,492
3258102756,3867115890,1646307349,1646307742,393,574
3277298737,3849028830,1664038736,1664039580,844,1457
3170292789,3612973191,1643334712,1643335711,999,432
3240839516,3768311968,1644570201,1644570975,774,2360
3511755413,3237807880,1649774771,1649775758,987,1968
3929988329,3258417294,1659666598,1659667258,660,2185
3978691513,3444349973,1661421691,1661421867,176,2431
3969355995,3333543321,1667746342,1667746781,439,147
3276666399,3179180919,1641706136,1641706946,810,2199
3492258334,3083235668,1652300861,1652301479,618,1886
3433576059,3014354609,1644864341,1644864349,8,113
3971722824,3284433811,1644560725,1644561709,984,1430
3046738951,3934199220,1663773914,1663774052,138,2088
3491272857,3473728186,1643474065,1643474830,765,1329
3615359439,3145552419,1661103989,1661104886,897,122
3814017798,3686247296,1641674912,1641675836,924,1815
3814851615,3729034883,1653128740,1653128901,161,1043
3081188307,3585495750,1651493869,1651494121,252,920
3842362489,3729340640,1656369210,1656369450,240,157
3101363863,3328245802,1649210626,1649210930,304,2285
3820302319,3215423327,1659976990,1659977546,556,461
3475322181,3183867254,1652480369,1652481073,704,784
3929464797,3345458354,1655497924,1655498696,772,2222
3043258601,3237563954,1652792544,1652793217,673,113
3553712893,3383093669,1654098408,1654099079,671,1076
3003872692,3382159828,1645618309,1645618558,249,1125
3920436432,3197371652,1642982945,1642983131,186,2369
3740376361,3400114442,1666164664,1666164718,54,609
3929988329,3869505474,1653353352,1653354263,911,603
3507564472,3174544371,1646518932,1646519270,338,419
3804748811,3285243887,1643773104,1643773135,31,1445
3178090646,3840502377,1658116734,1658117436,702,445
3744871116,3204083684,1645708170,1645708997,827,1384
3828890005,3029468819,1644280938,1644281593,655,511
3099976032,3094940809,1657720519,1657721488,969,372
3035135381,3445422843,1644216558,1644217114,556,500
3090179745,3593437920,1645544020,1645544081,61,1121
3173667762,3447470600,1642517160,1642517738,578,1283
3231496949,3073924620,1655610888,1655611360,472,998
3194070207,3107501731,1662061509,1662062100,591,2079
3107713394,3482166014,1658482250,1658482424,174,129
3282587673,3442447509,1660525707,1660526642,935,311
3525152477,3976984063,1649098839,1649099462,623,2380
3099976032,3269865212,1660061764,1660062079,315,1985
3082108681,3615897427,1659319115,1659319458,343,793
3303025505,3882254802,1669653568,1669653698,130,1931
3906903088,3568756567,1658492188,1658492242,54,1347
3104793032,3553725082,1648121147,1648121986,839,341
3409332035,3696359426,1665090918,1665091579,661,655
3540799427,3546824914,1651573660,1651573889,229,2424
3736085476,3098955230,1651834954,1651835312,358,169
3336991621,3595270507,1655968130,1655968609,479,1070
3201479561,3335818403,1666756107,1666757072,965,135
3515941468,3018946311,1662848050,1662848322,272,559
3081803809,3100201926,1660396720,1660397522,802,1392
3612556887,3019576854,1663942145,1663942207,62,1816
3409779636,3090910630,1664101531,1664102262,731,482
3458478056,3743687544,1659880690,1659880992,302,292
3400211756,3968795612,1650491283,1650491843,560,941
3063744739,3022428512,1655186290,1655187079,789,1310
3994577207,3912828190,1647588190,1647588961,771,46
3057102903,3996993457,1657213288,1657214194,906,1147
3638281686,3057085790,1656757445,1656757524,79,1263
3054160201,3723944830,1661472248,1661472455,207,249
3474081200,3370267721,1647116208,1647116784,576,983
3193657080,3259344210,1663480527,1663480875,348,1586
3686298420,3890821469,1656297971,1656298478,507,491
3103728720,3319545220,1658712085,1658712417,332,1302
3533936136,3705601482,1655481765,1655482152,387,2234
3610056283,3637923107,1663117315,1663117979,664,2065
3328922333,3890781778,1646697763,1646698632,869,1029
3452773006,3255460937,1658593943,1658594901,958,1027
3710422072,3963351842,1653023411,1653023528,117,2326
3541920859,3445558523,1649126690,1649127326,636,783
3284159385,3708101315,1642516464,1642516806,342,268
3599007187,3318735194,1651802656,1651802792,136,1018
3907004279,3348198228,1669752471,1669753398,927,165
3269956451,3712211736,1663225837,1663226549,712,2486
3289630313,3060727793,1666063757,1666064486,729,1363
3947105207,3378325026,1668294443,1668294582,139,453
3592520398,3330817237,1653972893,1653972994,101,2050
3129860388,3340427847,1659969509,1659969668,159,1494
3246159564,3334237477,1666432817,1666433696,879,386
3310512172,3013064040,1641855806,1641856624,818,1142
3194664110,3276666399,1660637660,1660638474,814,713
3353722089,3926612159,1662093137,1662093459,322,322
3949713678,3682803273,1660211755,1660211785,30,1649
3049969877,3706178319,1642423542,1642423686,144,2018
3933196862,3415041326,1661741887,1661742887,1000,2494
3542215276,3704517188,1666172492,1666173474,982,344
3723784545,3620725243,1660336423,1660337129,706,1396
3181388502,3446987671,1651623388,1651623451,63,2215
3252187190,3637609349,1653613119,1653613672,553,743
3083479870,3875343154,1649196046,1649196530,484,231
3939948508,3083494718,1658266363,1658267114,751,2292
3335915365,3563103144,1656824129,1656824701,572,1555
3896594746,3509619062,1665437223,1665437786,563,2125
3607385542,3758695244,1641285218,1641285902,684,526
3581083030,3689020840,1644619277,1644620171,894,141
3177036721,3611967437,1644692439,1644693143,704,1334
3701196344,3318227153,1660427967,1660428196,229,1542
3129170273,3945905688,1648593705,1648593764,59,509
3960267299,3889112055,1667426581,1667427414,833,614
3098342545,3093364150,1647324394,1647324985,591,2054
3202453519,3300015174,1655868922,1655869658,736,2154
3414488975,3553950534,1664312641,1664313125,484,952
3760365434,3338082003,1642053062,1642053154,92,1740
3472474698,3745532894,1659422634,1659423523,889,1993
3603068932,3950936299,1645863560,1645863833,273,1049
3368423726,3552101140,1662213712,1662214462,750,305
3232285701,3309922968,1643864876,1643865385,509,1036
3949201468,3936193189,1641004569,1641005249,680,577
3686240080,3074837048,1666458597,1666459181,584,812
3131938458,3828833040,1646315112,1646315346,234,180
3393606099,3328854884,1667764913,1667765713,800,244
3161243271,3041809783,1646526797,1646527059,262,2137
3599604382,3226559906,1647451823,1647452236,413,1378
3730984573,3796936978,1660182047,1660182134,87,118
3094414065,3916928531,1651265461,1651265679,218,1098
3953483372,3106437492,1653311385,1653311817,432,798
3855777399,3390431277,1651804986,1651805082,96,867
3540279517,3118128782,1663866263,1663866822,559,1124
3270935026,3183256246,1642945352,1642945677,325,185
3458815526,3641618845,1665810536,1665811077,541,237
3061461510,3452564658,1665491354,1665492076,722,2110
3063566522,3797270025,1665258784,1665259611,827,2348
3413898378,3776334300,1663904582,1663904903,321,2105
3653183152,3501786397,1642244039,1642244989,950,896
3401738714,3158029379,1657258889,1657259132,243,1077
3153518026,3724806243,1649809426,1649810084,658,105
3713116694,3637269987,1654973395,1654973839,444,1880
3867799694,3704305860,1669310931,1669311570,639,2363
3319128889,3310294122,1665041817,1665042359,542,1763
3998329857,3892336923,1669485001,1669485536,535,2225
3864930473,3188384391,1654778615,1654778775,160,1348
3310951639,3310953839,1641188668,1641189424,756,240
3250253670,3229881750,1661184499,1661184664,165,1165
3594231530,3153831709,1662195033,1662195758,725,846
3182131313,3391711118,1643119506,1643119826,320,613
3343941091,3491356699,1646064096,1646064919,823,2311
3322663101,3507500782,1668973050,1668973775,725,1814
3112859411,3756473550,1669480382,1669481226,844,1871
3349433488,3971093415,1665306502,1665307259,757,936
3904007370,3573158941,1645007947,1645008270,323,1423
3716757245,3433261355,1641044639,1641045051,412,1569
3865781327,3483553551,1641097622,1641097774,152,1562
3128248749,3600247537,1657023046,1657023929,883,1067
3572792752,3821157240,1653080092,1653081025,933,1563
3666148943,3591264259,1669160919,1669161551,632,1791
3278886018,3758323845,1646770207,1646770636,429,1269
3907705988,3193403424,1643474658,1643475283,625,1325
3624748073,3746050591,1657850320,1657851152,832,865
3029758309,3158209281,1664935022,1664935796,774,715
3869930031,3016568360,1655752143,1655752562,419,455
3689032543,3437259542,1647629977,1647630294,317,329
3075288965,3122144249,1641139882,1641140444,562,2457
3981778568,3678541527,1665748366,1665748411,45,2065
3664627036,3928930330,1669301086,1669301952,866,2171
3451249074,3582076532,1669450523,1669451226,703,103
3473394094,3902437090,1668601195,1668602120,925,2484
3421294150,3958449916,1659668682,1659669284,602,393
3122293667,3546192493,1651633915,1651634870,955,407
3342929537,3586101932,1664453440,1664453811,371,1477
3324069408,3134436515,1645977009,1645977386,377,1300
3896019652,3081370961,1653534156,1653534417,261,2035
3140971443,3773658133,1666323275,1666323533,258,2427
3211956216,3464734783,1647568562,1647569353,791,926
3088854267,3620748135,1649974216,1649974656,440,1200
3823951765,3861652282,1650748769,1650748916,147,26
3456295243,3525152477,1661725052,1661725459,407,953
3311529434,3319128889,1641915048,1641915329,281,1457
3582076532,3639035607,1646848690,1646848945,255,96
3746979257,3498685499,1653698268,1653699111,843,1049
3698898645,3134117241,1666187403,1666187926,523,2212
3809312897,3080703553,1641331331,1641331872,541,198
3260802289,3129138715,1661655424,1661656123,699,1376
3046500774,3800392649,1662796982,1662797126,144,798
3936193189,3537443088,1664169118,1664170079,961,1250
3021968850,3354200745,1654584816,1654585709,893,312
3158894896,3663884600,1645564504,1645564545,41,778
3131683456,3349433488,1642108727,1642109715,988,1488
3629984961,3457542537,1665351294,1665351936,642,1431
3825930964,3497079704,1652433412,1652434405,993,513
3626672801,3497079704,1652795246,1652795511,265,1978
3629984199,3245723038,1661144235,1661144297,62,423
3919478201,3718652649,1648003401,1648004016,615,1707
3899618702,3606368289,1660317082,1660317935,853,2424
3384536407,3128401376,1642233996,1642234167,171,2005
3889967886,3968636198,1653352018,1653352464,446,1037
3625034951,3486727273,1645755019,1645755861,842,2238
3727995134,3348198228,1654136448,1654137095,647,1412
3167494570,3889079063,1660176360,1660177307,947,1469
3112615469,3222254600,1662888497,1662889189,692,1564
3719763865,3888851378,1644064556,1644065289,733,560
3573692342,3086357122,1654879475,1654880095,620,229
3786480807,3378221943,1642565034,1642566032,998,2043
3643132014,3041792624,1666943480,1666943733,253,1593
3684537058,3912511626,1644115706,1644116176,470,2460
3313431689,3208490048,1660289904,1660289931,27,836
3857434991,3427520419,1643386250,1643386711,461,569
3211965606,3334965309,1656514171,1656515130,959,1266
3585218766,3192367201,1642986156,1642986255,99,583
3569686431,3550107804,1664115308,1664116292,984,2112
3291512173,3082108681,1649594316,1649594534,218,57
3579684205,3821039922,1650025429,1650025653,224,156
3594254200,3252961062,1666740981,1666740981,0,2140
3612973191,3261447619,1655596565,1655597025,460,2029
3777938800,3535467955,1661772373,1661772967,594,673
3286463125,3970286228,1666338597,1666339320,723,907
3833692711,3392271707,1644793154,1644793671,517,1376
3566693010,3976095218,1651606611,1651607383,772,1363
3858150562,3934383056,1645411069,1645411560,491,2084
3877299439,3686641761,1666467423,1666468216,793,829
3239020709,3105558193,1644632426,1644632722,296,1074
3749379449,3391206046,1655451742,1655452447,705,2456
3101265323,3538692457,1665652638,1665653314,676,1404
3480308437,3190035679,1658071241,1658071995,754,444
3848607936,3375404573,1663873439,1663873687,248,1881
3779611783,3838993248,1658596893,1658597674,781,2375
3211015636,3455941777,1659179283,1659179469,186,2111
3771616536,3307251676,1648137814,1648138288,474,1484
3986557042,3570335491,1657081326,1657082238,912,322
3477770827,3201957142,1659882375,1659882767,392,737
3855218155,3725439899,1661414006,1661414032,26,902
3276840933,3025133604,1649234628,1649235416,788,240
3562463361,3809458973,1669447674,1669447885,211,324
3276142713,3250627439,1662384669,1662385201,532,373
3502050886,3261265769,1647866773,1647867611,838,540
3027651085,3486814228,1660358427,1660358895,468,1049
3369865184,3205988899,1668800047,1668800727,680,1357
3143274658,3038014403,1650022065,1650023023,958,532
3734576015,3978691513,1642500854,1642501729,875,2310
3208106743,3640957872,1644739486,1644740086,600,1179
3753483202,3633382140,1654104021,1654104830,809,1042
3232497890,3292739128,1658164323,1658164710,387,80
3197201691,3993623323,1647257538,1647257638,100,334
3523508617,3252973419,1649561701,1649562198,497,327
3093387843,3058141936,1644792421,1644793131,710,1453
3249071020,3429684538,1647305998,1647306983,985,230
3607959490,3169898520,1663631069,1663631108,39,2395
3878180077,3522963106,1659018274,1659018508,234,627
3362812887,3486582851,1648308615,1648309337,722,959
3472112661,3641983006,1665700866,1665701386,520,595
3088465843,3731588710,1658768233,1658768865,632,1347
3475027844,3343162937,1656647375,1656647479,104,604
3565805050,3027812492,1643029425,1643029675,250,1278
3660129917,3808952164,1665589275,1665589931,656,1585
3111639847,3922851964,1654059951,1654059955,4,912
3269966376,3574740304,1656885936,1656885967,31,2243
3801847517,3806728629,1668109218,1668109405,187,107
3866215730,3650367155,1641428091,1641428690,599,1406
3057090135,3446952845,1645930274,1645931210,936,2222
3170924487,3679065090,1666180270,1666180513,243,2296
3050341848,3668174777,1654809401,1654810276,875,985
3752621490,3298635617,1662150524,1662151512,988,1104
3208464777,3710202750,1645890019,1645890550,531,1456
3958710935,3645943439,1652007440,1652007705,265,1638
3099818927,3931854815,1655231454,1655231696,242,417
3241190614,3527349190,1643139903,1643140872,969,1683
3154729703,3877811036,1666985866,1666986426,560,732
3486262024,3569390971,1651897490,1651897646,156,97
3674049704,3466494394,1658579146,1658579405,259,869
3651812819,3050271924,1647188996,1647189218,222,709
3902777743,3173809486,1663798836,1663799636,800,2421
3654527501,3024979152,1665463301,1665463810,509,2480
3103497887,3317382420,1660591891,1660591892,1,178
3292172583,3057159511,1657338062,1657338904,842,751
3790635482,3168600862,1645430037,1645430426,389,2418
3886651871,3937197371,1646626788,1646627117,329,1298
3381692213,3249916829,1664309353,1664309828,475,1418
3161784330,3299389436,1659161337,1659162295,958,1779
3082912574,3706206403,1668940943,1668941648,705,2472
3088587729,3672694122,1657638462,1657639147,685,255
3195274844,3468324129,1659408030,1659408083,53,1519
3430090428,3130134092,1667012790,1667012796,6,2240
3474558723,3339048327,1654317604,1654317731,127,816
3461108375,3690646467,1658502867,1658502941,74,2308
3425803609,3794548376,1643762555,1643762737,182,658
3713455058,3132802864,1663168666,1663169073,407,1030
3708337100,3306619417,1645105858,1645105975,117,787
3286463125,3972294801,1644276366,1644276550,184,2070
3370771897,3648257100,1661707271,1661707920,649,428
3848936636,3064323869,1654508248,1654508405,157,2318
3528475061,3259260257,1647926007,1647926742,735,590
3359046521,3670063835,1653089613,1653090081,468,694
3655087982,3637269987,1651570447,1651570874,427,488
3956058747,3694762938,1656565300,1656566084,784,2025
3900451371,3096076350,1658923842,1658923869,27,2284
3994014690,3556803718,1654333834,1654333958,124,580
3624085921,3878573707,1646098803,1646098803,0,917
3666338218,3311113773,1665912644,1665912727,83,1135
3209480732,3953465037,1654133154,1654133504,350,1659
3770561730,3556823098,1642224114,1642224734,620,1878
3627503494,3311118815,1662752432,1662753267,835,1100
3731828976,3767136549,1644706439,1644707063,624,1
3485526833,3110639083,1657200168,1657200650,482,547
3670112572,3049579265,1657454143,1657454168,25,1845
3375759020,3228319450,1661025053,1661025777,724,774
3278346826,3121336226,1644189512,1644190154,642,1882
3606643671,3063478155,1651600992,1651601587,595,2170
3821120962,3190003253,1665018049,1665018954,905,1418
3589571844,3926426459,1658264439,1658265439,1000,76
3797778150,3080325374,1644790638,1644790883,245,2419
3469783180,3924838447,1653203163,1653203816,653,115
3009835115,3068400634,1642679886,1642679941,55,1341
3697231480,3159873313,1669472484,1669473328,844,1074
3781580109,3691879230,1668947018,1668947245,227,666
3086950119,3567703076,1665843988,1665844709,721,2015
3172502658,3683134571,1661465628,1661466550,922,1441
3027295354,3171413650,1650739582,1650740512,930,741
3934914335,3369049258,1658055504,1658056488,984,1804
3323217825,3622596133,1668781189,1668781885,696,1857
3446519765,3345875910,1655044022,1655044205,183,545
3041809783,3604260104,1642938635,1642939498,863,1811
3506307976,3336965818,1669036475,1669036603,128,700
3977317498,3897222406,1655958096,1655958259,163,1245
3356765270,3199322269,1654263763,1654264504,741,1447
3155366529,3632335400,1646480230,1646480299,69,257
3773770885,3651058536,1641045490,1641046485,995,1753
3893227652,3418364050,1667003504,1667003849,345,463
3673743780,3518620219,1653787758,1653788526,768,1118
3680429293,3470128186,1644185860,1644186520,660,2285
3935822380,3424944206,1665135003,1665135088,85,1776
3418364050,3524282034,1666532949,1666533627,678,1750
3800239896,3738887934,1642760817,1642761315,498,1305
3991390314,3287901684,1662841218,1662842073,855,2363
3007446724,3176818286,1655137845,1655138096,251,2102
3861263764,3704305860,1657545779,1657546152,373,532
3626020948,3086575348,1664782293,1664783001,708,425
3301119536,3894801934,1652914593,1652915471,878,1960
3892850406,3622596133,1644978735,1644979695,960,332
3214698363,3475835420,1663731113,1663731246,133,647
3545658442,3660468597,1641519934,1641520009,75,692
3331882759,3516547882,1652476668,1652477459,791,2013
3922251351,3141134453,1658873387,1658873409,22,2360
3267248595,3179354869,1668283769,1668284536,767,946
3341042744,3358578228,1655184961,1655185763,802,1445
3074928223,3349847682,1657612674,1657612893,219,1879
3313608055,3550299952,1659513975,1659514574,599,367
3481922555,3569600936,1653276630,1653277343,713,288
3312336013,3305480485,1663508445,1663508925,480,2337
3711016575,3788819111,1655309093,1655309356,263,2336
3839788123,3199315199,1661432141,1661432345,204,1451
3913994422,3239020709,1656724736,1656725031,295,784
3443435826,3240249176,1646863472,1646863804,332,1221
3640571571,3593603889,1658654684,1658655051,367,1986
3440324329,3486907422,1661652942,1661653857,915,1829
3747907269,3167074299,1663203708,1663204429,721,1978
3804257503,3156683897,1646646876,1646647019,143,1692
3302294195,3731437059,1658343821,1658344647,826,1420
3460047535,3120984531,1654976882,1654977779,897,1380
3934386586,3181578884,1657724827,1657725747,920,616
3270177744,3133030435,1666361161,1666361187,26,1396
3131735006,3356728242,1668464282,1668465130,848,760
3194871172,3894593426,1660704523,1660704615,92,2472
3078830914,3457417743,1647613917,1647614193,276,2020
3339027368,3671355250,1655496530,1655497104,574,7
3737504606,3096746005,1647283238,1647283621,383,1604
3172825605,3267360802,1649156755,1649157294,539,968
3534192041,3805772843,1654688728,1654688977,249,1842
3678505160,3972886254,1669074424,1669074547,123,185
3617453316,3960727376,1660726660,1660726838,178,1305
3685977300,3896357807,1644553233,1644553612,379,2208
3672482112,3915772795,1654030677,1654031350,673,2033
3619529955,3453070428,1668534999,1668535725,726,1262
3795990774,3970820689,1648693192,1648694031,839,1038
3885235661,3880599649,1649213510,1649213872,362,800
3916244157,3215257603,1654802425,1654803191,766,850
3299821745,3272623699,1666203703,1666204174,471,665
3141963631,3477522732,1669348030,1669348841,811,2022
3198319752,3513576000,1663292707,1663293677,970,424
3316951862,3408104715,1660814729,1660815182,453,1604
3431354119,3918383192,1646067344,1646067585,241,1954
3842560828,3398116898,1652225756,1652226161,405,663
3070520574,3954055058,1660117895,1660117991,96,2050
3172825605,3581011004,1662027540,1662028306,766,470
3830243698,3044390847,1646148936,1646149752,816,146
3564667780,3019854226,1664480540,1664480855,315,97
3728976822,3463003824,1647237112,1647237245,133,2151
3718176139,3855563284,1656548108,1656548868,760,323
3224792502,3298635617,1642173182,1642173695,513,1998
3034440971,3693691265,1668913402,1668914354,952,2231
3794481759,3409332035,1659789948,1659790308,360,1217
3137092101,3291286959,1647029928,1647030514,586,2311
3762856505,3807576323,1669045294,1669046043,749,1402
3487104766,3662788693,1667675445,1667676167,722,1551
3728240849,3610577318,1648970997,1648971828,831,1280
3772980352,3099013723,1649974214,1649974335,121,549
3616890026,3211795832,1660559407,1660560171,764,2251
3593988999,3614952111,1641111326,1641112008,682,1949
3003145369,3521258004,1658819586,1658820235,649,1149
3324395012,3622259711,1652168375,1652169375,1000,217
3487406679,3090441115,1648798635,1648798856,221,1543
3345413125,3481584783,1653515225,1653516009,784,1477
3183515887,3608512295,1648669103,1648669845,742,1012
3144405714,3722945080,1657519839,1657520820,981,394
3833594316,3097469330,1652004370,1652005363,993,1497
3508224327,3930347129,1654879221,1654879298,77,1209
3215088423,3634018428,1654609764,1654609977,213,657
3152555864,3505272067,1645858955,1645859795,840,2274
3225477579,3169072505,1651636269,1651637176,907,1513
3222082052,3127940283,1643804347,1643805333,986,389
3556819852,3339025394,1646049003,1646049149,146,254
3808604912,3046351455,1646347941,1646348095,154,748
3207407283,3962658092,1650170374,1650171263,889,1300
3175295329,3355184225,1643286900,1643287819,919,2074
3795508879,3232469999,1645976296,1645976940,644,1831
3541200701,3843576243,1660963822,1660964007,185,2389
3718684083,3378162995,1644159245,1644159831,586,107
3582267659,3058606856,1645591446,1645592192,746,1062
3904625406,3949947697,1654716920,1654717786,866,416
3926200409,3034470773,1650332213,1650332943,730,636
3016068435,3008283469,1644811701,1644812262,561,1012
3335976452,3147792323,1663930595,1663930617,22,841
3036346251,3411708498,1653992876,1653992996,120,1875
3405346555,3208243335,1648103603,1648104435,832,221
3066360181,3925344243,1645075627,1645075983,356,1268
3791486887,3815605229,1648391529,1648392088,559,1634
3600573063,3900051900,1659384223,1659385104,881,825
3327504995,3130612494,1653074203,1653074728,525,671
3504398546,3170296955,1643711389,1643712162,773,1213
3208215579,3548028995,1649101019,1649101451,432,2280
3300456889,3482235012,1643064889,1643065286,397,24
3904874839,3688758916,1647391847,1647392661,814,1329
3561113748,3927329503,1656968592,1656969457,865,1404
3185611253,3819235768,1668480356,1668480576,220,962
3875892624,3107366519,1659928165,1659929132,967,1431
3085429140,3050370620,1641955902,1641956817,915,961
3128287586,3653429754,1648653463,1648653800,337,1419
3993438914,3828857457,1653828758,1653829341,583,1678
3904183865,3412715210,1666127504,1666127795,291,875
3221031593,3744726408,1656380261,1656380864,603,797
3003243547,3890852478,1655621953,1655622229,276,242
3140488273,3930591160,1656211828,1656212703,875,1714
3680810431,3917067097,1666720373,1666720934,561,1606
3841660750,3693041370,1653436098,1653436609,511,859
3795299092,3944914500,1641458516,1641459268,752,643
3149336644,3344664961,1667107856,1667108694,838,1883
3593487418,3487972666,1668099119,1668099174,55,1090
3315402916,3700968228,1657437425,1657437649,224,1978
3304728211,3709788465,1658366193,1658366259,66,421
3700813458,3499787925,1645934469,1645935212,743,2385
3785586097,3634936481,1653840514,1653841204,690,1449
3750698244,3686407290,1647504572,1647504668,96,1820
3999390272,3151288415,1649755361,1649756086,725,959
3133805973,3855777399,1641388787,1641389456,669,2097
3091709202,3347896915,1648735641,1648735916,275,1825
3492629459,3148284665,1641607489,1641608156,667,422
3759787118,3501820222,1669243024,1669243319,295,423
3443360830,3502050886,1659892964,1659893436,472,709
3432954312,3788688228,1643520672,1643521619,947,696
3066439887,3469471892,1649675862,1649676044,182,1353
3501786397,3546943801,1656397062,1656397484,422,1847
3027812492,3542285714,1664581095,1664581480,385,1586
3864133914,3751418832,1666056704,1666056746,42,1770
3448734872,3478288963,1655581134,1655581930,796,1189
3867353788,3323783108,1641118859,1641119020,161,2117
3188384391,3674729672,1664437814,1664437921,107,1931
3086325930,3256317082,1641276752,1641277299,547,2029
3534223960,3947083981,1664502307,1664502558,251,1982
3991046503,3940520472,1644986469,1644987335,866,1563
3175676853,3192940759,1659790656,1659791210,554,866
3661462228,3911619189,1655068165,1655068776,611,363
3565287194,3420520626,1663740496,1663741474,978,1502
3151923668,3037984397,1648171356,1648172061,705,1130
3835049098,3585919417,1659360688,1659360729,41,2087
3750765878,3193344217,1648517874,1648517887,13,517
3969241066,3797769846,1647767063,1647767293,230,1944
3986885276,3049307137,1641715324,1641715546,222,863
3911316683,3873218862,1656842330,1656842647,317,2265
3404008086,3267411650,1643694983,1643695884,901,1115
3934433729,3814017798,1649666507,1649667480,973,2225
3287600901,3928044191,1651317729,1651317917,188,354
3198527442,3446481380,1648741464,1648741846,382,2361
3607959490,3216439052,1651147507,1651148090,583,1448
3478362234,3089962675,1661876087,1661876354,267,378
3243231806,3356317749,1663437810,1663438320,510,1711
3821039922,3328146266,1646863018,1646863785,767,1284
3020683788,3752000675,1653567179,1653567602,423,2230
3478101953,3922927380,1641855112,1641855445,333,2040
3786924052,3350872529,1658002221,1658002557,336,1297
3650041115,3873840731,1642248977,1642249217,240,1914
3615362859,3027295354,1660720537,1660720660,123,2438
3917721165,3206549691,1654127516,1654128048,532,206
3822736402,3460572652,1659740172,1659740743,571,2204
3640387984,3861173090,1660250219,1660250362,143,2451
3881482215,3161586578,1655490142,1655491107,965,2062
3804914454,3122144249,1649727611,1649728156,545,2196
3983988321,3749980168,1653080310,1653081114,804,1580
3131131112,3639618179,1645537096,1645537957,861,1051
3114277786,3112298724,1654307443,1654308137,694,728
3893937230,3756473550,1647712772,1647713312,540,2431
3899585675,3251372174,1669560071,1669560300,229,997
3719503327,3800392649,1659812900,1659813401,501,1410
3512215996,3248096339,1655250236,1655251049,813,338
3052279761,3539866422,1646931762,1646932121,359,2310
3178529360,3247688800,1667872887,1667873638,751,854
3866260144,3480115115,1657365140,1657366094,954,2165
3271278790,3642377610,1652214952,1652215174,222,1052
3793518113,3570335491,1652534609,1652535325,716,318
3204083684,3721226798,1666886410,1666887304,894,1722
3743886187,3795817960,1648680689,1648681114,425,750
3369792484,3103417672,1668454298,1668455125,827,2354
3293387588,3261447619,1661557086,1661557272,186,1030
3003872692,3277001118,1660237513,1660237930,417,320
3679939578,3474975781,1657101441,1657102063,622,2197
3846585557,3264753140,1663878440,1663878990,550,1024
3718026583,3068400634,1647260573,1647261521,948,592
3660998516,3319422840,1665586985,1665587094,109,1282
3529946433,3365663032,1642909098,1642909191,93,1343
3655087982,3890940747,1643633553,1643634259,706,2229
3226298244,3347646218,1646054747,1646055720,973,1653
3410972917,3402690548,1645650596,1645651479,883,2292
3054979282,3112615469,1664720491,1664721486,995,803
3224095644,3343048708,1661901638,1661901898,260,794
3924559198,3916261675,1645043667,1645044520,853,1446
3228737899,3333764188,1660765760,1660766013,253,693
3620311248,3912106632,1667687316,1667687637,321,1094
3624060457,3359541123,1665768726,1665769666,940,859
3084531614,3079137127,1661032622,1661033016,394,1923
3656027442,3790883274,1642742953,1642743796,843,772
3812034379,3911960681,1660258905,1660259330,425,2391
3289850617,3330749303,1656265748,1656266482,734,2185
3617746688,3948310967,1648820117,1648821066,949,133
3864301593,3152036409,1668405825,1668406117,292,145
3229979386,3443490373,1650061935,1650062203,268,364
3982644241,3796348557,1656937721,1656938702,981,2309
3144551332,3239469849,1649805707,1649806238,531,342
3461505923,3167290048,1664285234,1664285727,493,269
3804328787,3807323401,1642095353,1642095605,252,1138
3918121469,3283922234,1642182665,1642183513,848,706
3824478322,3329463543,1642517657,1642518243,586,2326
3241425701,3371745136,1648561999,1648562098,99,1246
3315321131,3329117199,1656623997,1656624827,830,1200
3986814631,3791894034,1664408815,1664409542,727,1929
3022767670,3211003582,1652626755,1652626922,167,2113
3135579253,3640745969,1652366831,1652367789,958,1525
3518620219,3950666008,1658079163,1658079566,403,1768
3828219822,3599915754,1667018138,1667018351,213,2061
3060633640,3915336029,1653868549,1653868599,50,905
3341694529,3791462728,1644791913,1644792312,399,369
3548670552,3546866871,1658753528,1658753942,414,1083
3293201387,3041809783,1645058685,1645059018,333,2312
3421344639,3549122378,1646437516,1646438193,677,1015
3948002281,3440322150,1641500674,1641501309,635,1711
3652513122,3920482918,1645635004,1645635403,399,1299
3673948643,3090910630,1642425541,1642426508,967,915
3794408677,3329825235,1647501608,1647501921,313,1594
3688910009,3046618211,1664516590,1664516903,313,222
3003116947,3534517997,1650825736,1650826545,809,1
3862685266,3556061704,1655764624,1655765232,608,910
3494680258,3729820423,1645671439,1645671729,290,2070
3891400237,3795269127,1656949223,1656949876,653,751
3898012654,3780652187,1642585062,1642585259,197,1096
3984461468,3111823829,1661972426,1661972669,243,1108
3559176364,3632763218,1665933459,1665933852,393,1596
3098891437,3883265629,1660823236,1660823695,459,126
3421294150,3988674966,1649640751,1649641548,797,2016
3408300554,3976346769,1668952217,1668953150,933,565
3676690161,3976970303,1647572505,1647573242,737,1059
3422745115,3271648296,1652754680,1652755616,936,631
3170579908,3030290445,1656119540,1656119898,358,2276
3809642935,3458335460,1655248879,1655249303,424,192
3089126812,3350872529,1659789822,1659790664,842,268
3958539607,3045587450,1644509486,1644509926,440,1060
3649774117,3505761464,1655044702,1655044777,75,2276
3487387362,3346484497,1642039846,1642040414,568,1208
3471707938,3151982756,1664223600,1664224457,857,1162
3895332326,3599869347,1646539580,1646540278,698,1243
3817667121,3738571497,1643915936,1643916823,887,195
3864249446,3409978701,1660363907,1660364118,211,1824
3801358344,3740102481,1664463849,1664464363,514,2069
3481482238,3599160097,1641952335,1641953282,947,958
3626118668,3351277781,1646405153,1646405385,232,2470
3978330638,3129170273,1665974360,1665975049,689,443
3983162503,3620700244,1659102606,1659103020,414,1593
3259880338,3934199220,1641228103,1641228519,416,195
3862854265,3093534312,1665848200,1665848927,727,892
3842431875,3647951580,1643668275,1643668701,426,733
3649154395,3327061038,1656692193,1656692765,572,2224
3304596274,3385183586,1664318920,1664318986,66,407
3024813851,3494498890,1656082151,1656082311,160,1454
3767868249,3664242822,1663420781,1663421655,874,1292
3216470508,3971934050,1668298407,1668299247,840,1313
3490286406,3804768140,1652247681,1652248211,530,1998
3466494394,3968683220,1657869252,1657869606,354,2432
3336423969,3777022057,1642008637,1642009103,466,1022
3629207282,3279550373,1649329647,1649330513,866,19
3492247995,3290794282,1667227063,1667227919,856,2373
3768846820,3249916829,1662076648,1662076917,269,1334
3175295329,3272187328,1652939152,1652939670,518,1030
3784828021,3543696190,1652418244,1652418465,221,1186
3922423821,3248397935,1642034694,1642035057,363,1364
3006456611,3313975664,1645040276,1645041263,987,2496
3357403419,3885696227,1651744755,1651745512,757,1898
3577114014,3932077086,1658240041,1658240628,587,430
3193890426,3057348673,1668982290,1668982981,691,97
3321699949,3646079529,1663895046,1663896014,968,1116
3346832945,3237841242,1654354737,1654354796,59,1433
3790180006,3949522552,1655840869,1655841361,492,1805
3805888209,3511325003,1658081621,1658082045,424,1683
3043256301,3359722926,1664765287,1664765944,657,2473
3356590035,3376287193,1660346619,1660347441,822,294
3988337484,3363768036,1650653037,1650653107,70,619
3492629459,3846493363,1661943161,1661943632,471,1353
3580901513,3131735006,1654989919,1654990175,256,576
3775146250,3136172164,1652610949,1652611304,355,757
3535467955,3194721041,1643620876,1643621790,914,2047
3797294746,3266991557,1666747903,1666748211,308,1643
3780885377,3865422787,1644632861,1644633689,828,2003
3571719140,3750069283,1642175781,1642175846,65,1182
3352444293,3920277028,1652511888,1652512626,738,2165
3415892236,3002013720,1651174730,1651174847,117,263
3008550397,3729389785,1644198531,1644198617,86,1934
3706605056,3346832945,1655652912,1655653644,732,614
3216753609,3918988651,1663525566,1663526135,569,1382
3650172161,3365708107,1658808939,1658809090,151,179
3325962611,3280251149,1665611042,1665611088,46,238
3095849365,3452067391,1646285509,1646286456,947,2417
3584402021,3409823179,1647072833,1647073825,992,1292
3799624292,3536080615,1657616867,1657617149,282,1746
3338082003,3891579335,1650455807,1650456378,571,1715
3028679133,3588684575,1662092996,1662093363,367,1508
3228497776,3560977513,1647139297,1647139321,24,2198
3698358344,3327253070,1654444147,1654444410,263,1550
3593967802,3399180008,1641124309,1641124872,563,1277
3450353368,3139198469,1661392612,1661392852,240,1407
3464330947,3510634049,1660199583,1660200492,909,183
3091112554,3724455974,1667693683,1667693773,90,1903
3142869544,3321752938,1649988718,1649988961,243,1133
3836331716,3108566218,1650796517,1650796913,396,124
3703534908,3203904444,1665097618,1665097997,379,1274
3253827804,3672609185,1666861746,1666862478,732,2446
3705752007,3520511256,1651847133,1651848055,922,1121
3922827209,3582033850,1650896255,1650896622,367,274
3193344217,3316951862,1667105552,1667106257,705,622
3382983805,3256859026,1651434505,1651435156,651,585
3219265850,3442194248,1642710190,1642710394,204,2369
3014975304,3817548425,1646862297,1646863098,801,392
3343177837,3225989431,1666742845,1666743246,401,2435
3426565803,3629207282,1649163938,1649164223,285,101
3877205464,3776334300,1651212520,1651213310,790,890
3567637602,3072276713,1643879403,1643879827,424,1804
3720240255,3564883937,1664103121,1664103806,685,953
3009635817,3384222838,1669064117,1669064856,739,1772
3796875669,3650342769,1668164867,1668165520,653,381
3322287315,3691879230,1657230494,1657231064,570,122
3046006152,3055603453,1661349582,1661350557,975,769
3309158757,3422728078,1656501857,1656502414,557,2007
3995270744,3028535162,1643561728,1643562494,766,1300
3726367604,3967754963,1654764441,1654764974,533,60
3033925963,3095559156,1648452416,1648452725,309,1570
3440598942,3624060457,1641337161,1641337943,782,1219
3288261603,3424562136,1650614707,1650615372,665,433
3611657912,3902777743,1651006468,1651006988,520,504
3609804397,3571428723,1655865452,1655866199,747,1285
3167985603,3305299292,1661741458,1661741596,138,1906
3639804787,3959081575,1664750024,1664750375,351,433
3780991625,3279239799,1641927168,1641928051,883,60
3189396065,3505417530,1661567283,1661567761,478,2033
3010488834,3712443558,1667620666,1667620900,234,1882
3247980767,3748841094,1647111204,1647111973,769,294
3485459472,3037984793,1644347737,1644347870,133,1114
3652728312,3142848483,1667118831,1667119711,880,1403
3106705860,3343232841,1651860054,1651860066,12,1073
3083494718,3430165544,1668274283,1668275283,1000,976
3194618871,3331426472,1667607404,1667607531,127,25
3139126728,3051642574,1656665497,1656666377,880,2278
3685233592,3027829599,1665006565,1665007163,598,237
3029468613,3022102664,1665478137,1665478227,90,109
3610577318,3631568439,1645431580,1645432065,485,472
3065548516,3504911583,1649439097,1649439416,319,835
3729820423,3708309303,1664842591,1664843110,519,528
3050867171,3617715231,1647138881,1647139643,762,1261
3299389436,3243059921,1667585678,1667585756,78,1362
3762856505,3336376139,1647498046,1647498396,350,800
3052822229,3769836039,1653232897,1653233039,142,2096
3631424312,3366321387,1667133897,1667134566,669,1484
3395316132,3219575313,1665869821,1665870338,517,946
3511755413,3897211381,1663879776,1663880081,305,526
3724669056,3431909978,1656753543,1656754496,953,777
3894247542,3991859515,1660409905,1660410400,495,1262
3452181736,3184720975,1641738401,1641738530,129,2225
3590735151,3922385616,1645245444,1645245948,504,552
3723784545,3656770582,1666285455,1666285493,38,2161
3194618871,3856882586,1644460943,1644461028,85,1219
3325962611,3642771281,1652164367,1652164902,535,1125
3758622438,3495919793,1668882331,1668882798,467,1374
3964711138,3915111520,1648809327,1648809645,318,1299
3565052722,3611763388,1654015416,1654015941,525,13
3051404798,3573826666,1664397398,1664397648,250,313
3421671936,3189111071,1658811293,1658811678,385,1243
3975380491,3179547560,1644487175,1644487569,394,1241
3048328762,3374005704,1646110483,1646111078,595,772
3751411767,3562547940,1641790470,1641790927,457,43
3033438220,3561529281,1658951096,1658952051,955,33
3276341369,3569478966,1643323856,1643324253,397,1122
3695478448,3881942272,1645172482,1645173297,815,379
3165700370,3785432995,1646283768,1646283821,53,950
3175498635,3753391012,1650517782,1650518650,868,346
3360051725,3054927562,1663608344,1663608649,305,1710
3647210250,3692498377,1668709061,1668709949,888,710
3129034897,3354999072,1665987803,1665988249,446,266
3121128511,3620303845,1647895519,1647895752,233,292
3638233110,3693000511,1668099816,1668100193,377,1801
3251382188,3988337484,1643706872,1643707382,510,487
3118188990,3679065090,1646264410,1646265128,718,264
3208215579,3599551667,1653413854,1653414757,903,1412
3042052031,3065350513,1656268104,1656268237,133,340
3211514286,3034147055,1648893137,1648893732,595,123
3287600901,3082885404,1641742225,1641742881,656,292
3561573044,3854737938,1662348407,1662348880,473,875
3657101592,3309219121,1651692957,1651693802,845,450
3585816096,3234064286,1668477698,1668478680,982,1929
3541942422,3830015015,1669062074,1669062201,127,599
3425006843,3812034379,1663661053,1663662028,975,152
3499994307,3348390759,1653234803,1653235088,285,1029
3772749656,3182131313,1650452998,1650453943,945,232
3986003303,3250627439,1654121364,1654121637,273,1523
3823682564,3473399101,1643064112,1643064274,162,1524
3102332016,3223204355,1642346563,1642346925,362,814
3335573495,3658423327,1662640892,1662641677,785,2008
3462825977,3757499622,1666723352,1666724235,883,981
3310496626,3976405875,1653024101,1653024379,278,139
3929312426,3822187489,1669429589,1669429983,394,53
3173788210,3561573044,1667950133,1667951117,984,1819
3733004020,3804328787,1643121991,1643122041,50,1960
3714575918,3915942384,1660665360,1660666338,978,1716
3970970054,3248167631,1653006603,1653006666,63,1439
3659771853,3254503569,1662075384,1662076066,682,547
3090304189,3626457002,1641080174,1641080514,340,183
3720381616,3833046871,1655033801,1655034252,451,1058
3886720244,3999180921,1659174135,1659174461,326,1650
3442447509,3770561730,1643566876,1643566908,32,191
3261527870,3871736180,1646029764,1646030730,966,1282
3314872000,3459599732,1667994366,1667994607,241,1660
3266270844,3660247870,1659516439,1659516913,474,2073
3227368879,3953118937,1652733912,1652734843,931,613
3272428764,3407746149,1665724345,1665725037,692,1477
3235825340,3086325930,1655226902,1655227360,458,1849
3867868879,3687215472,1651648604,1651649526,922,910
3589441972,3245354614,1649673751,1649674174,423,1062
3151938386,3268349855,1645946964,1645947240,276,316
3885194706,3048077825,1658075342,1658076273,931,1604
3535631980,3437707461,1644765734,1644766629,895,1025
3866582723,3557643641,1655278069,1655278987,918,594
3994388981,3854390772,1648763959,1648764751,792,1727
3572276937,3733486808,1662904016,1662904279,263,1973
3315650808,3539866422,1643461047,1643461049,2,1123
3096412109,3994388981,1661549690,1661550380,690,1862
3243059921,3609043475,1642669972,1642670710,738,105
3993076833,3431354119,1659969199,1659969736,537,1969
3754706912,3194721041,1654636312,1654636857,545,1327
3263168418,3930565588,1655980418,1655980496,78,2386
3890492731,3122002940,1650915421,1650915626,205,2493
3246159564,3430638959,1647914149,1647914615,466,134
3188588023,3950433378,1667515576,1667516248,672,350
3255115511,3634282428,1648639632,1648640331,699,1929
3383686911,3223094732,1668038392,1668039040,648,1765
3313687025,3842431875,1648315414,1648315626,212,488
3141134453,3281445213,1658077014,1658077632,618,1739
3356690610,3130973015,1663783364,1663783791,427,1233
3028679133,3912803496,1669589453,1669589761,308,694
3073798415,3947105207,1652215126,1652215206,80,554
3152554117,3832252723,1665973613,1665973660,47,109
3020108220,3172773924,1647993494,1647993509,15,2442
3578655079,3062844769,1659089660,1659090513,853,15
3332206707,3462483679,1641437103,1641437213,110,1904
3708032127,3630982131,1644982682,1644982910,228,1834
3024431618,3785432995,1650061606,1650062242,636,1066
3662788693,3679939578,1646300550,1646301378,828,1328
3050434345,3891579335,1642811330,1642811437,107,162
3142313032,3924559198,1642033120,1642033568,448,1630
3393911160,3748837929,1663870954,1663871507,553,799
3516399207,3988539489,1653150952,1653151182,230,1928
3604461797,3744563835,1667160086,1667160384,298,1773
3260157601,3968297784,1645104032,1645104715,683,1824
3261255394,3584910336,1643782399,1643783053,654,1649
3957665117,3651847351,1641512250,1641512780,530,93
3247269367,3941586762,1647744954,1647745246,292,603
3522465860,3413040065,1660256885,1660257733,848,2280
3769786489,3593704176,1655085795,1655086393,598,1646
3942325631,3208346862,1642304309,1642305237,928,1597
3102526783,3006388757,1653816630,1653817254,624,1835
3336965818,3417411117,1647305056,1647305286,230,1406
3019576854,3087278716,1669169595,1669170550,955,1684
3284948113,3571428723,1657549736,1657550152,416,2048
3031649001,3641928180,1642980302,1642980905,603,407
3265364405,3089325315,1661336500,1661337121,621,1215
3156331863,3424368056,1651434933,1651435349,416,13
3100239217,3760224151,1667511867,1667512822,955,2028
3378522829,3705601482,1668567565,1668568548,983,2148
3600334566,3986353377,1655748896,1655748924,28,2123
3881378306,3644100988,1647262408,1647263367,959,1070
3832585790,3900951859,1655811562,1655812549,987,2401
3022388087,3419068106,1657690437,1657691224,787,1225
3074412412,3066360181,1647362772,1647363330,558,2379
3880476189,3570955260,1643089700,1643089758,58,1302
3511192827,3525152477,1641738423,1641738865,442,1950
3118518203,3072834944,1661266073,1661266156,83,1513
3653031568,3082026010,1653016908,1653017205,297,363
3447887397,3993917332,1664428027,1664428818,791,1206
3324611610,3143620816,1666172681,1666173590,909,1551
3908895548,3553712893,1655643002,1655643042,40,877
3701103798,3927284839,1644039521,1644040043,522,1756
3604236901,3356883463,1663514740,1663515263,523,1565
3830579550,3170985187,1654505692,1654506376,684,620
3404873411,3628675820,1644585539,1644585827,288,2369
3196302340,3072599295,1659251762,1659251859,97,269
3601851578,3913645530,1656373522,1656374522,1000,2278
3188126815,3774102998,1664299261,1664299702,441,1059
3683038464,3731386559,1659979181,1659979946,765,2141
3355942761,3859379131,1648382066,1648382340,274,1319
3520943619,3663155034,1641207236,1641208080,844,1150
3712195438,3083519927,1650674643,1650675347,704,1323
3896091695,3607352755,1666120027,1666120813,786,1741
3857211245,3128805218,1659589806,1659590028,222,1930
3358242037,3620700244,1658639592,1658640024,432,1537
3434650074,3453552267,1654268761,1654269746,985,1874
3686968293,3584139105,1644584564,1644585362,798,1301
3706206403,3937698731,1648248487,1648248839,352,1482
3456602518,3352986307,1668825366,1668826032,666,1520
3411921561,3286463125,1659430473,1659431162,689,538
3123781164,3082828436,1661355792,1661356355,563,1154
3232497890,3585526520,1652679019,1652679294,275,1442
3957577547,3952252601,1656546680,1656547003,323,410
3211839563,3282561101,1656856989,1656857195,206,2326
3888851378,3035737560,1659188586,1659189110,524,64
3549768940,3840502377,1654121334,1654121798,464,2323
3642377610,3460504628,1642746464,1642747149,685,1833
3969046292,3133655192,1668184543,1668185222,679,1029
3855261620,3634936481,1665119241,1665119352,111,701
3054758455,3061979919,1653884113,1653884305,192,660
3243902799,3019694538,1669048711,1669048771,60,564
3730266625,3664242822,1669122366,1669122705,339,2447
3445095607,3494990710,1669633386,1669634123,737,1126
3678624517,3276666399,1668836431,1668837240,809,698
3296957627,3346948485,1644244582,1644244754,172,1787
3729340640,3114361358,1657717615,1657718532,917,2441
3362598320,3617795950,1644056662,1644057148,486,351
3601590462,3938973292,1643221191,1643221317,126,1174
3302294195,3641372344,1653288462,1653289453,991,2372
3351803423,3101137807,1645853061,1645853497,436,259
3156538951,3651571335,1660881346,1660881920,574,1988
3473571389,3749619105,1666371623,1666372423,800,974
3417143667,3739338939,1668571999,1668572640,641,686
3034815361,3673935826,1656375366,1656376010,644,441
3894030912,3786148014,1643910253,1643911123,870,2282
3749593178,3816011687,1663393036,1663393167,131,1540
3994913668,3685715658,1668192272,1668192378,106,609
3986885276,3000650426,1665781584,1665781778,194,1463
3939722468,3686530724,1648077510,1648078203,693,1144
3777316167,3949133704,1668463188,1668464004,816,435
3459115924,3225477579,1654658962,1654659594,632,1538
3121932256,3872444916,1644595251,1644595840,589,809
3693652924,3347854994,1661487966,1661488297,331,1812
3576386271,3294278402,1655319822,1655320419,597,1180
3014646091,3724157579,1649552238,1649552961,723,1777
3875892624,3542832965,1666158803,1666159218,415,1914
3665668423,3082026010,1667332646,1667332893,247,1906
3066645531,3095151362,1665887856,1665888423,567,1938
3087876190,3369049258,1644164126,1644164166,40,2192
3861652282,3877090261,1651442379,1651442549,170,1623
3177851224,3356034290,1667291400,1667291738,338,1462
3835864517,3052875832,1665664530,1665665292,762,738
3742145726,3816690173,1663826585,1663827291,706,543
3719785520,3296419150,1661670075,1661670439,364,255
3883057669,3953927472,1661944600,1661945419,819,2134
3957824946,3187644022,1649464632,1649465048,416,2162
3227246451,3447743170,1657163324,1657163863,539,1962
3845818528,3903261473,1658089094,1658090089,995,164
3903321481,3523045898,1658894558,1658895459,901,653
3993066194,3095621927,1641406755,1641407222,467,1288
3399631396,3485298583,1651773372,1651773469,97,930
3508060901,3661705197,1645436831,1645437445,614,1242
3450074680,3870463011,1646153574,1646154111,537,1459
3758577708,3626015702,1668297102,1668297376,274,1236
3189085834,3269690639,1657719207,1657719657,450,1950
3125008218,3698358344,1655376380,1655376666,286,2105
3753863307,3263350346,1656231801,1656231901,100,995
3630318253,3839642166,1649143361,1649144160,799,1394
3751780241,3616890026,1646546419,1646546881,462,1647
3775948778,3828890005,1654597780,1654598620,840,1617
3134166826,3839454838,1649391243,1649391540,297,1781
3736260750,3954490536,1656439967,1656440183,216,1210
3863485115,3993994586,1642920894,1642921495,601,1021
3481006313,3915494041,1664238491,1664239096,605,2484
3828810890,3707867178,1655244328,1655244733,405,1989
3233536885,3757624193,1654142023,1654142759,736,2127
3278077270,3968564476,1668692467,1668692807,340,218
3732472752,3711943152,1666049388,1666049534,146,2095
3890875667,3366643644,1659321708,1659322690,982,1854
3671296032,3939711103,1668170755,1668171693,938,315
3739406554,3853056907,1657559778,1657559834,56,1578
3044564753,3526218972,1662814956,1662815614,658,452
3568756567,3689828648,1666855519,1666856018,499,1230
3139935588,3630744377,1662202253,1662202627,374,782
3610577318,3183435456,1644573252,1644573890,638,422
3219181477,3054606477,1665719780,1665720009,229,1678
3629593465,3792708367,1642992715,1642992746,31,1278
3039081980,3051876837,1652978995,1652979304,309,902
3145393304,3442354739,1659586939,1659587848,909,2437
3537214664,3503394389,1655791507,1655792171,664,1212
3379829698,3295316821,1645694793,1645695224,431,691
3296956444,3791315348,1644505500,1644506072,572,1739
3720248207,3361167735,1666280378,1666280659,281,1862
3686594925,3928044191,1667912207,1667913124,917,1958
3166284447,3204336699,1659255238,1659255606,368,28
3488151008,3289630313,1661052582,1661052995,413,1467
3930662723,3595499905,1666551567,1666552533,966,1782
3897412947,3471288672,1649433924,1649433985,61,1793
3616218859,3135119423,1662510944,1662511501,557,1833
3032851657,3361016803,1655247813,1655248067,254,696
3216753609,3837062335,1652926087,1652926551,464,1501
3993580342,3962617141,1664047595,1664048467,872,1831
3799287196,3532021354,1663490297,1663490834,537,619
3864249446,3412927884,1649416826,1649417606,780,1677
3790883274,3069746677,1654874865,1654875651,786,1507
3755413351,3810915449,1653732557,1653733434,877,766
3097128642,3787920743,1660548793,1660549052,259,1306
3185373368,3951845301,1668921254,1668921949,695,1271
3672350582,3069431080,1664517741,1664518520,779,2485
3925754107,3183507473,1642936200,1642936712,512,148
3879299283,3507500782,1651172409,1651173369,960,1170
3715731774,3392569339,1647700507,1647700677,170,1291
3008550397,3499026312,1657279890,1657280121,231,2440
3891579335,3122624322,1658733282,1658734035,753,2305
3252981510,3369049258,1657639175,1657639960,785,1072
3537592483,3772178120,1661757806,1661758788,982,2028
3264434341,3211945942,1662082193,1662082287,94,2432
3904445895,3462714323,1659720411,1659720986,575,1476
3405388298,3267600229,1655786152,1655786555,403,2334
3658477943,3169394495,1664982899,1664983680,781,95
3728950700,3559615011,1652313523,1652313710,187,853
3896308173,3465238210,1648734708,1648734850,142,1942
3586778995,3591264259,1641134247,1641134583,336,388
3038832798,3935936621,1642063391,1642064230,839,1282
3594903436,3217250826,1654729375,1654730261,886,2044
3889544424,3825173498,1656679335,1656679349,14,1256
3935125903,3009366895,1642032283,1642032984,701,1401
3284269721,3512353520,1644800697,1644801102,405,1304
3969650128,3002013720,1641190317,1641190620,303,2064
3765693461,3538039823,1663425854,1663426058,204,2476
3656829277,3931277047,1641636410,1641636416,6,1608
3355798436,3152795421,1651590727,1651591534,807,1094
3311244386,3970049421,1665608568,1665609215,647,1957
3797769846,3567614002,1650781569,1650781693,124,2285
3569578952,3124147703,1654561450,1654562366,916,1667
3089548621,3149191705,1658174191,1658174305,114,678
3390976131,3553471050,1641480902,1641480999,97,648
3736118442,3758577708,1645015116,1645015994,878,378
3452843457,3941586762,1665725051,1665726007,956,1650
3114361358,3261333996,1664361254,1664362221,967,1116
3098955230,3625504025,1661443753,1661444685,932,901
3045925838,3353295219,1667486915,1667487480,565,2041
3346604377,3747889498,1653583968,1653584965,997,2290
3364911803,3102776006,1641695145,1641695971,826,1755
3819235768,3488484971,1644044668,1644045529,861,1967
3125350196,3630963449,1663241061,1663241170,109,559
3228366627,3471993716,1645749142,1645749675,533,2163
3841904297,3101265323,1654019423,1654019815,392,227
3533898881,3400434269,1665488344,1665488853,509,1393
3460229906,3634018428,1656968146,1656968816,670,1907
3468586613,3842431875,1665566155,1665566768,613,1416
3407746149,3956836647,1664614381,1664615081,700,2060
3577216621,3211641180,1643076292,1643077024,732,256
3459018363,3264993323,1663628421,1663628648,227,1675
3178728299,3041652512,1664389130,1664389552,422,16
3964613907,3855762650,1662119140,1662119603,463,1960
3927666827,3334743610,1650789333,1650789671,338,2453
3089126812,3486802233,1666307874,1666307904,30,1
3935022176,3273289104,1658831316,1658831475,159,1453
3003243547,3066305343,1669031448,1669032313,865,880
3649447383,3447257561,1654252284,1654252998,714,219
3545188902,3670266153,1641403065,1641404041,976,2480
3952316985,3712804229,1644272920,1644273811,891,2366
3353527086,3820254686,1647211442,1647212266,824,292
3957973658,3831951487,1664506541,1664506919,378,2277
3837366084,3454754318,1659107015,1659107295,280,56
3407322181,3354395496,1658075665,1658076575,910,1299
3759510872,3503453854,1662456436,1662456695,259,672
3952889735,3083519927,1643789128,1643789289,161,1762
3269763687,3670267009,1649473194,1649473199,5,1875
3601187603,3374603408,1652723405,1652724077,672,32
3683175603,3816921514,1649111979,1649112558,579,747
3828219822,3853448159,1643343481,1643343730,249,900
3580908290,3039972849,1665262414,1665263091,677,507
3192375486,3936135558,1655236250,1655237164,914,1428
3745712275,3460669513,1664697829,1664698143,314,569
3264879958,3099934862,1646656098,1646656267,169,736
3690667222,3117575075,1656978641,1656978781,140,854
3758622438,3097609387,1657431617,1657432244,627,2162
3117322872,3034088160,1647108178,1647108857,679,851
3424897066,3939711103,1646801728,1646802369,641,1391
3397910828,3221850819,1642331042,1642331133,91,1566
3017075122,3037786726,1658699245,1658699378,133,292
3121651540,3306753571,1653028022,1653028768,746,173
3048386186,3848860153,1652001327,1652002007,680,2287
3126499590,3396146110,1654204158,1654204824,666,314
3181578884,3474742534,1665759968,1665760412,444,1704
3628789282,3555105048,1644685899,1644686240,341,480
3431354119,3929901413,1655861636,1655861674,38,1842
3992927391,3565001530,1662784003,1662784893,890,64
3588684575,3086084685,1643169212,1643170162,950,1442
3403911906,3525442421,1657155784,1657155805,21,809
3934386586,3050701199,1643515651,1643516235,584,1618
3011015055,3959651432,1664749181,1664750090,909,129
3020285623,3969728585,1643117546,1643117650,104,2289
3442967650,3699263886,1646678455,1646678983,528,1752
3636237325,3479725709,1660744876,1660744961,85,2327
3308435698,3124200545,1656054723,1656055513,790,254
3723438987,3822693340,1649864340,1649864448,108,2187
3020526331,3713129998,1654468657,1654469203,546,1450
3581011004,3564417343,1648406602,1648407441,839,2113
3811482837,3156683897,1664343753,1664344074,321,2062
3361365460,3219575313,1669186245,1669187073,828,630
3697291064,3585919417,1653695461,1653695794,333,854
3126746702,3842445140,1657480526,1657481378,852,1160
3627191763,3154551351,1642855494,1642856205,711,2319
3547429967,3182765580,1646446200,1646446566,366,1621
3655786063,3666179764,1650188218,1650188416,198,897
3028679133,3232141615,1655039385,1655039684,299,374
3968682824,3047001138,1650550395,1650550514,119,850
3066546417,3504258562,1641366086,1641366729,643,2277
3070395663,3759608318,1644522905,1644522937,32,343
3233318289,3486582851,1663433950,1663434036,86,1982
3284380221,3029149493,1654744263,1654744748,485,2057
3928572443,3596567072,1650219573,1650219843,270,16
3275494433,3210430918,1647502521,1647503172,651,1015
3004708023,3392271707,1644694247,1644694343,96,1448
3981817077,3017484229,1654991692,1654992553,861,1795
3442330693,3649036403,1644424039,1644424389,350,1967
3235245267,3572896327,1643022453,1643022901,448,2064
3904445895,3461263871,1666834181,1666834532,351,2334
3059870015,3680060067,1669701604,1669702601,997,466
3123532931,3197371652,1662233643,1662233718,75,2262
3524831718,3531842620,1658577614,1658578545,931,1736
3587324906,3861764050,1661979555,1661980465,910,1266
3930124385,3308435698,1645854057,1645854586,529,1654
3282275875,3126778118,1646154264,1646154723,459,2282
3599869347,3540730645,1652609423,1652610137,714,1824
3787514151,3065246027,1663899286,1663899961,675,1975
3904874839,3442293538,1660193427,1660193811,384,305
3905922866,3936943386,1661834662,1661835376,714,2057
3565781990,3980139195,1661293747,1661294095,348,2163
3385603289,3558848518,1643723394,1643724148,754,1538
3448373235,3890117007,1668857487,1668858292,805,2372
3156928973,3395609056,1654580034,1654580248,214,1437
3280223679,3986970365,1649336925,1649337757,832,1731
3419415544,3924577071,1656734858,1656735630,772,15
3622656083,3911671645,1663383649,1663383861,212,1569
3749529134,3289850617,1660957248,1660957757,509,47
3608775321,3354579861,1647481192,1647481239,47,1452
3482268698,3007087811,1666798630,1666799538,908,914
3921229994,3760972512,1651359576,1651360521,945,1889
3852506516,3673549679,1665624303,1665624695,392,699
3948942044,3456799118,1657527737,1657528077,340,477
3653770219,3040416131,1648954889,1648955644,755,1289
3631424312,3547365303,1665732389,1665732950,561,1287
3165807050,3812481438,1646450479,1646451139,660,1126
3219181477,3889967886,1643651988,1643652491,503,703
3921261515,3490430582,1648030192,1648030672,480,361
3513399148,3744002702,1643390593,1643391059,466,1697
3859360549,3098276544,1643506967,1643506981,14,987
3958275419,3859249968,1643599460,1643599936,476,1224
3011459628,3842677051,1668294733,1668295673,940,469
3346164838,3875434702,1646242687,1646242700,13,2164
3117322872,3122288373,1648177970,1648178500,530,128
3538823780,3492376573,1643295228,1643295627,399,2372
3754139010,3287078889,1649485797,1649485834,37,2341
3067380299,3912511626,1663532747,1663533235,488,1280
3629593465,3591834837,1649153733,1649154166,433,1332
3306871271,3961140276,1659860297,1659860650,353,140
3166206557,3336211604,1661971702,1661972337,635,1874
3215423327,3535941714,1653038976,1653039627,651,2099
3771528397,3703548595,1664142770,1664143531,761,1109
3910760009,3196704660,1646521310,1646521923,613,1822
3592471391,3540717336,1643130375,1643130840,465,93
3453736515,3935936621,1659598878,1659598950,72,632
3371063992,3168984273,1657299689,1657300332,643,975
3777568712,3403925711,1665097880,1665098063,183,1763
3716626172,3515460273,1641663939,1641664188,249,2126
3774102998,3820585135,1649039060,1649039779,719,1709
3896866052,3787673872,1645741835,1645742231,396,382
3624947127,3892800106,1652708372,1652708937,565,1258
3715994986,3704517188,1662836386,1662836741,355,1486
3767912489,3406332128,1647650571,1647651188,617,2024
3385273825,3132584801,1647501406,1647502158,752,1564
3905167655,3776785233,1666447994,1666448403,409,2104
3784123884,3142106289,1666559280,1666559355,75,1117
3715766296,3059848821,1641478306,1641478371,65,1269
3001480546,3495691991,1664417999,1664418731,732,1328
3448373235,3344337283,1650656497,1650656887,390,1494
3247688800,3771028638,1668633825,1668634766,941,1643
3712581685,3782182063,1662049554,1662049923,369,821
3948942044,3098316380,1643220558,1643220990,432,2416
3447326124,3825332100,1667062530,1667062942,412,1294
3702541874,3656027442,1650109189,1650110136,947,1184
3968297784,3423043196,1647665842,1647666450,608,527
3251372174,3088562105,1661642452,1661643233,781,652
3106584115,3006388757,1663954237,1663955086,849,362
3747302768,3516399207,1661679284,1661679825,541,122
3976730264,3349870020,1645978001,1645978001,0,382
3976367014,3690015481,1662774644,1662775014,370,2255
3859221152,3132034706,1642771299,1642771922,623,1284
3072599295,3145039731,1668551473,1668552422,949,845
3432364009,3982715838,1665984976,1665985261,285,2088
3242406857,3293615945,1643618929,1643619440,511,334
3120056957,3204935260,1662980581,1662980907,326,1542
3265262512,3485801867,1658196030,1658196142,112,1221
3128529900,3043153412,1643092863,1643092971,108,1896
3298044531,3261463305,1642898578,1642899029,451,930
3174712961,3686025670,1665705421,1665705875,454,710
3302700303,3105558193,1652592349,1652593338,989,411
3153902371,3313975664,1664139843,1664140463,620,1307
3327873529,3581083030,1648842651,1648842681,30,622
3038424212,3807924634,1663865172,1663865291,119,2024
3749702246,3672350582,1652848367,1652848420,53,1777
3661462228,3778147762,1663997188,1663997368,180,615
3070676307,3877464299,1660211320,1660211457,137,2291
3532569602,3622933919,1662047053,1662047439,386,318
3710782213,3300203056,1646250555,1646250868,313,1568
3774325139,3003116947,1666972313,1666972389,76,96
3774724683,3935936621,1653457450,1653457459,9,2150
3681719344,3070087815,1646086378,1646086607,229,27
3794103075,3189435516,1650578637,1650578673,36,590
3957115705,3093364150,1661138077,1661138913,836,1471
3490087619,3651535646,1650420695,1650421380,685,1266
3546859493,3669324531,1665913246,1665914095,849,2238
3375585327,3695360424,1667155322,1667155702,380,343
3003705867,3929282989,1659350936,1659351215,279,459
3993076833,3397972687,1661620039,1661620850,811,2137
3313615371,3795817960,1654271289,1654271452,163,647
3841170833,3123441689,1641310244,1641310356,112,2491
3817252660,3668235327,1661957452,1661957556,104,488
3641729236,3667028828,1658620797,1658621662,865,1065
3258352640,3070087815,1664468035,1664468398,363,466
3832880789,3141134453,1645945343,1645945815,472,1544
3031026970,3750160040,1655667809,1655667992,183,1787
3547672806,3413514902,1648705236,1648705317,81,764
3366354894,3605587138,1656792415,1656793303,888,1346
3105815944,3205077454,1641546188,1641546888,700,2268
3787817814,3122818832,1648657923,1648658488,565,2300
3101669976,3687215472,1666759797,1666759959,162,391
3708134798,3552282443,1654565424,1654565594,170,317
3211541773,3053026624,1644446897,1644447613,716,1511
3395782360,3222082052,1644982718,1644983656,938,412
3792253761,3823692648,1656880259,1656880825,566,1342
3963334554,3836089663,1641989302,1641989811,509,2425
3523099697,3775146250,1659950328,1659951162,834,2335
3822146001,3120984531,1665483673,1665484118,445,740
3845122668,3352729606,1646018625,1646019491,866,535
3707476548,3808397193,1664397141,1664397808,667,1997
3478771172,3795503592,1664675871,1664676217,346,24
3565803867,3298993308,1641323404,1641323586,182,2027
3830330372,3158554223,1659576656,1659576818,162,785
3413777646,3003422357,1646305995,1646306760,765,176
3705996677,3261447619,1656984668,1656985508,840,1266
3768984387,3352622181,1664397401,1664397870,469,2036
3154567629,3030290445,1657137452,1657138211,759,2089
3385183586,3309158757,1645712654,1645712723,69,249
3752133167,3458116043,1659257934,1659258453,519,644
3286555567,3404043594,1656774657,1656775533,876,471
3933892798,3625179175,1659493527,1659493603,76,757
3451329310,3866541862,1644137988,1644138132,144,285
3855762650,3256566881,1666678903,1666679732,829,1274
3259367927,3282561101,1667538036,1667538097,61,2404
3224715818,3025581381,1665276933,1665277500,567,388
3616441586,3526797183,1642168093,1642168095,2,1566
3309305862,3353878603,1659794823,1659794895,72,1058
3787550831,3141688992,1665881152,1665881523,371,2154
3055918856,3916456426,1660435160,1660436123,963,2046
3110482626,3987732407,1667865087,1667865482,395,1429
3344143432,3697066162,1660611013,1660611409,396,481
3481922555,3088587729,1648381260,1648381493,233,2039
3477363517,3219869001,1665960631,1665960654,23,1919
3100239217,3686249771,1653434515,1653434773,258,1110
3226559906,3901616267,1658252060,1658253017,957,1615
3383573457,3641682706,1667318741,1667319430,689,2339
3181237998,3707258240,1644223799,1644224062,263,1015
3752701792,3648118736,1653834042,1653834805,763,638
3481672220,3941489594,1641897261,1641898190,929,2488
3573975780,3310970237,1653514721,1653514877,156,58
3804824307,3389097842,1662376695,1662377204,509,1882
3745248673,3397397223,1665428717,1665428778,61,944
3552282443,3603594711,1645980132,1645980221,89,2015
3796559738,3452067391,1656835630,1656836307,677,1730
3252021647,3223313152,1656190880,1656191141,261,2484
3660983068,3461630480,1644368143,1644368440,297,1139
3901126730,3413300274,1653277445,1653278132,687,2439
3010673027,3849816711,1667543760,1667544440,680,18
3368571252,3608893234,1656167457,1656167597,140,1984
3804064265,3586776572,1652056975,1652057464,489,2406
3945607460,3070404759,1656485328,1656485749,421,226
3578075354,3907299052,1642603352,1642603549,197,1764
3649465172,3118502732,1646451339,1646452171,832,1483
3246321113,3784495839,1660005896,1660006576,680,2250
3309305862,3398242179,1641980050,1641981049,999,2301
3802614854,3079038995,1655354216,1655354605,389,644
3797930164,3962784099,1669685859,1669686304,445,1744
3298505096,3774806676,1649335202,1649335657,455,266
3623115966,3983610735,1650128317,1650128782,465,1505
3564440153,3112615469,1662622596,1662622892,296,1317
3251808759,3503842077,1664092980,1664093718,738,1064
3634010080,3456285013,1644190074,1644190115,41,2270
3895422097,3542078032,1646166837,1646167119,282,1157
3173969437,3888141694,1646873934,1646874110,176,194
3603594711,3284433811,1654133742,1654134739,997,775
3621000186,3166206557,1666202759,1666203700,941,807
3894844173,3482933937,1653364263,1653364544,281,2250
3643637605,3976405875,1661611326,1661611936,610,273
3145045320,3329825235,1643411894,1643412242,348,2381
3421078448,3870574001,1658142753,1658143015,262,1052
3357048496,3336211604,1642277623,1642278237,614,2316
3393501277,3054606477,1660054413,1660055300,887,1535
3856985099,3750069283,1643474516,1643474881,365,1136
3285019414,3647480411,1652174856,1652175468,612,2230
3718905579,3048497124,1641931046,1641931658,612,1268
3706085200,3760975208,1652764874,1652765148,274,1947
3264281080,3353422891,1664766019,1664766587,568,1353
3382396122,3695161514,1641666359,1641666877,518,1491
3707552735,3234355426,1650311838,1650311987,149,1687
3052376951,3192367201,1662915151,1662915965,814,1375
3232141615,3624683080,1645136843,1645137060,217,230
3251854206,3639695113,1641804980,1641805709,729,1456
3833553454,3054171550,1646533908,1646533983,75,260
3812800144,3464235741,1658912039,1658913036,997,1833
3047713943,3669874673,1651197128,1651197457,329,2288
3034815361,3025223556,1657653091,1657653999,908,2078
3782377691,3436916222,1657135153,1657135837,684,1723
3504919226,3731399462,1653403190,1653404123,933,1093
3989550849,3772853715,1646417206,1646418179,973,731
3310951639,3549768940,1656173157,1656173204,47,1733
3419751912,3700896206,1641956840,1641957548,708,2486
3394999152,3006508919,1646001419,1646002044,625,257
3555571916,3105829075,1669113733,1669114230,497,2478
3767581542,3766595984,1654769469,1654769726,257,309
3019631963,3242752835,1650045775,1650046700,925,566
3900571767,3111163302,1667078474,1667078623,149,2320
3038529026,3623782659,1669436849,1669437141,292,260
3793967785,3253545861,1641597512,1641597809,297,2223
3248892530,3970886019,1644123962,1644124050,88,1754
3251744109,3202063550,1655438845,1655439722,877,1204
3343232841,3527349190,1646594525,1646594951,426,285
3433418040,3124004516,1651322806,1651323302,496,570
3643637605,3117575075,1644143484,1644144029,545,964
3594254200,3339911597,1653699645,1653700565,920,2020
3845522882,3002316212,1651532933,1651533497,564,1237
3677001111,3164836342,1656302878,1656303087,209,1675
3557751532,3827122083,1646591430,1646592145,715,1120
3320742371,3714065380,1664023624,1664023875,251,681
3060757458,3215815915,1656665739,1656665890,151,2036
3058846696,3479359145,1643078442,1643078484,42,668
3792834070,3974092782,1653950488,1653950751,263,1997
3270935026,3622978712,1659779220,1659779563,343,408
3832880789,3782182063,1659323190,1659323797,607,2106
3707552735,3815537815,1664948093,1664949065,972,1955
3642498039,3545658442,1644915204,1644915309,105,600
3040889811,3098290557,1644399510,1644400347,837,1109
3661494924,3884551317,1669513039,1669513893,854,1397
3908209550,3094125203,1642263907,1642263907,0,945
3897222406,3940948395,1644221821,1644222267,446,1778
3204081712,3524508110,1645990438,1645991199,761,664
3381060534,3934914335,1649539900,1649540645,745,1328
3911619189,3705996677,1657361951,1657362277,326,583
3082912574,3181074947,1647182184,1647182295,111,2304
3313079052,3415185806,1649050604,1649051583,979,1101
3070810251,3571972204,1649833988,1649834038,50,2443
3482268698,3707070213,1665534236,1665534300,64,771
3069332103,3927066139,1650853549,1650854246,697,760
3795326002,3710844932,1665941139,1665941948,809,1347
3429004715,3435578430,1652760863,1652761030,167,2212
3198338148,3066007042,1666539849,1666540076,227,1283
3669880471,3080287966,1664883729,1664884404,675,619
3283301166,3107366519,1646612771,1646613591,820,1591
3576961863,3194603908,1646864659,1646865119,460,185
3687215472,3102776006,1666736870,1666737641,771,1517
3244502667,3464770966,1651544589,1651544722,133,246
3807184369,3315321131,1668199946,1668200196,250,1442
3170579908,3487972666,1645408194,1645408526,332,2184
3865239822,3859249968,1642647685,1642648092,407,2125
3816015403,3335210480,1642892094,1642892613,519,249
3133319209,3212218759,1656276764,1656277753,989,746
3364945349,3467211844,1667473049,1667473342,293,2286
3129176226,3055020688,1658124803,1658125350,547,1282
3708896596,3656175066,1655174533,1655174734,201,636
3203904444,3985326073,1648107957,1648108584,627,2420
3302294195,3482509515,1643741761,1643741975,214,1970
3596839317,3010819705,1658099111,1658099987,876,2012
3993866389,3719124928,1655428856,1655429191,335,1989
3375799029,3345650412,1644094668,1644095226,558,274
3384794661,3027570184,1646414402,1646414541,139,556
3536954029,3053166522,1659153402,1659153738,336,321
3889079063,3491022991,1644835709,1644836243,534,1341
3201479561,3961903747,1655134712,1655134942,230,1017
3948710872,3080829502,1644603426,1644604193,767,437
3698989053,3866158221,1661606513,1661607156,643,45
3811318665,3250484759,1655585152,1655585635,483,1462
3289402711,3459018363,1642581550,1642582141,591,1731
3492657889,3808900684,1651575896,1651576128,232,2473
3735286926,3830243698,1649943900,1649944138,238,37
3287175350,3528418687,1643683505,1643684371,866,2150
3895976556,3802749978,1645542596,1645543002,406,2122
3621456276,3070395663,1666657933,1666658070,137,762
3557215676,3841904297,1663452436,1663452614,178,181
3664337365,3648263372,1666623994,1666624727,733,1016
3049124672,3773770885,1654444774,1654444810,36,564
3205418435,3541413511,1656206164,1656206168,4,2278
3275494433,3763453899,1662583216,1662583597,381,858
3996978717,3069523420,1664017304,1664017563,259,2036
3899782287,3118358674,1659390942,1659391270,328,2293
3351145248,3582168015,1661164416,1661165295,879,19
3913071406,3474115926,1641745949,1641746206,257,1705
3359541123,3029468819,1666775525,1666775640,115,346
3598506871,3329751201,1654260754,1654261250,496,2299
3021126829,3476971345,1664465804,1664466753,949,925
3894454988,3391262941,1641859476,1641860125,649,738
3494498890,3773488272,1651286795,1651287703,908,788
3404945581,3768087701,1645941551,1645942004,453,241
3536118453,3874664424,1642665428,1642665693,265,603
3407579711,3735286926,1655695988,1655696122,134,308
3162836777,3253436330,1660579860,1660580452,592,1481
3862389429,3299817472,1643653516,1643654294,778,1973
3344957789,3250867562,1646882286,1646882983,697,2353
3913071406,3135134317,1658498810,1658499609,799,2062
3776148003,3974481828,1660412043,1660412330,287,1321
3419415544,3858951131,1655433540,1655433555,15,1054
3685977300,3482166014,1645492790,1645493265,475,2215
3378814600,3336494171,1655513269,1655513311,42,2284
3693453006,3518322544,1643211080,1643211229,149,139
3753863307,3567368088,1648657658,1648657939,281,1376
3819235768,3300412448,1659977491,1659978479,988,573
3538686599,3546006441,1667038801,1667039378,577,765
3904546701,3659224437,1643924629,1643925584,955,2221
3309405529,3420266147,1645197541,1645197995,454,305
3253589940,3388628484,1660896038,1660896099,61,1381
3264434341,3188643066,1650395124,1650396072,948,1404
3204963755,3623869570,1643838983,1643839977,994,226
3457542537,3191811632,1665569077,1665569704,627,1873
3606545393,3040219251,1655895236,1655895869,633,1449
3755962729,3907700603,1661671062,1661671190,128,1623
3708426776,3457542537,1667201116,1667201605,489,546
3345458354,3604881190,1644022611,1644023192,581,2034
3106705860,3025133604,1644278929,1644279582,653,663
3939480099,3609029368,1664341175,1664341432,257,1527
3189673990,3176317370,1663310981,1663311796,815,703
3589571844,3375759020,1645863688,1645864375,687,534
3095728444,3032123620,1661285774,1661286367,593,430
3670709726,3029956642,1667770332,1667770439,107,1812
3497911447,3233318289,1650019943,1650020238,295,902
3881861537,3173788210,1662819891,1662820686,795,412
3106788261,3601851578,1647716556,1647717041,485,664
3355910238,3767508362,1651996327,1651996432,105,1658
3431562624,3468586613,1659003711,1659003843,132,2185
3344143432,3676893681,1656573962,1656574861,899,999
3150503842,3363802434,1658651978,1658652447,469,1041
3369731959,3760365434,1654077217,1654077738,521,571
3803000258,3232160942,1667909119,1667909762,643,561
3436199937,3032888380,1641527123,1641527361,238,1504
3839369127,3508858140,1668780535,1668780931,396,1912
3729299306,3103743198,1655714735,1655715575,840,1230
3385806632,3800861252,1665445736,1665446231,495,721
3880608911,3217375075,1665034361,1665034566,205,1832
3050701199,3696096099,1663652447,1663653155,708,757
3719884534,3180973124,1656537567,1656538395,828,1554
3206061644,3046707177,1663034902,1663035209,307,1226
3936179181,3091072272,1647277349,1647277972,623,1369
3896777982,3501972053,1660808456,1660809136,680,2015
3162947685,3972955608,1657343789,1657344033,244,1320
3895277580,3638297718,1661664940,1661665275,335,1054
3376552382,3930051071,1667161536,1667162036,500,1291
3431175768,3154991935,1665407566,1665408192,626,1498
3656829277,3868397809,1657885038,1657885464,426,728
3927646653,3551111997,1665458241,1665458440,199,615
3028886204,3624060457,1654134109,1654134648,539,1968
3442854678,3212095735,1652653978,1652654302,324,601
3126746702,3589366986,1650518763,1650518895,132,1062
3165807050,3362836351,1650540839,1650541161,322,2483
3251744109,3707199669,1668255492,1668255899,407,2051
3782741533,3095503795,1655409302,1655409345,43,1107
3911364139,3503842077,1653344544,1653345213,669,896
3840962989,3718909055,1659229919,1659230692,773,405
3884750087,3749379310,1662526235,1662526789,554,244
3142101976,3158988425,1667184527,1667184869,342,188
3937445570,3329253794,1644660404,1644660832,428,2201
3508133844,3160349110,1658668479,1658668872,393,230
3694244943,3262203147,1642572829,1642573136,307,375
3985825297,3562859716,1649581846,1649582058,212,2249
3441206388,3055944630,1647090080,1647090725,645,2186
3886917024,3889541754,1656098877,1656099655,778,348
3997353499,3508143883,1668516360,1668516873,513,626
3714535860,3225616352,1649067555,1649068474,919,693
3102992210,3118406319,1645326608,1645326663,55,2346
3596932196,3534133715,1654940976,1654941188,212,3
3352444293,3086894794,1641078401,1641078509,108,1049
3895976556,3385196866,1657132217,1657132758,541,2164
3832463052,3985418000,1650049712,1650050194,482,689
3085412399,3675429073,1663694511,1663695381,870,889
3120737114,3054639823,1643354737,1643355144,407,1428
3046991819,3030290445,1664117097,1664117622,525,1693
3792834070,3804145408,1669045351,1669045911,560,1639
3354200745,3728498046,1653815732,1653815746,14,525
3580594125,3789380087,1660924258,1660925251,993,754
3282950540,3823206701,1657842733,1657843232,499,101
3986885276,3629797745,1663169219,1663169729,510,1327
3226451761,3431614426,1657381113,1657381678,565,1281
3091418450,3271318708,1643997656,1643998397,741,935
3829874150,3450628929,1656610477,1656610990,513,1390
3867860336,3208346862,1641836281,1641837162,881,2485
3401138486,3028267408,1642868794,1642869743,949,1877
3374005704,3917373940,1668980982,1668981399,417,875
3914946558,3135707503,1667872889,1667873762,873,908
3790406016,3886917024,1642507595,1642507767,172,1235
3665075758,3255485773,1664763107,1664763877,770,70
3188162412,3477522732,1641378809,1641379231,422,1357
3018325807,3908007955,1652986195,1652986282,87,1178
3485644295,3273219526,1663386646,1663387076,430,456
3462483679,3453552267,1660771922,1660772795,873,625
3534852421,3983536056,1641208291,1641208914,623,948
3713126710,3083020614,1666264165,1666264708,543,1520
3098264219,3946919028,1657399035,1657399108,73,2455
3995654203,3258577325,1659363678,1659364390,712,1185
3548484912,3567637602,1668365104,1668366093,989,2275
3916928531,3354395496,1665447159,1665447666,507,1942
3566824993,3278980230,1658224000,1658224205,205,766
3831380073,3008470758,1661153192,1661154152,960,308
3268821463,3265434991,1651891733,1651892119,386,286
3839369127,3635616513,1658632018,1658632534,516,2392
3611982999,3317431311,1669486857,1669487133,276,1662
3387938632,3231517158,1642505166,1642505366,200,2080
3698633384,3850304083,1641770220,1641770856,636,1407
3898391169,3228518080,1646761677,1646762332,655,2437
3449352254,3401463703,1650128711,1650128994,283,1004
3246701704,3587508502,1667892910,1667893557,647,1209
3235672444,3345458354,1660394626,1660395579,953,2389
3008609242,3821157240,1650399831,1650400042,211,1975
3128133737,3165835560,1664376092,1664377003,911,1338
3949201468,3248730765,1665474768,1665474845,77,378
3659752387,3188468802,1662931161,1662931685,524,1185
3957577990,3150503842,1652771104,1652771462,358,268
3391857064,3090804084,1642917619,1642917850,231,2086
3917956140,3644100988,1662778249,1662778575,326,396
3868701805,3729475963,1664052070,1664052247,177,144
3165423009,3546192493,1656225639,1656225982,343,2457
3316031407,3710331536,1649288521,1649288740,219,1806
3866601790,3847237978,1652334289,1652335026,737,1714
3814588354,3344957789,1651377251,1651377582,331,237
3541372095,3242897765,1669099557,1669100423,866,2468
3805845272,3391857064,1645161246,1645161694,448,1419
3096740365,3495798110,1645805685,1645806317,632,54
3829901682,3077238667,1641830474,1641831318,844,1842
3290359932,3520106918,1654614931,1654615208,277,633
3163551629,3199892178,1651688704,1651689262,558,571
3348006171,3441206388,1650293063,1650293763,700,2398
3022348535,3273518390,1661652374,1661653155,781,112
3624188526,3505789435,1658842232,1658842700,468,1905
3449365489,3159900056,1643413031,1643413111,80,864
3035464149,3865529150,1644370724,1644370755,31,1770
3367849829,3542153652,1661416653,1661417528,875,2217
3469524230,3621966073,1643713683,1643714485,802,431
3764492400,3915206176,1661921887,1661921907,20,1207
3888438556,3644128961,1653493387,1653493924,537,295
3586025172,3937129101,1646766082,1646766972,890,1251
3088587729,3541372095,1662855098,1662855734,636,1270
3866993832,3952107057,1660460412,1660460635,223,1209
3790402339,3293416862,1660048385,1660049279,894,1787
3069318012,3617715231,1643051101,1643051977,876,854
3352667302,3891518316,1661030508,1661031432,924,233
3688133320,3594471575,1656881669,1656882003,334,2148
3199395221,3168820334,1667704781,1667705610,829,1559
3625586912,3066429600,1655731818,1655732210,392,941
3318717113,3005700539,1659341954,1659342337,383,1469
3595738872,3891053268,1659447120,1659447363,243,1927
3404200815,3662355477,1669606553,1669606778,225,1203
3890181496,3660575608,1659350990,1659351601,611,1445
3052438592,3774722709,1651827820,1651828051,231,1596
3563840007,3371818930,1663147596,1663148076,480,1612
3235049473,3757305418,1644509607,1644510459,852,91
3097789994,3967439884,1644459698,1644460643,945,1851
3681170705,3219575313,1669499624,1669499779,155,618
3816921514,3878810894,1641246955,1641247094,139,2413
3183867254,3980087695,1665884318,1665884495,177,1159
3316951862,3231794234,1663030173,1663031023,850,1466
3766345791,3153552268,1646185797,1646186696,899,2202
3424655507,3893937230,1665979569,1665979622,53,1911
3513847916,3428595992,1668182974,1668183892,918,222
3248900308,3797182963,1661227271,1661228157,886,1551
3904445895,3476403398,1668796542,1668796833,291,1003
3213836945,3423088497,1664833044,1664833234,190,1940
3877049401,3549703546,1651176474,1651177386,912,2145
3268446099,3889541754,1661255589,1661255774,185,1513
3618397647,3271919876,1656140965,1656141511,546,149
3069318012,3331335383,1666849142,1666849964,822,673
3132863382,3671637527,1646036902,1646037250,348,1389
3673892525,3239792198,1653795805,1653795914,109,201
3696243779,3661243199,1648070875,1648071063,188,972
3929464797,3080889735,1650759584,1650759585,1,242
3379285136,3447203087,1655043636,1655044523,887,1118
3964637208,3727544443,1641285642,1641285813,171,1775
3077590635,3172305265,1649272976,1649273871,895,621
3298505096,3804768140,1642392341,1642392624,283,1831
3490381305,3143962586,1657787978,1657788058,80,1599
3537151295,3273752842,1665861457,1665861711,254,535
3324394622,3590361712,1662760872,1662761639,767,62
3220424979,3370867881,1656683937,1656684638,701,1869
3421728246,3949133704,1669572544,1669572631,87,839
3224095644,3926467866,1658599537,1658600040,503,2207
3981191978,3542827244,1642501792,1642501900,108,2207
3156980878,3978925529,1668305663,1668306432,769,2292
3232285701,3485526833,1665220003,1665220065,62,2398
3278703976,3666079547,1663761015,1663761728,713,1874
3098667748,3093146280,1652352531,1652352884,353,1120
3924990392,3134166826,1662583383,1662583804,421,694
3254181971,3204336699,1659779477,1659779657,180,1552
3465229825,3252760026,1645975200,1645976186,986,319
3488757134,3534581934,1662080171,1662080614,443,527
3038014403,3761142574,1655968448,1655968524,76,2332
3945358150,3525978019,1658960828,1658961593,765,1792
3638297718,3165845148,1654517459,1654517597,138,275
3979552361,3821299576,1645809061,1645810009,948,1980
3928572443,3342929537,1666748490,1666749229,739,1803
3573826666,3597794683,1667081466,1667081556,90,2357
3590361712,3655923753,1652696409,1652696512,103,773
3876097800,3696096099,1669093816,1669094207,391,1200
3887290680,3769647112,1668352857,1668353091,234,1943
3452773006,3749702246,1652730397,1652731346,949,491
3798447157,3481811999,1661263569,1661263855,286,1088
3981173642,3308028752,1661787187,1661787946,759,1708
3154079557,3809773923,1645868113,1645868499,386,1422
3800460824,3777846262,1651896458,1651896859,401,1199
3505480563,3137200123,1662556814,1662557782,968,1023
3497911447,3925365269,1656404265,1656404879,614,2092
3903588940,3886521997,1642892041,1642892786,745,2223
3227951880,3627503494,1662895106,1662895953,847,1518
3302700303,3335210480,1645434071,1645434872,801,1350
3024554792,3012264999,1646581616,1646581688,72,390
3442330693,3749529134,1648458903,1648458965,62,2028
3258926142,3271885744,1650150566,1650150818,252,111
3006456611,3021006721,1669316890,1669317105,215,1881
3885084129,3959081575,1649277317,1649278307,990,1133
3209464030,3315593278,1654621678,1654621797,119,317
3563738755,3939722468,1642526003,1642526776,773,363
3370120843,3521081470,1649131468,1649132457,989,781
3668552386,3548484912,1649911496,1649911979,483,1890
3346631744,3725465166,1652450213,1652450353,140,873
3358745496,3132376039,1662908572,1662909432,860,407
3913984749,3263372197,1665604610,1665605303,693,2056
3419415544,3885087517,1666739802,1666739985,183,212
3066362135,3157821920,1654614137,1654614797,660,2313
3351610798,3324634418,1659541800,1659542152,352,1836
3325735498,3596247005,1647809037,1647809952,915,2253
3227970299,3647222339,1648290967,1648291255,288,1196
3152795421,3125900419,1649347090,1649347478,388,399
3903321481,3746050591,1642855474,1642856271,797,243
3617200235,3180836532,1668450095,1668450525,430,986
3791547480,3118443010,1648187664,1648187916,252,116
3901736828,3293416862,1651109976,1651110135,159,1048
3867353788,3594009328,1655855911,1655856724,813,967
3098955230,3851327758,1656483901,1656484715,814,714
3693000511,3128401376,1669114548,1669115542,994,2358
3247959785,3436199937,1647995707,1647996620,913,2260
3285243887,3392395230,1651890524,1651890903,379,897
3086564112,3194142427,1658288254,1658289164,910,371
3957803611,3921261515,1648949486,1648950115,629,1063
3972955608,3446519765,1646925363,1646926228,865,293
3286466102,3609003771,1661166840,1661167047,207,2319
3952389962,3875045889,1665969026,1665969710,684,581
3486802233,3829856490,1649906630,1649907189,559,722
3962617141,3361514629,1661716412,1661716979,567,2024
3259260257,3748627476,1646453819,1646454614,795,1849
3290481654,3532307372,1660871963,1660872598,635,132
3758115218,3564839908,1666751959,1666752876,917,123
3882414600,3136564426,1644090706,1644091538,832,433
3832995595,3743886187,1652652377,1652652717,340,2404
3829986472,3217173480,1645106242,1645107056,814,720
3491346910,3852810875,1657490344,1657491252,908,1848
3741024153,3908209550,1657968123,1657968683,560,1033
3438130685,3004951157,1667767034,1667767946,912,1803
3528505546,3035838196,1653338012,1653338479,467,1226
3962453693,3067150549,1669443292,1669444185,893,1466
3132210207,3803051709,1643092286,1643092341,55,887
3344077337,3671974600,1650633408,1650634377,969,404
3718731864,3798527829,1644494211,1644495090,879,429
3751600788,3609562862,1669091521,1669092240,719,1492
3629942160,3447926518,1641333835,1641334264,429,1913
3920277028,3481620613,1652955432,1652955821,389,2464
3622656083,3227446097,1656938299,1656938381,82,1312
3354912831,3928685907,1648808885,1648808997,112,850
3499481975,3657391976,1656485976,1656486169,193,1142
3286424440,3090090794,1653570720,1653571716,996,2197
3309767670,3649073682,1653159557,1653159711,154,1875
3041897048,3703943697,1655579846,1655580654,808,1524
3576315042,3225857817,1668289225,1668289517,292,1804
3947369111,3378791519,1654238784,1654239714,930,286
3435340439,3310523513,1650885820,1650885872,52,1976
3656878544,3560020610,1644497355,1644498234,879,1606
3847237978,3542832965,1655477702,1655477879,177,1605
3775645582,3271409183,1657881009,1657881690,681,2103
3830015015,3795817960,1659463508,1659464489,981,1864
3720223108,3527201198,1650866579,1650867300,721,1085
3314901091,3043753185,1649877811,1649878198,387,802
3351218513,3606998838,1652254866,1652255546,680,1117
3178837482,3411921561,1642225103,1642225365,262,559
3800271865,3825824228,1664199034,1664199316,282,1145
3315056551,3125717667,1660975304,1660975738,434,2307
3996989799,3267360802,1644719773,1644720343,570,971
3671437138,3345410681,1641892030,1641892143,113,2177
3449352254,3458971289,1647576815,1647577366,551,1873
3555538922,3986955632,1646858547,1646858990,443,235
3583918364,3227446097,1669645452,1669645806,354,1695
3982929088,3520523282,1641677255,1641677823,568,1817
3569006301,3392918310,1660483386,1660483457,71,1456
3820585135,3835355277,1650241731,1650242369,638,567
3708337100,3407770585,1652065213,1652065564,351,62
3404934353,3933940005,1657320281,1657320336,55,1445
3104164320,3492103801,1649479410,1649480060,650,513
3634044438,3007480776,1650627031,1650628030,999,840
3112270906,3947604616,1661654826,1661654908,82,1398
3913984749,3226559906,1661650156,1661650353,197,1153
3435698448,3037577001,1649490490,1649491328,838,1502
3447743170,3877902487,1640997236,1640997543,307,957
3435698448,3600334566,1653821434,1653822054,620,64
3502587181,3609601814,1655846256,1655846867,611,845
3160349110,3832585790,1663292994,1663293957,963,2223
3081188307,3331604266,1666161066,1666161366,300,245
3683134571,3963702135,1647221244,1647221333,89,2206
3508108339,3804948415,1657569238,1657569760,522,2059
3384200089,3182643672,1648426703,1648427280,577,2007
3330817237,3526088150,1668837987,1668838569,582,1211
3182097979,3393712145,1662047394,1662048314,920,2382
3721110937,3641983006,1645925131,1645925379,248,133
3066305343,3331295538,1641194081,1641194190,109,2192
3650342769,3866832484,1669068745,1669069479,734,1773
3529681535,3248397935,1649819708,1649820124,416,891
3439700326,3573583612,1660301452,1660301635,183,1982
3573969593,3113938510,1659174756,1659175402,646,2474
3719445490,3552958954,1665566723,1665567520,797,66
3700737923,3109465057,1657357298,1657357780,482,603
3851879278,3424522509,1652907459,1652908122,663,1257
3916928531,3767453896,1652568247,1652568364,117,676
3651753987,3424994271,1641453271,1641453681,410,2434
3247959785,3226280658,1650885670,1650886525,855,365
3439905167,3693797946,1649099586,1649100097,511,2469
3957051129,3534852421,1661573734,1661574403,669,116
3624103484,3706215600,1660442842,1660442927,85,2414
3534910343,3935809720,1648882926,1648883727,801,2357
3586600196,3287078889,1656795502,1656795682,180,1042
3134436515,3102820806,1641886639,1641887486,847,163
3908312889,3636960130,1648762682,1648762719,37,1361
3145393304,3841318125,1652157565,1652157906,341,292
3870463011,3210337290,1643587595,1643587796,201,2084
3729600228,3835864517,1667397127,1667397551,424,1721
3582076532,3194871172,1649673283,1649673792,509,1412
3904183865,3298505096,1651231468,1651232100,632,878
3896922629,3868440818,1663243151,1663243716,565,2109
3172619193,3718714231,1665680340,1665680776,436,2279
3252070101,3037042091,1648681042,1648681869,827,203
3130561868,3096412109,1641316567,1641317299,732,2310
3243502165,3783119155,1662305153,1662305819,666,2232
3232160942,3223459561,1666782678,1666783262,584,2332
3006507589,3426491499,1665989071,1665989116,45,1046
3760304580,3251409316,1655686656,1655687073,417,2103
3459599732,3882329817,1664600845,1664601149,304,1704
3229979386,3393406422,1659095902,1659096799,897,577
3887032656,3016992122,1642000599,1642001543,944,2347
3393032827,3341241551,1669221379,1669222040,661,2130
3982268438,3625504025,1652483255,1652483325,70,369
3489466063,3226220903,1641994355,1641995219,864,1132
3325944344,3713455058,1648404557,1648405388,831,1277
3929407612,3886158471,1648772558,1648772772,214,1051
3058837915,3279454391,1645718583,1645719583,1000,503
3766914780,3654344198,1662423632,1662423674,42,721
3573158941,3655135775,1660140872,1660141508,636,517
3486442976,3213397142,1662969092,1662969773,681,1221
3492909923,3618095446,1649697573,1649698369,796,206
3595726436,3729914869,1648117941,1648118477,536,711
3415584739,3612642563,1664816563,1664816628,65,1264
3794103075,3512100935,1652471161,1652472030,869,799
3411347712,3320435078,1643900500,1643900953,453,882
3342820244,3284958290,1661979297,1661979550,253,1281
3419465829,3284630826,1647954001,1647954315,314,1570
3045587450,3108500091,1658661070,1658661631,561,121
3034216304,3249261763,1654807566,1654807626,60,1891
3579921083,3825930964,1669311272,1669312146,874,1147
3065810858,3047126246,1658160492,1658160842,350,1027
3776148003,3396149289,1643254232,1643254362,130,1372
3050271924,3487972666,1648676053,1648676952,899,2122
3733821292,3996978717,1659919575,1659919741,166,1623
3132611388,3314901091,1644029649,1644030203,554,283
3553146922,3617746688,1666211095,1666211103,8,1038
3099934862,3436578278,1660950637,1660950786,149,2089
3118807144,3351277781,1653636507,1653637266,759,433
3102776006,3031649001,1643769239,1643769979,740,416
3883286458,3854737938,1653118634,1653118959,325,288
3803606691,3910979746,1665964776,1665965313,537,51
3894175918,3106276005,1660907562,1660907723,161,669
3613021322,3689464410,1641377407,1641377907,500,1349
3041385548,3617958907,1660885318,1660885693,375,2174
3213169891,3991686619,1645850831,1645851287,456,796
3729389785,3377847710,1669300875,1669301383,508,2465
3398865388,3499481975,1650406473,1650406913,440,1153
3828833040,3949771162,1645050131,1645051045,914,532
3644951156,3335462055,1665931928,1665932460,532,401
3327681313,3667718430,1646955121,1646955990,869,398
3505600550,3448726123,1668887841,1668888251,410,399
3277550058,3956058747,1663955042,1663955568,526,73
3710943716,3039544352,1650009502,1650010233,731,1094
3880052402,3137324029,1650145852,1650146239,387,671
3108500091,3811930283,1653291259,1653291906,647,654
3093716530,3931230284,1646283387,1646283895,508,674
3876377964,3533898881,1643006461,1643006633,172,823
3414700083,3948260526,1661866176,1661866747,571,759
3482891017,3498441448,1662060532,1662060967,435,1240
3279454391,3977539783,1650028988,1650029105,117,1113
3898391169,3243873593,1658761354,1658762314,960,297
3915315003,3625179175,1669240221,1669240950,729,1073
3937729247,3428299424,1662423687,1662424440,753,1716
3613018005,3143226144,1650367497,1650367952,455,1897
3347896915,3969728585,1655600142,1655600929,787,1077
3451285207,3733240502,1654263719,1654264532,813,229
3445422843,3003005378,1657917813,1657917949,136,159
3498707377,3195138141,1645967168,1645967230,62,663
3725117905,3049913617,1645658277,1645659151,874,2346
3012892515,3308435698,1661131879,1661132140,261,1014
3761147252,3144405714,1664443425,1664443618,193,658
3062844769,3994927164,1650409954,1650409963,9,337
3656000543,3551344746,1655365566,1655366468,902,610
3894801934,3019773309,1663571039,1663571936,897,2272
3757693725,3268570857,1654948525,1654949281,756,1568
3223917351,3730106432,1653846855,1653847693,838,2444
3425002636,3413984037,1656679423,1656680347,924,1811
3733190374,3508311968,1660366246,1660366556,310,1225
3472983363,3465064732,1646608055,1646608125,70,1597
3846628868,3558539337,1649027444,1649027923,479,2485
3555571916,3761269014,1651645760,1651646539,779,1774
3887564578,3767409219,1642104668,1642105187,519,2375
3091108616,3845886572,1651085448,1651085608,160,1461
3077346044,3180973124,1648792253,1648793195,942,1625
3625772064,3503394389,1647225181,1647225576,395,1173
3733484132,3020526331,1658546560,1658546828,268,1149
3959086145,3112070783,1654438380,1654439071,691,2013
3479322514,3034255613,1661215601,1661216382,781,696
3148259657,3084060274,1654610854,1654611428,574,797
3260783577,3364390232,1656072247,1656072525,278,1480
3864930473,3098955230,1658536781,1658537536,755,635
3769269484,3814641263,1646815823,1646815891,68,1759
3723944830,3492749874,1658717852,1658718449,597,1484
3516410980,3128613298,1657438379,1657438459,80,2359
3296956444,3210422873,1643627215,1643628065,850,1468
3488813245,3315854812,1655505630,1655506296,666,1070
3573158941,3956194935,1657836255,1657837145,890,1150
3775103844,3250926786,1655713755,1655713829,74,1016
3844560489,3166492454,1658460622,1658461375,753,1292
3491022991,3398876044,1647640575,1647640986,411,1223
3738359725,3464653044,1645002369,1645002988,619,645
3058750967,3996469603,1650228170,1650228695,525,1112
3653780780,3229321048,1663556959,1663557372,413,694
3468654589,3587727278,1660009858,1660010614,756,2361
3922675517,3816026938,1648854154,1648854558,404,1719
3647539125,3409962434,1652351090,1652351189,99,2023
3533403208,3178640485,1651040180,1651040344,164,1271
3014462663,3686207600,1668538055,1668538895,840,1760
3289402711,3661037098,1661454688,1661455288,600,1879
3862890852,3835049098,1655400153,1655401118,965,1782
3647938021,3645073300,1653286012,1653286048,36,2391
3649724545,3366609475,1659253525,1659253848,323,2047
3075465136,3166284447,1655202176,1655203013,837,2051
3129170273,3368571252,1650901461,1650901964,503,1295
3174705393,3251744109,1642494605,1642494616,11,1947
3356302136,3994007098,1651424144,1651424946,802,489
3971934050,3029403229,1649867879,1649868226,347,1326
3673810421,3633382140,1663332763,1663333653,890,1015
3170537714,3744759130,1665771130,1665771797,667,45
3052438592,3246028948,1657199224,1657200071,847,732
3037786726,3582544512,1641574918,1641575559,641,1998
3739406554,3278612503,1641152084,1641152761,677,311
3058789362,3760972512,1658829544,1658829626,82,2180
3035287101,3937628057,1649148265,1649148913,648,27
3494179125,3059022884,1654037054,1654037196,142,934
3552457707,3092003105,1653294009,1653294738,729,1343
3852506516,3012032774,1646190071,1646190650,579,456
3457998128,3298635617,1664167881,1664168178,297,2220
3865422787,3299472791,1649392542,1649392724,182,904
3124562368,3446812207,1661829307,1661829566,259,860
3713455058,3863448086,1655154002,1655154733,731,1802
3066990756,3276617814,1648306447,1648307091,644,2262
3104303534,3149560686,1662390645,1662390799,154,2049
3475612329,3249627758,1663752813,1663753267,454,1341
3037301537,3799117805,1668131088,1668131918,830,406
3097031283,3262864867,1652800010,1652800106,96,1414
3048405710,3653577731,1648665751,1648666199,448,1140
3958507300,3175505409,1660531474,1660531561,87,1363
3204346356,3042702763,1653283169,1653283223,54,2162
3397987502,3598841094,1647356486,1647357314,828,169
3568141696,3512720372,1665676193,1665676814,621,516
3148549210,3439799907,1669736352,1669736702,350,1575
3254952204,3540799427,1642431852,1642432743,891,2456
3660548799,3348234563,1666125934,1666126331,397,1748
3335976452,3855165548,1665242814,1665243744,930,1610
3603702697,3502050886,1645678623,1645679586,963,2147
3153040217,3679522128,1655069430,1655070035,605,1868
3046351455,3207210781,1657124715,1657125695,980,1907
3287171733,3254030842,1652669838,1652670300,462,1637
3921877328,3105931624,1651099998,1651100955,957,1951
3044450059,3244398882,1660649291,1660650010,719,569
3255978821,3824168840,1645125219,1645125324,105,1645
3624139591,3142765587,1656497804,1656498169,365,809
3060728062,3365939940,1654333411,1654333652,241,361
3105815944,3202881162,1656800619,1656801131,512,812
3264401846,3103215750,1653919306,1653919748,442,1893
3243086924,3923137418,1641201385,1641201476,91,1773
3719965258,3184404815,1646938660,1646939081,421,2120
3811472324,3440324329,1651734644,1651734706,62,1213
3164462099,3605699054,1661113229,1661114068,839,493
3704980935,3358241145,1643650656,1643651365,709,2413
3734779425,3745712275,1652884872,1652884893,21,159
3396524452,3976757440,1661000664,1661000980,316,2433
3463135439,3037741311,1654800542,1654800947,405,1380
3527201198,3764492400,1664024429,1664025213,784,2380
3512575951,3979203926,1644753929,1644754530,601,1248
3100113266,3567328601,1645821526,1645821589,63,656
3050800748,3474081200,1656486069,1656486173,104,1443
3872928406,3414901923,1643244557,1643245385,828,2
3636960130,3012917381,1641161763,1641161791,28,323
3054659800,3622656083,1655924633,1655924648,15,517
3389926670,3316287541,1647460527,1647461030,503,40
3745419810,3135556195,1656624358,1656624561,203,1133
3241392393,3023140319,1667292470,1667292715,245,1628
3011466658,3288309878,1653798153,1653798679,526,112
3029263333,3859379131,1660662000,1660662524,524,196
3163986082,3285381118,1642815944,1642816447,503,841
3820466728,3875892624,1647954113,1647955041,928,1540
3951751770,3046085814,1657356059,1657356362,303,1374
3322801895,3097031283,1666104925,1666105918,993,1515
3170158934,3176818286,1663990876,1663991756,880,1
3024268753,3556647439,1660231531,1660231699,168,1725
3042046828,3412955545,1665936924,1665937110,186,1824
3370834194,3129792187,1661052096,1661052721,625,931
3206248943,3663474230,1656412084,1656412979,895,2384
3117749198,3414852594,1657197868,1657198027,159,620
3149896107,3636237325,1659385442,1659385534,92,1991
3782266785,3123166182,1646060643,1646061252,609,2121
3154158203,3137803904,1663875299,1663875751,452,1565
3183515887,3258417294,1664859094,1664859600,506,2255
3673761066,3641729236,1649852243,1649852736,493,2276
3081396297,3701668957,1641733825,1641734751,926,1279
3104210284,3004160380,1643624124,1643624482,358,1073
3466459383,3872691076,1655166818,1655167685,867,798
3021126829,3487475790,1654368516,1654369374,858,1876
3852810875,3760930897,1652270830,1652271773,943,2382
3191398794,3564026629,1653502349,1653502993,644,1253
3266751679,3464754983,1662803362,1662804108,746,736
3290860752,3084138267,1665955712,1665955833,121,1017
3047713943,3564839908,1662311907,1662312201,294,1368
3490381305,3347776562,1656412579,1656412828,249,2018
3899585675,3215088423,1660473153,1660473602,449,301
3009801123,3013681789,1650613479,1650613989,510,600
3708922840,3081396297,1653600651,1653601625,974,817
3661507330,3278566573,1663647353,1663647530,177,1369
3271876104,3728498046,1642175692,1642175938,246,2005
3667528236,3279370751,1653212590,1653213436,846,1823
3883812439,3138539283,1667480090,1667480356,266,2003
3278104266,3098083694,1655553720,1655554510,790,1228
3714065380,3728240849,1665791731,1665792343,612,1638
3414901923,3103497887,1662960033,1662960322,289,1078
3258050916,3934890046,1668317385,1668318308,923,1772
3414834461,3675359399,1647646815,1647647218,403,1765
3898188404,3780885377,1651249965,1651250767,802,1370
3188126815,3935383578,1661247138,1661247835,697,183
3395316132,3995365519,1641609695,1641610573,878,1084
3990520153,3739406554,1663110441,1663110584,143,2464
3729340640,3175676853,1654874431,1654874832,401,2353
3230836206,3082828436,1664979550,1664980511,961,1359
3339480960,3541200701,1658164923,1658164955,32,14
3265324040,3128009914,1642925956,1642926753,797,904
3766196716,3402349073,1657311086,1657311704,618,971
3617128437,3751975877,1641877202,1641877822,620,2246
3885084129,3882315040,1662895541,1662896272,731,164
3344177563,3363944559,1657952950,1657953759,809,1178
3893227652,3169394495,1660733826,1660734121,295,1268
3936468941,3763188005,1667164431,1667164716,285,810
3097609387,3802790977,1667234637,1667235274,637,2158
3289332257,3039893721,1662729675,1662730525,850,1743
3632101943,3374007172,1668677689,1668677699,10,1557
3371745136,3356154602,1652041897,1652041963,66,996
3162524259,3318735194,1665138884,1665139457,573,465
3400121766,3495919793,1644819980,1644820307,327,1294
3271039091,3377826578,1666216029,1666216836,807,233
3929407612,3327795374,1662202418,1662202824,406,893
3333776110,3885194706,1657808109,1657808939,830,951
3876696308,3401463703,1669202927,1669203174,247,50
3165700370,3938097708,1644774835,1644775285,450,2030
3592519306,3394695318,1648932130,1648932135,5,892
3782673553,3527164294,1649282045,1649282469,424,1520
3007308564,3813318946,1642395343,1642396254,911,529
3345875910,3522549719,1652179669,1652180285,616,1265
3483666747,3742275397,1641376055,1641376118,63,147
3573975424,3220577762,1653715897,1653716242,345,1201
3199411589,3298676228,1648887341,1648887786,445,341
3967727550,3207258694,1646956289,1646957127,838,1258
3953224601,3323809275,1668823617,1668824424,807,2131
3019302226,3953483372,1669060914,1669061181,267,2457
3486802233,3791894034,1654772740,1654773036,296,1583
3443190053,3870877628,1650594730,1650595700,970,1844
3911364139,3311860866,1644508380,1644509115,735,903
3891477592,3622656083,1647846814,1647847566,752,1391
3931679805,3646908383,1658186822,1658187723,901,2088
3339459948,3874569616,1663647620,1663648054,434,191
3619175296,3604694727,1645207049,1645207348,299,2366
3219656369,3156928973,1664293212,1664293791,579,2326
3079530021,3246759301,1667489113,1667489239,126,705
3941783209,3983727854,1644271521,1644272268,747,2216
3449993526,3655250241,1668286430,1668286894,464,523
3097395182,3757020498,1667602189,1667602320,131,697
3421671936,3490942401,1651835054,1651836043,989,2231
3490415118,3815102601,1656752991,1656753000,9,1496
3835842311,3744734019,1651413500,1651414143,643,104
3760535935,3309305862,1662639826,1662640142,316,1586
3907764491,3775753518,1644754907,1644755597,690,1929
3863427189,3622656083,1659037988,1659038089,101,557
3029500930,3227462918,1667698767,1667698783,16,1444
3897421758,3706178319,1648929603,1648930272,669,256
3752347758,3272250396,1649996762,1649996766,4,2182
3700968228,3995850572,1655404241,1655404626,385,71
3017005264,3774722709,1650817477,1650817650,173,49
3720934127,3522861132,1654358578,1654359153,575,2459
3462744716,3753998489,1642638591,1642639127,536,281
3437665905,3311252249,1659288436,1659289024,588,244
3687243333,3423306122,1657435124,1657435939,815,1887
3515044837,3886917024,1659755814,1659756671,857,1310
3693453006,3794103075,1655169186,1655170014,828,827
3620395885,3213169891,1649881337,1649881743,406,2100
3582544512,3946068928,1650824035,1650824244,209,634
3269763687,3220424979,1660533956,1660534681,725,51
3294635633,3520341683,1643486509,1643486660,151,542
3829201459,3864133914,1662356576,1662356880,304,1523
3607717009,3230836206,1648804922,1648805240,318,1110
3186207758,3149534519,1662670186,1662670748,562,1726
3265895976,3453227348,1643878987,1643879213,226,1442
3012822525,3429004715,1642158893,1642159670,777,736
3820254686,3255978821,1644738533,1644738660,127,176
3730845439,3741983763,1658303755,1658304238,483,1111
3739613077,3977860015,1653680164,1653680856,692,870
3161999632,3199322269,1663976132,1663976375,243,1818
3733649713,3393458100,1666999580,1667000412,832,809
3080195715,3607385542,1654549903,1654550730,827,1809
3759415017,3247959785,1658575637,1658576278,641,2059
3235672444,3802614854,1657264552,1657264622,70,2299
3450893865,3841174974,1658928892,1658929091,199,2119
3574486853,3259260257,1659383333,1659383349,16,82
3565052722,3619529955,1653339656,1653339902,246,1158
3009635817,3879605776,1660866409,1660866906,497,2317
3004870031,3234559565,1652788152,1652788947,795,2055
3530162623,3711442352,1644950748,1644951554,806,53
3086530794,3604759141,1645143114,1645144106,992,480
3541157955,3932002704,1643139277,1643140200,923,2223
3907213401,3258057377,1662674887,1662675772,885,1612
3339649448,3286696325,1655607331,1655608262,931,1489
3660129917,3454448670,1641341949,1641342817,868,967
3985159412,3534201448,1647361290,1647361604,314,2025
3695419353,3743886187,1647444766,1647445575,809,1323
3062844769,3476820014,1641530199,1641530470,271,503
3113214024,3199635800,1656160464,1656160578,114,471
3725283025,3650172161,1668150899,1668151342,443,2360
3564883937,3595612540,1656301430,1656302279,849,306
3144068102,3364409507,1662635946,1662636462,516,752
3534201448,3796754155,1652967053,1652967853,800,890
3272912522,3325565610,1647878295,1647878920,625,168
3025133604,3434324683,1645136123,1645137066,943,550
3703534908,3755243698,1669431880,1669432632,752,1278
3188588023,3447926518,1669161195,1669162069,874,2105
3992345499,3334298803,1656602978,1656603124,146,1402
3410737355,3924583665,1657536852,1657537222,370,1309
3509864353,3331604266,1663699236,1663699641,405,1110
3986081370,3073762858,1660094620,1660095240,620,2113
3960204629,3181236848,1661256469,1661257291,822,2385
3606749014,3278886018,1645284867,1645285831,964,2165
3282449988,3201630796,1652538977,1652539633,656,1185
3153902371,3979899306,1647764545,1647765164,619,2255
3440969146,3855013110,1651572839,1651573324,485,985
3248892530,3884798812,1658857208,1658857382,174,916
3022767670,3112622637,1661182364,1661183181,817,1318
3603092087,3112298724,1643482191,1643482653,462,257
3673761066,3754795349,1667615365,1667615577,212,1363
3924466889,3646536668,1668183546,1668184267,721,163
3699263886,3300662625,1669468788,1669468863,75,930
3692512390,3298748343,1651784404,1651784973,569,2476
3806664868,3182135067,1668633154,1668633337,183,1263
3194142427,3309158757,1666837902,1666838806,904,1632
3284840023,3487740667,1667593054,1667593598,544,1716
3686424169,3649774117,1657695854,1657696454,600,2329
3320381981,3817073865,1654200999,1654201982,983,1978
3486096604,3695411154,1646668987,1646669277,290,1338
3047922240,3066956305,1667744764,1667745214,450,1177
3026769225,3079137127,1653373048,1653373448,400,1249
3030074344,3401463703,1662128219,1662129013,794,466
3190417421,3018325807,1641888317,1641888859,542,76
3089613411,3706797905,1648181938,1648182285,347,2498
3973666003,3113760926,1653199025,1653200006,981,1335
3622259711,3175706913,1666314597,1666315296,699,2213
3680139573,3403933668,1662633359,1662633397,38,622
3030630339,3275298041,1649991667,1649991844,177,501
3905999483,3762690279,1654944247,1654944764,517,1755
3790635482,3278854404,1644944388,1644944767,379,339
3454297726,3948180125,1643373312,1643373356,44,294
3271318708,3515170949,1655207190,1655207571,381,1770
3529576659,3469648387,1658103957,1658104402,445,9
3993917332,3315321131,1664759359,1664759620,261,665
3908443461,3177762456,1647006463,1647007284,821,2364
3565278029,3821979869,1654987052,1654988010,958,758
3162947685,3733143454,1644089864,1644090816,952,514
3105946115,3922066704,1645022206,1645022967,761,65
3146529279,3285030317,1647862825,1647863669,844,1211
3057028614,3620395885,1659160085,1659160553,468,1562
3254473094,3476971345,1659193063,1659193413,350,799
3934383056,3176252124,1660616905,1660617044,139,2062
3093523046,3103943430,1646473705,1646474096,391,43
3583864167,3965563922,1642727511,1642728461,950,292
3304087986,3556848299,1663054255,1663054846,591,1134
3492638245,3450023391,1660573659,1660574348,689,1189
3377901268,3765962960,1664088220,1664088440,220,1640
3834166808,3774806676,1660190724,1660190946,222,47
3725989619,3066645531,1668582799,1668583398,599,1242
3860268588,3772853715,1652758808,1652759535,727,2322
3154009016,3787880772,1651065272,1651065781,509,649
3066053770,3249916829,1648575326,1648575722,396,1759
3947788644,3106490071,1668795613,1668795729,116,935
3729340640,3679578513,1660248392,1660248989,597,2
3577216621,3276763839,1659645382,1659645750,368,141
3562105236,3242897765,1650414144,1650414443,299,1557
3386628594,3165492854,1660190797,1660191048,251,2325
3585982995,3949841652,1658762168,1658762807,639,303
3162405135,3590621650,1662123553,1662123593,40,752
3272428764,3142848483,1648985594,1648985612,18,1856
3881000980,3622933919,1664809247,1664810098,851,397
3100113266,3737772457,1651067577,1651068227,650,2003
3435292986,3095743155,1667157207,1667157985,778,1256
3354479032,3955219063,1660595815,1660595903,88,71
3737603669,3749756110,1661438025,1661438063,38,2114
3692772256,3894149054,1662044739,1662044945,206,1666
3376287193,3967372197,1660923011,1660923186,175,298
3309286736,3954490536,1659897761,1659897856,95,1227
3301620813,3577216621,1651722775,1651723114,339,599
3546034581,3450502369,1647364679,1647365400,721,488
3339459948,3112419355,1666210141,1666210679,538,907
3553725082,3581207584,1646684115,1646684885,770,446
3641185549,3332206707,1663032241,1663033086,845,1872
3284284605,3181074947,1662728552,1662729297,745,1411
3862468039,3791547480,1643452836,1643453776,940,1942
3393501277,3568404894,1649464755,1649465112,357,1610
3759608318,3685233592,1663949287,1663949781,494,536
3110753111,3003861546,1657483087,1657483499,412,2334
3437122732,3424431005,1652585069,1652586006,937,843
3304958701,3179180919,1644110660,1644111320,660,2381
3289684726,3347942747,1651109672,1651110575,903,709
3395457102,3505600550,1660165122,1660165825,703,1246
3782266220,3109284478,1641598562,1641599444,882,2287
3141198072,3203128336,1664934286,1664934719,433,1153
3663985085,3800239896,1668476966,1668477176,210,1999
3306290309,3316496524,1653829064,1653829132,68,2436
3882412784,3331866261,1664055166,1664055998,832,1748
3995868243,3391206046,1662375628,1662376032,404,31
3390329949,3980050310,1657285491,1657285516,25,1578
3642339062,3601604629,1668067836,1668068420,584,947
3094361527,3110691442,1645449510,1645450357,847,2476
3347434027,3558912751,1649970105,1649970249,144,2202
3413948595,3662788693,1663317262,1663317715,453,2255
3150503842,3478362234,1641716141,1641716712,571,895
3544353013,3961601633,1667180597,1667181275,678,251
3553712893,3401677898,1654851070,1654851199,129,432
3986081370,3953655387,1643778055,1643778560,505,1550
3592026567,3091108616,1668364668,1668364883,215,2343
3280558341,3216439052,1649805829,1649806533,704,945
3272663489,3600573063,1664516403,1664517172,769,595
3008609242,3248167631,1643209306,1643210056,750,901
3341897848,3277926691,1644585168,1644585604,436,1833
3557791528,3322663101,1647577471,1647577572,101,2243
3640010781,3492749874,1658371292,1658371548,256,1278
3963995256,3168818004,1658415486,1658415728,242,2186
3987606604,3628583147,1655061675,1655061842,167,2012
3010649870,3814899146,1643699882,1643700180,298,1513
3510761729,3645341350,1642616112,1642616279,167,1036
3220405755,3473399101,1644074574,1644074893,319,579
3065530519,3894413849,1650146362,1650147194,832,1243
3853178623,3194259307,1669021592,1669022275,683,672
3896777982,3572276937,1659447174,1659447947,773,2441
3643412582,3162844882,1655462901,1655463394,493,1220
3932613929,3017559077,1646191419,1646192298,879,1957
3926699428,3772788087,1663119990,1663120698,708,913
3155835978,3924167113,1665993908,1665994207,299,409
3400233871,3592471391,1655801673,1655802254,581,2043
3157600969,3942852295,1662631224,1662631976,752,1081
3479322514,3693102953,1666786555,1666786989,434,1605
3430090428,3195451932,1646559888,1646560383,495,919
3960494982,3242897765,1650627445,1650627465,20,73
3108998670,3816533759,1659927649,1659928502,853,1948
3113207421,3710708040,1648291704,1648292124,420,2113
3066426534,3594682644,1666923311,1666924164,853,705
3748478851,3985243519,1647202299,1647203171,872,2098
3787920743,3240340462,1646551181,1646551935,754,2087
3970444667,3476312823,1659353643,1659354382,739,83
3811235183,3677965553,1658222702,1658222876,174,322
3323698166,3796065026,1650661359,1650661771,412,2079
3540029077,3746351822,1656048153,1656048775,622,2126
3995428703,3437705581,1647126524,1647127271,747,797
3041001828,3874569616,1663310791,1663311544,753,614
3316031407,3772178120,1660020468,1660021040,572,166
3385603289,3968000691,1649487716,1649487875,159,1824
3280630861,3929988329,1660227594,1660227665,71,1065
3038424212,3474242977,1665044521,1665045291,770,2170
3362173874,3205162065,1668854719,1668855456,737,1500
3862939959,3537787770,1660979514,1660980293,779,2264
3149313426,3924990392,1661564443,1661565423,980,997
3908848133,3189038779,1663450682,1663451167,485,1675
3243018622,3542688397,1646602704,1646603225,521,84
3851327758,3100239217,1651290101,1651291048,947,1811
3208346862,3882559155,1655784038,1655784165,127,2265
3643382802,3033692011,1650883950,1650884341,391,163
3913071406,3433835303,1643354654,1643355559,905,2313
3252070101,3240347468,1662091528,1662091826,298,2499
3821979869,3045070182,1657205809,1657206730,921,1097
3278297907,3544133682,1644147306,1644147587,281,1367
3765472006,3548132533,1669722564,1669722833,269,262
3050867171,3657464089,1647262162,1647262478,316,378
3431117217,3151697582,1647688155,1647688642,487,574
3890194122,3112070783,1657283853,1657284242,389,1093
3510318605,3191398794,1658687663,1658688401,738,189
3182752768,3459188746,1655313059,1655313486,427,659
3941903445,3247551122,1665929209,1665929479,270,1849
3008417861,3759909818,1656983454,1656984373,919,233
3083235668,3067930449,1658036939,1658037233,294,680
3179405209,3779331078,1664333546,1664334190,644,2403
3744196402,3814045699,1647522367,1647522465,98,1301
3834573240,3354330082,1649044964,1649045896,932,1341
3522963106,3199411589,1666832527,1666833465,938,1081
3948515015,3733190374,1652610051,1652610333,282,495
3718684083,3431082237,1642811706,1642812180,474,1646
3366896849,3377781677,1654963619,1654964443,824,1677
3419809319,3458478056,1661713490,1661714061,571,1317
3790648941,3472052544,1658940866,1658941726,860,2081
3707778731,3149313426,1649968006,1649968098,92,506
3281803406,3371767777,1666917449,1666918410,961,2443
3863697907,3571428723,1659475460,1659475686,226,1863
3354330082,3046991819,1650646166,1650646393,227,2427
3055169776,3948769271,1660362887,1660363621,734,2304
3340331761,3272563093,1645059231,1645059394,163,209
3027064938,3476060971,1659286722,1659287343,621,384
3418364050,3612269633,1643906663,1643906995,332,1640
3016995357,3032834107,1653178257,1653178773,516,616
3745419810,3523305140,1653198719,1653199613,894,513
3683793217,3802592493,1651027018,1651027496,478,986
3521217476,3640571571,1657157969,1657158478,509,2332
3235086334,3704498751,1660310705,1660311408,703,848
3952552328,3457284809,1667320272,1667321000,728,659
3482509515,3459090367,1658521942,1658522504,562,802
3421730413,3898391169,1644955736,1644956362,626,858
3956191936,3133655192,1665084771,1665085398,627,907
3890159677,3438756008,1649397516,1649398225,709,488
3741494242,3565392717,1644727654,1644728205,551,1713
3657464089,3439325479,1650249207,1650249913,706,418
3690586350,3712727713,1650634077,1650634174,97,678
3800312034,3821864560,1657173879,1657174298,419,1891
3995850572,3812481438,1656648609,1656649073,464,304
3850392190,3334792271,1656816210,1656817127,917,1067
3520699413,3990312725,1647188143,1647188533,390,2487
3517992014,3026701207,1648430340,1648430441,101,1783
3427937915,3603853942,1644333174,1644334065,891,1840
3970049421,3481584783,1641728467,1641728696,229,818
3133153956,3123999917,1653384947,1653385141,194,1706
3736911154,3537294800,1664390360,1664390814,454,1661
3951354982,3043656500,1666854336,1666854394,58,1460
3142160799,3283155844,1650752882,1650753492,610,1689
3605412707,3046080865,1669007704,1669008184,480,68
3855563284,3726117061,1641454229,1641454898,669,1094
3574985668,3604236901,1651134804,1651135694,890,2074
3868630067,3105733809,1645689477,1645690472,995,640
3715231431,3984818292,1653358913,1653359444,531,724
3694206371,3831660488,1651983114,1651983515,401,1283
3710782213,3492376573,1659983618,1659984081,463,1170
3988957478,3751022139,1649451364,1649452208,844,2490
3185985712,3166343569,1663887448,1663887779,331,749
3673735088,3458252541,1651345821,1651346326,505,1358
3777609973,3482763584,1659325794,1659326223,429,879
3876427301,3776429592,1659824596,1659825354,758,1613
3776128581,3274507247,1664972236,1664972270,34,1196
3049424358,3673597203,1654242431,1654243325,894,1731
3194871172,3413984037,1654144047,1654144743,696,1196
3537443088,3559267449,1662267259,1662267421,162,1418
3028063669,3646286885,1654110343,1654110421,78,1105
3874626130,3376180688,1667078864,1667079042,178,1976
3834011879,3402259490,1655777535,1655778470,935,2075
3951751770,3003087336,1662553655,1662553763,108,2197
3450503481,3114036217,1658811665,1658812015,350,729
3398278082,3583859826,1657441930,1657442680,750,2199
3796198742,3290176410,1649578907,1649579881,974,217
3345458354,3952316985,1644938779,1644939098,319,1899
3802890793,3003422357,1658028337,1658028691,354,860
3487406679,3424897066,1646327934,1646327965,31,2133
3206061644,3069989068,1666374404,1666374525,121,2092
3501308694,3488757134,1641684005,1641684827,822,263
3507952797,3214969929,1653635937,1653636719,782,1674
3457451540,3875343154,1666019552,1666019965,413,1091
3669880471,3481922555,1648502647,1648503562,915,587
3202783831,3920437320,1651718859,1651719710,851,2397
3762533949,3198520645,1668896974,1668897098,124,957
3554977739,3070640991,1644015417,1644016324,907,626
3408903285,3172293659,1658387371,1658388031,660,1361
3222446672,3698025795,1643409413,1643410033,620,1387
3273348089,3692512390,1657738113,1657738961,848,1371
3460842972,3889498156,1657283169,1657283231,62,996
3197201691,3233823273,1650752658,1650752868,210,1981
3973713516,3417798594,1641514245,1641514859,614,1738
3088604045,3028705386,1666610449,1666610540,91,2378
3667528236,3463121212,1657036262,1657036699,437,525
3388328160,3319128889,1662625930,1662626800,870,258
3480984393,3859976372,1663831134,1663831826,692,1997
3149336644,3314932010,1668063112,1668063461,349,2305
3538823780,3229871774,1660651810,1660651843,33,1762
3561572123,3243534925,1642047018,1642047589,571,2354
3147210428,3992345499,1654914068,1654914974,906,404
3603594711,3106705860,1667251514,1667251952,438,2194
3992345499,3844416504,1658703388,1658704074,686,1751
3366321387,3617324068,1648125708,1648126053,345,1975
3258057377,3656002043,1641093169,1641093600,431,2082
3425006843,3457451540,1665068426,1665069390,964,874
3245773600,3728160519,1662901453,1662902037,584,414
3774725066,3516107650,1653305763,1653306293,530,1786
3228073924,3331336589,1652151352,1652152227,875,151
3660754603,3065298582,1654914229,1654914382,153,812
3868827867,3924879744,1669198869,1669199281,412,2214
3743687544,3147245859,1654012589,1654012760,171,1725
3244763805,3047629830,1659763997,1659764494,497,764
3107366519,3062261092,1646667669,1646667683,14,880
3811930283,3580953063,1641066640,1641067570,930,2265
3826827617,3451167153,1658522629,1658523624,995,531
3687919265,3487030175,1665783827,1665784017,190,1328
3298521381,3733975709,1643937177,1643938118,941,1194
3004890840,3789279639,1666633431,1666634164,733,2200
3241033604,3871509767,1664537228,1664537717,489,1443
3198654347,3657391976,1659281239,1659281247,8,1517
3997810649,3700109325,1645215617,1645216060,443,296
3131331478,3960816300,1659706719,1659707140,421,956
3594853846,3312344118,1641607428,1641607491,63,388
3277284318,3264460374,1663964672,1663964800,128,2034
3870778205,3791510494,1662826359,1662827176,817,2132
3356689959,3882748527,1662198019,1662198222,203,1551
3234620335,3822307865,1643975657,1643975702,45,768
3227584428,3248724095,1641866416,1641867391,975,855
3606954305,3681399132,1649686779,1649686832,53,236
3911185524,3463734539,1652412590,1652413049,459,2486
3622984488,3554977739,1654214008,1654214045,37,2447
3269653223,3395479272,1667159074,1667159216,142,1330
3645666563,3309286736,1658449402,1658449604,202,1163
3448734872,3684926586,1647874702,1647875506,804,1396
3604514331,3971180079,1668367534,1668367609,75,1101
3057574793,3835069955,1641268787,1641269689,902,610
3216912897,3173642675,1661594822,1661595192,370,1390
3955064333,3735081666,1668553235,1668553561,326,2005
3965863452,3813287023,1669575690,1669576332,642,836
3126417218,3947879014,1646812646,1646813073,427,988
3661037098,3901468403,1659857434,1659857683,249,232
3198999623,3795508879,1654278672,1654278908,236,912
3816170686,3280818938,1664600106,1664600249,143,854
3473399101,3065216937,1665728298,1665728694,396,2060
3159638305,3774958505,1645255105,1645255736,631,2445
3749266673,3453552267,1666256755,1666256762,7,1384
3343162937,3223094463,1656732306,1656732843,537,1418
3183672525,3364842162,1657755181,1657756111,930,211
3105259495,3166521010,1665452407,1665453359,952,200
3210078490,3442209140,1647281469,1647281683,214,1872
3589571844,3556061704,1652396816,1652396823,7,1305
3854357910,3397910828,1658618398,1658618956,558,329
3598576303,3959261742,1662968741,1662968962,221,1302
3057721767,3620236387,1665213930,1665214512,582,2013
3469648387,3845511281,1668322077,1668322300,223,722
3394220693,3925690262,1669113667,1669113860,193,1419
3298676228,3665931760,1650635377,1650636236,859,1077
3840906120,3864414449,1650325153,1650325625,472,1188
3424431005,3827461144,1661188938,1661189483,545,1117
3471288672,3825332100,1654385421,1654386334,913,2008
3707584091,3602955685,1658580469,1658581135,666,2420
3978330638,3885583347,1660907194,1660907886,692,1490
3974804920,3197201691,1650990240,1650990378,138,503
3896239645,3544020942,1663304572,1663304727,155,1264
3417328370,3353295219,1647454427,1647455060,633,1444
3297001171,3413810353,1665262496,1665263196,700,674
3938615588,3881519714,1651318744,1651318834,90,1335
3995654203,3283171763,1644894125,1644894488,363,2178
3212707122,3700813458,1659461451,1659462406,955,474
3249759052,3303561746,1663007046,1663007737,691,2288
3224864814,3059176048,1647723376,1647724365,989,940
3208757755,3793298032,1650318737,1650319191,454,1247
3044564753,3233823273,1650591661,1650592270,609,1915
3862528538,3711059561,1655784721,1655784930,209,1433
3567637602,3291512173,1663069613,1663069867,254,374
3135707503,3732585972,1650072418,1650072531,113,970
3068296722,3275649997,1648912437,1648912617,180,487
3740854424,3531820891,1664145404,1664145852,448,803
3927214415,3201446016,1650968347,1650968844,497,874
3364911803,3965960711,1662452486,1662453022,536,2044
3782266220,3850392190,1657964012,1657964097,85,1051
3593244627,3484264209,1648149461,1648149894,433,919
3608200385,3012264999,1655339414,1655340323,909,1560
3302700303,3431411171,1644312438,1644313321,883,739
3867860336,3059491889,1649122732,1649123250,518,586
3388628484,3640949933,1666849011,1666849482,471,1969
3248452729,3253931464,1650063384,1650063615,231,1216
3426017820,3647597870,1645533012,1645533344,332,2068
3792117640,3514152633,1652290406,1652291357,951,1025
3301611102,3638281686,1643817075,1643817842,767,203
3561062307,3963385029,1651544379,1651545378,999,469
3478097925,3241021396,1664171383,1664171676,293,522
3870877628,3885583347,1645040028,1645040103,75,1292
3780117215,3165973608,1662789625,1662790450,825,1622
3096740365,3271689881,1656214306,1656214897,591,138
3711943152,3708654413,1653251068,1653251728,660,427
3046617108,3775501779,1669021718,1669022047,329,1396
3882415224,3259625938,1666576141,1666576673,532,1726
3136396999,3823917098,1650016406,1650016893,487,1594
3545188902,3950763153,1653007791,1653008199,408,2323
3017484255,3939977057,1666489729,1666490171,442,1581
3057922933,3815235622,1650954016,1650954797,781,2147
3367510444,3486810833,1660968672,1660969259,587,2190
3039176873,3752289852,1663503334,1663503887,553,1491
3783325820,3573583612,1661125693,1661126510,817,1023
3810798932,3269865212,1641649270,1641649434,164,1570
3242064640,3997353499,1667568066,1667568846,780,884
3467650879,3798447157,1652728294,1652729247,953,1382
3091008161,3364059276,1664355932,1664356892,960,1444
3870779720,3329135548,1667130428,1667131342,914,1815
3967015655,3844966905,1656748798,1656749517,719,1853
3115367011,3060121211,1668459217,1668459743,526,465
3786194675,3542285714,1647976367,1647976450,83,196
3152795421,3717137928,1662473176,1662473303,127,1354
3716257088,3516488694,1655409772,1655409963,191,1614
3002029298,3066714195,1665437503,1665437824,321,2299
3991963732,3902437090,1653410538,1653411287,749,2469
3421344639,3438084709,1647445700,1647445746,46,89
3027110508,3878180077,1648657664,1648658429,765,442
3560967248,3925364546,1663015748,1663016013,265,629
3744386868,3790996735,1659273286,1659274109,823,2199
3916674515,3083479870,1647248620,1647249153,533,790
3218964640,3689544534,1661333470,1661334446,976,823
3851327758,3531345844,1665545706,1665545853,147,1182
3117816089,3066990756,1643883277,1643883511,234,113
3403471618,3939977057,1648173172,1648173672,500,2195
3509864353,3401463703,1643643725,1643644252,527,2282
3384200089,3079013365,1649054372,1649054758,386,1396
3846323092,3474088124,1663772882,1663773743,861,575
3987813210,3784808734,1648634983,1648635909,926,1032
3190508233,3240324089,1662738371,1662738566,195,2341
3662745240,3579404607,1641906471,1641907349,878,1053
3894175918,3482268698,1644567014,1644567492,478,101
3120505983,3984818292,1660832382,1660832670,288,55
3155871721,3234851871,1650292864,1650293141,277,897
3867026366,3537450451,1649174224,1649174538,314,2104
3809059026,3121391240,1641409620,1641410022,402,1762
3028364856,3261463305,1655260478,1655261212,734,809
3591348696,3880353584,1645995526,1645996226,700,2283
3078791988,3949970421,1648164324,1648164818,494,1168
3188643066,3143318519,1654337759,1654338038,279,596
3656865344,3876927357,1662306745,1662307187,442,842
3722114463,3149046961,1645981274,1645982205,931,225
3248733503,3197352308,1662917110,1662917110,0,2464
3590656592,3529024969,1663585831,1663586696,865,2403
3602340127,3062435759,1663087950,1663088335,385,667
3515044837,3606270024,1662061457,1662062010,553,1335
3156261740,3518607253,1644565475,1644566265,790,632
3415892236,3926200409,1654299529,1654300133,604,2175
3768253081,3228277648,1643442118,1643442538,420,2428
3790180006,3223694966,1668752958,1668753471,513,1399
3095772004,3716246985,1647541868,1647542200,332,1404
3445558523,3315583401,1654604164,1654604207,43,1845
3499272388,3097609387,1655244898,1655245505,607,205
3766160943,3990312725,1662609340,1662609872,532,1102
3466735449,3533740602,1655545690,1655545787,97,997
3730845439,3153902371,1653559871,1653560220,349,1621
3891258957,3587171844,1666568693,1666568928,235,147
3697338181,3719124928,1643110880,1643111141,261,106
3019572992,3708032127,1645327512,1645328247,735,452
3540737045,3061814600,1644948068,1644948717,649,1850
3081725518,3721340009,1641773853,1641774275,422,1714
3446519765,3609664184,1654036490,1654037242,752,458
3804914454,3812385830,1642364092,1642364921,829,1971
3178235505,3847957207,1651053357,1651053821,464,912
3837062335,3445530012,1660615109,1660615113,4,1744
3692861248,3675481622,1657951573,1657952129,556,113
3306188967,3307933176,1658040023,1658040861,838,1886
3790406016,3712443558,1659719284,1659719637,353,1085
3195274844,3050229164,1649827405,1649828357,952,2091
3070795112,3910029798,1653459099,1653460054,955,766
3767983934,3101460702,1662743286,1662744043,757,1894
3097834756,3095559156,1651289826,1651290696,870,558
3010531134,3534192041,1658681782,1658682169,387,2043
3261527870,3166492454,1655619778,1655620156,378,695
3209097023,3532063469,1641486206,1641486559,353,325
3041385548,3482473663,1647074037,1647074713,676,1970
3159950284,3124964775,1667001172,1667001588,416,2306
3904517073,3487387362,1651927950,1651928237,287,1267
3683507812,3916456426,1645262029,1645262525,496,961
3491398730,3890781778,1651756604,1651756923,319,109
3028267408,3182878730,1661190730,1661191688,958,1890
3359895223,3279351366,1669444055,1669444285,230,419
3414370730,3763317740,1650072887,1650073181,294,750
3451106027,3794548376,1647924996,1647925137,141,1357
3742159503,3863080370,1652748879,1652748950,71,1952
3071850041,3344337283,1641304098,1641304323,225,1778
3412675211,3007686100,1668478932,1668479682,750,804
3171906034,3228497776,1648636194,1648637143,949,6
3278827891,3718714231,1660357535,1660358384,849,1506
3143189190,3759909818,1656030872,1656031011,139,174
3387785849,3555105048,1644582683,1644583032,349,105
3982268438,3250023388,1663654488,1663654947,459,682
3321835417,3793117012,1660135081,1660135421,340,1123
3697028552,3988957478,1662019864,1662019871,7,24
3364059276,3749188570,1650657118,1650658013,895,643
3452181736,3442408044,1656324952,1656325417,465,119
3408604990,3389472671,1668433856,1668434172,316,1633
3256317082,3185745995,1662116255,1662116570,315,1862
3955055535,3892848585,1644972681,1644973011,330,392
3527201198,3235086334,1650967971,1650968152,181,2367
3310951639,3259260257,1641648630,1641649608,978,2204
3622596133,3589984222,1650449429,1650450349,920,640
3228277648,3734533600,1660760563,1660761434,871,692
3619045997,3271605522,1642031868,1642032541,673,226
3448866192,3388814364,1651282231,1651282333,102,2280
3920327961,3609562862,1665043268,1665043664,396,808
3505789435,3691032308,1665975652,1665976210,558,1082
3683198772,3795508879,1667325851,1667326085,234,161
3515480973,3568162481,1660197828,1660198560,732,532
3936193189,3027129249,1649710630,1649710694,64,1392
3640010781,3118425000,1646732174,1646732355,181,539
3761775611,3197466224,1646526022,1646526291,269,1797
3931679805,3012032774,1648247214,1648247601,387,50
3324618357,3075088680,1663908381,1663909165,784,1609
3311921613,3442081758,1663603731,1663604457,726,352
3549549632,3069318012,1647198226,1647198959,733,389
3261376049,3682274097,1660796641,1660797629,988,379
3733190374,3883703576,1649489942,1649490703,761,2385
3500595056,3565803867,1665335259,1665335548,289,481
3565052722,3342929537,1652843929,1652844691,762,2484
3276341369,3118425000,1643271539,1643271763,224,1350
3367457506,3740807524,1659224823,1659225681,858,2412
3429887771,3199563620,1664183105,1664183563,458,1615
3048328762,3771528397,1668303377,1668303666,289,1297
3349626057,3341211432,1665800194,1665800212,18,2472
3018946311,3669018473,1658603515,1658603525,10,1172
3129683689,3593603889,1653637371,1653637420,49,1651
3730920499,3287171733,1644324631,1644325095,464,1241
3158338043,3359189419,1668294270,1668294740,470,1658
3996587507,3174499556,1660265832,1660266809,977,958
3751694809,3410719383,1653604474,1653605020,546,10
3721571243,3838851134,1663059466,1663060207,741,154
3914429910,3979352608,1660522020,1660522218,198,2298
3868695814,3271278790,1642531568,1642532359,791,2055
3866260144,3677001111,1657176313,1657176725,412,2102
3014275222,3589366986,1658122804,1658123462,658,18
3223313152,3304596274,1643157384,1643157725,341,1391
3965960711,3153391276,1659444193,1659444510,317,2329
3296957627,3558370114,1663662414,1663663305,891,364
3371745136,3980971387,1663404490,1663404625,135,2495
3903068218,3311382844,1643918524,1643919204,680,1419
3699263886,3980108258,1653765152,1653765888,736,2375
3875243979,3302294195,1657472840,1657473801,961,1052
3553471050,3023772977,1664747488,1664748211,723,2148
3201629659,3447946570,1649643269,1649643851,582,193
3452181736,3596567072,1650311525,1650311818,293,1314
3106465076,3288834634,1644011915,1644012867,952,723
3583029647,3520872962,1661754324,1661754775,451,306
3981932099,3645310975,1649312727,1649313629,902,2406
3201479561,3365094410,1645639621,1645640451,830,52
3867554012,3488878461,1650779539,1650780344,805,1030
3661016961,3311329069,1653234002,1653234410,408,1673
3032498591,3631424312,1652943105,1652943328,223,1957
3307730398,3665086817,1647118794,1647118947,153,1093
3981817077,3042045098,1646426927,1646427008,81,1514
3011459628,3657251975,1647758710,1647758978,268,123
3968297784,3539303536,1665743262,1665743601,339,1338
3435319506,3177628377,1643400246,1643400258,12,2191
3045925838,3896239645,1648232823,1648233389,566,225
3998221237,3713116694,1665484977,1665485606,629,2141
3123522446,3790356065,1658767433,1658767757,324,817
3891579335,3089471552,1656121321,1656121757,436,1650
3896594746,3616218859,1662773722,1662773756,34,882
3090588645,3780368492,1654334668,1654334766,98,2373
3855218155,3101410977,1660714492,1660714849,357,664
3892848585,3901579796,1663262573,1663263065,492,760
3371745136,3494544431,1668529260,1668529529,269,2140
3885893310,3557643641,1668074655,1668075521,866,44
3366558556,3178981589,1641860946,1641861642,696,1473
3239527114,3012822525,1668220316,1668220382,66,546
3840558415,3860430252,1655679072,1655679785,713,2395
3804094924,3097917804,1658484756,1658484990,234,43
3528288695,3679867888,1659017883,1659017977,94,2251
3078500208,3896019652,1644302389,1644303184,795,613
3520341683,3327504995,1645001721,1645002421,700,871
3756806050,3269622220,1643294564,1643294646,82,708
3399479391,3002350398,1647142280,1647142452,172,2361
3460504628,3239020709,1641520830,1641521810,980,1452
3107713394,3888851378,1657515026,1657515132,106,804
3870032753,3881000980,1648863431,1648864241,810,2281
3541579882,3421671936,1657723172,1657723881,709,681
3201068600,3947105207,1669610162,1669610369,207,424
3424211722,3677965553,1666318341,1666318660,319,1301
3566874478,3397970538,1663330986,1663331598,612,63
3278886018,3202063550,1657079768,1657080491,723,93
3608512295,3346604377,1645737326,1645737978,652,973
3100716894,3835202206,1641740331,1641740969,638,2484
3442330693,3003087336,1665078801,1665079672,871,50
3217719618,3437259542,1667390359,1667390378,19,2213
3042461816,3457542537,1660642103,1660642436,333,1295
3686298420,3858876644,1651181857,1651182116,259,433
3932002704,3105815944,1662041628,1662042602,974,1492
3134380066,3857434991,1642740080,1642740603,523,91
3707892765,3701979416,1645664362,1645665136,774,1415
3664112134,3672694122,1643053783,1643054126,343,1735
3557559741,3128318593,1665394994,1665395859,865,2348
3739320901,3139376524,1664986641,1664987480,839,84
3293924278,3897421758,1669260913,1669261523,610,1073
3983711613,3709736172,1641133292,1641134037,745,439
3558733181,3054828202,1646803125,1646803270,145,1839
3224455204,3505100409,1655022535,1655022835,300,183
3828761401,3479580096,1648239186,1648239892,706,793
3472375572,3041290048,1644498567,1644499065,498,2403
3693652924,3804329236,1667440599,1667440631,32,680
3115236500,3421671936,1649294234,1649294543,309,1240
3715200176,3271479070,1658418668,1658419546,878,833
3708032127,3638803969,1657618395,1657618500,105,1827
3130181848,3730920499,1665874951,1665875617,666,487
3150582711,3157155319,1669720019,1669720262,243,1556
3962062858,3616651934,1657324357,1657324358,1,1065
3719455699,3287508774,1665392010,1665392125,115,1770
3442087752,3797930164,1644196845,1644196918,73,1883
3061594029,3264460374,1658782138,1658782571,433,2401
3054160201,3328471090,1656328686,1656329007,321,79
3789727449,3861764050,1647776450,1647776745,295,154
3375782922,3776783076,1643261757,1643262583,826,418
3591101388,3217583205,1657107499,1657108214,715,116
3933892798,3721136961,1660348174,1660348920,746,17
3252753513,3869495480,1657325569,1657326553,984,372
3998209085,3713404433,1646088377,1646089153,776,2252
3671830270,3052063374,1665889732,1665889828,96,320
3896922629,3520872962,1653687957,1653688511,554,348
3516624109,3559301819,1641301953,1641302481,528,889
3489083203,3091108616,1666542678,1666543494,816,1289
3375782922,3786840082,1660097361,1660097588,227,1789
3825645806,3358959910,1662141866,1662142040,174,882
3009177873,3715731774,1650205181,1650205980,799,1436
3355429456,3818353360,1643793591,1643793597,6,1100
3849910709,3040742963,1641520066,1641520492,426,2326
3103627338,3617340911,1642162722,1642162797,75,349
3640915578,3020729502,1666301604,1666302070,466,683
3828516865,3232497890,1653751310,1653752023,713,2080
3671971306,3503510962,1663682370,1663682793,423,1264
3403471618,3275027460,1660206085,1660206555,470,1913
3066757468,3505480563,1642002122,1642002418,296,101
3364600825,3476312823,1646723688,1646724231,543,392
3048361071,3973401658,1647489324,1647490025,701,2353
3929305160,3398242179,1647688533,1647689072,539,1098
3093773162,3095594016,1653061929,1653062317,388,199
3303025505,3680841490,1661136216,1661137182,966,978
3744293001,3896357807,1643200038,1643200541,503,432
3163708045,3064831559,1653380404,1653381033,629,2363
3897293094,3223094732,1664633421,1664634192,771,309
3559615011,3600015858,1648318238,1648318493,255,1653
3577878798,3087326516,1644087878,1644088723,845,2110
3174639274,3520341683,1658978949,1658979695,746,2410
3907299052,3857931113,1647444928,1647444938,10,299
3982929088,3444809495,1654530373,1654530648,275,1812
3824545323,3121651540,1661364531,1661365325,794,328
3952282084,3023140319,1661407711,1661408031,320,2313
3528288695,3870779720,1658623273,1658624119,846,243
3844822083,3489453670,1652508373,1652508497,124,471
3764078507,3342820244,1662417770,1662418214,444,290
3439442608,3267107046,1651411423,1651411852,429,1777
3331604266,3903709933,1641304915,1641305484,569,1908
3771841105,3936943386,1641597535,1641597876,341,2286
3935740815,3574708692,1648680875,1648681256,381,877
3797930164,3512353520,1655620914,1655621206,292,115
3316951862,3601187603,1666493959,1666494079,120,2388
3894115655,3199411589,1646888867,1646889486,619,1334
3139035952,3828516865,1650989929,1650990461,532,262
3056173313,3618397647,1654754527,1654754864,337,2034
3819467184,3965960711,1643544384,1643544605,221,790
3858150562,3408104715,1666802032,1666802706,674,1622
3031292798,3828342380,1656943552,1656943673,121,2252
3823802882,3479401102,1665059660,1665059766,106,765
3739338939,3180798863,1641740351,1641740576,225,1809
3148691436,3863676573,1662161193,1662161718,525,196
3151288415,3617757019,1647704985,1647705497,512,2251
3993623323,3700287335,1663633134,1663633337,203,2486
3566347637,3468682335,1645887568,1645888349,781,378
3007702341,3460669513,1644067964,1644068671,707,1305
3690349378,3613188168,1657885462,1657886309,847,1929
3945607460,3002631535,1646724614,1646724851,237,1758
3393406422,3605316405,1667677582,1667678376,794,574
3365615023,3031299470,1644115435,1644116404,969,1353
3226559906,3102526783,1643449772,1643450759,987,560
3124964775,3828738126,1659347108,1659347415,307,1861
3857211245,3815774397,1653412873,1653413702,829,257
3445666899,3575375841,1651637052,1651637872,820,1713
3098955230,3560756539,1664656693,1664657209,516,1535
3564296836,3450535254,1657434920,1657435830,910,1832
3940735440,3295262122,1651103373,1651103821,448,1649
3586489382,3424476490,1662585418,1662585784,366,263
3667258476,3782741533,1646617594,1646618187,593,606
3894413849,3064461314,1665482642,1665483383,741,343
3739595528,3890875667,1654061925,1654062254,329,2481
3780678233,3398814666,1655657041,1655657640,599,113
3911619189,3862854265,1664191461,1664191874,413,1560
3297684978,3983391279,1644037953,1644038629,676,449
3137803904,3196079047,1666791532,1666791712,180,2108
3735700656,3667718430,1662067815,1662068182,367,1190
3840502377,3594777411,1657850192,1657851031,839,136
3381846064,3877638741,1652660958,1652661465,507,1589
3556577780,3839788123,1653943884,1653944814,930,2311
3595284541,3190972776,1661429979,1661430109,130,1832
3986003303,3540717336,1650962584,1650963526,942,2069
3861496190,3046510463,1653033945,1653034464,519,802
3218746999,3156452001,1662814322,1662815176,854,2196
3365829981,3351490739,1658917423,1658917937,514,1988
3343033950,3141503682,1661790189,1661791056,867,171
3536156667,3680100111,1664130966,1664131385,419,272
3981817077,3613188168,1661463600,1661463724,124,1693
3758622438,3599160097,1646993318,1646993396,78,46
3624911947,3643637605,1653197089,1653197433,344,1651
3070186247,3736871918,1663028843,1663029664,821,1188
3949713678,3802694367,1647690262,1647690818,556,2157
3252790120,3438550737,1651222677,1651223309,632,890
3366321387,3822869749,1666462232,1666462806,574,2064
3366385571,3014363081,1661220799,1661221418,619,477
3749379310,3130594039,1661279071,1661279962,891,263
3278703976,3168919126,1668570479,1668570983,504,1806
3898495918,3901360663,1657373871,1657374632,761,1528
3232737784,3003861871,1645196993,1645197362,369,14
3972424804,3134872743,1659162973,1659163531,558,2364
3948515015,3454392909,1652684132,1652684354,222,1244
3644961840,3875045889,1652783764,1652783887,123,978
3930124385,3067539427,1649563444,1649563927,483,1158
3941528766,3918602291,1659912267,1659912939,672,175
3147792323,3543105564,1667249379,1667250308,929,2188
3404043594,3269865212,1666629698,1666629935,237,59
3417532235,3444174394,1668750670,1668750906,236,1444
3739613077,3584309667,1648536965,1648537484,519,1288
3592379849,3766160943,1661347843,1661347865,22,9
3228565452,3609664184,1664290170,1664290822,652,1791
3475686271,3806936803,1657637253,1657637500,247,2029
3677001111,3903321481,1645559127,1645559571,444,859
3866993832,3285516363,1657219927,1657220427,500,1628
3704305860,3366354894,1652228146,1652228770,624,1010
3776934270,3814577253,1665130160,1665130221,61,2355
3939244771,3691062084,1660306524,1660306999,475,67
3605492251,3359901981,1644762586,1644763432,846,1091
3349666443,3790751649,1654252648,1654253621,973,778
3492103801,3775660991,1654773022,1654773576,554,2296
3525192232,3714122939,1662482068,1662482165,97,970
3681489851,3511755413,1643349041,1643349776,735,2459
3646536668,3088155289,1653219278,1653219843,565,1815
3590831664,3841660750,1645517923,1645518348,425,295
3696211720,3264018414,1648745202,1648745757,555,1938
3707604534,3530278315,1659344665,1659344749,84,895
3734035973,3364661787,1652948813,1652949072,259,2089
3806251232,3728976822,1669113586,1669114075,489,2018
3810915449,3662507847,1656747868,1656748542,674,427
3194379247,3600573063,1657915477,1657916272,795,411
3682747704,3009635817,1660372723,1660372952,229,955
3428026242,3766595984,1644181129,1644181661,532,2421
3897433648,3142106289,1660852138,1660853025,887,2289
3545781567,3888757366,1663091685,1663092425,740,1505
3467215587,3433261355,1665022524,1665022599,75,230
3634018428,3214969929,1641196115,1641196409,294,830
3670158499,3206399216,1643088431,1643088927,496,2085
3819235768,3402804885,1647087678,1647087875,197,611
3905356323,3581454117,1648284145,1648284658,513,2288
3357048496,3691925367,1650020430,1650021320,890,2168
3682279970,3546954605,1662260383,1662260720,337,1889
3527013883,3250359001,1648064754,1648065225,471,904
3388515499,3264079501,1649536755,1649537394,639,546
3249554278,3957115705,1651200050,1651200569,519,727
3849902434,3049579265,1646794163,1646794358,195,1070
3939722468,3067229796,1657926415,1657927069,654,1281
3935809720,3365807352,1654083482,1654083675,193,1390
3746050591,3698706740,1653651010,1653651942,932,1354
3661243199,3768814245,1647225183,1647225740,557,707
3999390272,3616803531,1659438431,1659438902,471,689
3419117613,3041928480,1660645758,1660646515,757,309
3526327974,3321346285,1667307047,1667307136,89,1338
3329496705,3100716894,1665076755,1665076990,235,862
3553471050,3350891476,1644801896,1644802509,613,1610
3917500425,3394999152,1657917074,1657917173,99,846
3228110844,3634010080,1666254512,1666255011,499,2497
3059322626,3486814228,1661479780,1661480335,555,1210
3985617701,3539402223,1657667423,1657668153,730,1934
3017715856,3018756378,1648748398,1648748885,487,557
3541413511,3854859043,1663868144,1663869104,960,1930
3277978979,3256859026,1652153844,1652154394,550,2198
3031649001,3520392773,1653666195,1653666933,738,2463
3020452542,3453839667,1649120536,1649120600,64,52
3178981589,3097016405,1643483225,1643484051,826,1843
3176941664,3887743057,1648554963,1648555107,144,2308
3653770219,3283171763,1643201040,1643201126,86,1302
3767581542,3525261242,1660798180,1660798308,128,1464
3340933137,3815102601,1665045670,1665045706,36,1078
3702965571,3849977339,1660816231,1660817030,799,633
3553467860,3784414098,1661853824,1661854316,492,1098
3830330372,3472375572,1660875404,1660875823,419,2218
3368420871,3755513433,1642407783,1642408445,662,1490
3071667890,3729600228,1661900140,1661900579,439,717
3264401846,3994409144,1654213648,1654213909,261,2174
3628789282,3915439541,1650432863,1650433515,652,136
3031827531,3270240132,1656091787,1656092107,320,1935
3748850384,3366385571,1655734487,1655734841,354,1004
3829971179,3970444667,1652811336,1652812053,717,1012
3905744284,3722199706,1666679496,1666680364,868,139
3283171763,3673810421,1669566029,1669566163,134,765
3164355501,3235086334,1645830935,1645831075,140,29
3862371205,3004708023,1668569676,1668569925,249,2066
3959228076,3829986472,1658119758,1658120331,573,1093
3312124839,3166517941,1658753651,1658753726,75,1412
3890492731,3194603908,1641718613,1641718933,320,968
3436916222,3325313312,1648345332,1648345361,29,700
3577114014,3375927053,1644329499,1644329571,72,1959
3523394395,3598841094,1655254988,1655255538,550,2013
3947369111,3342538148,1655273437,1655274272,835,1105
3341890542,3393156673,1646468247,1646468994,747,153
3639659256,3352595765,1663896618,1663897308,690,981
3806015172,3146555014,1644253320,1644253457,137,1374
3983158937,3045070182,1654738804,1654738886,82,2268
3907299052,3425856728,1646220941,1646221613,672,1970
3385264040,3928521533,1645278108,1645279094,986,1674
3380303288,3620013325,1667363286,1667363799,513,887
3725611236,3794103075,1666275091,1666275350,259,806
3666380447,3628792484,1643627490,1643628081,591,86
3608079336,3304559201,1667724463,1667725448,985,1608
3790180006,3139434250,1656881355,1656881874,519,1363
3220800349,3199255829,1647887744,1647888599,855,1338
3617533561,3735286926,1648580661,1648581450,789,1589
3546192493,3549635553,1667579196,1667579591,395,707
3686144397,3735098036,1655066778,1655066805,27,970
3936292699,3654344198,1649229400,1649229827,427,1572
3216243579,3450689808,1646467203,1646467363,160,1399
3801956152,3816561204,1664168278,1664168948,670,978
3928361511,3359212197,1649235779,1649236575,796,2137
3366262960,3475322181,1655424153,1655425098,945,1568
3335565751,3797270025,1668171495,1668171738,243,632
3915206176,3755085868,1641742218,1641742880,662,1719
3451263201,3794524447,1667436010,1667436086,76,1661
3206197726,3532569602,1667492633,1667492914,281,517
3989646368,3119345546,1647130808,1647131195,387,772
3706206403,3620311248,1641421984,1641422839,855,1551
3287901684,3750698244,1655797590,1655797968,378,1466
3829901682,3499541432,1643703411,1643703681,270,1096
3048781539,3469887287,1648801586,1648802344,758,2058
3649660430,3248452729,1644121880,1644122489,609,56
3935936621,3269680998,1645188184,1645188809,625,2197
3522715448,3261419893,1657141433,1657141898,465,1740
3838850701,3189002771,1664614914,1664615089,175,1784
3029468819,3717137928,1661635789,1661636596,807,1084
3505753274,3546290525,1663479643,1663480346,703,2244
3423088497,3997353499,1646716130,1646716418,288,2428
3105733809,3883286458,1656168558,1656168842,284,110
3130612494,3550702679,1664869773,1664870293,520,1245
3304559201,3112298724,1663542791,1663542917,126,1497
3668174777,3912672075,1662323862,1662324056,194,2415
3195629628,3213995449,1647580553,1647580587,34,2319
3465238210,3550299952,1650942865,1650943271,406,76
3365807352,3562004989,1661928513,1661928650,137,1969
3638595264,3954185607,1649218247,1649219030,783,2001
3840533238,3679867888,1644319188,1644319618,430,103
3500455630,3923523643,1658520327,1658521315,988,1071
3697066162,3641493201,1649836616,1649836622,6,2402
3875045889,3866534454,1645136600,1645137236,636,945
3896308173,3508133844,1669350099,1669350548,449,492
3828342380,3479401831,1649646230,1649646718,488,2108
3387840253,3673549679,1655669873,1655670337,464,1362
3140064319,3839200168,1663083175,1663083192,17,947
3039962870,3378791519,1650355289,1650355367,78,725
3161243271,3069746677,1646513434,1646513464,30,60
3169072505,3533172784,1649472194,1649472755,561,1221
3531256735,3903709933,1650856113,1650857082,969,730
3910712536,3129667560,1642622168,1642622519,351,1091
3922972838,3445422843,1662954474,1662954638,164,939
3855754332,3048405710,1649219382,1649219951,569,46
3379726555,3240435560,1646143685,1646143888,203,1733
3105789496,3615897427,1656245407,1656245468,61,526
3691607111,3895274115,1650714280,1650714325,45,1461
3954988798,3199892178,1646909781,1646910454,673,316
3364911803,3273701051,1648895397,1648896202,805,1566
3620006027,3524315738,1652071467,1652072161,694,814
3627981146,3307185651,1648490915,1648491702,787,1867
3583585259,3335063983,1641998603,1641999294,691,2017
3564296836,3922675517,1652631907,1652632860,953,201
3181778467,3492909923,1657629070,1657629303,233,1944
3010790966,3336525489,1659507360,1659507667,307,491
3382396122,3727995134,1659285552,1659285809,257,1923
3620236387,3937429867,1662504359,1662504755,396,649
3504919226,3154567629,1657653130,1657653963,833,1521
3914613880,3947879014,1646587307,1646587653,346,2430
3099102864,3524131973,1662667876,1662668173,297,1257
3918397944,3097145374,1657794458,1657794504,46,1803
3045691620,3268216928,1641065058,1641065919,861,2356
3746351822,3663228098,1648691681,1648691910,229,1513
3294276727,3826530948,1653004873,1653005467,594,2106
3597557082,3348770994,1668229612,1668230011,399,2027
3142313032,3344713569,1649580225,1649580689,464,2466
3277577090,3482148686,1653452688,1653453464,776,217
3941512307,3915336029,1655406093,1655407053,960,1314
3651421358,3099934862,1668364588,1668365393,805,2458
3922728266,3544133682,1653031682,1653031888,206,1518
3962773297,3863448086,1641674676,1641675430,754,441
3264081641,3266666808,1656168963,1656168983,20,697
3785638958,3627981146,1643369357,1643370176,819,602
3831699015,3532675680,1649758837,1649759422,585,1079
3010488834,3182243157,1662789622,1662789706,84,1985
3830303170,3086324092,1662822233,1662822543,310,1808
3832463052,3802040767,1663448516,1663448804,288,553
3448373235,3847561511,1642720173,1642721008,835,0
3687919265,3701370209,1649069487,1649069898,411,823
3445689630,3752442248,1643456900,1643457837,937,1445
3529764378,3228805720,1650134507,1650134757,250,2026
3098316380,3245354614,1658145750,1658145773,23,504
3496921526,3556425071,1645634922,1645634971,49,234
3325944344,3914348680,1658739793,1658739904,111,352
3476882609,3882619512,1644617358,1644617628,270,1497
3048409719,3796784054,1644935586,1644935987,401,1014
3371790369,3385264040,1644977409,1644978142,733,473
3184955498,3856882586,1649763471,1649763783,312,1400
3720615918,3679065090,1648758029,1648758886,857,1606
3378162995,3298505096,1652474929,1652475188,259,1660
3118425000,3391262941,1644010697,1644011324,627,310
3136810446,3725989619,1641673865,1641674204,339,146
3667414511,3171214894,1653307971,1653308689,718,1637
3180836532,3269653223,1667826123,1667826855,732,433
3354395496,3061982327,1651830029,1651830412,383,85
3808541027,3393501277,1658438262,1658438813,551,751
3855769157,3680453323,1641539596,1641539614,18,1662
3859379131,3560043638,1656350590,1656350955,365,2141
3169898520,3769767823,1651686894,1651687715,821,1292
3453839667,3118502732,1662084799,1662085180,381,2106
3496318579,3237245622,1661430661,1661431291,630,136
3989741708,3378542130,1646516621,1646517599,978,1144
3870998298,3114097031,1662115976,1662116690,714,504
3707578213,3349718189,1656483177,1656483808,631,2133
3882748527,3777835723,1642011434,1642011619,185,1768
3636619501,3070520574,1646301646,1646302089,443,567
3599694754,3273518390,1661264346,1661265287,941,448
3149804005,3913984749,1662543138,1662543773,635,357
3802694367,3713062516,1646219188,1646219263,75,1149
3468586613,3692095834,1661604980,1661605239,259,1648
3757370089,3486061006,1649174172,1649174513,341,2016
3494990710,3315185864,1646306107,1646306765,658,1977
3620311248,3564667780,1647350666,1647351215,549,2380
3021515419,3800271865,1657666069,1657666119,50,1099
3530491537,3346261120,1650123548,1650123900,352,341
3693028654,3471703914,1646711113,1646711753,640,2377
3214969929,3620013325,1656809569,1656809855,286,2138
3558139345,3461108375,1662523631,1662524145,514,2143
3975096180,3862528538,1667663700,1667664563,863,922
3984348951,3520943619,1662628407,1662629061,654,126
3587440298,3822935707,1660704208,1660704730,522,134
3894454988,3160242179,1648555852,1648555875,23,2295
3056053831,3962798581,1668990970,1668991143,173,196
3609804397,3984215552,1642311645,1642311867,222,894
3828342380,3820225206,1660703777,1660703898,121,659
3511194169,3276232281,1654998965,1654999726,761,1029
3751411767,3942656665,1662178044,1662178288,244,898
3274452346,3824517920,1660896378,1660896411,33,945
3112615469,3478771172,1660922838,1660923704,866,2162
3913608544,3978893578,1653615618,1653616229,611,691
3234620335,3275827194,1659862522,1659863485,963,2189
3728631423,3866541862,1668437434,1668438398,964,1654
3584309667,3910837040,1647258139,1647258208,69,268
3090804084,3162947685,1655722613,1655723062,449,1237
3194617168,3198195956,1663817922,1663818346,424,497
3927214415,3542204344,1646928166,1646929067,901,2242
3975663862,3424655507,1665682226,1665682371,145,815
3102089102,3468173779,1662803816,1662804319,503,535
3085311533,3864143186,1647669066,1647670052,986,1311
3017407853,3453884967,1649448559,1649449116,557,1578
3928020650,3366155048,1641237735,1641238137,402,830
3718652649,3216243579,1664997098,1664997111,13,630
3342685325,3952425376,1665744594,1665745091,497,68
3712727713,3478404891,1642774683,1642775263,580,150
3021253966,3706560099,1663363486,1663363991,505,2369
3415124478,3845496977,1652983559,1652984250,691,354
3877483900,3310294122,1653544504,1653545229,725,665
3643276679,3187561832,1646355079,1646355773,694,1596
3759393612,3303815040,1644503602,1644504187,585,96
3304728211,3197739962,1647869050,1647869913,863,796
3204912218,3864045087,1661958197,1661958839,642,1268
3697028552,3224095644,1651580349,1651580862,513,1254
3898188404,3029403229,1659262937,1659263708,771,1204
3362173874,3837065973,1655383672,1655384476,804,227
3252187190,3197323395,1665882834,1665883617,783,724
3569573616,3311244386,1663906244,1663906899,655,1193
3998728915,3224715818,1668336170,1668336622,452,1708
3445558523,3925754107,1667491460,1667491848,388,2115
3436582780,3692772256,1651930335,1651931181,846,1983
3277284318,3387774254,1653565571,1653565629,58,2187
3498770747,3595535977,1667613184,1667613660,476,1727
3473394094,3443490373,1650376190,1650376656,466,297
3998329857,3242897248,1647501508,1647501828,320,931
3828531030,3600725106,1665506305,1665506586,281,1817
3690349378,3922423821,1664832898,1664833338,440,1835
3103681676,3722422633,1647738365,1647738840,475,2316
3834152797,3430916751,1668469677,1668470313,636,450
3743835099,3562814356,1664678094,1664678858,764,1199
3021515419,3921317746,1667458602,1667459214,612,52
3668456327,3278886018,1657154771,1657155628,857,324
3153040217,3343729897,1653087774,1653087893,119,1796
3151896132,3526088150,1666036569,1666037206,637,1480
3372334548,3447326124,1647234337,1647234653,316,2338
3542293606,3547358965,1663040436,1663040880,444,1514
3608775321,3086084685,1649969830,1649970222,392,1661
3151386327,3046991819,1658091599,1658091814,215,1239
3817073865,3300983140,1666588818,1666588881,63,738
3480642253,3066990756,1661612782,1661612826,44,1496
3685473604,3122144249,1650880134,1650880500,366,1898
3354330082,3533403208,1667554395,1667554619,224,1763
3207407283,3767136549,1662195424,1662196245,821,2120
3476060971,3260306978,1654143287,1654143750,463,1440
3671054235,3619704547,1648310484,1648311016,532,1083
3733143454,3674729672,1654985364,1654985635,271,1766
3282079727,3739865914,1662709844,1662709962,118,751
3963370859,3210279328,1643142541,1643143240,699,2103
3960727376,3354574342,1645645881,1645646111,230,340
3930124385,3974318707,1660096168,1660096792,624,1718
3716246985,3321699949,1658054924,1658055086,162,675
3270240132,3132959520,1658256046,1658256126,80,188
3548128446,3987606604,1641387614,1641388204,590,658
3242064640,3629984961,1650909518,1650909850,332,1173
3520523282,3239575265,1665504879,1665504931,52,827
3647398701,3646687421,1652734834,1652735422,588,1765
3666079547,3576284955,1660042798,1660043597,799,84
3280818938,3474376744,1650361740,1650362638,898,1515
3571719140,3707867178,1668926725,1668927048,323,1879
3059848821,3607717009,1652473312,1652473426,114,2161
3940115951,3852731262,1659255853,1659256736,883,530
3035803277,3102669962,1644292303,1644292328,25,2311
3975065378,3534218813,1645410756,1645411032,276,2319
3020429639,3920437320,1645484277,1645484563,286,989
3086653619,3850546468,1662674183,1662674270,87,618
3939181696,3410719383,1654536118,1654537045,927,1332
3280328195,3740051209,1644531626,1644531678,52,974
3678778706,3656002043,1641748585,1641748926,341,2481
3043611684,3500201376,1651863281,1651863647,366,1380
3046738951,3328373210,1659349686,1659350232,546,1637
3318227153,3205864966,1666432332,1666432839,507,1280
3734754514,3271864656,1641629810,1641629921,111,2442
3698133773,3002396640,1655933191,1655933627,436,2347
3330058679,3998200859,1668275331,1668276251,920,1306
3797778150,3532634291,1666801227,1666801570,343,585
3596007538,3059602794,1648372299,1648372991,692,1498
3023448006,3414193650,1655708244,1655708947,703,638
3361670451,3312344118,1654664194,1654664515,321,2313
3202783831,3947788644,1662338663,1662338710,47,496
3760817382,3183740417,1656389350,1656389381,31,1464
3022283384,3118754726,1646460526,1646461216,690,353
3975075818,3669018473,1650068389,1650069202,813,657
3947083981,3140608489,1665363585,1665363737,152,2401
3228794031,3739731580,1659853114,1659853715,601,375
3375799029,3894690935,1661952062,1661952363,301,1272
3018651462,3605587138,1658558618,1658558968,350,2489
3840502377,3769786489,1666573151,1666573769,618,368
3707892765,3734779425,1660768656,1660769114,458,1751
3359296227,3541413511,1661940003,1661940802,799,1245
3104459009,3893829650,1652914939,1652915756,817,1945
3945611603,3747907269,1649296677,1649297245,568,1843
3988935369,3588728644,1648505704,1648505839,135,422
3014993252,3381692213,1651153148,1651153227,79,85
3398508681,3659224437,1661245675,1661246673,998,971
3878695242,3548484912,1648973904,1648974582,678,2133
3280328195,3933558253,1668536697,1668536949,252,2173
3958449916,3831951487,1665217027,1665218008,981,654
3666380447,3774724683,1645479264,1645479958,694,1409
3473571389,3553096192,1655933751,1655933886,135,2440
3834160941,3970654045,1652110606,1652111203,597,1239
3159645889,3080853733,1657280575,1657281053,478,1493
3170519162,3906964033,1643538308,1643539256,948,695
3770641398,3841287368,1657024838,1657025019,181,1192
3604426149,3412501516,1668387857,1668388262,405,1452
3254030842,3702178313,1657110113,1657110612,499,1969
3363902315,3871971681,1657034802,1657035135,333,760
3643185661,3014983064,1648998897,1648998959,62,32
3064032505,3038529026,1649710772,1649710864,92,1835
3687239883,3548759819,1646898588,1646898626,38,597
3482933937,3761218329,1658037137,1658037766,629,1561
3784168038,3096412109,1664447896,1664448646,750,607
3163551629,3682608460,1668511241,1668511464,223,1728
3625894399,3890054358,1659682723,1659683568,845,439
3939711103,3951216492,1668030235,1668030825,590,2023
3056173313,3397987502,1649495442,1649495595,153,1990
3835036552,3369175849,1668916716,1668916818,102,1355
3547758342,3445469609,1664783391,1664783826,435,706
3782266220,3362249024,1654066362,1654066422,60,2405
3647549073,3198338148,1650335539,1650335741,202,602
3722483331,3529024969,1653696456,1653697329,873,1999
3885893310,3777872237,1662373698,1662373844,146,968
3137092101,3363733362,1650703237,1650703921,684,1548
3490435539,3696096099,1665499994,1665500104,110,332
3607580736,3692095366,1663285133,1663285217,84,99
3270919620,3172305265,1652161378,1652162005,627,164
3348282881,3406357109,1642640878,1642641832,954,1618
3938272679,3692904228,1642897151,1642897431,280,610
3900911220,3329253794,1646572333,1646572360,27,348
3713116694,3346164838,1664704111,1664704326,215,1464
3228709105,3421178618,1644972745,1644972861,116,981
3069675415,3473170336,1653126825,1653127065,240,1692
3439120258,3462714323,1660497072,1660497580,508,487
3389812297,3574740304,1654859661,1654860263,602,859
3245723038,3072277927,1658776777,1658777602,825,706
3417138981,3877205464,1644907940,1644908675,735,684
3250248786,3181032246,1647383387,1647383480,93,1837
3216667034,3066093153,1650545369,1650546031,662,1765
3124147703,3231701470,1644157025,1644157179,154,664
3569686431,3211965606,1641538556,1641538689,133,781
3762538736,3351490739,1659444370,1659444525,155,1671
3118533471,3375966339,1643077518,1643077788,270,1574
3402349073,3832296106,1651322393,1651322774,381,1858
3159562411,3872691076,1645466964,1645467140,176,393
3109127825,3504258562,1658649732,1658649909,177,800
3229080104,3758577708,1663356366,1663356857,491,1340
3227446097,3546290525,1668699618,1668699708,90,1620
3307067721,3721226798,1662835584,1662836566,982,1640
3197371652,3302992244,1654618970,1654619893,923,61
3801107936,3075765827,1662210107,1662210472,365,658
3608512295,3448373235,1663730309,1663730467,158,1145
3073944007,3084030782,1651806726,1651806743,17,522
3698025795,3955750752,1655217268,1655217598,330,702
3231794234,3392569339,1663448330,1663449317,987,2144
3321312190,3555452314,1660049337,1660049462,125,1237
3686967459,3030192990,1642630648,1642630889,241,1550
3178643457,3536633962,1655157609,1655158354,745,373
3796754155,3479608671,1649602814,1649603639,825,2154
3604762599,3823942349,1648135728,1648136144,416,292
3216243579,3752621490,1666142572,1666143484,912,1645
3985326073,3680100111,1654663329,1654663691,362,979
3928852706,3528505546,1651980500,1651981405,905,2330
3014462663,3952889735,1654151183,1654151356,173,742
3623351962,3615137704,1645356618,1645357487,869,443
3855113371,3330749303,1659205422,1659205524,102,1030
3621462507,3008850935,1651578705,1651578742,37,2243
3065216937,3020429639,1661362218,1661362492,274,2046
3437259542,3169486525,1643405411,1643406353,942,485
3591551688,3674335911,1642019708,1642019778,70,2370
3287508774,3048296949,1648846339,1648846903,564,1575
3596483616,3831699015,1642308198,1642308330,132,1426
3942862085,3284832227,1660007935,1660008875,940,2055
3063566522,3757719267,1663361296,1663362062,766,1394
3244997486,3164467795,1641229826,1641230259,433,633
3517556603,3908153195,1647246126,1647246867,741,1262
3029481461,3051876837,1650782746,1650783667,921,2209
3141963631,3343033950,1664487871,1664488314,443,649
3084940745,3547072063,1651805560,1651805669,109,397
3993798870,3405352606,1652009239,1652009241,2,56
3005926074,3819468348,1646668817,1646668946,129,2488
3329751201,3620522583,1653361257,1653362164,907,1045
3735538229,3738761840,1655986776,1655986861,85,1186
3541200701,3628554134,1659108616,1659108930,314,939
3707476548,3791055136,1652745600,1652746299,699,503
3253589940,3824545323,1668366839,1668367555,716,2313
3807549475,3081803809,1644994350,1644994675,325,196
3057028614,3324618357,1650008230,1650008593,363,1658
3569051470,3194560289,1641599318,1641600149,831,93
3191811632,3557751532,1659166542,1659167292,750,1563
3980824960,3112389617,1644832085,1644832415,330,1351
3799459873,3224130773,1662022568,1662023296,728,430
3807785088,3265611656,1649383755,1649384550,795,14
3299472791,3984533628,1648836918,1648837322,404,2155
3645860854,3092365114,1643482190,1643482697,507,1026
3940387270,3332506866,1648276339,1648276910,571,48
3183299670,3667528236,1660818241,1660818401,160,2187
3183340735,3993572792,1660586205,1660586872,667,389
3292365668,3656092578,1664788610,1664789359,749,1809
3907764491,3971648409,1656285987,1656286874,887,1767
3327873529,3679939578,1646600759,1646601330,571,456
3378325026,3696856656,1662345142,1662345318,176,1478
3343279177,3530495336,1656627786,1656628378,592,2399
3704305860,3822143503,1642217761,1642218285,524,637
3474808421,3778848529,1643500372,1643501291,919,70
3839454838,3451206797,1662463667,1662463922,255,1629
3492638245,3793232281,1648325153,1648325682,529,1059
3289684726,3142869544,1644554961,1644555655,694,1790
3439442608,3447257561,1667058355,1667058661,306,114
3277550058,3315583401,1647586418,1647586462,44,2083
3637686903,3012930968,1643738034,1643738471,437,671
3247959785,3914348680,1661212737,1661213640,903,1296
3465382952,3090179745,1647224472,1647225434,962,587
3512631937,3288555658,1658864197,1658864606,409,600
3060989519,3468586613,1641411964,1641412657,693,288
3313687025,3959651432,1668067076,1668067940,864,1455
3434608050,3516585405,1647465315,1647466098,783,1790
3697231480,3425613329,1642371380,1642371555,175,1557
3233932115,3246759301,1661967911,1661968815,904,2300
3624947127,3718823049,1668013987,1668014799,812,1003
3415761431,3002316212,1647049151,1647049896,745,2352
3416196153,3468633309,1659185639,1659186389,750,362
3924577071,3624644696,1643749023,1643749435,412,1719
3594682644,3867214487,1660084958,1660085287,329,1428
3220903356,3429010148,1655377392,1655378078,686,317
3407460146,3297001171,1654439066,1654439089,23,816
3038014403,3172524712,1656649496,1656650245,749,796
3563259493,3609058442,1662496631,1662497267,636,514
3303815040,3115494713,1663708728,1663709301,573,144
3746229411,3005480994,1652065509,1652065869,360,1361
3117322872,3547758342,1641302023,1641302137,114,1762
3626505512,3729325351,1645065586,1645066270,684,1211
3199797181,3633544934,1644064640,1644064889,249,2326
3546866871,3437215040,1641643411,1641644205,794,1211
3886158471,3371818930,1645306396,1645307209,813,1403
3993995217,3054432255,1644485793,1644486462,669,1324
3993798870,3423918005,1666145975,1666146401,426,430
3740438273,3432954312,1666393935,1666394677,742,1672
3112259657,3628556060,1652645514,1652646216,702,70
3507431231,3284838720,1666449873,1666450300,427,1833
3827122083,3787880772,1658772224,1658772319,95,221
3420520626,3941548978,1648648132,1648649054,922,1335
3182396653,3063782933,1663176372,1663177020,648,1427
3419807636,3271436858,1665713512,1665713830,318,287
3075088680,3945611603,1649755101,1649755503,402,245
3182396653,3414852594,1662793391,1662793719,328,2036
3941903445,3666486477,1662124277,1662125133,856,1962
3629933310,3710786724,1662662890,1662663365,475,713
3156980878,3556647439,1663893915,1663894501,586,2259
3381060534,3265262512,1656752869,1656753223,354,505
3109941959,3669789756,1642078318,1642078917,599,1179
3339312980,3553436680,1643418283,1643418824,541,490
3977699882,3403512366,1646653530,1646654293,763,2043
3173791920,3310953839,1663314233,1663315086,853,2215
3897212070,3530930024,1655359547,1655359644,97,741
3915315003,3728419832,1643658135,1643658820,685,951
3957051129,3760224151,1666694853,1666695782,929,2310
3227970299,3782266785,1658277311,1658277957,646,1134
3456364565,3028710587,1666523563,1666523959,396,1284
3102992210,3310882037,1661516514,1661516692,178,382
3424650360,3875748779,1661420364,1661421265,901,448
3683326795,3320488617,1644489663,1644489743,80,862
3707676798,3425804563,1652100162,1652100732,570,151
3884256882,3625393284,1652497470,1652498232,762,876
3706085200,3224130773,1657180638,1657181096,458,1680
3605195406,3378325026,1657893241,1657893702,461,164
3840764880,3120490643,1660258567,1660258587,20,1670
3441383531,3912803496,1644593443,1644594122,679,363
3017484229,3442447509,1644245859,1644246626,767,966
3839788123,3481689842,1659018946,1659019390,444,1793
3059870015,3358968371,1663286660,1663287063,403,1141
3676690161,3419117613,1645170870,1645171339,469,1252
3882315040,3575535453,1662692732,1662693670,938,2080
3160061122,3649658953,1655455088,1655455558,470,1033
3428142421,3724157579,1666279709,1666280700,991,1463
3678541527,3659285822,1663427739,1663427793,54,407
3595049641,3296419150,1645603397,1645604245,848,1802
3351205685,3070640991,1648486494,1648486973,479,477
3826433692,3106490071,1649555469,1649556453,984,1800
3059151355,3047628685,1668681109,1668681638,529,2060
3043256301,3024551635,1656600408,1656601055,647,52
3075288965,3816995343,1642927051,1642927983,932,1546
3827557826,3195214383,1656506679,1656507230,551,122
3183079019,3126499590,1660740375,1660741173,798,1292
3871845792,3301994647,1650617976,1650618824,848,145
3980926444,3371790369,1657274408,1657275107,699,610
3267411650,3562004989,1658214577,1658215163,586,407
3264345880,3057314040,1645738317,1645738630,313,1182
3125436993,3131131112,1662534613,1662534714,101,82
3932212405,3616094004,1654455409,1654455779,370,62
3347896915,3775645582,1659703118,1659703874,756,2187
3435319506,3136172164,1641915829,1641916253,424,1291
3896910823,3514458890,1650933274,1650933595,321,883
3769647112,3728240849,1641584010,1641584164,154,1267
3089844622,3752176146,1665887884,1665888775,891,2109
3508060901,3489273340,1643423096,1643423907,811,1663
3423073970,3963615140,1652560401,1652561089,688,694
3719146348,3906216789,1661300118,1661300771,653,2064
3614741796,3125289160,1647133034,1647133653,619,1054
3164122941,3955055535,1663712008,1663712646,638,2306
3882412784,3780808964,1661691464,1661692098,634,1544
3514013878,3046707177,1666474728,1666474789,61,907
3311529434,3181047536,1664681014,1664681360,346,1779
3759230876,3793996748,1656422282,1656423136,854,1804
3833987128,3027295354,1667214939,1667215552,613,981
3831699015,3479359145,1649839236,1649839703,467,612
3367915131,3884704204,1664547462,1664548338,876,1552
3711847265,3258102756,1659894447,1659894607,160,1597
3065482463,3281725583,1660045646,1660046262,616,1386
3972052329,3022252567,1655273258,1655273732,474,1323
3432899117,3294357161,1652033553,1652034246,693,1762
3552101140,3691317999,1646467229,1646468197,968,911
3841174974,3110016926,1654511435,1654511558,123,448
3862918742,3061814600,1664827667,1664827693,26,1124
3673735088,3110395191,1658743959,1658744765,806,311
3550741990,3902705203,1660797315,1660797334,19,18
3975065378,3297001171,1662176197,1662176466,269,14
3695558824,3697231480,1653138566,1653139530,964,1459
3099013723,3024554792,1644381780,1644382024,244,1136
3451249074,3595984663,1663540206,1663540292,86,1137
3291175188,3486907422,1669505635,1669506633,998,1947
3294478149,3648257100,1653073998,1653074749,751,1381
3370164589,3904625406,1664924470,1664924730,260,982
3806466784,3419068106,1656152603,1656153326,723,2314
3501308694,3034601276,1654461695,1654462092,397,290
3365316758,3870485916,1645308617,1645309282,665,1197
3982268438,3191398794,1642242532,1642242789,257,1897
3347942747,3569329621,1650699409,1650699676,267,1899
3327504995,3767453896,1664382254,1664382902,648,799
3367865740,3640587334,1648228524,1648229251,727,764
3515367610,3611269407,1655846618,1655846724,106,2448
3609029368,3624748073,1663500268,1663500635,367,1316
3646544919,3538692457,1646664224,1646664914,690,1153
3914888679,3691925367,1643831703,1643831885,182,465
3036448305,3883703576,1644431511,1644431606,95,1219
3824517920,3483254795,1664101115,1664101995,880,850
3423088497,3425282516,1645099551,1645100335,784,736
3348620933,3682928814,1661265851,1661266365,514,215
3087394554,3383755219,1647856748,1647857569,821,411
3310037244,3446741935,1668969475,1668970304,829,1148
3146378665,3323809275,1668079552,1668079598,46,273
3333223237,3113321914,1661620317,1661621276,959,2307
3067930449,3095170532,1652954762,1652954901,139,1737
3941512307,3455198360,1642797906,1642798003,97,2287
3977872515,3788688228,1668569927,1668570386,459,2365
3177370273,3840003483,1667493991,1667494121,130,374
3082885404,3557325531,1655850110,1655850326,216,1814
3941512307,3221885729,1646655610,1646655693,83,1167
3726378645,3854535872,1641686272,1641686637,365,2239
3012457192,3930909418,1651346760,1651347108,348,1845
3021515419,3250248786,1654151521,1654152498,977,903
3857215319,3008760173,1655824020,1655824353,333,2346
3949445116,3005449860,1655347490,1655347610,120,2226
3739439527,3174722772,1659614532,1659614918,386,1068
3486059916,3444174394,1644567852,1644568458,606,1066
3042046828,3722247979,1658797064,1658797952,888,108
3558370114,3067380299,1659810918,1659811441,523,1179
3371790369,3074385503,1657686684,1657686783,99,1699
3364945349,3800312034,1645822873,1645823118,245,1687
3975663862,3245522058,1649242364,1649242752,388,582
3228277648,3415522797,1651458979,1651459774,795,1721
3231727990,3939755962,1647996127,1647996831,704,1218
3435292986,3895277580,1662966074,1662966478,404,2297
3734565675,3668552386,1668253517,1668253767,250,2136
3134117241,3771504908,1659200871,1659201177,306,2045
3596932196,3252535116,1668006488,1668007210,722,883
3373806425,3204346356,1654572503,1654573434,931,434
3640756400,3956394849,1666802323,1666803250,927,735
3906455689,3916557399,1660801371,1660801961,590,154
3470287808,3471376255,1644480919,1644481395,476,174
3772788087,3467211844,1643000775,1643001612,837,1657
3306460846,3814899146,1655316391,1655316459,68,1584
3905356323,3869505474,1643111987,1643112127,140,132
3312930717,3542996543,1643608672,1643609088,416,815
3818713435,3184178717,1669030597,1669031196,599,208
3296556189,3064758483,1669100915,1669101123,208,1728
3770948247,3771028638,1662587496,1662587952,456,2150
3167864948,3816536444,1663549122,1663549554,432,1340
3907700603,3266681677,1647110150,1647111084,934,2156
3013484024,3939477257,1667732873,1667733639,766,2378
3788911315,3370217481,1662570929,1662571613,684,2235
3870320323,3403911906,1662772226,1662772507,281,1982
3612061421,3261003235,1669250298,1669250485,187,2333
3131025611,3947461796,1646290356,1646290983,627,1160
3425815854,3135579253,1657691436,1657691563,127,1613
3810861883,3261866390,1667360572,1667360698,126,2347
3526798607,3066990756,1658439725,1658440472,747,2367
3237824925,3362405611,1650478898,1650479170,272,1239
3926699428,3632335400,1649756605,1649756632,27,394
3965867792,3590621650,1656984000,1656984132,132,959
3404200137,3056982737,1656482374,1656482552,178,924
3730106432,3779590261,1661334731,1661335309,578,990
3827937024,3520392773,1669504094,1669504246,152,44
3359417056,3384452997,1661663661,1661663774,113,874
3659917344,3682928814,1652526389,1652527226,837,2403
3768099353,3486810833,1652664737,1652665421,684,1050
3068982966,3802410450,1653709372,1653709605,233,1963
3546866871,3636960130,1662943312,1662943889,577,1286
3368204842,3436888201,1653373159,1653373325,166,2433
3793518113,3640587334,1652679648,1652679751,103,96
3966881800,3725042810,1659139406,1659139909,503,801
3363651899,3239158180,1644275077,1644275801,724,1442
3814899146,3686641761,1669164443,1669164514,71,598
3402426323,3440598942,1655098866,1655099678,812,1105
3524480094,3216582576,1656544632,1656544877,245,1009
3103417672,3893849847,1650907029,1650907121,92,1799
3474558723,3813290629,1663728466,1663729077,611,2087
3359541123,3434575449,1662970582,1662971380,798,1259
3804773972,3295905536,1650814495,1650814530,35,1
3867205407,3797617787,1650508756,1650509317,561,2446
3598117343,3706206403,1645056804,1645056979,175,1542
3167494570,3376287193,1645153703,1645153861,158,1529
3226234284,3248892530,1647704952,1647705176,224,659
3569761806,3562110382,1663811508,1663811763,255,1378
3923259150,3013775923,1647555222,1647555888,666,2119
3163708045,3672874828,1653855030,1653855383,353,2008
3790549304,3554862003,1660165423,1660165901,478,1865
3348282881,3994168332,1649913182,1649913946,764,1294
3884878006,3498758411,1667154244,1667154324,80,4
3777872237,3349626057,1656091273,1656091684,411,2216
3781394729,3404394014,1655415644,1655416074,430,126
3057090135,3172305265,1642566259,1642567174,915,898
3821998886,3706206403,1656523234,1656523477,243,852
3647951580,3722114463,1650594443,1650595247,804,1116
3378162995,3424790413,1666515225,1666515578,353,538
3092292487,3683993851,1655248221,1655248566,345,310
3826257607,3513399148,1658923053,1658923987,934,1541
3860745004,3074886612,1657743114,1657743511,397,2474
3939244771,3279671068,1655309213,1655310095,882,2412
3302455172,3431909978,1652887932,1652888527,595,1174
3425490548,3735946925,1657037580,1657038005,425,922
3634539557,3990233750,1646956698,1646957294,596,496
3406357109,3997162156,1651748133,1651748957,824,1947
3358743866,3216665855,1649395684,1649396548,864,2276
3070241461,3124044009,1649236261,1649236336,75,537
3869618249,3042120123,1656087696,1656087909,213,377
3906024837,3616441586,1657716833,1657717302,469,1705
3114605564,3934914335,1649198883,1649198969,86,1860
3139455252,3926612159,1648931975,1648932969,994,685
3925344243,3400329831,1657629600,1657630520,920,1857
3294703062,3165929307,1647198196,1647198616,420,1040
3013073909,3191632331,1655641119,1655641659,540,1207
3128318593,3424768768,1646109286,1646110224,938,1859
3361670451,3780546851,1648419896,1648420021,125,1969
3245723038,3748511559,1651308487,1651309017,530,157
3799078288,3787298788,1665392507,1665392792,285,2349
3835069955,3030551637,1663922504,1663923222,718,927
3415522797,3959093613,1655841401,1655841459,58,233
3530806404,3060633640,1661717228,1661718154,926,1398
3313615371,3777022057,1654653867,1654654006,139,1404
3987813210,3515138485,1661431378,1661431422,44,1205
3994913668,3916226073,1669394643,1669395256,613,1587
3941642636,3316485303,1666714254,1666714348,94,406
3551402272,3749619105,1650719973,1650720726,753,2189
3232737784,3272912522,1653040613,1653040800,187,1401
3080930599,3856160688,1660030811,1660031726,915,1692
3883265629,3861764050,1648688158,1648688850,692,160
3914888679,3108998670,1665104709,1665105213,504,1279
3104306511,3122002940,1646926572,1646926998,426,94
3332144974,3996989799,1661924756,1661924758,2,17
3513399148,3367279073,1659093585,1659093670,85,1452
3041809783,3005231138,1657495443,1657496151,708,342
3243883781,3278792522,1663812696,1663813481,785,2018
3899772312,3865200739,1652522753,1652523494,741,1924
3860446106,3376960491,1647448337,1647448628,291,78
3865847882,3755294305,1653617682,1653617792,110,2012
3978728021,3155835978,1658872778,1658873010,232,277
3750949753,3926815435,1647860683,1647860903,220,488
3232497890,3632911091,1669031978,1669032738,760,1788
3981932099,3119345995,1656167605,1656168392,787,1629
3438474821,3828738126,1663908669,1663909159,490,1159
3271436858,3946919028,1669369628,1669370500,872,2489
3207283619,3875570780,1659390224,1659391107,883,1107
3069841199,3805953085,1667713308,1667713594,286,1004
3078791988,3167716044,1663102242,1663102854,612,436
3131735006,3239792198,1642574898,1642575642,744,342
3578616050,3765023649,1661318875,1661319059,184,2483
3098546487,3324073911,1658887901,1658888534,633,1424
3407909365,3315650808,1662843864,1662844757,893,1203
3693475435,3665931760,1644816257,1644817072,815,1225
3489858368,3216667034,1650641825,1650642027,202,1267
3250528764,3182982515,1656073016,1656073855,839,1553
3555187890,3585989542,1647559834,1647560694,860,252
3399552669,3316625530,1647581272,1647582238,966,595
3002971802,3867214487,1645611611,1645612508,897,1620
3505026131,3557087358,1646188594,1646188937,343,2166
3566834497,3323834326,1655496999,1655497242,243,1375
3241190614,3154009016,1651888246,1651889059,813,376
3162947685,3682993605,1666985596,1666986174,578,2284
3939977057,3397779824,1643874612,1643874920,308,533
3758695244,3880353584,1644393495,1644393807,312,2098
3498758411,3292010262,1646538954,1646539772,818,132
3059416141,3866993832,1664621511,1664621715,204,404
3348406323,3008550397,1665744778,1665744974,196,1243
3174712961,3485926280,1656005327,1656006049,722,223
3728976822,3083479870,1642963936,1642964286,350,1385
3348234563,3136810446,1642640511,1642640758,247,2097
3404934353,3722817789,1663683183,1663683334,151,882
3290681709,3231501792,1665171652,1665172246,594,660
3785361012,3116777827,1649164877,1649165124,247,805
3342315965,3590384867,1649859269,1649859826,557,3
3566825897,3086076310,1651107425,1651108050,625,1621
3811827366,3395457102,1668500399,1668501255,856,483
3660575608,3998221237,1643099114,1643099860,746,483
3824478322,3390134392,1654770076,1654770290,214,613
3120105783,3564198089,1663236333,1663236972,639,2473
3768211591,3329463543,1667035995,1667036414,419,503
3520392773,3225857817,1644110147,1644110543,396,196
3499481051,3852685738,1655528535,1655529443,908,2493
3667258476,3180294141,1663524686,1663525428,742,1027
3765617850,3287171733,1667820157,1667820469,312,253
3676634608,3473355243,1656077958,1656078485,527,1763
3008062664,3773658133,1669293815,1669293900,85,569
3980934555,3864930473,1667167396,1667167447,51,2351
3106371588,3031026970,1655697037,1655697064,27,1495
3175505409,3669324531,1664439161,1664439809,648,764
3730920499,3921930806,1659268531,1659268813,282,1249
3497288872,3151704655,1648648041,1648648536,495,773
3915986965,3776148003,1653816186,1653816818,632,1688
3547749057,3581207584,1664296392,1664296808,416,2227
3072734804,3838136289,1642644108,1642644949,841,59
3734893217,3636621583,1668325825,1668326103,278,875
3072080605,3061982327,1645394708,1645394733,25,1795
3184994293,3466156489,1668725626,1668726530,904,2403
3418338710,3214558994,1661026636,1661026830,194,2075
3955064333,3445689630,1652465423,1652465861,438,1874
3586025172,3261527870,1658443479,1658443740,261,608
3574394407,3878005127,1668828458,1668828672,214,1105
3421178618,3585919417,1652751046,1652751438,392,1686
3287988080,3331904172,1666209160,1666210139,979,160
3548799053,3245354614,1647798008,1647798958,950,1785
3896357807,3586600196,1669590888,1669591514,626,3
3573941843,3534201448,1643654244,1643654687,443,242
3375177760,3112217806,1664730839,1664731630,791,680
3140488273,3126995401,1646489782,1646490518,736,64
3160349110,3437309077,1652481622,1652482375,753,125
3974917779,3827195774,1667956984,1667957478,494,1264
3802816973,3186207758,1654716781,1654717729,948,1742
3474242977,3957577547,1666432810,1666432983,173,2015
3938505582,3562547940,1660422811,1660423669,858,2180
3806652632,3620985435,1668552951,1668553795,844,2424
3036953061,3163058578,1655690058,1655690425,367,1678
3195716414,3003972844,1658287490,1658288436,946,2371
3243649022,3269294562,1644459097,1644459924,827,1861
3983162503,3927646653,1669176097,1669176991,894,1002
3212841978,3890159677,1665842105,1665842380,275,1055
3317382420,3088571651,1654768089,1654768336,247,713
3534218813,3319545220,1650219774,1650220282,508,2376
3255248380,3655566080,1649000012,1649000755,743,1147
3623191811,3759787118,1641633182,1641633714,532,1654
3837366084,3671637527,1664779457,1664780203,746,2369
3390445291,3364600825,1659589451,1659589542,91,1449
3005356433,3227652803,1664573076,1664573425,349,229
3003330774,3194456422,1652566120,1652566244,124,50
3916456426,3284433811,1664806938,1664806987,49,1825
3476312823,3057725565,1664574108,1664574549,441,2224
3791419861,3139935588,1665065545,1665065969,424,887
3134422689,3737153063,1666771262,1666771582,320,1278
3343543154,3185512282,1643496474,1643497456,982,69
3882748527,3481584783,1653197524,1653197761,237,1035
3975462879,3994844749,1645000460,1645001452,992,2359
3313265862,3145039731,1645188005,1645188852,847,22
3759421049,3416230781,1654348493,1654349233,740,1817
3005200951,3850906711,1652902202,1652902779,577,780
3078500208,3069313994,1649403352,1649404066,714,761
3525442421,3651503901,1653148833,1653149381,548,249
3656158144,3365440817,1665038163,1665038606,443,572
3458252541,3505761464,1645997172,1645998110,938,1285
3351277781,3831426674,1655296303,1655296595,292,1614
3951216492,3883338335,1656372200,1656372905,705,835
3298748343,3828503026,1651113644,1651114095,451,1972
3526239660,3483827042,1664359070,1664359524,454,551
3145039731,3424768768,1653830279,1653831029,750,1845
3162836777,3489909547,1651318168,1651318804,636,2279
3113005024,3102820806,1646299997,1646300761,764,379
3090103866,3658260972,1651051768,1651052239,471,398
3867543887,3418338710,1660640121,1660640184,63,2274
3686944200,3527869582,1649050209,1649050365,156,694
3832880789,3380053573,1652195072,1652195728,656,1238
3309767670,3176608983,1664738261,1664739224,963,655
3158503756,3762422234,1651349661,1651350087,426,2218
3669520344,3767983934,1645247242,1645247609,367,1374
3330924198,3983166385,1644012979,1644013361,382,2462
3055918856,3185373368,1642241978,1642242790,812,1863
3989206811,3088553332,1652511909,1652512059,150,456
3629933310,3045016501,1650207828,1650208782,954,519
3831660488,3107865208,1668898166,1668898304,138,2169
3480523769,3098290557,1648766659,1648767611,952,1212
3195451932,3934326645,1641515138,1641515791,653,1584
3415917688,3718026583,1642387776,1642388482,706,2134
3688758916,3222060578,1645789742,1645789788,46,1126
3392395230,3713693431,1650746734,1650747705,971,2118
3321074447,3615595663,1656012532,1656012721,189,481
3085931016,3059870015,1653049726,1653050716,990,1493
3391037775,3881216721,1667969224,1667969228,4,2132
3604376955,3315182095,1662018230,1662018656,426,1852
3549038219,3838082378,1659865309,1659865626,317,81
3645073300,3327933393,1656312037,1656312597,560,1240
3564026629,3463800741,1660863476,1660864259,783,518
3728506494,3276618988,1650885253,1650885678,425,657
3139882519,3208831400,1667929869,1667930315,446,899
3686025670,3317961564,1658536782,1658537614,832,1634
3716626172,3252593307,1648923794,1648923987,193,1023
3978893578,3657587705,1644479196,1644479647,451,1983
3074051284,3084066396,1662281270,1662282165,895,1493
3556647439,3049727234,1654541736,1654542668,932,649
3658423327,3997541339,1664018535,1664019307,772,1876
3260174905,3890054358,1647239972,1647240873,901,1224
3939948508,3093131372,1669152345,1669152830,485,1393
3646687421,3333516284,1661430191,1661430544,353,67
3620939715,3604762599,1655889053,1655890029,976,910
3440064321,3246796194,1649065610,1649065734,124,463
3993572792,3580774207,1649198394,1649198887,493,771
3863427189,3310496626,1647870288,1647871165,877,1109
3016616906,3939973483,1658944861,1658945079,218,1469
3041290048,3124079349,1655093726,1655094464,738,1685
3502217263,3871180604,1643028782,1643029089,307,1393
3995850572,3618441418,1653923305,1653924161,856,1733
3570872297,3381060534,1666507672,1666508583,911,1862
3716415183,3429684538,1644008570,1644008795,225,956
3029468819,3583864167,1644571339,1644572194,855,1005
3988976739,3101609490,1650861651,1650862412,761,864
3260783577,3853258306,1655009290,1655009920,630,1218
3923137418,3593553797,1651163483,1651164127,644,2179
3315056551,3012917381,1641498022,1641498408,386,2476
3313431689,3002727939,1657892782,1657892937,155,966
3946833004,3352389016,1669523120,1669523843,723,1270
3148256129,3433237569,1662042149,1662042896,747,2151
3276482511,3488484971,1669373024,1669373578,554,2475
3836855857,3908848133,1651551991,1651552685,694,627
3055545326,3996963058,1659757379,1659757710,331,606
3730428171,3333103680,1659509569,1659510411,842,2041
3862890852,3773742235,1661011114,1661011779,665,547
3960772879,3898495918,1667997076,1667997585,509,1046
3322019981,3038832798,1664888986,1664889891,905,1017
3088504949,3485459472,1643514437,1643515263,826,1535
3096662890,3278843111,1669435169,1669435252,83,419
3468914867,3977078930,1643376821,1643377412,591,2361
3521160717,3820225206,1647382089,1647382391,302,1216
3115029581,3418007140,1641533042,1641533907,865,1324
3555571916,3343033950,1667698891,1667699861,970,1253
3325842490,3574740304,1644601759,1644601834,75,258
3951751770,3470586731,1661736062,1661737024,962,2362
3673810421,3679939578,1652358483,1652358863,380,300
3412109130,3285243887,1667622144,1667622793,649,628
3344549344,3664408598,1663038654,1663039186,532,2309
3279773317,3591088164,1645161775,1645162139,364,151
3984570592,3634936481,1649011200,1649011688,488,2404
3910712536,3994783794,1647483310,1647483832,522,160
3243086924,3221885729,1665002480,1665002992,512,1304
3959651432,3500701807,1654905773,1654906084,311,1469
3386724007,3705809622,1665138097,1665138405,308,1765
3455808094,3699152541,1666298820,1666299712,892,1481
3680427036,3637269987,1643125332,1643126214,882,364
3434090231,3526197227,1660788377,1660788851,474,1398
3619175296,3189358030,1647975003,1647975404,401,343
3359078190,3329253794,1662691752,1662691963,211,484
3396063880,3150793263,1653858411,1653859191,780,1998
3402439102,3179405209,1664518742,1664519157,415,2290
3889112055,3158554223,1666460433,1666460851,418,65
3990520153,3403223215,1664415599,1664416553,954,620
3805060036,3853644964,1651790545,1651790985,440,992
3792527009,3055918856,1643150045,1643150689,644,1108
3752000675,3208464348,1661988710,1661988993,283,1443
3057085790,3042360618,1660712600,1660713007,407,1192
3735547050,3560015501,1668506949,1668507248,299,1761
3525088003,3929312426,1665251823,1665252606,783,1570
3180101007,3818028118,1653320401,1653320685,284,232
3290710394,3837904800,1642642599,1642643137,538,1392
3751600788,3103351502,1657335528,1657335947,419,990
3581449963,3057574793,1642971559,1642971705,146,2347
3571897260,3534545428,1668699423,1668699843,420,1147
3402543059,3035895563,1645384127,1645384277,150,201
3486582851,3525442421,1664168054,1664168405,351,958
3219509030,3228574805,1647971428,1647972335,907,14
3755243698,3752701792,1649997776,1649998528,752,1300
3603096793,3074395717,1652481911,1652482785,874,836
3914601322,3513193858,1666273198,1666273687,489,237
3030286864,3425720812,1643695442,1643696013,571,1018
3079415495,3133030435,1661289267,1661289690,423,834
3166521010,3300159475,1665523127,1665523921,794,1223
3537443088,3566818588,1659837796,1659838246,450,1354
3289255457,3020683788,1653771826,1653772811,985,948
3619309272,3014552263,1655593131,1655593266,135,2489
3613021322,3233536885,1654033978,1654034707,729,1685
3216470508,3709518724,1665978036,1665978606,570,327
3712630492,3748812993,1664517372,1664518295,923,1683
3422106507,3005125326,1645514703,1645515224,521,1819
3508202949,3421505883,1658305290,1658305792,502,2098
3922066704,3038529026,1647426288,1647426588,300,588
3106584115,3133427035,1668866394,1668866483,89,2325
3881378306,3567980215,1658697675,1658697781,106,1312
3428763205,3167716044,1645336011,1645336719,708,1729
3693797946,3562456307,1655772440,1655772494,54,981
3916261675,3539303536,1653674104,1653674641,537,2301
3614399988,3381845607,1644894403,1644894608,205,1727
3694206371,3260246509,1644449620,1644449937,317,203
3115494713,3757020498,1653739192,1653740131,939,2315
3408104715,3885162740,1656073209,1656073388,179,2375
3823288349,3226298244,1645398372,1645398916,544,388
3170292789,3191462400,1660491445,1660491931,486,2174
3063955055,3571428723,1655853426,1655853473,47,1269
3748110496,3421730413,1669504534,1669505307,773,1952
3199117399,3802694367,1665467136,1665467465,329,1072
3799078288,3870349696,1658192709,1658193159,450,752
3339415879,3179280029,1653437865,1653438495,630,1283
3861153303,3433768649,1666351331,1666351874,543,1815
3495691991,3599354804,1643030265,1643031010,745,840
3936980618,3955663201,1654137133,1654137771,638,2402
3048409719,3086357122,1652984664,1652984688,24,1910
3419751912,3714909437,1647143708,1647143735,27,1056
3596883607,3832995595,1663789597,1663789964,367,77
3881851624,3090304189,1654615920,1654616117,197,1399
3173788210,3005101248,1652511917,1652511922,5,1737
3253827804,3190859932,1656802981,1656803274,293,2261
3900241568,3949522552,1667873081,1667873314,233,649
3849977339,3519003851,1660374937,1660375358,421,945
3460229906,3714322007,1656999753,1656999926,173,663
3470102638,3694349997,1642350494,1642350726,232,704
3392156471,3986963711,1644276748,1644277691,943,137
3580908290,3409779636,1645569287,1645569583,296,1893
3366609475,3755269138,1665106735,1665107287,552,2343
3315569726,3183507473,1645865147,1645865318,171,224
3101137807,3080007856,1644160964,1644161865,901,1621
3516838480,3735547050,1660933899,1660934415,516,637
3194342775,3640613606,1659206030,1659206953,923,285
3657101592,3587633750,1642002328,1642003262,934,2092
3319605191,3502074085,1661066958,1661067846,888,1613
3095124554,3410613004,1660283193,1660283415,222,2232
3842362489,3329887381,1658524829,1658525037,208,1249
3035476619,3359601528,1649370848,1649371835,987,413
3225328547,3804189322,1653014676,1653015061,385,129
3946919028,3095849365,1666509833,1666510235,402,1255
3328699609,3852685738,1648246349,1648247119,770,5
3259625938,3671830270,1649280340,1649280720,380,2222
3763723423,3167864948,1650123242,1650124193,951,251
3172825605,3738887934,1669703488,1669704063,575,2474
3593704176,3584704567,1645927890,1645928852,962,1817
3352389016,3700109325,1644690262,1644691131,869,1549
3437259542,3890117007,1656497092,1656497629,537,1323
3098955230,3456080836,1648750025,1648750543,518,1652
3637457925,3355078629,1658956184,1658956537,353,1519
3984259471,3843953645,1664920808,1664921480,672,2066
3855900879,3200875282,1650370037,1650370433,396,365
3968143962,3558281313,1664874589,1664874739,150,101
3546605941,3875570780,1649856133,1649856197,64,1219
3401134518,3615137704,1645748122,1645748928,806,1672
3519726741,3770388331,1650043146,1650043660,514,2070
3178728299,3662507847,1642441494,1642442328,834,31
3341241551,3456546904,1645730914,1645731787,873,1449
3547365303,3697028552,1668201492,1668202067,575,172
3034919553,3640756400,1642987787,1642988780,993,864
3728950700,3195148360,1660458285,1660458469,184,65
3029263333,3329498574,1663172413,1663173303,890,1625
3377901268,3015715378,1664480042,1664480508,466,1613
3383179408,3211965606,1668580354,1668581175,821,2409
3657101592,3831346903,1642345007,1642345891,884,2
3573692342,3487475790,1667750964,1667751785,821,1977
3462072699,3862890852,1644447380,1644447859,479,2358
3695237310,3592235229,1667604523,1667605127,604,2465
3862371205,3500320805,1663580471,1663580642,171,847
3990264315,3463009951,1663119022,1663119587,565,808
3158873070,3284137438,1648785100,1648785354,254,772
3139376524,3786194675,1657042205,1657042722,517,1910
3315539995,3343048708,1647925061,1647925623,562,1036
3930474522,3853644964,1658073320,1658073375,55,348
3984818292,3339185857,1667377402,1667378304,902,1052
3748511559,3264339209,1667774822,1667775322,500,73
3273857586,3865947139,1651443787,1651444686,899,963
3781537659,3086534991,1645927147,1645927981,834,2092
3821299576,3856467502,1666999463,1666999804,341,684
3753483202,3806167216,1661405885,1661406817,932,433
3996933937,3442209140,1652643093,1652643558,465,1072
3842738399,3536219260,1668764295,1668765147,852,2150
3382943055,3288261603,1665367071,1665367876,805,1656
3402690548,3718176139,1647076408,1647077182,774,19
3611657912,3688076815,1641641370,1641642303,933,643
3444005080,3596454426,1668802408,1668802696,288,1924
3354330082,3958539607,1646437770,1646438542,772,1022
3780808964,3191811632,1648227080,1648227763,683,261
3028311577,3639515059,1666879958,1666880093,135,1662
3577878798,3362796099,1651497669,1651498434,765,2079
3637944484,3987606604,1649721811,1649722763,952,33
3435915872,3701726268,1651087809,1651088244,435,2418
3752522830,3285516363,1653206254,1653207137,883,1109
3250381378,3530806404,1653266575,1653267203,628,1659
3934125569,3751588241,1659957432,1659958321,889,87
3125730442,3201630796,1646969202,1646970011,809,20
3240435560,3603096470,1644317373,1644317526,153,193
3279239799,3426433476,1641708075,1641708535,460,1088
3239162274,3948942044,1651638529,1651638965,436,1211
3338020076,3104902156,1657081541,1657081801,260,1960
3370779634,3473571389,1665702063,1665702729,666,2498
3250566757,3168820334,1643856024,1643856096,72,30
3362898304,3445469609,1643084833,1643085382,549,2056
3214969929,3116451556,1651652761,1651653036,275,1756
3656158144,3694591547,1664523520,1664523874,354,792
3014511835,3033438220,1666659627,1666659929,302,1422
3327504995,3175976694,1657834687,1657834909,222,824
3494613087,3046618211,1651530150,1651531031,881,49
3253913009,3793840002,1654158634,1654158674,40,477
3876427301,3156261740,1660143567,1660144233,666,2491
3587727278,3613700451,1653589497,1653590178,681,910
3079447248,3837157118,1642834972,1642835379,407,1786
3082108681,3141963631,1652337466,1652337825,359,2373
3606994517,3649774117,1649605764,1649606213,449,12
3888505889,3377743288,1642770627,1642771418,791,418
3599327423,3099013723,1645555375,1645555947,572,405
3343048708,3524482926,1652198602,1652199600,998,362
3450228800,3453076338,1660335750,1660336030,280,584
3191265442,3879898101,1656818347,1656819321,974,2006
3331295538,3655786063,1661737351,1661738199,848,961
3718652649,3256807270,1655095473,1655096213,740,972
3850214790,3409978701,1660937999,1660938993,994,1244
3668753730,3561113748,1662387838,1662388392,554,992
3534910343,3105946115,1642707647,1642708553,906,2127
3859864317,3752858965,1667398972,1667399425,453,1367
3643637605,3337967165,1666728015,1666728127,112,695
3595535977,3105558193,1654407047,1654407744,697,590
3682279970,3055145919,1643110135,1643110808,673,1311
3361051044,3284380221,1652115474,1652116270,796,560
3699625300,3046787822,1647239185,1647239870,685,516
3817073865,3828531030,1664409485,1664409536,51,42
3029956642,3868474839,1659723958,1659724926,968,983
3231971396,3261403182,1643415871,1643415874,3,1030
3582544512,3223694966,1643318987,1643319769,782,2054
3346604377,3298505096,1668950831,1668951063,232,1892
3101265323,3638233110,1650733210,1650733950,740,188
3722948390,3814899146,1646400543,1646401226,683,1533
3611967437,3546432752,1650306860,1650307093,233,2340
3131753608,3693797946,1644277221,1644278115,894,1699
3223159718,3960727376,1666536362,1666537262,900,650
3092365114,3812481438,1653372953,1653373701,748,267
3795494127,3953483372,1650469819,1650470743,924,1873
3875045889,3165884724,1644062632,1644062979,347,23
3105558193,3636001595,1647562386,1647563300,914,2452
3745289284,3325981847,1669591144,1669592092,948,2462
3825332100,3819584735,1662050145,1662051142,997,746
3637944484,3180062640,1646909189,1646909672,483,94
3911960681,3265434991,1661421767,1661422123,356,2052
3755580356,3963793916,1658095753,1658096530,777,1642
3490415118,3663038239,1646023299,1646024029,730,1988
3405388298,3938776287,1661124151,1661125107,956,2214
3353500391,3693102953,1660593659,1660594198,539,2366
3249916829,3714203425,1654369239,1654369343,104,336
3645625556,3733102461,1657876967,1657877319,352,20
3535467955,3964434363,1649737318,1649737622,304,31
3018838603,3341241551,1665156470,1665156997,527,259
3908443461,3975663862,1664393900,1664394041,141,841
3414277030,3141198072,1650458207,1650458870,663,1402
3455941777,3875892624,1649977476,1649978219,743,772
3094940809,3140486428,1646752477,1646753259,782,2111
3053100790,3893709526,1647657659,1647658322,663,181
3937628057,3040136606,1644593618,1644594156,538,1064
3362836351,3356034290,1669053248,1669053593,345,741
3924990392,3088553332,1665072460,1665072484,24,1450
3876427301,3410655469,1665822705,1665822758,53,780
3578974875,3442244098,1665133426,1665133788,362,1158
3752653418,3558370114,1661365594,1661365596,2,1343
3624872846,3615848654,1641754662,1641755472,810,306
3913398460,3976095218,1665295669,1665296090,421,695
3211945942,3109390601,1657639173,1657639625,452,2249
3296556189,3713455058,1655169988,1655170141,153,1750
3846628868,3277577090,1650008699,1650009057,358,293
3957824946,3645484554,1661535486,1661536280,794,1680
3519726741,3564033398,1645054486,1645055313,827,1547
3811235183,3365316758,1661865049,1661865912,863,187
3273827707,3460678842,1659880280,1659880439,159,834
3464653044,3478921948,1643854266,1643854400,134,1153
3692368068,3596839317,1643780642,1643780900,258,1230
3241847877,3153902371,1647784492,1647784588,96,1596
3900755896,3063744739,1643743288,1643743780,492,1615
3887791096,3826827617,1654861415,1654862046,631,941
3864045087,3919792223,1652472479,1652473276,797,1332
3278077270,3368734939,1644292513,1644293230,717,234
3280405059,3795990774,1669357564,1669357689,125,1384
3689231617,3729475963,1655161056,1655161942,886,143
3609601814,3048386186,1669617657,1669617774,117,265
3291780380,3936821313,1642412861,1642413022,161,1208
3376579544,3669874673,1652070877,1652071451,574,1936
3949947697,3860432776,1646129608,1646130215,607,2494
3286466102,3304499678,1649399064,1649399137,73,2125
3733102461,3753985186,1646136264,1646136567,303,1584
3153040217,3032834107,1659251649,1659252178,529,1982
3192194263,3805653360,1665075863,1665076484,621,2280
3594009328,3755580356,1653315636,1653315837,201,1425
3819405521,3922766043,1646643339,1646643791,452,2023
3777684793,3194342775,1661363055,1661363461,406,808
3465433147,3288309878,1664740330,1664740558,228,385
3241021396,3574740304,1654913397,1654913651,254,1876
3866681013,3294783182,1667691956,1667692089,133,57
3068913990,3923647484,1659949682,1659949881,199,2308
3827557826,3254181971,1655354577,1655355153,576,2443
3610480358,3879898101,1657841852,1657842496,644,1078
3208346862,3281923852,1659308734,1659309082,348,991
3048077825,3686968293,1656711166,1656712003,837,982
3524942512,3693475435,1656312651,1656313642,991,1503
3697231480,3022401876,1669456716,1669456717,1,1232
3660732427,3548670552,1657763784,1657764667,883,176
3292797747,3967506765,1663389936,1663390897,961,2306
3146645864,3698965715,1643515156,1643515863,707,1064
3194069746,3690633750,1642947730,1642947742,12,1241
3822126164,3553436680,1657043230,1657043281,51,1173
3730702889,3524109178,1645468087,1645468473,386,2140
3166284447,3062844769,1646395582,1646396576,994,745
3704498751,3875118670,1651765645,1651766112,467,667
3061982327,3596076085,1669409972,1669410054,82,626
3194125043,3526687041,1663107107,1663107494,387,386
3266121254,3640756400,1666991540,1666992228,688,1660
3281562391,3871345895,1664197616,1664198348,732,1059
3866222795,3807440065,1647501742,1647502736,994,1375
3159645889,3112270906,1663153743,1663154470,727,2397
3245354614,3067220098,1644028253,1644029068,815,2361
3990949387,3645585393,1664572561,1664573345,784,853
3269283315,3251409316,1655636593,1655636769,176,1429
3333543321,3750698244,1656417652,1656418346,694,716
3173642675,3194259307,1653204940,1653205082,142,1353
3087326516,3474115926,1643368353,1643369163,810,979
3364600039,3351802314,1668072577,1668073204,627,1197
3061462743,3909168020,1666853027,1666853097,70,466
3311329069,3229497695,1641592911,1641593288,377,1803
3733004020,3638847705,1646684151,1646684657,506,38
3352389016,3415892236,1651834120,1651834432,312,1709
3894359262,3266498789,1657643005,1657643491,486,2152
3692441467,3778228977,1643752564,1643752992,428,1972
3828530052,3067930449,1658986312,1658987236,924,829
3990343743,3487387362,1655839294,1655839540,246,1332
3279671068,3521081470,1650462494,1650462636,142,2458
3984274810,3258057377,1644100167,1644100495,328,1463
3054803754,3412675211,1646043994,1646044487,493,2189
3510761729,3182643672,1648466977,1648467280,303,2237
3280558341,3714105777,1652819267,1652819957,690,75
3759909818,3983490056,1665065545,1665066366,821,2360
3705809622,3799480079,1662380735,1662380834,99,1307
3878177076,3392121294,1662638937,1662639651,714,905
3686320266,3596839317,1650157925,1650158812,887,2087
3645341350,3414834461,1662190513,1662191257,744,503
3645625556,3362405611,1652822350,1652823192,842,1319
3464754983,3650675743,1657072727,1657073026,299,1845
3120705176,3869495480,1650345987,1650346635,648,1227
3399622567,3833342718,1661386336,1661386646,310,690
3305299292,3961830711,1641268237,1641268669,432,2331
3792253761,3007480776,1642814875,1642815090,215,420
3690667222,3963303057,1642979556,1642980045,489,1435
3776027879,3130899709,1653723079,1653723622,543,433
3506090868,3329117199,1666190552,1666190995,443,2363
3296478783,3693691265,1648411667,1648412268,601,1267
3845256746,3914796719,1642909964,1642910633,669,274
3028267408,3508858140,1655618865,1655618979,114,1311
3569478966,3383110959,1644997662,1644997782,120,1282
3252421501,3837366084,1658212613,1658212652,39,1275
3493393225,3612878721,1651139974,1651140902,928,32
3378791519,3640349880,1662507716,1662507919,203,1744
3742647803,3471376255,1657860185,1657860844,659,2407
3794462820,3877638741,1654433531,1654434094,563,765
3316496524,3222060578,1650621406,1650622375,969,2451
3519233850,3962440297,1659210769,1659211672,903,270
3778894897,3754139010,1649853300,1649854198,898,1607
3791419861,3175595669,1644512700,1644512737,37,1813
3445666899,3783119155,1644552290,1644552840,550,1387
3134436515,3042836639,1641491730,1641492153,423,1264
3735855753,3772792062,1668067659,1668068175,516,2376
3632283664,3176317370,1656299266,1656299974,708,1976
3216241275,3898603481,1646792592,1646793229,637,1808
3513576000,3069881077,1664731305,1664731550,245,2197
3420489464,3685158343,1662200967,1662201308,341,2431
3658461707,3827431944,1661168907,1661168993,86,1119
3028679133,3435540149,1651404498,1651404520,22,2057
3091072272,3830866959,1655269497,1655270229,732,2473
3048296949,3548511640,1651460477,1651461420,943,776
3911849911,3409662195,1668130350,1668131034,684,781
3958449916,3605195406,1641236251,1641236413,162,2093
3222749852,3566874478,1649770093,1649770738,645,2067
3749980168,3899117968,1657962239,1657962871,632,599
3935022176,3049147900,1661949088,1661950015,927,1041
3363802434,3382693942,1650501868,1650502235,367,338
3893018254,3697085492,1661876905,1661877195,290,929
3302700303,3398508681,1660218971,1660219247,276,2217
3246321113,3764173171,1662971871,1662972000,129,1149
3410737355,3630966486,1651624973,1651625429,456,2459
3300994471,3506345760,1650688567,1650689028,461,344
3896867161,3096386556,1656046465,1656046696,231,2332
3917715509,3574708692,1661279571,1661280516,945,1577
3452843457,3195716414,1651047760,1651048395,635,2405
3306188967,3890159677,1648978867,1648979629,762,1819
3438465122,3126499590,1649166079,1649166118,39,1172
3816779135,3907665331,1667634663,1667635208,545,1356
3544020942,3719084637,1652588682,1652589414,732,2343
3860745004,3827551944,1641683270,1641683499,229,1244
3777929700,3786322776,1643686295,1643686868,573,1468
3457542537,3865950417,1665225394,1665225786,392,108
3829377486,3469507401,1661449617,1661449942,325,1374
3898495918,3629984961,1669470443,1669470705,262,1655
3037130270,3692247556,1662037791,1662038126,335,314
3454554705,3499841500,1662431724,1662432649,925,1193
3114733025,3069431080,1647006373,1647007073,700,1197
3736260750,3958507465,1649500802,1649501410,608,2228
3299389436,3394999152,1654720340,1654720816,476,189
3823790407,3921930806,1651937991,1651938461,470,966
3518322544,3595670942,1669023068,1669023135,67,1466
3130134092,3070237620,1647183967,1647184255,288,1430
3711490719,3089525434,1646821753,1646821815,62,507
3499182342,3824860461,1669269621,1669269856,235,694
3736911154,3650367155,1654483612,1654483685,73,1344
3885555985,3254695387,1647322755,1647323705,950,789
3129034897,3688056726,1660092973,1660093741,768,1521
3556061704,3595535977,1663308051,1663308751,700,912
3880608911,3881861537,1645138595,1645138695,100,1177
3701214753,3782673553,1647512138,1647512266,128,836
3696184358,3095437969,1649051390,1649051784,394,1263
3658513045,3190859932,1658009456,1658010357,901,1307
3467391664,3377781677,1646710330,1646710891,561,2018
3096274177,3882414600,1651425420,1651426113,693,1543
3537592483,3075001202,1651081246,1651081859,613,921
3053166522,3956547336,1666397476,1666397617,141,1873
3044117851,3887564578,1643445743,1643445908,165,1875
3403512366,3413777646,1644488080,1644488367,287,2342
3657753711,3546859493,1642356462,1642356898,436,789
3532450192,3127940283,1641336073,1641337055,982,911
3258352640,3207757416,1667070083,1667070550,467,1796
3056982737,3218946191,1655959516,1655959552,36,999
3650172161,3133153956,1662851271,1662851892,621,1791
3047372637,3250926786,1657475930,1657476750,820,1911
3290800332,3244918124,1669549393,1669549599,206,772
3269653223,3451823359,1654484868,1654485711,843,1478
3002316212,3286463125,1649932678,1649933554,876,334
3862456223,3462825977,1658126083,1658127005,922,1277
3629225227,3584925664,1644083427,1644083793,366,1178
3228794031,3998763119,1662039027,1662039079,52,1035
3520758396,3311860866,1643787266,1643787455,189,322
3672123230,3863652254,1662589855,1662590757,902,626
3656002043,3888141694,1666955651,1666956507,856,1978
3832265812,3018756378,1664736460,1664737028,568,928
3412675211,3650471605,1669400651,1669401128,477,1589
3665714575,3239527114,1646792591,1646792927,336,1114
3363802434,3020526331,1666560225,1666560527,302,2403
3772430644,3029578425,1662090160,1662090918,758,1002
3084730908,3724116295,1667240264,1667241040,776,460
3194379247,3156210736,1641123294,1641123835,541,516
3169559952,3816536444,1643792252,1643792369,117,643
3421671936,3679983127,1651141066,1651141450,384,1005
3451823359,3257865090,1653282487,1653282568,81,1498
3565056457,3515170949,1658052958,1658053872,914,1306
3440064321,3426617058,1657274262,1657275098,836,2493
3206061644,3504457520,1652266451,1652267072,621,128
3068296722,3097161771,1644719760,1644719920,160,532
3888312656,3291667893,1664242745,1664242972,227,1144
3330058679,3471587065,1646147908,1646148430,522,1651
3916456426,3471638565,1646818114,1646818599,485,738
3580774207,3898494020,1653242233,1653242594,361,1184
3374692305,3635921511,1655880861,1655881049,188,1812
3791547480,3167058279,1655559183,1655559466,283,2394
3529681535,3647398701,1645976259,1645977250,991,34
3479580096,3518607253,1648516056,1648516092,36,2416
3795990774,3304589206,1657278425,1657279038,613,1568
3085001659,3004890840,1641537969,1641538424,455,1091
3077552507,3437109709,1669707551,1669708004,453,788
3702983168,3741983763,1659928765,1659929413,648,839
3946068928,3435292986,1659175813,1659176778,965,2131
3946614568,3403933668,1649918098,1649918262,164,1680
3316485303,3343059553,1643735975,1643736580,605,2425
3888260346,3595726436,1644050606,1644051480,874,698
3003422357,3064804156,1643791360,1643791723,363,1582
3005101248,3168576951,1647625930,1647626644,714,1990
3910149883,3727859047,1666876249,1666876903,654,510
3350566867,3884346810,1657918586,1657918620,34,1632
3449504551,3292739128,1668559007,1668559232,225,1486
3688056726,3351863157,1646784055,1646784494,439,1969
3283947136,3804318840,1658428044,1658428845,801,1865
3555452314,3833553454,1650107002,1650107571,569,1658
3373962186,3029149493,1646017302,1646018070,768,1859
3718731864,3582060994,1641253516,1641254439,923,1475
3074795505,3784105182,1657643276,1657644071,795,1387
3448135160,3481308282,1644418906,1644418948,42,2177
3483445976,3322663101,1661990230,1661990893,663,229
3174676733,3126940487,1669278170,1669278819,649,182
3472820961,3613730980,1658366046,1658366472,426,57
3775753518,3821275122,1669071159,1669071279,120,1408
3199892178,3898403925,1649032124,1649032164,40,1155
3411921561,3998641184,1650131987,1650132366,379,1122
3895334140,3827431944,1665712883,1665713080,197,465
3002316212,3538686599,1651757313,1651757632,319,1753
3760142759,3912183552,1643365861,1643366690,829,889
3366896849,3426753006,1645678672,1645678855,183,1964
3383110959,3795792181,1644281038,1644281599,561,1413
3349626057,3017715856,1651155577,1651155932,355,1022
3802018450,3219435736,1655961904,1655962610,706,2018
3308028752,3477889008,1650064168,1650064959,791,920
3176346935,3008760173,1655608285,1655608933,648,173
3077683954,3432186900,1646787529,1646788478,949,1590
3079137127,3116684420,1660468027,1660468755,728,1715
3571991159,3456019436,1664122129,1664122342,213,2296
3241549340,3141134453,1667307675,1667308143,468,280
3751411767,3698156103,1653488315,1653488898,583,1786
3406239480,3095221133,1651471544,1651472052,508,478
3167121088,3478921948,1653978406,1653978881,475,1005
3461628724,3363125076,1659841499,1659841872,373,929
3287600901,3265078616,1665749049,1665749496,447,1591
3774945806,3982210988,1668756018,1668756494,476,655
3946068928,3952185527,1641124210,1641124967,757,2340
3194140038,3740183658,1651434956,1651435672,716,660
3080876844,3617340911,1658261000,1658261363,363,2259
3689544534,3912014286,1668203151,1668203416,265,1896
3364409507,3506384176,1669540528,1669540834,306,745
3656770582,3215514672,1661853377,1661853575,198,2119
3136174856,3576422890,1650916620,1650917523,903,1977
3898603481,3778625091,1641836597,1641837106,509,621
3848936636,3392469094,1667921565,1667922293,728,2068
3181778467,3721110937,1669138915,1669139375,460,324
3386961417,3423043196,1647726188,1647726800,612,767
3855113371,3414834461,1667192784,1667193204,420,1370
3449352254,3105946115,1655329787,1655330135,348,1272
3244946730,3234656999,1659910109,1659911054,945,265
3260867614,3554822566,1669290652,1669291493,841,1558
3639035607,3799480079,1667875746,1667876699,953,57
3918383192,3773658133,1666623883,1666624519,636,1963
3023448006,3784698616,1662169814,1662170756,942,282
3570872297,3991686619,1668110522,1668110648,126,1851
3159562411,3724861653,1650296479,1650297071,592,1806
3748812993,3117262222,1660465226,1660465412,186,1142
3569051470,3647938021,1668284581,1668284826,245,257
3190906256,3328245802,1643460624,1643461049,425,168
3004870031,3479580096,1653246390,1653247101,711,10
3420676198,3771841105,1651789014,1651789812,798,1725
3643372353,3187291408,1661911385,1661912057,672,463
3003941040,3768087701,1665568211,1665568718,507,1604
3430102174,3112217806,1657735429,1657735665,236,891
3964613907,3746979257,1663517390,1663517687,297,516
3335462055,3226092646,1641816415,1641817116,701,1236
3027295354,3443384698,1666001431,1666002160,729,483
3981019442,3115777637,1652090207,1652090353,146,147
3227584428,3411993487,1643740047,1643740378,331,1527
3410613004,3087394554,1665549682,1665550485,803,641
3306934792,3386868280,1650976050,1650977008,958,2063
3565803867,3252753513,1650071923,1650072143,220,128
3567328601,3389448374,1646341805,1646341837,32,1215
3657597585,3084855451,1668886427,1668886704,277,640
3597403559,3492103801,1663987166,1663987613,447,2209
3171235556,3524466015,1663993645,1663994549,904,843
3022102664,3420266147,1660501031,1660501519,488,2235
3533936136,3773488272,1652254840,1652255494,654,1209
3626552836,3579728276,1648779207,1648779899,692,1925
3091709202,3241944871,1660199929,1660200314,385,571
3222119601,3276118203,1665188865,1665189748,883,2320
3814045699,3622334419,1642038900,1642039006,106,1068
3737603669,3551170621,1648835806,1648836105,299,977
3936292699,3601240692,1659785092,1659785374,282,2173
3358578228,3419783275,1658277440,1658277524,84,500
3744955044,3182097979,1667972492,1667972525,33,643
3027064938,3406979800,1664576089,1664576470,381,1899
3886651871,3917229175,1667640032,1667640818,786,726
3565803867,3880046311,1649139835,1649139898,63,1540
3502815865,3645523523,1648308247,1648308298,51,147
3216810372,3524466015,1647300280,1647300807,527,1380
3637609349,3622485921,1668979153,1668979752,599,58
3182752768,3570480973,1668481134,1668481846,712,452
3863922323,3562463361,1645566762,1645567268,506,854
3121651540,3913071555,1654345010,1654345283,273,1296
3855063597,3505417530,1653077130,1653077636,506,1430
3636619501,3920261171,1651582539,1651583527,988,1030
3861496190,3277521554,1645725476,1645725932,456,1679
3877205464,3497171741,1668940544,1668941139,595,1011
3649154395,3504893701,1657615097,1657615765,668,2312
3465500045,3036527901,1642207893,1642208092,199,1169
3784594026,3634328779,1660737710,1660737916,206,1821
3283922234,3822213532,1649290236,1649290458,222,1804
3010368174,3765693461,1663204243,1663204915,672,1475
3269622220,3432563578,1645214003,1645214815,812,2313
3101161243,3053005521,1664800951,1664801061,110,1344
3239158180,3884067849,1668505942,1668506310,368,2339
3984570592,3439660528,1642003535,1642003922,387,549
3858225831,3559489793,1660768857,1660769640,783,2110
3399334455,3960897829,1667422031,1667422885,854,2470
3477243904,3216753609,1649701226,1649701520,294,46
3321818923,3765472006,1668569367,1668569600,233,1637
3359078190,3734035375,1664817628,1664817828,200,1187
3454753343,3102332016,1648279813,1648280305,492,2289
3900356013,3526797183,1664259489,1664260363,874,679
3523394395,3790829012,1659494896,1659495042,146,220
3578298884,3638281686,1653224242,1653224369,127,100
3814029511,3673892525,1645047622,1645048111,489,2143
3481293963,3195716414,1641971226,1641971799,573,118
3916928531,3335275571,1648414967,1648415009,42,1277
3436582780,3712115076,1667529779,1667530773,994,1534
3028803724,3137891271,1664696984,1664697644,660,21
3783325820,3066426534,1649699359,1649699681,322,2439
3370217481,3870778205,1653185697,1653186620,923,2284
3144175285,3299362427,1654787878,1654788729,851,1816
3137803904,3483445976,1661381708,1661382094,386,437
3417138981,3043310672,1652635067,1652636030,963,1400
3399235044,3759986276,1646888197,1646888309,112,2031
3396453607,3072347750,1665271954,1665271985,31,521
3769290304,3952283751,1651897449,1651898352,903,2266
3561529281,3777609973,1643886071,1643886919,848,6
3516838480,3551884757,1652778544,1652779463,919,34
3428763205,3194456422,1645807707,1645808116,409,140
3492638245,3318466045,1644356871,1644357201,330,1253
3868427833,3509167906,1663230270,1663230634,364,1182
3689231617,3516410980,1648263559,1648263922,363,50
3957411858,3293416862,1642572422,1642572870,448,1525
3075088680,3355910238,1650871034,1650871702,668,2274
3470586731,3005356433,1643709021,1643709885,864,1215
3001889220,3467686942,1647486746,1647487519,773,596
3102526783,3549475344,1648502308,1648502689,381,710
3724157579,3512353520,1663339279,1663339860,581,1386
3328024680,3006507589,1641814742,1641815184,442,2350
3566824993,3470570814,1651498002,1651498289,287,1724
3631340178,3636930993,1669706492,1669706692,200,1507
3983711613,3225857817,1659696660,1659696805,145,2197
3287988080,3401582775,1659836677,1659836741,64,2189
3335565751,3733440098,1662017396,1662018316,920,911
3313426081,3055145919,1651897767,1651898374,607,1118
3823161778,3289332257,1663463167,1663463439,272,1500
3662526382,3121932256,1643756800,1643757462,662,1218
3545701656,3163058578,1655382080,1655382234,154,452
3532270724,3428501033,1656245819,1656246560,741,57
3437707461,3507338655,1664212418,1664212939,521,1465
3819791378,3806936803,1666779859,1666780577,718,1740
3045427279,3456239535,1645993875,1645994129,254,780
3806875541,3702755503,1643162506,1643162651,145,2028
3215423327,3350891476,1662681934,1662682854,920,16
3158554223,3336965818,1643937319,1643937464,145,744
3645484554,3640957872,1655178949,1655179573,624,601
3393724727,3035476619,1662736612,1662737312,700,1263
3649658953,3166518187,1641336838,1641337730,892,1751
3350387055,3934848520,1642068318,1642068766,448,1364
3534715157,3575816255,1664807398,1664807632,234,973
3527995096,3855261620,1651560671,1651560879,208,1199
3993076833,3102672864,1653693215,1653693870,655,636
3288441459,3259430206,1666732564,1666733012,448,1401
3003941040,3925561355,1657411800,1657412408,608,2053
3277550058,3920261171,1642208265,1642209040,775,1396
3853056907,3045570288,1641266881,1641267216,335,1263
3482406705,3658423327,1654775497,1654775499,2,1197
3333223237,3904874839,1663630209,1663630767,558,2132
3177190923,3872170030,1662915970,1662916004,34,1640
3259039915,3831699015,1652262429,1652262978,549,131
3183299670,3407513744,1643695114,1643695901,787,1472
3594231530,3012930953,1646367748,1646367931,183,1686
3098538909,3988790434,1648261671,1648261851,180,1213
3573975780,3618683738,1646194424,1646195307,883,1830
3977139394,3256615260,1651236235,1651237060,825,1447
3122109326,3553725082,1667374725,1667375397,672,418
3497911447,3816026938,1652020202,1652020521,319,1947
3605519659,3970645989,1662128303,1662128700,397,1566
3748841094,3725283025,1655714966,1655715495,529,114
3666268915,3249916829,1660629609,1660630352,743,706
3291780380,3603594711,1652023482,1652023499,17,2245
3255751346,3150485567,1657479205,1657480161,956,705
3391056146,3386868280,1653800279,1653800284,5,195
3775753518,3129594470,1641969550,1641970491,941,1021
3152456543,3171282160,1661637112,1661637918,806,1003
3862102577,3964690423,1647128574,1647128896,322,1992
3814608487,3286129059,1641820093,1641820206,113,574
3776785233,3961973688,1657804062,1657804138,76,822
3996993457,3962138330,1654146680,1654147674,994,2463
3320767438,3516410980,1664296760,1664297639,879,819
3930994715,3473037406,1643897563,1643897929,366,1784
3617746688,3236308141,1648173447,1648173485,38,1691
3581026789,3926612159,1642890228,1642890671,443,127
3114764410,3705247337,1654797518,1654797527,9,2452
3802018450,3383110959,1651083525,1651083768,243,925
3583585259,3422046745,1649541347,1649541802,455,1075
3907713562,3963257683,1648086593,1648086969,376,2155
3625034951,3713404433,1657895396,1657895426,30,1357
3815692931,3364661787,1657485129,1657485189,60,385
3368294774,3666174374,1669521568,1669521715,147,923
3690043318,3832265812,1651313090,1651313679,589,133
3020526331,3904183865,1651293478,1651294308,830,2487
3853912096,3579642249,1642351638,1642352452,814,639
3649774117,3763723423,1655616521,1655616523,2,391
3828722911,3218903379,1660824362,1660824369,7,78
3620817271,3488151008,1656754253,1656754718,465,1564
3011993360,3166754795,1650492173,1650492434,261,2063
3682116874,3177190923,1655437172,1655437923,751,848
3342315965,3818713435,1651272285,1651273145,860,1324
3761147252,3494179125,1659907920,1659907938,18,223
3066990756,3197466224,1653561877,1653562811,934,907
3604852600,3342929537,1665754987,1665755664,677,1611
3383093669,3791460437,1664959393,1664959565,172,838
3467933841,3311329069,1662802382,1662803237,855,1118
3248892530,3457895283,1649867197,1649867992,795,638
3424884440,3051863550,1654350514,1654350625,111,1007
3539571109,3856658213,1642474314,1642475035,721,810
3021515419,3331977197,1659323425,1659323809,384,1746
3907764491,3909859344,1657975874,1657976652,778,488
3302917137,3113760926,1668345408,1668345475,67,1905
3475686271,3176526207,1649992852,1649993453,601,2380
3790648941,3392918310,1658812375,1658812596,221,1474
3379296882,3962658092,1660010362,1660010759,397,1619
3147298514,3857590396,1658041846,1658042612,766,2019
3562110382,3248900308,1642621159,1642621350,191,821
3315402916,3587727278,1645665317,1645666282,965,1297
3492247995,3887036201,1644144849,1644145036,187,1574
3647597870,3813666053,1647544969,1647545039,70,1010
3479608671,3951592432,1662703938,1662704049,111,950
3330048607,3982960576,1657879550,1657879879,329,904
3856474495,3957430800,1658021978,1658022382,404,1894
3790329301,3404959548,1661201073,1661201152,79,952
3232546504,3804914454,1661879811,1661880418,607,1144
3066451739,3895332326,1667033449,1667034303,854,934
3233507128,3246028948,1665019921,1665020151,230,2370
3467211844,3524482926,1665374988,1665375054,66,583
3669299007,3855113371,1662442020,1662442330,310,645
3969650128,3347896915,1655938885,1655939772,887,198
3912672075,3926088173,1645362435,1645363062,627,752
3036194601,3569244680,1665272370,1665272627,257,1049
3327253070,3776334300,1657267982,1657268291,309,1064
3465406980,3934848520,1657891776,1657892491,715,747
3424211722,3416719967,1647197691,1647198399,708,524
3448139036,3209480732,1669145105,1669145286,181,118
3910979746,3628729475,1657652223,1657652854,631,1031
3026025743,3995358434,1652963352,1652963752,400,2495
3370350588,3954297181,1668207621,1668207876,255,1246
3070676307,3990037235,1641971935,1641972355,420,128
3867115890,3101265323,1655784268,1655784621,353,500
3465064732,3239158180,1642549001,1642549046,45,1184
3023075779,3747907269,1641656190,1641656621,431,632
3115245083,3883874845,1665340941,1665341465,524,1524
3859379131,3981379416,1656595535,1656595570,35,952
3411272565,3089126812,1655278442,1655279019,577,1079
3821998886,3100670764,1644179597,1644179823,226,2308
3261195333,3988976739,1657610241,1657611152,911,2256
3583918364,3629412022,1663016538,1663016815,277,2021
3481620613,3272663489,1667181784,1667182075,291,2330
3864414449,3764318951,1654076030,1654076056,26,1077
3833594316,3097426944,1656417531,1656418232,701,2019
3559208316,3156962564,1668771509,1668771618,109,1147
3319946083,3652765431,1669722251,1669722957,706,1687
3324634418,3519003851,1660122012,1660122032,20,1624
3997038651,3242752835,1653724307,1653725124,817,2164
3436234030,3914926954,1647454254,1647454393,139,255
3612642897,3612973191,1644492899,1644493526,627,1602
3974758009,3119345995,1658499415,1658499435,20,1058
3913366963,3012034151,1660750517,1660750606,89,1418
3463405011,3322656350,1658275172,1658276022,850,251
3741929805,3409352040,1668060776,1668060908,132,2005
3985854594,3225328547,1646774418,1646775337,919,1212
3230248695,3698633384,1657253929,1657254457,528,2064
3925344243,3971722824,1658918746,1658919555,809,1739
3468987116,3240435560,1651328820,1651329819,999,1961
3889967886,3492657889,1654483097,1654483683,586,1716
3086575348,3293339453,1663858865,1663859505,640,939
3414224162,3175478710,1651184475,1651185076,601,804
3883864322,3694210631,1651352512,1651353136,624,765
3948754212,3736681866,1650488892,1650489235,343,1859
3809387134,3752653418,1655986362,1655987280,918,110
3297681098,3564395523,1647232561,1647232939,378,252
3104303534,3479087219,1648851671,1648851696,25,776
3684883542,3340337106,1667591202,1667591951,749,1036
3477243904,3755580356,1654682551,1654682650,99,2093
3163986082,3086324092,1643485469,1643485942,473,1235
3393156673,3782457642,1669509810,1669510765,955,1144
3718882981,3840416991,1643149113,1643149448,335,964
3031816428,3199395221,1661102853,1661103188,335,1107
3287988080,3615848654,1669704021,1669704662,641,952
3936042616,3135134317,1653086691,1653087049,358,163
3189085834,3819770312,1654388532,1654388641,109,368
3502074085,3364456908,1654670210,1654671078,868,666
3042461816,3012323943,1649780058,1649781038,980,390
3998728915,3960450011,1660624750,1660625496,746,1336
3105449263,3761142574,1658157150,1658157648,498,383
3890159677,3599104606,1653707776,1653708070,294,1340
3419751912,3493232103,1645830615,1645831288,673,2465
3850906711,3092925867,1658437162,1658437215,53,2069
3759656646,3666179764,1655337935,1655338462,527,1657
3869794122,3911632634,1666871697,1666872308,611,630
3497171741,3832585790,1660546928,1660547773,845,1434
3098546487,3154553765,1646598551,1646598975,424,99
3595726436,3703881738,1647321295,1647322119,824,1778
3371002443,3287508774,1664968002,1664968018,16,93
3424884440,3681631482,1656441888,1656442279,391,1990
3461938856,3089034472,1643120938,1643121597,659,1143
3876696308,3232285701,1657267948,1657267987,39,1
3010673027,3672560021,1653065646,1653066196,550,276
3737772457,3632283664,1650275257,1650276069,812,557
3690518174,3292368988,1649188588,1649189560,972,975
3408104715,3132349279,1658609777,1658610074,297,69
3408978529,3194204306,1656306916,1656307361,445,1881
3278038835,3450628929,1658443893,1658444190,297,908
3680060067,3949445116,1651697199,1651697765,566,1059
3823161778,3333776110,1646951752,1646952378,626,1777
3202783831,3339264241,1646342749,1646343391,642,2091
3297963936,3850178015,1652560597,1652561481,884,1509
3433261355,3972955608,1643822461,1643822815,354,1238
3478280943,3019204329,1663256093,1663256526,433,1168
3813403697,3299211422,1652059651,1652060506,855,1677
3074795505,3660468597,1647148880,1647149554,674,286
3366155048,3438247915,1654081261,1654081788,527,203
3201630796,3156928973,1651467715,1651468365,650,2462
3668174777,3505417530,1643849265,1643849465,200,1832
3898959510,3726788021,1644637913,1644638404,491,527
3516624109,3617795950,1645304387,1645305089,702,2429
3269690639,3618380884,1648877732,1648878648,916,1807
3929887239,3119702215,1645677366,1645678105,739,310
3458116043,3265895976,1669610280,1669610334,54,178
3588376802,3135556195,1666994686,1666994861,175,429
3729321195,3055211808,1666960416,1666960810,394,1818
3705943924,3797182963,1658944335,1658944548,213,1125
3064831559,3105815944,1644400967,1644401784,817,1176
3734621671,3792527009,1661910578,1661910893,315,648
3740102481,3284137438,1641094108,1641094903,795,544
3124562368,3105789496,1647183627,1647184478,851,1360
3524482926,3622478840,1649052610,1649052642,32,882
3304497399,3399631396,1668440969,1668441107,138,146
3443785253,3868427833,1643595296,1643595908,612,191
3407460146,3888851378,1661089055,1661089215,160,1181
3095151362,3311252249,1666591808,1666591917,109,652
3536903033,3867205407,1663283555,1663283994,439,1795
3702983168,3879322451,1669405376,1669406307,931,2055
3986814631,3232342525,1667103429,1667103966,537,894
3151704655,3687239883,1655223342,1655223864,522,880
3948754212,3370779634,1661326924,1661327171,247,1640
3695478448,3391540103,1668805327,1668805989,662,292
3570335491,3905356323,1664874046,1664874793,747,1049
3225466850,3350566867,1656393803,1656394265,462,2178
3772034355,3262711330,1661214756,1661215261,505,1315
3979899306,3433576059,1654150428,1654150692,264,2436
3651110510,3412675211,1646997980,1646998091,111,274
3639695113,3939977057,1654754359,1654754457,98,134
3969650128,3861247260,1664466567,1664467415,848,1816
3541423460,3669311789,1642515520,1642515913,393,672
3170292789,3580594125,1651014690,1651015044,354,2462
3989206811,3707362025,1661647588,1661648331,743,2329
3587171844,3168535205,1661566161,1661566445,284,2410
3761147252,3212841978,1658568696,1658569249,553,1619
3725611236,3947083981,1647869162,1647869568,406,1146
3645523523,3931230284,1652991937,1652992405,468,2452
3415917688,3937445570,1668913222,1668914051,829,397
3898641431,3127142463,1644240140,1644240392,252,2469
3774437189,3275027460,1663345496,1663345510,14,1428
3714535860,3194664110,1646483954,1646484950,996,963
3410719383,3074477991,1663910102,1663910133,31,2384
3318663320,3139035952,1657461758,1657462725,967,1708
3030117347,3730845439,1669557239,1669557308,69,1922
3429010148,3343941091,1652611311,1652611323,12,410
3134422689,3660575608,1650266027,1650266617,590,69
3506143492,3398412701,1642756283,1642756932,649,161
3814620482,3192367201,1655418064,1655418292,228,641
3716626172,3106732056,1652065004,1652065362,358,1346
3548128446,3960727778,1663861740,1663862701,961,577
3770641398,3148041041,1663278832,1663279510,678,2000
3860268588,3308071201,1669542585,1669542719,134,2255
3898391169,3340125949,1656930611,1656931524,913,1490
3168625610,3218798966,1653824892,1653825524,632,1454
3968682824,3735691730,1644667442,1644668103,661,2348
3969744786,3668753730,1664871467,1664871961,494,1069
3021492589,3030630339,1667656327,1667656632,305,1993
3367279073,3664381582,1648676252,1648677216,964,127
3253589940,3637518238,1657410022,1657410745,723,289
3693581710,3530162623,1643573254,1643574179,925,2202
3066990756,3633544934,1655221425,1655221942,517,706
3911671645,3228518080,1649441453,1649441717,264,1461
3904012023,3257034858,1647799714,1647800105,391,253
3160938941,3799459873,1654065651,1654066528,877,1513
3485815053,3568141696,1668631229,1668631450,221,1598
3023530031,3270177744,1647725612,1647726282,670,40
3048077825,3429074631,1641794847,1641795007,160,667
3756028002,3556647439,1664452126,1664452884,758,2476
3101886383,3466735449,1661832633,1661832795,162,1635
3823942349,3469648387,1652911424,1652911474,50,530
3178742688,3496369924,1654972159,1654972432,273,951
3677064508,3866260144,1664857113,1664857938,825,1593
3929305160,3300015174,1658251693,1658251857,164,1561
3181388502,3965434074,1660897009,1660897380,371,578
3199255829,3508340066,1646333144,1646334045,901,1884
3269294562,3929794333,1657400851,1657401449,598,2440
3857215319,3682608460,1649195949,1649196296,347,739
3035245517,3028535162,1665296812,1665297264,452,2267
3060121211,3060522981,1664003052,1664003385,333,471
3990312725,3220736075,1658862944,1658863693,749,2253
3400121632,3886158471,1663613578,1663614307,729,2371
3848272906,3186371475,1646808642,1646808989,347,829
3293339453,3714719241,1667990877,1667991481,604,1751
3279773317,3524942512,1641525519,1641525756,237,1384
3943184820,3002415281,1647494921,1647495051,130,1246
3247551122,3456019436,1647437316,1647437672,356,2471
3554275173,3993814137,1645456248,1645456760,512,130
3957577547,3500152600,1648528590,1648529379,789,951
3973440480,3841314189,1661737901,1661738556,655,785
3196704660,3299191225,1644347830,1644348671,841,638
3169601604,3608485872,1654710549,1654711459,910,929
3397972687,3595469152,1646108881,1646109478,597,1578
3881956491,3128318593,1655914300,1655915109,809,1205
3971180079,3120419076,1661669116,1661669403,287,2145
3128449335,3148691436,1645878797,1645878971,174,1730
3814620482,3612061421,1658067778,1658068211,433,568
3432522125,3515138485,1648691527,1648691763,236,2213
3784698616,3865781327,1648471730,1648472523,793,831
3143293050,3375847073,1668630892,1668631013,121,1877
3092564684,3521410258,1655449739,1655450320,581,1784
3723110330,3832640445,1653900859,1653901440,581,1085
3647255060,3322656350,1657503628,1657504487,859,2172
3407909365,3784698616,1657946536,1657947247,711,947
3204083684,3887397856,1653349727,1653350616,889,1581
3641542734,3990643900,1651358369,1651359164,795,2305
3796559738,3344549344,1655918675,1655918908,233,2255
3421178618,3243902799,1657277233,1657277569,336,2481
3294569676,3403471618,1665619265,1665619374,109,1028
3620395885,3342929537,1646379566,1646380307,741,2082
3264993323,3667718430,1667614491,1667615254,763,2362
3441206388,3502074085,1654979198,1654979754,556,268
3541200701,3493752989,1649845959,1649846178,219,1963
3229318915,3066714195,1667589458,1667589930,472,846
3880835949,3995358434,1646054364,1646054688,324,1899
3696211720,3190035679,1652152669,1652153215,546,90
3594777411,3580310329,1641195015,1641195121,106,1446
3457451540,3108427765,1641947190,1641947494,304,967
3985513037,3452391459,1646771719,1646772305,586,1814
3324069408,3894801934,1665138767,1665139549,782,595
3618397647,3191265442,1647058738,1647059049,311,268
3436582780,3067380299,1658917741,1658917972,231,2040
3345875910,3038823274,1664877003,1664877933,930,272
3489915638,3506187447,1653391226,1653391604,378,2451
3485815053,3231988469,1645142376,1645143293,917,811
3061299464,3230836206,1663069746,1663070159,413,2051
3860883669,3191133743,1666421831,1666422089,258,313
3569600936,3278854404,1656577649,1656578099,450,2400
3678805802,3339719117,1665674934,1665675571,637,1619
3969110896,3404432145,1650747089,1650747228,139,1446
3144068102,3090304189,1654939744,1654939791,47,2042
3047643464,3511569871,1647079944,1647080150,206,2230
3356590035,3105636655,1645192516,1645193332,816,1466
3522963106,3608200385,1644489077,1644489999,922,220
3107501731,3230248695,1651944510,1651945342,832,743
3970286228,3066546417,1652015713,1652016305,592,544
3066362135,3133805973,1650427996,1650428933,937,355
3100201926,3778575442,1650019607,1650019911,304,1805
3601240692,3040867771,1647719750,1647720463,713,1861
3973713516,3623974243,1652281279,1652281594,315,998
3075465136,3358277498,1641762573,1641762662,89,1187
3209097023,3227310314,1669363633,1669364251,618,223
3638527581,3776685300,1664346552,1664346640,88,1873
3076285457,3040867771,1663929504,1663929549,45,1144
3381398230,3827461144,1644410628,1644410724,96,1226
3660513601,3630123918,1650445125,1650445565,440,1721
3081803809,3153413554,1665502701,1665503659,958,114
3466494394,3327427782,1664655535,1664655945,410,312
3895542691,3561899633,1660804139,1660805029,890,2185
3878698797,3202984277,1656839476,1656840208,732,2163
3934383056,3005809519,1645353215,1645354116,901,1979
3031299470,3321346285,1646268172,1646268270,98,769
3952425376,3182135067,1643244801,1643245133,332,1835
3537411123,3217857851,1647999479,1647999619,140,393
3906772132,3724669056,1663051410,1663051434,24,1635
3614206353,3444005080,1656814420,1656814463,43,1343
3346986628,3855984822,1647886926,1647887422,496,1075
3473399101,3125350196,1665554337,1665555097,760,2367
3629412022,3401463703,1659360177,1659361123,946,869
3299362427,3557734825,1663808781,1663809652,871,673
3722078855,3141048645,1651559920,1651560396,476,2098
3776063818,3997215508,1654186556,1654186843,287,1640
3427342650,3959093613,1655955042,1655955670,628,1379
3310294122,3817667121,1647110173,1647110175,2,700
3796875669,3855218155,1646610021,1646610669,648,1557
3795269127,3431117217,1658434109,1658434109,0,161
3639695113,3615897427,1663141038,1663141225,187,1882
3710708040,3904546701,1658890577,1658891434,857,2136
3359601528,3225328547,1643082282,1643082922,640,2489
3345543859,3391540103,1646846968,1646847532,564,1757
3516547882,3288106394,1656910225,1656910282,57,1265
3208831400,3505322684,1645852518,1645852929,411,2017
3639804787,3018838603,1659942607,1659942728,121,2057
3822404633,3341283434,1664100560,1664100684,124,1288
3083182515,3294783182,1664651536,1664652199,663,513
3202225412,3663985085,1641430078,1641430967,889,368
3726378645,3828810890,1654408350,1654409275,925,924
3879257961,3087700946,1655583924,1655584617,693,378
3693475435,3849816711,1663664547,1663665002,455,125
3762829533,3989206811,1650876232,1650876426,194,767
3548351680,3342538148,1656320717,1656321322,605,1645
3036470049,3880298832,1645963595,1645964591,996,270
3538686599,3659752387,1664090567,1664090740,173,1931
3019576854,3952107057,1668820112,1668820394,282,2420
3151323388,3120737114,1666652897,1666653229,332,1601
3740009683,3956027073,1648712569,1648713210,641,2146
3041155430,3037090215,1652996038,1652996720,682,523
3930591160,3383791217,1650868286,1650868969,683,2170
3406979800,3072741474,1652395771,1652396064,293,2079
3474115926,3541200701,1661534528,1661535000,472,2366
3855777399,3089844622,1643423706,1643424247,541,149
3993332175,3871736180,1653269540,1653270522,982,945
3263842575,3175929512,1646629597,1646630217,620,1261
3060522981,3762890946,1658110406,1658110712,306,972
3416521015,3310715907,1647491042,1647491959,917,1344
3554275173,3292298549,1668033511,1668033654,143,34
3759967696,3465382952,1645939677,1645940026,349,31
3025014828,3759867623,1669443005,1669443234,229,888
3527201198,3118554894,1662604156,1662604940,784,1035
3535763829,3764724451,1659195421,1659195699,278,943
3424522509,3257690557,1655932920,1655933437,517,426
3678505160,3832243899,1645260215,1645260351,136,1838
3095170532,3140488273,1652538325,1652539265,940,1275
3413056504,3168434098,1660265767,1660266707,940,2299
3290860752,3457998128,1655207780,1655208328,548,901
3434575449,3931294653,1666038304,1666039264,960,2126
3491562484,3777846262,1662946119,1662946680,561,200
3620725243,3616803531,1669490404,1669490986,582,2365
3738571497,3177427428,1649219264,1649219325,61,1207
3163326257,3442967650,1646999568,1647000284,716,1409
3814851615,3114744245,1646641379,1646641779,400,1925
3638281686,3527201198,1647358797,1647359432,635,824
3084138267,3520571883,1665327448,1665327480,32,960
3824353209,3964987979,1649234257,1649234657,400,1858
3941548978,3480905975,1668165773,1668166568,795,1223
3670266153,3083791573,1653078059,1653078626,567,105
3902777743,3664267954,1660014940,1660015853,913,610
3896867161,3023448006,1655401753,1655402528,775,1660
3129667560,3877638741,1667384074,1667384638,564,2143
3896308173,3574708692,1641453991,1641453993,2,2294
3112622637,3114863942,1667414697,1667414789,92,190
3658461707,3708101315,1666335544,1666336150,606,1483
3749619105,3482891017,1657742717,1657742977,260,2387
3806520351,3564026629,1659459104,1659459107,3,1704
3977860015,3421730413,1659163164,1659163562,398,1087
3015956370,3082026010,1649267693,1649267922,229,1789
3982058383,3948964302,1650139718,1650140282,564,942
3794447092,3062423981,1661475125,1661475411,286,2038
3257118282,3363279084,1661385394,1661386316,922,291
3515941468,3285303154,1646450906,1646451748,842,281
3151386327,3529898997,1662481302,1662481418,116,1576
3980841914,3286555567,1644000004,1644000605,601,2468
3348390759,3501732936,1643737312,1643738283,971,1024
3336525489,3312930717,1662228788,1662229408,620,360
3378325026,3848963466,1648828669,1648829594,925,932
3950936299,3993365296,1660800520,1660801327,807,480
3970286228,3150027454,1641818372,1641818479,107,808
3925393914,3892535771,1663762434,1663762605,171,1000
3635921511,3365381632,1645654972,1645655456,484,208
3022348535,3599795440,1659642818,1659642986,168,1815
3716977635,3220405755,1658377931,1658378539,608,2381
3051404798,3124574350,1660739916,1660740741,825,0
3542129823,3780991625,1666672498,1666673227,729,1790
3025108334,3395525819,1659604414,1659605404,990,2086
3890781778,3531859919,1652190664,1652190699,35,1469
3426433476,3629207282,1665767790,1665768776,986,1100
3154991935,3554753273,1669646207,1669646854,647,1620
3702541874,3546799061,1649494832,1649495382,550,463
3095594016,3720012234,1652379195,1652379398,203,44
3943927246,3678336055,1647664569,1647665044,475,1954
3151704655,3063714742,1663357194,1663357703,509,555
3339415879,3746443510,1661797062,1661797451,389,450
3747062640,3770948247,1656991649,1656992163,514,1968
3479725709,3027110508,1662389239,1662390153,914,287
3286065477,3307949630,1653138864,1653139085,221,861
3407156969,3125911793,1651717831,1651718779,948,1161
3999228111,3275436235,1654012697,1654013561,864,225
3346484497,3095503795,1651100384,1651101063,679,1946
3617715231,3387785849,1661851359,1661852209,850,1188
3016995357,3997758248,1662463733,1662464428,695,1908
3309219121,3314823389,1654253705,1654254208,503,719
3012929490,3306252501,1646171465,1646171606,141,1700
3340511048,3626216693,1662165200,1662165927,727,2030
3016299339,3148589566,1653146414,1653146604,190,151
3497079704,3023140319,1656194691,1656195384,693,910
3205472801,3951692395,1646899383,1646900159,776,582
3217923322,3917067097,1660845627,1660845819,192,183
3832296106,3875118670,1647857661,1647857972,311,1461
3251948771,3712211736,1644074741,1644074839,98,1060
3074928223,3434864548,1651450734,1651451443,709,1465
3555187890,3066990756,1654758908,1654759114,206,574
3318848700,3813666053,1667397041,1667397881,840,1884
3374007172,3790883274,1660211889,1660212259,370,1304
3417532235,3079013365,1661300013,1661300999,986,440
3394936535,3949668592,1663796619,1663797547,928,1315
3658513045,3659204779,1668904750,1668904999,249,267
3669880471,3218798966,1660807585,1660807651,66,1484
3587874085,3799078288,1647563153,1647563208,55,1841
3561543601,3690646467,1666817250,1666817615,365,1249
3917715509,3893828389,1651006899,1651007633,734,1577
3241500636,3593437920,1656224704,1656225203,499,405
3063520189,3098316380,1663002961,1663003087,126,1746
3511593307,3276118203,1642487397,1642488182,785,437
3891270072,3519269683,1648099615,1648099806,191,829
3404394014,3597403559,1659429746,1659430144,398,1689
3595500034,3642339062,1666542403,1666543324,921,1501
3404394014,3527201198,1657833236,1657833802,566,1582
3769290304,3843953645,1655304261,1655304392,131,1146
3339480960,3219509030,1647151176,1647151443,267,1555
3553146922,3744347272,1645295309,1645295464,155,1919
3992817916,3865950417,1659948406,1659949210,804,2277
3963257683,3980934555,1648493073,1648493175,102,1208
3903978752,3814608487,1656854519,1656855510,991,2290
3256566881,3598223917,1641780073,1641780369,296,1790
3062015697,3962676436,1649697104,1649697712,608,2483
3335915365,3697692313,1645130707,1645131352,645,1797
3983158937,3446481380,1655206954,1655207098,144,2270
3876377964,3213124781,1644839467,1644839857,390,75
3170158934,3430387951,1652035764,1652036194,430,1586
3414488975,3273676719,1662459198,1662459877,679,572
3073474496,3629999604,1641327786,1641328483,697,307
3930565588,3594231530,1648385816,1648386232,416,781
3803000258,3455040603,1656690169,1656690242,73,670
3004708023,3636446257,1657311346,1657312287,941,1226
3933332705,3985239597,1663086342,1663086449,107,2058
3771588829,3949133704,1662918056,1662918844,788,699
3154079557,3443084089,1651166999,1651167078,79,196
3733102461,3586101932,1662335875,1662336494,619,995
3061619114,3869794122,1641275280,1641275855,575,2102
3175676853,3833692711,1657007273,1657007763,490,2096
3744002702,3787514151,1655224876,1655224983,107,1114
3023431340,3574285791,1647649404,1647650280,876,2287
3743934334,3279671068,1664861532,1664861654,122,878
3987162833,3276142713,1646736836,1646737503,667,1459
3319422840,3615137704,1643781904,1643782846,942,627
3862829462,3599874732,1651820027,1651820068,41,1937
3822816987,3280328195,1650489122,1650489159,37,1474
3356689959,3097033729,1644874626,1644875217,591,2288
3048388831,3831380073,1665472010,1665472335,325,1408
3007357837,3129993467,1664764858,1664765855,997,2262
3967147343,3968412854,1658318228,1658319198,970,1774
3328544337,3624171160,1642860064,1642860423,359,2380
3577990920,3732840219,1656780553,1656781031,478,456
3671974600,3358743866,1654040159,1654040163,4,1144
3102526783,3868873330,1655717535,1655717755,220,397
3030117347,3883071832,1643851565,1643852543,978,2331
3878512967,3628554134,1663439317,1663439802,485,817
3745420516,3727859047,1659240403,1659240609,206,470
3103943430,3096854657,1665477280,1665477417,137,808
3771931468,3681719344,1652424447,1652425137,690,2125
3462714323,3896922629,1641867432,1641867704,272,2250
3884067849,3714535860,1662894402,1662894698,296,2466
3945055663,3356728242,1645375229,1645375706,477,1109
3474975781,3899315309,1667088395,1667088815,420,1820
3484699376,3118502732,1650037148,1650037281,133,852
3733102461,3617324068,1653497424,1653497842,418,1067
3107366519,3757518149,1659713300,1659714156,856,1364
3158988425,3225477579,1651756626,1651757372,746,401
3018946311,3953927472,1654673969,1654674061,92,961
3883071832,3516107650,1668436812,1668437276,464,2134
3723944830,3729768092,1664503395,1664503924,529,1586
3771931468,3190906256,1659240045,1659240049,4,2086
3473037406,3414719919,1653238111,1653238537,426,2098
3181778467,3927273567,1663137616,1663137987,371,38
3306188967,3809698347,1643765533,1643766405,872,2188
3037042091,3913680174,1654646321,1654646410,89,1926
3354200745,3067220098,1665291615,1665291698,83,11
3154653229,3795494127,1658636513,1658637500,987,968
3881378306,3012032774,1647150013,1647150698,685,491
3664989774,3343153937,1661023229,1661023878,649,757
3515933745,3173034893,1647238039,1647238790,751,1652
3921877328,3110360947,1648547591,1648547722,131,786
3148366567,3217029107,1642498212,1642498259,47,675
3844966905,3499841500,1661116929,1661117802,873,357
3628830127,3526327974,1660888085,1660888295,210,2297
3601187603,3197176680,1658689579,1658689679,100,2432
3479608671,3066757468,1645499806,1645500101,295,1697
3609029368,3043256301,1665852199,1665852442,243,2282
3732840219,3294984880,1646875067,1646875414,347,566
3555966791,3633544934,1642719257,1642719876,619,1370
3855113371,3188567155,1666193251,1666194234,983,16
3609601814,3370263528,1650451125,1650451212,87,1567
3408460871,3792924517,1642012855,1642013636,781,1067
3840422094,3191462400,1664327305,1664328273,968,615
3125813072,3633382140,1644800642,1644801367,725,919
3042176960,3692441467,1654316700,1654317135,435,85
3152109348,3131683456,1645612555,1645613485,930,1875
3230836206,3994014690,1657422618,1657423582,964,817
3819547274,3942393978,1659802174,1659803093,919,1309
3337305693,3021253966,1663348080,1663348844,764,2431
3759510872,3738761840,1662161082,1662161089,7,534
3766595984,3865781327,1664671018,1664671300,282,2152
3500053511,3476450845,1662548998,1662549122,124,1050
3261447619,3634044438,1643563065,1643563305,240,2355
3834706710,3960267299,1652443624,1652444525,901,1289
3530286335,3028364856,1668455782,1668456103,321,1515
3779319466,3323797477,1657353891,1657354171,280,1572
3115928790,3361290885,1646411538,1646412136,598,1724
3306753571,3680703930,1652817001,1652817328,327,2369
3278886018,3908443461,1661211971,1661212848,877,2433
3591724433,3909173527,1653817299,1653817507,208,1699
3423965711,3990312725,1644998843,1644999439,596,1665
3090506589,3885694482,1655446126,1655446956,830,1700
3217137285,3029943531,1662168992,1662169916,924,1742
3084007689,3106276005,1656454507,1656455164,657,164
3085676024,3440372055,1658161294,1658162242,948,1095
3417742545,3870032753,1668582327,1668582780,453,1920
3164789962,3290176410,1665727279,1665727699,420,1809
3358241145,3188936143,1653799480,1653800102,622,687
3506937925,3494990710,1668820140,1668820206,66,2155
3393528919,3865529150,1658383720,1658384097,377,1013
3298748343,3219440900,1652995160,1652995632,472,1032
3009169806,3642498039,1653486712,1653487273,561,1072
3204508195,3558370114,1661690897,1661691008,111,1700
3195138141,3271318708,1668382150,1668383063,913,2278
3003134699,3110691442,1646434848,1646435764,916,876
3546782886,3766914780,1652250893,1652251285,392,2235
3901468403,3125008218,1657683618,1657684308,690,792
3854737938,3261477798,1650630985,1650631445,460,1683
3819541125,3501568597,1668710958,1668711242,284,1628
3489254440,3223064733,1661501418,1661502332,914,860
3537214664,3664989774,1650308524,1650308870,346,1665
3895990286,3298857826,1652388794,1652389515,721,2423
3066426534,3070237620,1654441253,1654442193,940,2401
3757189761,3438222015,1651258916,1651259528,612,195
3448378304,3486907422,1659603335,1659603836,501,1332
3399622567,3389497658,1655240709,1655241229,520,1998
3475322181,3022256617,1657859883,1657860121,238,579
3139376524,3573975780,1657435237,1657435949,712,1108
3904007370,3575816255,1648284379,1648285281,902,959
3656000543,3312805786,1667630806,1667631044,238,1909
3374007172,3189358030,1645739675,1645740455,780,1290
3337601088,3535941714,1662034713,1662034999,286,1807
3240347468,3938025728,1656692058,1656692559,501,706
3712630492,3619175296,1654428600,1654428708,108,1972
3086835861,3108818977,1641053046,1641053924,878,313
3418988797,3625651694,1657680336,1657680656,320,1215
3541597384,3922851964,1668638913,1668639821,908,55
3878852082,3080876844,1667400147,1667400955,808,2462
3218903379,3653780780,1657307460,1657307795,335,2236
3052396813,3154309446,1646365814,1646366298,484,454
3891477592,3597251704,1648622756,1648623520,764,231
3604769442,3658656847,1668104376,1668104423,47,2440
3677574672,3700813458,1653836351,1653836399,48,1089
3675683512,3628963667,1646232461,1646233272,811,644
3649036884,3706178319,1648934008,1648934405,397,676
3183079019,3859864317,1651634450,1651634716,266,1051
3537629569,3947921257,1661120110,1661120825,715,910
3962722941,3033079935,1645441465,1645442234,769,498
3017740025,3857687791,1650737261,1650737463,202,42
3032431944,3480115115,1659826988,1659827406,418,1920
3539839307,3211401798,1648102973,1648103884,911,2037
3280223679,3445863766,1650935180,1650935644,464,921
3905356323,3934386586,1655772125,1655772615,490,338
3615177362,3565287194,1667936689,1667937656,967,334
3256231811,3870779720,1655409332,1655410209,877,1033
3342215329,3967425379,1650692021,1650692813,792,1571
3897756969,3057348673,1643374133,1643374866,733,2048
3659563225,3925561355,1657007028,1657007188,160,983
3135134317,3522861132,1662990996,1662991602,606,2214
3424431005,3025133604,1662727264,1662728215,951,1156
3784168038,3515941468,1665340974,1665341202,228,1079
3868474839,3425720812,1653858774,1653859313,539,1874
3740102481,3824649355,1642499307,1642500262,955,372
3555560595,3049147900,1649965015,1649965513,498,1896
3628675820,3550741990,1643396587,1643397046,459,515
3301202561,3751411767,1668161881,1668162316,435,1236
3137829230,3542078032,1643962989,1643963370,381,1392
3771588829,3483827042,1658031871,1658032271,400,867
3257034858,3639695113,1659187275,1659188038,763,205
3331604266,3162844882,1657192154,1657192962,808,1845
3607354151,3197545162,1658368149,1658368284,135,1076
3962138330,3339719117,1645871641,1645872503,862,2476
3155366529,3303719777,1664868048,1664868308,260,1309
3825971737,3735801716,1647688852,1647689783,931,228
3625869317,3491306285,1663860052,1663860140,88,2411
3553712893,3549752945,1657299776,1657300691,915,1690
3846060378,3019512245,1657847839,1657848153,314,1251
3729321195,3687691090,1656894950,1656895217,267,1686
3491468798,3260867614,1657638983,1657639237,254,452
3796275634,3200795190,1641251802,1641252709,907,1638
3271039091,3519233850,1651739262,1651740080,818,414
3569478966,3351921075,1660903865,1660904068,203,2214
3027064938,3997051818,1645906208,1645906494,286,541
3696448766,3137412000,1669647880,1669647952,72,763
3401957566,3731116644,1663834006,1663834303,297,1183
3259039915,3340331761,1652062671,1652063154,483,906
3303025505,3159900056,1657856671,1657857442,771,763
3629984199,3064701445,1642123680,1642124574,894,2262
3010161936,3722114463,1667272045,1667272487,442,2388
3066854514,3860879385,1661476905,1661477048,143,1049
3135139573,3286424440,1654784689,1654784880,191,1842
3523045898,3652728312,1651714912,1651715469,557,1692
3593988999,3738761840,1650544968,1650545482,514,2254
3592471391,3361508949,1664118795,1664119106,311,1878
3707767360,3887054161,1644986945,1644987892,947,126
3339385127,3735946925,1656524501,1656525308,807,1090
3917067097,3734621671,1651955132,1651955364,232,298
3142106289,3261685435,1642445808,1642446501,693,1188
3754706912,3228737899,1668136840,1668137451,611,1977
3581399447,3248250292,1649679956,1649680104,148,2268
3894175918,3940067834,1651099980,1651100845,865,898
3939181696,3881578299,1653573580,1653573833,253,1124
3701214753,3424584896,1660817952,1660818802,850,299
3582471153,3083479870,1645805642,1645806526,884,761
3181048786,3663155034,1642966081,1642966681,600,1200
3506952427,3006388757,1641077100,1641077898,798,1495
3097395182,3678149544,1647148946,1647148985,39,1817
3440324329,3881143383,1662819082,1662819336,254,1504
3880290667,3277550058,1668661889,1668661891,2,2440
3789314517,3284284605,1666155684,1666155942,258,1456
3301611102,3909168020,1669268260,1669268759,499,658
3087850405,3421078448,1656889177,1656890122,945,1086
3516107946,3816690173,1668295349,1668295796,447,1794
3157496248,3617324068,1659537521,1659538498,977,1815
3777597419,3796784054,1659410141,1659410564,423,189
3101137807,3954490536,1656026092,1656026797,705,1592
3019601621,3101265323,1647222563,1647223159,596,1082
3376742833,3617340911,1657744312,1657744514,202,1281
3541060382,3854351732,1641849494,1641850006,512,1344
3463121212,3888757366,1645590933,1645591916,983,808
3170292789,3869692733,1659332105,1659332986,881,1656
3340125949,3118976994,1663915004,1663915475,471,1228
3780546851,3664408598,1667824500,1667824826,326,609
3266498789,3893475632,1669044054,1669044881,827,2008
3399622567,3064831559,1665121610,1665121868,258,1007
3435292986,3361514629,1647287792,1647288101,309,1809
3852253700,3577718759,1641245365,1641245939,574,655
3259039915,3503510962,1651012826,1651013142,316,1059
3483553551,3736118442,1663897880,1663898614,734,1122
3153851884,3562875112,1649143090,1649143687,597,2491
3564667780,3943927246,1662787343,1662787711,368,410
3542996543,3596661503,1666262276,1666262480,204,1708
3101363863,3941317555,1645540060,1645541016,956,1308
3964738114,3189396065,1658223117,1658223315,198,836
3019773309,3481006313,1650187290,1650187467,177,2156
3197323395,3184608724,1664858405,1664858648,243,1590
3496617169,3855777399,1647985528,1647986073,545,2067
3446812207,3553467860,1645163174,1645163244,70,583
3650205106,3010767150,1647245299,1647245778,479,1328
3795934256,3761147252,1658447353,1658448118,765,1682
3101363863,3549122378,1660312732,1660313150,418,167
3287784262,3772910484,1664703461,1664704152,691,507
3573193288,3209544947,1653029917,1653030768,851,2071
3188936143,3565056675,1651588555,1651588852,297,1584
3586778995,3371002443,1669273319,1669273958,639,1914
3649142704,3251382188,1656664428,1656665194,766,2270
3113608489,3686249771,1649213378,1649213383,5,940
3197352308,3027829599,1666699406,1666699551,145,2369
3792012199,3693797946,1664473532,1664473776,244,2204
3464653044,3648072719,1662849538,1662850291,753,931
3347397074,3193095337,1668628990,1668629166,176,332
3652728312,3460504628,1668588922,1668589856,934,256
3304497399,3208215579,1664773936,1664774323,387,1570
3940948395,3537592483,1649940202,1649940426,224,2181
3398278082,3360051725,1665385605,1665386536,931,903
3756473550,3645560004,1645034896,1645035648,752,2144
3191811632,3921930806,1661217901,1661217974,73,842
3823206701,3793232281,1668351690,1668352208,518,1165
3786194675,3986825518,1648376006,1648376952,946,140
3782708820,3867026366,1653252898,1653253121,223,1982
3164789962,3576284955,1655047390,1655047462,72,866
3879182220,3885926991,1663291930,1663292227,297,566
3404043594,3389105515,1669080798,1669081624,826,513
3553048423,3636960130,1643677179,1643677278,99,1470
3815462032,3359078190,1645824923,1645825123,200,701
3960897829,3463135439,1646340934,1646341813,879,1344
3232160942,3933752482,1664393154,1664394023,869,760
3060883368,3835202206,1641892689,1641893226,537,1125
3328245802,3334298803,1659372279,1659372350,71,2162
3794408677,3799624292,1652349021,1652349446,425,2403
3928951547,3316496524,1651292058,1651292874,816,1487
3037375725,3067539427,1668037872,1668038699,827,857
3950666008,3641185549,1655451091,1655452033,942,1245
3389105515,3593861215,1657666419,1657666663,244,1345
3464770966,3569443529,1668523316,1668524265,949,1171
3104459009,3603853942,1661854933,1661855924,991,262
3527291464,3624947127,1650011073,1650011697,624,1998
3934890046,3760142759,1656684425,1656684561,136,1733
3263239497,3158291556,1644496517,1644497513,996,149
3668645457,3384460816,1668494649,1668495478,829,1595
3194204306,3400329831,1667606826,1667607204,378,1092
3582267659,3155366529,1669344376,1669344912,536,2251
3598506871,3255115511,1651279045,1651280016,971,960
3075088680,3286065477,1653034556,1653034795,239,1761
3603965318,3070984953,1655643047,1655643506,459,1023
3627902900,3584704567,1650188039,1650188588,549,1191
3650894238,3351610798,1651296704,1651297276,572,1234
3671748544,3722578408,1655992644,1655993500,856,1410
3953927472,3539797487,1648613124,1648613167,43,677
3404200137,3168983812,1657365741,1657365773,32,228
3428593255,3851540721,1652827808,1652828582,774,1517
3886368625,3630123918,1665423315,1665423315,0,1090
3184000585,3148589566,1666383095,1666383930,835,1720
3678425549,3403223215,1647256978,1647257343,365,2284
3869505474,3542078032,1648076247,1648076589,342,110
3566874478,3676893681,1658987560,1658987967,407,1427
3870779720,3840306405,1656738191,1656738632,441,687
3091418450,3084066396,1645815487,1645816175,688,848
3106436957,3167557703,1662731977,1662732030,53,1552
3214068022,3914429910,1667776119,1667776878,759,1585
3467391664,3222060578,1650771646,1650772116,470,1093
3233282653,3860268588,1642974582,1642975280,698,1291
3766062750,3358571434,1650468439,1650468509,70,1434
3543872563,3579684205,1658705252,1658706014,762,2098
3782752586,3173369021,1651088142,1651088483,341,1927
3252593307,3074477991,1653117492,1653118273,781,2121
3681489851,3811648493,1642249863,1642250221,358,2209
3776783076,3085136451,1654987418,1654987577,159,2052
3536903033,3409332035,1661950782,1661951676,894,1789
3630012590,3061643986,1651817144,1651817396,252,981
3115343467,3241007838,1643236985,1643237354,369,355
3962746969,3536931244,1658856859,1658857832,973,930
3962062858,3989206811,1665449011,1665449885,874,1435
3975198652,3185785923,1662362286,1662362842,556,346
3061462743,3048388831,1650779100,1650779666,566,730
3039081980,3508340066,1645962491,1645963421,930,2383
3215423327,3851778010,1642577174,1642577321,147,456
3149181988,3629207282,1643623557,1643624525,968,741
3339611423,3602955685,1660199099,1660199207,108,464
3060450258,3907665331,1645528082,1645528697,615,2479
3092003105,3041928480,1645553222,1645553825,603,1627
3660046291,3557215676,1648505744,1648506275,531,2282
3173108957,3883176560,1643171931,1643172490,559,2443
3486541605,3451131159,1658616397,1658616657,260,863
3497288872,3855762650,1652423190,1652424108,918,399
3178235505,3407409307,1668642182,1668642448,266,2483
3473394094,3496318579,1660939585,1660939781,196,1299
3292572977,3291286959,1659773868,1659774853,985,1260
3135134317,3413514902,1647856523,1647857076,553,558
3050267205,3817960208,1668840808,1668841212,404,10
3557087358,3892023630,1643441877,1643442712,835,1241
3366321387,3823962241,1650670274,1650671025,751,690
3122246747,3450672463,1647460200,1647461088,888,2494
3175979112,3404317985,1663142644,1663142922,278,1796
3233536885,3013484024,1642236912,1642237685,773,1500
3679522128,3392105056,1666135063,1666135709,646,1512
3888834059,3979552361,1648325503,1648326148,645,317
3717406689,3755294305,1665784404,1665784870,466,2114
3026025743,3710394011,1663043609,1663043976,367,549
3399552669,3911671645,1668449111,1668449224,113,1914
3223174482,3252421501,1660912368,1660913296,928,1539
3473170336,3177433990,1661529389,1661529993,604,2234
3385183586,3875045889,1663618237,1663619118,881,51
3310037244,3256859026,1643536979,1643537666,687,1098
3501962027,3307721045,1660710481,1660710694,213,551
3829971179,3565803867,1655431555,1655432076,521,548
3839454838,3256736613,1647596686,1647597323,637,1141
3287399418,3006388757,1642885162,1642885942,780,464
3010546611,3392535031,1650470317,1650470906,589,660
3154009016,3444005080,1648194789,1648195290,501,1757
3228073924,3522715448,1645261051,1645261232,181,1935
3905922866,3149313426,1652896179,1652896185,6,146
3023448006,3192940759,1667005747,1667005987,240,1994
3478502336,3434650074,1667339854,1667340587,733,1742
3619175296,3553301078,1644093722,1644094439,717,1581
3268670465,3637518238,1645544670,1645544695,25,2136
3501520918,3590831664,1653834814,1653835422,608,1058
3314240169,3153413554,1667325577,1667326376,799,2269
3132349279,3905999483,1642917813,1642918445,632,240
3381900638,3524589150,1646478878,1646479172,294,422
3833692711,3050817805,1663307563,1663308291,728,830
3481811999,3605492251,1657147681,1657148505,824,1721
3728974462,3919562972,1644121656,1644122568,912,913
3409352040,3523546928,1648378864,1648379503,639,1768
3357579618,3457317780,1668348597,1668349115,518,143
3439120258,3193830008,1645139067,1645139567,500,1467
3794103075,3344205602,1647319890,1647320175,285,1352
3168329235,3884949094,1667055277,1667055530,253,81
3520324090,3125314664,1654776868,1654777520,652,768
3218686367,3722551682,1645871374,1645872260,886,1894
3779998740,3943622737,1646211747,1646212732,985,2405
3601499230,3961672171,1643896646,1643896706,60,2094
3608200385,3373806425,1655416659,1655417089,430,1416
3711100517,3560043638,1653294257,1653294998,741,1324
3705755036,3750192699,1657559743,1657560165,422,1186
3019572992,3435340439,1660954874,1660955167,293,1620
3272879760,3178728299,1662282597,1662282637,40,965
3611982999,3625684557,1667760788,1667760861,73,1787
3683326795,3570423127,1666091461,1666091721,260,321
3636948225,3826573375,1668365803,1668365853,50,1881
3719273348,3949841652,1663446893,1663447430,537,1033
3308071201,3701151902,1656282380,1656282429,49,1477
3837157118,3277284318,1656190687,1656191200,513,696
3446572964,3599604382,1669567603,1669568175,572,2197
3614952111,3763453899,1662299454,1662299787,333,64
3101265323,3095594016,1655546045,1655546521,476,2142
3022428512,3453839667,1647144124,1647144365,241,2056
3419807636,3545544203,1663994902,1663995377,475,2199
3297123407,3785657136,1662843649,1662844419,770,1
3389114774,3673948643,1667054416,1667055219,803,1832
3086894794,3777684793,1665572802,1665573113,311,311
3351863157,3486814228,1642777006,1642777167,161,649
3697338181,3195451932,1657298595,1657299301,706,1361
3063566522,3079447248,1665330611,1665331134,523,1043
3052861028,3976095218,1650888713,1650889152,439,1838
3748110496,3145961063,1658306854,1658307419,565,1140
3816995343,3352986307,1649049104,1649049538,434,422
3391324219,3986979175,1654862400,1654863390,990,110
3771788181,3961677423,1649351871,1649352278,407,1027
3129283198,3854390772,1648985924,1648986804,880,896
3283922234,3805060036,1668973431,1668973699,268,1057
3854848967,3567926021,1645582380,1645583176,796,414
3428287409,3573826666,1658836283,1658836290,7,40
3702345362,3604435641,1665841837,1665842051,214,271
3330623875,3646797040,1657820196,1657820538,342,900
3252157235,3294635633,1653119333,1653119785,452,1200
3734367959,3649252503,1648881502,1648881765,263,2083
3766274699,3784912315,1653025592,1653026292,700,2470
3886736668,3382526428,1646916749,1646917224,475,1399
3021515419,3001889220,1659788511,1659788734,223,555
3250108907,3563972468,1642408624,1642409057,433,2285
3714322007,3276142713,1661741930,1661742318,388,2329
3581454117,3890161181,1658281129,1658281239,110,1953
3173969437,3479608671,1649298005,1649298655,650,23
3371745136,3137891271,1655341956,1655341964,8,382
3184455727,3521217476,1662884689,1662885631,942,1288
3385603289,3023140319,1662184725,1662184756,31,2234
3333095694,3834954155,1665169195,1665169572,377,1219
3148691436,3720941666,1665460153,1665460233,80,1575
3300412448,3285333536,1663039835,1663039942,107,2490
3974758009,3271436858,1657086410,1657087247,837,1549
3003705867,3256873642,1661909931,1661910748,817,368
3371063992,3385246088,1649733099,1649733393,294,390
3485926280,3065298582,1653834114,1653834671,557,2257
3512720372,3618313240,1645549563,1645549981,418,1076
3866532806,3872170030,1645159255,1645159960,705,942
3303418943,3839967647,1644653943,1644654455,512,1315
3096662890,3664267954,1668470876,1668470953,77,1898
3045691620,3623936873,1645062722,1645063655,933,972
3619490574,3269629374,1649312686,1649313550,864,1452
3338329823,3015253917,1655579847,1655580592,745,787
3890218641,3686407290,1642731711,1642732471,760,1802
3815235622,3498770747,1652316202,1652317039,837,2360
3852731262,3421294150,1652868848,1652869385,537,1278
3841459327,3678624517,1652442612,1652442948,336,1560
3013314607,3031816428,1642254723,1642254729,6,485
3992818695,3143679923,1647712047,1647713005,958,1537
3815537815,3425613329,1652039561,1652039751,190,1414
3765962960,3029053911,1666321653,1666322105,452,1056
3241549340,3675683512,1643910132,1643910706,574,27
3330058679,3913288832,1665626779,1665627200,421,2389
3821049069,3474723005,1662258242,1662258470,228,1721
3167985603,3098179768,1660479228,1660479841,613,1925
3874569616,3519726741,1668579498,1668579744,246,1291
3349692109,3242622170,1666586028,1666586566,538,444
3116281998,3327857419,1650064438,1650065282,844,993
3121336226,3645666563,1647283229,1647283998,769,1164
3415145597,3502947486,1652829428,1652829807,379,2462
3101669976,3826530948,1667626572,1667626608,36,715
3823942349,3335383594,1642539347,1642539769,422,2009
3791107997,3929312426,1652872500,1652873390,890,1042
3658656847,3553530817,1647513707,1647514446,739,2211
3882414600,3181912863,1656345405,1656345614,209,303
3125813072,3587508502,1658335910,1658336119,209,1737
3167737446,3070395663,1651776855,1651777285,430,2129
3979352608,3669311789,1646382361,1646382827,466,501
3222282745,3299211422,1669359880,1669360360,480,515
3748837929,3862371205,1661999981,1662000252,271,1554
3254144288,3315321131,1646081570,1646081647,77,644
3859680527,3908997041,1646631267,1646632248,981,1340
3560053389,3040563913,1648882979,1648883808,829,1032
3948946969,3439660528,1642026091,1642026681,590,739
3777835723,3912410470,1658353625,1658354065,440,1543
3644951156,3768846820,1653528295,1653528856,561,1169
3994409144,3500320805,1667138759,1667139651,892,1395
3850392190,3658910038,1665104294,1665105231,937,405
3304490341,3211641180,1648238160,1648238394,234,1808
3697028552,3521302995,1650667279,1650667980,701,1976
3733821292,3633080652,1659462640,1659463397,757,1772
3399503261,3352005808,1654030567,1654031548,981,2194
3341694529,3175676853,1661756461,1661757040,579,342
3237824925,3120984531,1662436140,1662436310,170,48
3363125076,3207013037,1651512769,1651513480,711,1202
3689680251,3333764188,1651320610,1651321539,929,133
3443490373,3250824932,1641442204,1641442494,290,1069
3658271419,3465500045,1646877743,1646878420,677,176
3659701814,3779611783,1660611167,1660611182,15,259
3647216166,3210337290,1658543904,1658544215,311,137
3769944434,3244514632,1642759866,1642760664,798,2481
3671748544,3239575265,1643017743,1643017832,89,693
3791107997,3541423460,1649464264,1649464602,338,2318
3543257848,3735286926,1647943273,1647943718,445,1412
3895886228,3073474496,1650747175,1650748104,929,616
3457361080,3786322776,1647622083,1647622603,520,460
3958920817,3676228617,1648547079,1648547813,734,2041
3216667034,3607352755,1646603721,1646604007,286,128
3000650426,3030117347,1657786700,1657787177,477,2261
3241190614,3298044531,1642172952,1642173911,959,657
3437593879,3640387984,1654309108,1654309343,235,2217
3037090215,3855548589,1643822668,1643823533,865,1296
3102776006,3474376744,1669332337,1669333249,912,1271
3349626057,3060727793,1669069830,1669070503,673,2347
3452683650,3096710771,1657652887,1657653023,136,1728
3396146110,3261174036,1669413815,1669414012,197,2086
3790549304,3816538946,1660069116,1660069481,365,1549
3987431029,3193890426,1667002223,1667002361,138,246
3277284318,3576386271,1643463514,1643464293,779,519
3669789756,3147047674,1649117648,1649118362,714,1390
3633239646,3940391939,1666627977,1666628921,944,1390
3083235668,3020108220,1666143544,1666143976,432,2291
3672874828,3231899706,1643897549,1643898229,680,1815
3984259471,3727618645,1643696505,1643696694,189,1841
3251854206,3659204779,1661038326,1661038990,664,113
3765660727,3543105564,1649052531,1649052642,111,1216
3773207612,3825824228,1662936305,1662936524,219,1428
3395679954,3362173874,1654572943,1654573086,143,2124
3211514286,3265895976,1644276059,1644276578,519,1588
3534545428,3343033950,1668882075,1668882225,150,989
3656846834,3278190233,1649812976,1649813783,807,48
3975663862,3257118282,1663738263,1663738965,702,2184
3686424169,3500201376,1643912095,1643912928,833,1223
3224455204,3095559156,1658140055,1658140175,120,86
3460572652,3962031345,1643579236,1643580104,868,680
3332506866,3197323395,1655599258,1655599685,427,1718
3287784262,3925561355,1658104601,1658104772,171,1946
3049869003,3807538433,1655183102,1655183258,156,1193
3840962989,3549105154,1652866980,1652867152,172,1278
3336423969,3532756620,1656653297,1656653314,17,2455
3946919028,3976335280,1645805940,1645806007,67,1348
3157308488,3334030228,1664981956,1664982664,708,1029
3811930283,3404945581,1656176642,1656177533,891,4
3420733881,3264339209,1650488258,1650489182,924,471
3881206954,3880353584,1644377510,1644377918,408,1639
3769290304,3259039915,1661813733,1661814623,890,1255
3859680527,3295518987,1646832185,1646832493,308,423
3318654389,3414834461,1642062833,1642062958,125,1257
3903886201,3636572173,1641637969,1641638717,748,816
3695237310,3044450059,1650530223,1650530422,199,2355
3683460040,3936980618,1641841922,1641842238,316,252
3893475632,3307225202,1652962023,1652962071,48,1362
3343279177,3495691991,1652366880,1652367467,587,1386
3253589940,3036046331,1651718769,1651719207,438,2263
3463009951,3462744404,1644881932,1644882201,269,427
3102251970,3330623875,1644190075,1644190652,577,2109
3321835417,3009781198,1653962324,1653962673,349,1718
3811164522,3790402339,1657705859,1657706059,200,1863
3021679982,3956191936,1667708890,1667709470,580,1375
3802072416,3241007838,1667886968,1667887666,698,449
3844822083,3585832857,1641533936,1641534527,591,1631
3014354609,3208106743,1654241545,1654241895,350,2266
3540799664,3747046698,1659977545,1659977693,148,1431
3109465057,3184270447,1648370162,1648370359,197,199
3334792271,3071667890,1644323181,1644323682,501,1210
3383348505,3973853235,1660279598,1660279830,232,963
3815507952,3989206811,1661662031,1661662322,291,1609
3619309272,3823288349,1647759833,1647759920,87,38
3906024837,3520943619,1651126979,1651127288,309,1591
3133319209,3543668840,1659192900,1659193271,371,2198
3333223237,3754631129,1652803299,1652803316,17,1111
3864301593,3758622438,1663288644,1663289345,701,1118
3813921952,3840558415,1646387149,1646387878,729,1945
3335565751,3208215579,1661664186,1661664276,90,1542
3872928406,3313292041,1643183807,1643184536,729,1446
3965926652,3542215276,1657895732,1657896591,859,2175
3772337054,3879787945,1646046908,1646047861,953,1691
3893601176,3295146156,1658927632,1658928368,736,892
3896357807,3948577391,1644448763,1644449380,617,972
3993504996,3304726864,1660313812,1660314520,708,2376
3055545326,3447555067,1644311610,1644312468,858,637
3957051129,3375879417,1648112173,1648112899,726,802
3002438521,3929464797,1655909413,1655909780,367,2150
3777835723,3991477345,1666046236,1666047090,854,1115
3637609349,3971093415,1652212174,1652212737,563,790
3859249968,3840953967,1664861331,1664861378,47,1795
3919196366,3345186165,1645013302,1645013716,414,51
3084334078,3833110040,1649755881,1649756066,185,1557
3678624517,3857434991,1660771803,1660772163,360,2297
3822187489,3420298161,1646929805,1646929878,73,2233
3148691436,3886917024,1655213456,1655213941,485,1755
3636528701,3833553454,1662798648,1662798812,164,565
3428287409,3052681277,1654358551,1654359230,679,1758
3516140957,3934988354,1668267648,1668267788,140,2162
3546290525,3327061038,1643840638,1643840751,113,2075
3992919381,3858519840,1656648477,1656649319,842,605
3315569726,3444809495,1646243785,1646244745,960,1420
3608775321,3624171160,1668493657,1668494533,876,591
3971934050,3261866390,1651371409,1651371585,176,1558
3253913009,3591348696,1665233618,1665233981,363,2392
3859976372,3432608968,1647989542,1647990200,658,2215
3014185506,3625393284,1653666209,1653666846,637,1933
3155797946,3719445490,1643125737,1643126397,660,590
3671830270,3803000258,1658809593,1658810459,866,2363
3369040211,3342538148,1660785164,1660785554,390,1069
3412053580,3398242179,1658365742,1658366736,994,986
3616173127,3150582711,1652838522,1652839061,539,1316
3695558824,3378221943,1665907956,1665908448,492,317
3975380491,3173969437,1648338748,1648339359,611,1246
3777022057,3446741935,1649240071,1649240676,605,1738
3861153303,3091817310,1654542501,1654543161,660,1085
3109500957,3490044613,1658747300,1658747341,41,1196
3471651838,3041290048,1664586637,1664587155,518,2357
3005773066,3092292487,1663764711,1663765599,888,1768
3740438273,3119345995,1642359723,1642360586,863,2226
3131753608,3914946558,1666172745,1666173534,789,982
3325944344,3417248496,1668514434,1668514508,74,628
3206425813,3720240255,1643512566,1643512790,224,2007
3302344507,3105733809,1665207416,1665207598,182,1879
3400899022,3788034142,1650400778,1650401710,932,1290
3547334414,3133767042,1651959290,1651959990,700,1955
3681001652,3925690262,1668837799,1668837854,55,66
3490087619,3824860461,1647538084,1647538871,787,2206
3540104512,3477363517,1642222967,1642223772,805,1048
3979926306,3063955055,1665105311,1665105567,256,568
3058750967,3018838603,1641615880,1641616730,850,1737
3711059561,3657203747,1647295947,1647296666,719,1750
3757370089,3892142252,1666391655,1666392058,403,2334
3450535254,3456285013,1641770813,1641771053,240,533
3480984393,3118406319,1655459606,1655460504,898,1012
3335275571,3437221963,1654340872,1654341857,985,268
3980971387,3761609140,1660274832,1660275084,252,285
3707778731,3077238667,1660113207,1660113730,523,2496
3765660727,3369049258,1658624540,1658624646,106,152
3911316683,3622950232,1651961708,1651961777,69,33
3261477798,3268821463,1642426083,1642426318,235,299
3733072964,3617795950,1644813037,1644813797,760,270
3074385503,3349692109,1655018668,1655019484,816,675
3261447619,3595984663,1660181534,1660181934,400,942
3880599649,3434729931,1649953460,1649953967,507,1760
3152036409,3664930564,1663881751,1663882333,582,1826
3046500774,3903886201,1661522860,1661523746,886,2161
3895991710,3015814199,1648194755,1648195295,540,1289
3791107997,3017712081,1642562176,1642562469,293,1874
3707578213,3705217157,1650172709,1650172713,4,1737
3180252962,3818023164,1648076465,1648076775,310,556
3045070182,3255252214,1657084406,1657084755,349,1530
3177491349,3997312356,1665771176,1665771697,521,986
3876829785,3912014286,1658181507,1658181620,113,2361
3184916120,3127549843,1658163589,1658164004,415,308
3201446016,3948969420,1668502454,1668502951,497,2478
3956836647,3986885276,1647390090,1647390128,38,374
3491022991,3835355277,1654313700,1654314493,793,96
3249705811,3243831128,1652288772,1652289655,883,862
3590627159,3114733025,1667998781,1667999418,637,902
3347226466,3783992161,1656289994,1656290022,28,955
3900843323,3468586613,1655303703,1655303711,8,297
3569478966,3620395885,1646530586,1646530780,194,2156
3333872407,3098108231,1642634328,1642634557,229,458
3908153195,3776027879,1652089461,1652089538,77,922
3284829365,3889854774,1650216772,1650217070,298,2418
3612269633,3104816625,1662111587,1662112543,956,888
3995299995,3431498601,1668227250,1668227906,656,1734
3790883274,3555731884,1660932879,1660933769,890,679
3141503682,3395525819,1662417522,1662418027,505,1126
3946919028,3272506285,1652093330,1652094225,895,700
3845130884,3835708711,1649977027,1649977282,255,2135
3533274758,3437215040,1644045424,1644046211,787,174
3832275392,3814809809,1657181017,1657181487,470,2201
3084783158,3084030782,1665070733,1665071465,732,1920
3155871721,3347832946,1650446973,1650447557,584,701
3402019498,3508809990,1650066202,1650067113,911,328
3322226292,3072985971,1667412914,1667413213,299,376
3485578733,3687293094,1663655425,1663656405,980,948
3807922855,3078628091,1663563882,1663564552,670,1734
3515933745,3361223822,1658833407,1658833602,195,667
3606998838,3748492935,1654948309,1654948949,640,1697
3106781266,3968076690,1647634255,1647635098,843,363
3394249709,3382526428,1653772122,1653773077,955,217
3399552669,3870384331,1647230264,1647230596,332,912
3870779720,3379756257,1661837244,1661838079,835,816
3859164696,3194618871,1659285867,1659286424,557,2420
3000863237,3097596187,1645403984,1645404585,601,328
3635052101,3556620301,1645660173,1645660330,157,831
3095221133,3648072719,1664462499,1664463353,854,2104
3926426459,3928361511,1663533530,1663534270,740,1775
3188588023,3242897765,1652606778,1652607033,255,347
3194142427,3159638305,1665912479,1665912892,413,1137
3788911315,3773996198,1661631749,1661632338,589,469
3794575914,3424650360,1667587956,1667588094,138,840
3666338218,3374692305,1649464358,1649465213,855,1816
3348802129,3195159288,1649685279,1649685428,149,799
3190508233,3717137928,1648755163,1648756072,909,526
3527291464,3640605424,1663255787,1663256705,918,473
3087662482,3442354739,1641679401,1641679404,3,1791
3308891574,3427860415,1657286703,1657286991,288,2113
3407735827,3328699609,1666697580,1666698368,788,958
3052681277,3495919793,1667673734,1667674192,458,1315
3167985603,3285333536,1642824329,1642824812,483,2465
3423971586,3362249024,1649334293,1649335091,798,1447
3920327961,3713231806,1661561342,1661562163,821,2131
3071341023,3548128446,1653331673,1653332098,425,144
3323797477,3474402148,1647006006,1647006528,522,2196
3322337553,3514498367,1668100471,1668100498,27,759
3287508774,3665086817,1667779148,1667779320,172,1538
3800014504,3095594016,1661613724,1661614022,298,2270
3315544584,3658295713,1669514642,1669514807,165,1482
3369040211,3097469330,1653356643,1653357433,790,425
3066067288,3763300182,1649886001,1649886002,1,717
3937758732,3511192827,1653296147,1653297078,931,2124
3942852295,3928852706,1667968283,1667968495,212,326
3959081575,3213124781,1643078418,1643078765,347,1935
3935978133,3574240169,1652732047,1652732285,238,766
3524508110,3363651899,1646170153,1646170734,581,511
3358578228,3522211010,1647529098,1647529550,452,1988
3569177433,3635938446,1661115681,1661116603,922,1660
3197371652,3752442248,1659019751,1659019910,159,1304
3252981510,3118502732,1655542264,1655542386,122,1165
3762829533,3550218169,1641289266,1641289372,106,1431
3672874828,3184608724,1664945831,1664946543,712,2226
3790650118,3554753273,1658123006,1658123321,315,1358
3388844626,3192005711,1661829061,1661829885,824,368
3016971363,3396149289,1663937658,1663938092,434,1100
3446490643,3027558279,1646506914,1646507174,260,1139
3291984936,3553048423,1643091232,1643091803,571,1939
3426491499,3216241275,1667781828,1667782176,348,2190
3029943531,3442674561,1641420428,1641421142,714,1631
3363279084,3361694981,1662676107,1662676767,660,327
3616441586,3923137418,1661858598,1661858939,341,25
3222446672,3060718787,1667992420,1667993355,935,1768
3919478201,3880052402,1647859747,1647860711,964,1285
3647539125,3721136961,1642356100,1642356804,704,1077
3895422097,3533954093,1651596530,1651596626,96,1474
3835842311,3155807587,1646524600,1646525496,896,1714
3264079501,3126940487,1664560884,1664561033,149,2176
3628034615,3733486808,1657703268,1657704259,991,2248
3035135381,3634999231,1641520929,1641521459,530,844
3526315797,3993995217,1653784605,1653784739,134,2232
3981778568,3773434774,1656718492,1656718773,281,2048
3717926703,3948833001,1644445899,1644446884,985,1519
3942399353,3187644022,1667815582,1667816461,879,2215
3283211870,3889544424,1655672760,1655673738,978,2424
3430464852,3743569811,1642545180,1642545251,71,1339
3553436680,3066305343,1645334116,1645334601,485,603
3517631415,3309767670,1661255272,1661255332,60,1236
3261333996,3315951327,1658286449,1658287252,803,1917
3499281518,3216241275,1667704633,1667705114,481,2014
3925496970,3442194248,1657781958,1657782307,349,183
3218780941,3243873593,1669004823,1669005257,434,355
3743136976,3963702135,1650173975,1650174598,623,1846
3062464540,3203904444,1659251052,1659251857,805,2301
3548511640,3833722302,1667960130,1667960879,749,913
3612556887,3332012161,1665499288,1665499775,487,2026
3258417294,3407139317,1649041553,1649041895,342,1212
3409823179,3735286926,1643306639,1643307368,729,664
3823692648,3856587038,1664955373,1664956008,635,614
3057348673,3711701083,1648442001,1648442815,814,570
3723780339,3794926978,1667289097,1667289765,668,2051
3313426081,3241341174,1656496179,1656496755,576,746
3506585658,3912111332,1650642743,1650643121,378,967
3035476619,3639059199,1647800072,1647800918,846,1834
3285381118,3801736024,1658306782,1658307240,458,1851
3904012023,3602924213,1648691036,1648691852,816,1741
3839642166,3994130271,1658102452,1658103233,781,1719
3830388213,3985854594,1659190829,1659191684,855,576
3825930964,3538972815,1641936726,1641936799,73,2340
3523394395,3078791988,1654931077,1654931469,392,1656
3055710852,3468654589,1662316814,1662317430,616,1257
3515170949,3157965235,1657113850,1657114148,298,1343
3355184225,3744293001,1653031940,1653032619,679,2077
3249305465,3732585972,1655204445,1655204861,416,994
3223290764,3813511439,1663746824,1663746929,105,488
3630614328,3731437059,1662204866,1662205250,384,2498
3711847265,3952663430,1644765210,1644766050,840,1478
3057756725,3391426421,1662949457,1662949806,349,1204
3457390239,3896777982,1644190487,1644191382,895,529
3272535116,3506273643,1666413261,1666414139,878,1300
3529764378,3801956152,1667309825,1667310476,651,383
3372271387,3657115450,1661468640,1661469027,387,1455
3102672864,3205162065,1665922287,1665922896,609,2374
3204359619,3508311968,1650092876,1650092998,122,46
3893872926,3854351732,1659078992,1659079612,620,2269
3481811999,3740009683,1658035042,1658035758,716,153
3314932010,3423306122,1667928476,1667928577,101,686
3877811036,3195504067,1643439076,1643439504,428,2144
3201587444,3126455934,1655756332,1655757234,902,2479
3752669447,3185444969,1651146100,1651146107,7,985
3908848133,3469359731,1649825908,1649826741,833,270
3586405616,3964613907,1667060177,1667060922,745,520
3207757416,3563103144,1661473876,1661474681,805,24
3926699428,3371707067,1660252661,1660253391,730,2427
3617324068,3990949387,1668178792,1668178872,80,2374
3735817368,3893170545,1656305000,1656305482,482,1212
3859680527,3526439962,1643589806,1643590744,938,1099
3846585557,3478921948,1669001706,1669002464,758,394
3254367735,3191414403,1646531541,1646532370,829,35
3563246157,3114128222,1662975577,1662976255,678,1231
3778402105,3542927039,1658194053,1658194303,250,2063
3381060534,3647255060,1663553871,1663554132,261,149
3071971535,3165423009,1658389169,1658390064,895,1136
3790298140,3411128747,1655640758,1655641211,453,673
3604852600,3414901923,1658679366,1658680348,982,116
3530162623,3932212405,1668675028,1668675652,624,1082
3534200501,3429445014,1654268090,1654268436,346,66
3271648296,3155044579,1663438779,1663439716,937,2242
3935601127,3722972444,1662184798,1662185796,998,194
3363802434,3072219388,1648138264,1648138513,249,211
3538039823,3927214415,1660660481,1660660678,197,692
3800392649,3922675517,1660639010,1660639012,2,1915
3548799053,3689303525,1653628343,1653628747,404,2346
3201479561,3244514632,1663491675,1663492626,951,1332
3490044613,3312336013,1658345273,1658345415,142,1170
3587508502,3800201060,1650220346,1650220653,307,762
3150067482,3643412582,1643472253,1643472476,223,556
3637981738,3902970032,1665582152,1665582920,768,1428
3243831128,3102753256,1666668405,1666668772,367,130
3522963106,3698906761,1656539532,1656540226,694,821
3084855451,3079038995,1654733074,1654733336,262,1789
3930909418,3151982756,1641137507,1641138086,579,1811
3285331142,3786478382,1666861385,1666861612,227,1479
3086135849,3473055855,1658520059,1658520276,217,1778
3206061644,3153552268,1669084301,1669085032,731,1300
3224128562,3804189322,1649727493,1649728408,915,2037
3501820222,3101137807,1652824336,1652824595,259,1411
3223459561,3818713435,1657045082,1657045279,197,2006
3787714854,3375966339,1644662492,1644662726,234,1247
3622978712,3118526217,1644718856,1644719655,799,393
3285333536,3211047702,1662495636,1662496615,979,1732
3293237543,3428889808,1654069324,1654069778,454,933
3962062858,3095661578,1661612010,1661612625,615,2461
3996587507,3645868952,1650320849,1650321338,489,769
3052233179,3633111737,1665146548,1665146829,281,1945
3194342775,3799776825,1644265374,1644265608,234,1623
3960204629,3608048838,1653106391,1653106753,362,1191
3320187187,3393458100,1643322619,1643323145,526,423
3081396297,3765962960,1646094080,1646094609,529,820
3704871253,3318663320,1663515036,1663515994,958,16
3713834683,3879157400,1652699874,1652699926,52,1204
3789999187,3516743828,1658922557,1658923154,597,786
3811472324,3584309667,1647159922,1647160152,230,97
3197300293,3227368879,1659878233,1659878473,240,2083
3289153734,3823419231,1667088925,1667089597,672,1441
3150582711,3829546967,1648627087,1648627744,657,469
3891400237,3604461797,1645454146,1645454827,681,2293
3515170949,3184404815,1643231874,1643231905,31,1834
3868474839,3572689902,1665255678,1665256134,456,990
3985486150,3791406454,1644286806,1644287384,578,1447
3131753608,3338329823,1661345757,1661346524,767,2271
3413781764,3167494570,1660882055,1660882187,132,1816
3523546928,3176753600,1658779242,1658780178,936,1844
3722078855,3428142421,1656839800,1656840342,542,2287
3794548376,3879157400,1651078693,1651079194,501,2436
3158029379,3535414109,1664518608,1664519251,643,2186
3815102601,3413300274,1643121600,1643122271,671,341
3003972844,3582046255,1653537791,1653537962,171,437
3042836639,3083235668,1643775046,1643775144,98,292
3539510682,3829971179,1657706756,1657707001,245,290
3191398794,3185210514,1658203433,1658204071,638,1241
3865950417,3653429754,1648381291,1648381460,169,830
3071341023,3979558738,1641785590,1641785959,369,1517
3015156809,3926088173,1656068242,1656069124,882,545
3141689539,3719124928,1660303919,1660304534,615,2452
3717334493,3461674303,1652129512,1652130395,883,673
3195716414,3715766296,1644294877,1644295500,623,1622
3321818923,3488551185,1650560056,1650560529,473,2022
3934988354,3218686367,1641237088,1641238054,966,2278
3744955044,3889112055,1666220410,1666220952,542,1418
3165536332,3633830454,1659187252,1659188181,929,2229
3994721189,3019854226,1661141622,1661142271,649,1909
3195716414,3711151849,1644876431,1644876526,95,396
3828555703,3973666003,1667601201,1667601977,776,159
3783119155,3609029368,1655851023,1655851821,798,1450
3412053580,3917684798,1655032953,1655033567,614,1737
3806570797,3628556060,1653594785,1653595286,501,2061
3922851964,3774916473,1649088843,1649089551,708,2349
3627981146,3502554871,1667568934,1667568991,57,582
3090666521,3493424957,1642744015,1642745007,992,2191
3696607958,3170924487,1658702017,1658702636,619,2329
3955825968,3174658362,1648705022,1648705074,52,914
3725439899,3651535646,1656245646,1656246153,507,337
3023254734,3993332175,1642402646,1642403400,754,872
3625586912,3017758671,1661681947,1661682165,218,390
3481584783,3313619618,1659455972,1659456821,849,2186
3696947299,3003872692,1646994072,1646994485,413,385
3268182022,3714105777,1647076273,1647077065,792,820
3514680311,3947083981,1647158503,1647158815,312,122
3190544941,3355798436,1663207737,1663208437,700,215
3948710872,3903947013,1650082757,1650083475,718,1450
3029943531,3953768846,1656559852,1656560703,851,2476
3483666747,3237245622,1659933926,1659934246,320,1654
3668078009,3355798436,1653989503,1653989550,47,2296
3790751649,3017758671,1658643469,1658643949,480,1341
3183259139,3288261603,1654852807,1654852808,1,1527
3261013545,3436636953,1654442019,1654443018,999,2280
3060718787,3135406478,1653837232,1653838170,938,506
3913288832,3945370501,1655057201,1655057447,246,755
3832336338,3037984793,1661907775,1661907908,133,320
3350387055,3049147900,1666384065,1666384449,384,2003
3070557341,3197545162,1643871804,1643871972,168,863
3569401888,3730270448,1645994913,1645995342,429,1731
3819541125,3544133682,1660755669,1660755979,310,1775
3806737055,3196009998,1645701804,1645701923,119,829
3228574805,3197739962,1654365131,1654366090,959,994
3447310943,3886736668,1660925913,1660926332,419,913
3657597585,3965000413,1668846831,1668846952,121,200
3604694727,3567126985,1665438370,1665438457,87,268
3992919381,3943836795,1662596212,1662596527,315,2202
3113793993,3868827867,1656811116,1656812095,979,704
3476312823,3217384934,1644548547,1644548946,399,25
3332506866,3927666827,1646288152,1646289063,911,1646
3401597507,3448203668,1668925320,1668926315,995,2259
3349879521,3234141140,1651649472,1651650322,850,1031
3252790120,3429445014,1668044442,1668045364,922,1231
3695360424,3285030317,1641660824,1641660874,50,887
3568404894,3767868249,1662163287,1662164001,714,1042
3147089920,3120186347,1662857488,1662858288,800,1174
3860432776,3303884789,1641180626,1641181608,982,1296
3807887781,3323834326,1649441317,1649441712,395,280
3911849911,3620725243,1659791534,1659792129,595,1754
3405168756,3547278175,1650122876,1650123351,475,2370
3540104512,3858121838,1662487208,1662487683,475,1652
3752347758,3650172161,1661582962,1661583562,600,2013
3045127324,3344077337,1646310993,1646311002,9,2358
3243059921,3681170705,1663964749,1663965576,827,1912
3369175849,3489254440,1662816803,1662817670,867,269
3005809519,3738624659,1653677952,1653678095,143,581
3366262960,3102992210,1653516251,1653516354,103,1338
3875118670,3407409307,1654046443,1654047154,711,444
3980824960,3909997437,1648612178,1648612610,432,1099
3052499026,3878810894,1667254961,1667255539,578,1738
3215502915,3399334455,1641935263,1641935485,222,1736
3301994647,3410655469,1656409924,1656410591,667,1460
3949522552,3521112560,1665921733,1665922658,925,913
3930142533,3034807560,1668436796,1668437310,514,872
3045587450,3417798594,1662015804,1662016125,321,2195
3740009683,3089574886,1648843342,1648843656,314,1093
3812732557,3984977278,1648612298,1648612490,192,116
3348006171,3277883706,1643658768,1643658865,97,197
3873218862,3916776869,1663144964,1663145747,783,1301
3927388172,3739439527,1651696607,1651697541,934,300
3203734562,3061462743,1660366990,1660367094,104,716
3814017798,3002931773,1661463439,1661463515,76,1510
3327145204,3683246538,1657770219,1657770552,333,2173
3106781266,3995654203,1648512579,1648513301,722,1645
3693581710,3115344578,1661121234,1661122024,790,1235
3286555687,3983988321,1656869560,1656870036,476,1956
3576100130,3103404280,1660500712,1660501654,942,1228
3089699104,3040416131,1642651288,1642651582,294,244
3650894238,3663342046,1646116022,1646116632,610,2439
3829606187,3267411650,1655059883,1655060036,153,1928
3731206373,3062015697,1668458284,1668458358,74,2320
3131331478,3648118736,1643437931,1643438513,582,549
3282587673,3406239480,1647821148,1647821975,827,1986
3320767438,3145948160,1644258801,1644259405,604,2447
3614206353,3871971681,1659036409,1659037390,981,69
3793772897,3126995401,1649523464,1649523773,309,1714
3990343743,3319605191,1643240354,1643241065,711,2197
3017075122,3764492400,1646378347,1646378566,219,147
3845256746,3991477345,1656313272,1656313375,103,1232
3268826534,3949620827,1663483472,1663484072,600,881
3315539995,3513193858,1661319284,1661319771,487,2051
3616429615,3445422843,1649675178,1649675364,186,587
3438756008,3615359458,1660910734,1660911686,952,2159
3750756562,3981932099,1647488366,1647489114,748,2085
3949668592,3328854884,1653105501,1653105950,449,619
3785883615,3616803531,1641399339,1641399804,465,1368
3462412055,3149804005,1664198889,1664199573,684,1610
3458645622,3655786063,1660513766,1660513919,153,1338
3354912831,3548511640,1667031796,1667032721,925,986
3099976032,3164467795,1658508398,1658509329,931,1439
3184994293,3103351502,1647040108,1647040733,625,1572
3903112291,3609799738,1646927410,1646927805,395,958
3558733181,3546954605,1668162734,1668162835,101,1009
3812732557,3391118279,1655015129,1655015350,221,1214
3423971586,3835036552,1658466243,1658466803,560,1782
3199288675,3370889279,1649704700,1649705677,977,1372
3802545642,3183672525,1647742529,1647743108,579,371
3599795440,3344394548,1661224243,1661224493,250,1465
3893872926,3728950700,1662631364,1662631419,55,418
3672123230,3401156180,1648026197,1648026344,147,70
3829597039,3288261603,1660558061,1660558827,766,2277
3438474821,3363611494,1657719306,1657719307,1,949
3596883607,3991310779,1655384171,1655384252,81,2185
3582544512,3197362399,1664056700,1664057613,913,1935
3765504986,3550677109,1641602261,1641602427,166,1995
3599104606,3683246538,1661028909,1661029522,613,81
3130899709,3684926586,1650537540,1650537651,111,1447
3930118877,3370120843,1654683317,1654683869,552,2460
3712443558,3893389283,1645998433,1645998674,241,718
3692498377,3151323388,1651211538,1651212301,763,380
3793996748,3957665117,1663530241,1663531098,857,926
3515480973,3866601790,1667520292,1667521286,994,125
3344337283,3184994293,1661404854,1661405763,909,1697
3023431340,3906903088,1643943163,1643943270,107,316
3738624659,3519828744,1650581229,1650581282,53,2444
3257865090,3349692109,1657519514,1657520487,973,45
3753998489,3286466102,1648191365,1648191752,387,1996
3122002940,3556033785,1652750743,1652751195,452,1738
3223917351,3898495918,1644751782,1644752291,509,479
3529732289,3412673526,1649517446,1649517588,142,2284
3855013110,3352751731,1668880050,1668880434,384,1241
3564296836,3205418435,1647605909,1647606274,365,831
3564440153,3649252503,1655651048,1655651859,811,1067
3850546468,3831380073,1648441624,1648441717,93,1704
3005809519,3547072063,1668271952,1668272227,275,2458
3531256735,3245919207,1669700176,1669700644,468,1612
3657587705,3289330422,1647411079,1647411637,558,1388
3799117805,3264993323,1668069929,1668070830,901,740
3587508502,3502316165,1660455682,1660456310,628,2029
3240435560,3270935026,1647613354,1647614234,880,156
3640613606,3254262388,1644063131,1644063203,72,929
3252021647,3214282155,1663119811,1663119840,29,1616
3256807270,3841174974,1641288778,1641289375,597,1150
3969036937,3835202206,1668670844,1668671499,655,1932
3821120962,3014975304,1647144051,1647144876,825,1475
3852834619,3119477442,1650270601,1650271478,877,1790
3437665905,3300694030,1661907317,1661907654,337,464
3955776304,3184955498,1649172349,1649173262,913,434
3332592315,3310542239,1657205866,1657206010,144,1095
3749282990,3176536531,1650789784,1650789864,80,1459
3819791378,3681170705,1643704900,1643705574,674,2487
3868427833,3848995096,1665872569,1665873532,963,2092
3659158165,3242752835,1661513710,1661514032,322,1607
3206197726,3691925367,1668657276,1668657622,346,2403
3887305908,3467650879,1667075434,1667076406,972,857
3599714580,3391857064,1656030008,1656030623,615,705
3463509445,3298748343,1665535390,1665535426,36,815
3106328456,3647398701,1654139973,1654140902,929,1901
3359278409,3174373725,1645837898,1645838792,894,2220
3077346044,3482763584,1668985320,1668985320,0,855
3618380884,3349716508,1659910551,1659911005,454,798
3529056509,3882329817,1655154648,1655154767,119,1373
3890054358,3828810890,1645897117,1645897538,421,547
3234141140,3803606691,1645157186,1645158122,936,749
3386961417,3471993716,1664573542,1664574520,978,935
3686247296,3677893619,1652577888,1652578839,951,2015
3370701718,3867799694,1668431242,1668431823,581,1347
3941512307,3605316405,1644162839,1644163819,980,2395
3851327758,3132258390,1669469266,1669469720,454,1155
3730368703,3191792012,1658197315,1658197686,371,562
3403337910,3979558738,1665256178,1665256783,605,280
3621000186,3690043318,1654313240,1654313848,608,356
3620522583,3106437492,1643822058,1643822806,748,1904
3965585706,3004624310,1652706911,1652707877,966,2093
3328544337,3729299306,1653866215,1653867108,893,1628
3591551688,3561562385,1662740703,1662741533,830,669
3619045997,3730845439,1646205913,1646206823,910,2015
3112739600,3169601604,1661322150,1661323112,962,2410
3189318073,3321202962,1652385973,1652386222,249,2271
3336211604,3505417530,1651791935,1651792887,952,1810
3816533759,3913162487,1666782685,1666783280,595,227
3508718004,3849725507,1663872299,1663872975,676,1559
3125459736,3079809630,1650111887,1650112757,870,1308
3019576854,3390431277,1649846207,1649846423,216,1728
3012457192,3262379384,1644284757,1644285164,407,1159
3321391869,3147245859,1644288031,1644288774,743,1990
3261403182,3322019981,1651551803,1651552099,296,2476
3276763839,3812997079,1660814618,1660814914,296,1793
3801205465,3677306151,1660490443,1660490770,327,1619
3201446016,3981379416,1641007852,1641008276,424,830
3439364410,3648257100,1662101532,1662102319,787,1136
3628583147,3829729960,1661574480,1661574611,131,1901
3682993605,3575535453,1652846194,1652846730,536,2143
3280046501,3974917779,1665489668,1665490632,964,2494
3694762938,3540799427,1668437711,1668437789,78,2200
3452219424,3660754603,1658161229,1658161748,519,1484
3561113748,3786148014,1659851089,1659851138,49,2004
3026244912,3297949666,1664642981,1664643296,315,1119
3254194915,3940222685,1647529003,1647529443,440,1257
3297001171,3322656350,1668693770,1668694145,375,2124
3818549518,3787230225,1642962297,1642963157,860,1367
3472474698,3875750764,1650789754,1650790651,897,1862
3009169806,3675418278,1643778731,1643779540,809,1138
3020729502,3147376468,1644843022,1644843915,893,652
3732456028,3850304083,1647216038,1647216378,340,2299
3911849911,3728419832,1646762359,1646762884,525,521
3149534519,3808191596,1653528101,1653528129,28,2025
3550874434,3543696190,1654208038,1654208310,272,561
3728498046,3796936978,1642757407,1642758294,887,2434
3736483863,3695692085,1664230579,1664231208,629,885
3387938632,3000600578,1668063092,1668063796,704,703
3469583371,3548351680,1666125661,1666126242,581,2251
3017715856,3485995293,1667616585,1667617211,626,550
3802040767,3515856480,1656657088,1656657209,121,2034
3198338148,3801038758,1652372868,1652373775,907,1206
3631152825,3895855296,1655537262,1655538038,776,2390
3562456307,3124277484,1663670265,1663670353,88,2234
3269294562,3430165544,1658920142,1658920434,292,554
3435292986,3802749978,1645799883,1645800830,947,568
3694349997,3710782213,1667911720,1667911876,156,1906
3241021396,3060674509,1667583306,1667583872,566,1894
3294446147,3939281989,1656462488,1656462811,323,1116
3122127756,3874569616,1644927252,1644927471,219,32
3986247608,3914275771,1644062897,1644063478,581,636
3391282493,3719146348,1649703461,1649704290,829,2375
3748511559,3414502284,1650720610,1650721088,478,1097
3178640485,3689453273,1651103172,1651103283,111,366
3886344418,3549033213,1662574985,1662575822,837,7
3323783108,3855013110,1661977855,1661978688,833,433
3428501033,3124363805,1649337058,1649337180,122,1547
3622230392,3282561101,1659017124,1659017732,608,827
3878831823,3871137970,1651179335,1651180294,959,839
3118188990,3762571799,1645925639,1645925660,21,2310
3039864595,3398278082,1666990023,1666990787,764,2457
3832438123,3860422016,1641223753,1641224238,485,1473
3621969167,3663038239,1660534926,1660535768,842,447
3253759705,3074795505,1668602242,1668602469,227,1830
3253568318,3708034201,1654583717,1654584008,291,1879
3294357161,3985239597,1642474557,1642475453,896,1310
3339611423,3118057575,1649281540,1649281762,222,521
3793738776,3747907269,1662952736,1662953399,663,2394
3833230225,3419751912,1647775839,1647776538,699,879
3421772590,3166805288,1655295685,1655296649,964,1906
3540737045,3950225483,1665822668,1665823217,549,2153
3545214789,3994927164,1645523935,1645524670,735,1371
3772337054,3912511626,1667513446,1667514439,993,1344
3079038995,3660983068,1650767125,1650767362,237,2407
3694006679,3933742178,1641932593,1641933562,969,2015
3700412611,3527291464,1655165603,1655165809,206,719
3204412545,3100402840,1663718537,1663719419,882,1366
3143189190,3859634422,1669134186,1669134882,696,1577
3566874478,3957053810,1644373982,1644374685,703,645
3906065558,3946833004,1657258300,1657258689,389,2317
3957051129,3506307976,1659559101,1659559446,345,2139
3272811357,3708809295,1660175422,1660175907,485,747
3928867307,3819541125,1660618414,1660618441,27,1910
3993332175,3133153956,1666178487,1666179473,986,228
3436234030,3898494020,1665815930,1665816323,393,126
3133030435,3827122476,1657388025,1657388533,508,913
3985617701,3878573707,1642656186,1642656778,592,911
3831660488,3237697952,1658355388,1658355394,6,2093
3130166522,3642339062,1642467904,1642468602,698,151
3780368492,3189085834,1642042977,1642043281,304,841
3381846064,3942575505,1661208921,1661209041,120,2207
3683440211,3662507847,1659326535,1659326576,41,1405
3498461454,3855754332,1646916337,1646917225,888,2200
3013862518,3309799085,1665970087,1665970972,885,1212
3977495302,3059151355,1668217335,1668217809,474,1789
3531357820,3518079213,1654452121,1654452348,227,2143
3950763153,3041652512,1653700693,1653700711,18,1814
3286078112,3231501792,1649483646,1649484444,798,356
3149191705,3771111014,1668633006,1668633401,395,53
3120419076,3589984222,1655861665,1655861699,34,371
3912410470,3799014776,1665656613,1665657057,444,1901
3875892624,3704437148,1650700045,1650700812,767,1578
3835612256,3435518470,1649671452,1649671780,328,62
3805283132,3373566394,1667749419,1667750028,609,591
3526061797,3099013723,1649037175,1649037762,587,362
3049124672,3224800126,1667118127,1667118573,446,2436
3842273000,3422703729,1652869361,1652869918,557,489
3577817989,3653069495,1642185495,1642186080,585,2242
3585553252,3968683220,1667369364,1667370162,798,2155
3130993420,3438084709,1657682076,1657682441,365,1580
3688758916,3257118282,1659656835,1659657655,820,1890
3862389429,3098264219,1666190604,1666191359,755,1664
3937628057,3664112134,1659772057,1659772470,413,2448
3178749877,3780546851,1645387310,1645388054,744,2453
3298527612,3151982756,1654555934,1654556238,304,1039
3066451739,3012593677,1649289048,1649289437,389,48
3361529884,3128839608,1655183989,1655184390,401,747
3805314214,3215622264,1657853002,1657853396,394,1441
3017005264,3555187890,1643509743,1643509803,60,2235
3180836532,3203128336,1649124378,1649124829,451,1297
3117234289,3888469544,1652223429,1652223553,124,416
3600334566,3115245083,1645121791,1645122455,664,360
3759967696,3114744245,1648185116,1648185512,396,921
3791302710,3891400237,1648333443,1648333732,289,740
3734893217,3965585706,1650166558,1650167536,978,1057
3155871721,3011466658,1669261888,1669262359,471,1993
3832265812,3029451399,1653337771,1653338730,959,1017
3605706184,3543732655,1641761109,1641761492,383,62
3288016190,3245491745,1641442255,1641442611,356,1922
3617715231,3111639847,1668798406,1668798965,559,2406
3252790120,3167716044,1652474860,1652475655,795,343
3032465570,3224364206,1645271309,1645271437,128,2360
3749266673,3117141664,1657511069,1657511680,611,166
3154551351,3867026366,1669447916,1669448713,797,1006
3155366529,3549122378,1648724918,1648725499,581,1782
3253759705,3352751731,1669558617,1669559109,492,866
3445647826,3788819111,1660307244,1660307597,353,1758
3344282962,3238443990,1667514217,1667515148,931,770
3368387959,3279351560,1645661148,1645661405,257,2193
3542927039,3734381035,1644957319,1644958099,780,1215
3964636806,3165208023,1656397924,1656398057,133,1959
3223917351,3922927380,1656845390,1656845526,136,143
3660732427,3255776587,1649200518,1649200653,135,1441
3052063374,3382856674,1662528316,1662528771,455,748
3576411084,3967727550,1666761900,1666762016,116,1052
3821594953,3086135849,1641919029,1641919290,261,408
3879182220,3556620301,1654588367,1654588432,65,1256
3724669056,3967506765,1660818351,1660818655,304,1059
3875945215,3992909356,1646525337,1646525400,63,2286
3732456028,3491718080,1668416189,1668416505,316,1161
3077552507,3988539489,1659392927,1659393620,693,612
3313292041,3272663489,1645993691,1645994009,318,1617
3546284533,3060121211,1663841896,1663842359,463,219
3656829277,3739490721,1646182087,1646182921,834,2027
3223694966,3133902865,1655276928,1655277559,631,966
3007446724,3070199722,1650450024,1650450373,349,728
3397397223,3475322181,1667858670,1667858983,313,2318
3553328177,3687293094,1645745071,1645745799,728,805
3877299439,3554680554,1641245945,1641246808,863,94
3073540574,3175832070,1662329203,1662329552,349,1562
3105357126,3099785790,1664894456,1664894696,240,689
3042120123,3273676719,1641859788,1641860264,476,417
3485298583,3462410204,1666543708,1666543833,125,101
3212038287,3936607466,1651994109,1651995020,911,1457
3777609973,3261376049,1650091830,1650092475,645,1545
3441581446,3479580096,1660798511,1660798829,318,2105
3879564460,3327795374,1658237768,1658238566,798,1564
3886720244,3171731237,1642954986,1642955326,340,2129
3529898997,3059322626,1669290965,1669291359,394,2401
3085001659,3265181921,1654513699,1654514127,428,2094
3194617168,3550107804,1650161124,1650161516,392,698
3894413849,3492376573,1656429353,1656429999,646,1324
3456948150,3401611149,1658098738,1658099419,681,1181
3385806632,3446519765,1653719498,1653719544,46,1602
3598223917,3486442976,1659736273,1659736822,549,645
3790751649,3091008161,1645300493,1645301099,606,456
3705809622,3404468022,1664115602,1664115715,113,1532
3168625610,3894690935,1649234388,1649234723,335,510
3707199669,3482576542,1652752264,1652752758,494,1568
3638822670,3021515419,1667440513,1667440680,167,867
3878005127,3481006313,1646133378,1646134102,724,1516
3908848133,3174544371,1653766991,1653767525,534,1713
3674049704,3608893234,1642637258,1642637419,161,167
3070237620,3972056646,1667292623,1667293320,697,1565
3074795505,3977107209,1660041295,1660041702,407,1164
3690015481,3353855658,1655311324,1655311922,598,1529
3661705197,3823917098,1645047212,1645047427,215,880
3109980927,3321818923,1665085885,1665086217,332,843
3450503481,3639804787,1664054639,1664055407,768,714
3885194706,3673549679,1643378860,1643378867,7,2418
3625684557,3433374325,1658181336,1658182070,734,2011
3796990042,3474666564,1643345417,1643345568,151,1784
3553725082,3439129317,1658567002,1658567830,828,969
3072911780,3454276568,1659744913,1659745122,209,1933
3327427782,3339349217,1641110922,1641111052,130,2462
3691607111,3851780195,1651207072,1651207215,143,1777
3078628091,3878180077,1647307479,1647307681,202,441
3235049473,3446490643,1664410012,1664410998,986,970
3904907996,3642314622,1658307296,1658307556,260,151
3776027879,3013073909,1655650917,1655651553,636,270
3503011690,3773505782,1654595664,1654596005,341,2277
3839610928,3217583205,1663782934,1663783880,946,2398
3069881077,3906964033,1660157681,1660158270,589,2339
3059858458,3060522981,1667698788,1667699117,329,184
3298436959,3605587138,1651822623,1651823318,695,230
3223463387,3889537515,1653841699,1653842464,765,1843
3533740602,3603399306,1650144552,1650145208,656,1374
3635324805,3221276652,1644016249,1644016901,652,795
3134166826,3853056907,1652201071,1652201296,225,21
3202745117,3576579408,1662656388,1662656912,524,1136
3489225147,3456435173,1657535927,1657536012,85,207
3909765076,3809059026,1649007765,1649008374,609,2249
3321391869,3360436723,1659648906,1659649294,388,481
3964738114,3159669419,1652129503,1652129755,252,1447
3734579045,3696205962,1655683174,1655683504,330,414
3978925529,3088571651,1646314069,1646314882,813,1775
3578002057,3368387959,1647032525,1647033182,657,1847
3377528840,3837550746,1664395667,1664396580,913,967
3583307819,3816536444,1645084068,1645085002,934,892
3812385830,3177491349,1653118484,1653119214,730,775
3866832484,3658451605,1648026098,1648026176,78,1046
3740274448,3720934127,1646773087,1646773837,750,753
3142106289,3318227153,1664606234,1664607022,788,707
3719965258,3389309088,1663798737,1663799109,372,596
3148589566,3424562136,1668035288,1668035901,613,2452
3545701656,3048077825,1654898882,1654898968,86,1624
3530930024,3108288045,1668719007,1668719166,159,1230
3624188526,3071929787,1646945538,1646945843,305,1319
3104719783,3711151849,1669607593,1669607809,216,728
3230775095,3812034379,1663822602,1663823598,996,1413
3425720812,3382777450,1657197374,1657198106,732,797
3739406554,3637457925,1652582685,1652582946,261,1634
3400121632,3049424358,1662911315,1662912314,999,32
3523508617,3784808734,1651337732,1651338248,516,2166
3476405785,3735286926,1657634269,1657634538,269,646
3208220195,3996993457,1653238387,1653239155,768,1478
3793901427,3791547480,1665467294,1665467952,658,2220
3876829785,3965000413,1643623670,1643623925,255,1231
3141392063,3564839908,1665813705,1665813798,93,1433
3085412399,3567703076,1654176544,1654176900,356,424
3000383745,3285333536,1645583001,1645583715,714,1542
3775766805,3907635993,1667448190,1667448293,103,293
3770393539,3190859932,1649925768,1649926142,374,1845
3694349997,3894431064,1643811200,1643811650,450,899
3913162487,3547365303,1662013855,1662013857,2,268
3921816397,3366609475,1641444899,1641445054,155,2179
3289850617,3400211756,1668381804,1668381883,79,1395
3653850140,3855261620,1649376939,1649377115,176,584
3952654862,3835378465,1643665045,1643665047,2,599
3400211665,3682747704,1652048682,1652049609,927,885
3824083602,3154009016,1664122533,1664123522,989,715
3763455710,3210430918,1654397811,1654397996,185,2413
3663884600,3746351822,1668643339,1668643957,618,810
3337684100,3674349184,1665657325,1665657373,48,1076
3507939773,3569443529,1653082702,1653082783,81,128
3538823780,3647295073,1650938329,1650939137,808,1782
3094852425,3796255141,1654804128,1654804615,487,2491
3840953967,3168919126,1658975645,1658975659,14,1069
3910427189,3020729502,1660518185,1660518690,505,53
3777597419,3103215750,1650594833,1650594922,89,722
3992818695,3474625275,1654339392,1654340241,849,1181
3636572173,3309053474,1655469767,1655470720,953,773
3925344243,3942325631,1645729516,1645729578,62,2122
3424553049,3063674428,1641317019,1641317360,341,1078
3527067891,3381769309,1669682838,1669683748,910,39
3562104036,3816538946,1651868931,1651869530,599,215
3086950119,3375655129,1649418996,1649419905,909,2161
3669311789,3159240548,1644164940,1644165423,483,1994
3351803423,3730106432,1667978546,1667978800,254,2016
3210279328,3996587507,1651559093,1651559381,288,2126
3138539283,3712804229,1653180924,1653181426,502,1300
3300694030,3382015551,1645897072,1645897834,762,1749
3756028002,3138755786,1662043705,1662043825,120,1086
3181086026,3525192232,1645146368,1645146400,32,1784
3523099697,3258460512,1644442117,1644442211,94,1789
3582076532,3695235867,1646620577,1646621291,714,1609
3722817789,3336423969,1667678621,1667679029,408,2269
3514354263,3403512366,1655433405,1655433673,268,361
3889112055,3595270507,1651949709,1651949764,55,2468
3853644964,3269357443,1663412685,1663413316,631,1722
3113938510,3492134379,1643979589,1643979735,146,1908
3567980215,3788688228,1653206572,1653207562,990,1697
3097145374,3310935085,1661990190,1661990903,713,495
3272428764,3677306151,1665591192,1665591686,494,780
3087700946,3358959910,1654821684,1654822143,459,903
3505270174,3852506516,1642568868,1642569099,231,733
3661462228,3679522128,1661502974,1661503181,207,274
3993066194,3292812509,1650551122,1650551710,588,1029
3552305242,3048077825,1660665127,1660665867,740,1527
3365829981,3907213401,1653348609,1653349513,904,1613
3624748073,3354999072,1650219556,1650219915,359,1987
3899585675,3617349707,1652569062,1652569455,393,424
3910712536,3099818927,1661796503,1661796899,396,1642
3546432752,3049147900,1645060289,1645060361,72,261
3780991625,3270395343,1654201347,1654201396,49,696
3494680258,3416076001,1643221668,1643222463,795,222
3592487083,3595049641,1657100862,1657101034,172,2340
3375847073,3309684706,1663815413,1663815712,299,924
3860268588,3264460374,1644447370,1644447688,318,2332
3998209085,3231988469,1650243218,1650244080,862,358
3940948395,3984977278,1656963890,1656964025,135,2023
3959086145,3948695100,1641372842,1641373326,484,1845
3098907787,3072276713,1660599814,1660600000,186,390
3593704176,3749811473,1656385051,1656385075,24,860
3971648409,3132592220,1655541669,1655542301,632,974
3421078448,3366558556,1659308636,1659309568,932,1133
3271436858,3097609387,1660001977,1660002543,566,1350
3672123230,3362298218,1643304257,1643304958,701,53
3632283664,3170985187,1642448147,1642449045,898,1336
3703615574,3624683080,1642814082,1642814102,20,28
3452181736,3284892894,1641864680,1641865225,545,992
3339856407,3235155985,1669310002,1669310502,500,730
3140055258,3740236087,1665476886,1665477674,788,1580
3424211722,3959228076,1669253062,1669253388,326,258
3265262512,3746979257,1655743190,1655744115,925,2087
3300380060,3434182192,1658335896,1658336243,347,863
3395457102,3502484697,1652944129,1652945123,994,1685
3049424358,3984818292,1642661936,1642661936,0,1108
3572689902,3267045921,1645581224,1645581785,561,1904
3734381035,3655250241,1643775587,1643775920,333,2058
3171906034,3313426081,1669600384,1669601135,751,1555
3627191763,3661135703,1648344755,1648345036,281,1938
3852184769,3653285237,1655261445,1655262387,942,2323
3429328367,3689232908,1643674055,1643674379,324,2422
3767409219,3018838603,1660660639,1660661524,885,282
3370488301,3641460659,1658432863,1658433209,346,942
3942273552,3690586350,1656233575,1656234488,913,2150
3880046311,3816690173,1658250771,1658251451,680,1255
3056982737,3013247537,1644547511,1644548321,810,2074
3078791988,3324618357,1653711541,1653712199,658,1438
3743669526,3471707938,1643745370,1643746287,917,324
3731257404,3330623875,1663218490,1663218780,290,2298
3697231480,3191414403,1652292743,1652293245,502,162
3834174227,3621416999,1658120304,1658120915,611,492
3802890793,3659917344,1647254596,1647254988,392,1822
3229368997,3382133724,1648498827,1648498876,49,478
3645341350,3532675680,1652215257,1652215341,84,977
3805653360,3932530423,1645212492,1645212927,435,616
3605519659,3751975877,1663766589,1663767049,460,1834
3502815865,3518322544,1646193623,1646194323,700,2171
3478921948,3252021647,1653540930,1653541599,669,900
3078830914,3506273643,1665198137,1665198409,272,1607
3151564731,3023576817,1645014102,1645014903,801,1052
3225741855,3563750578,1668322217,1668322993,776,1904
3378864156,3129138715,1641753125,1641753869,744,2331
3648975076,3352622181,1665346591,1665347318,727,1297
3044564753,3849379963,1644712823,1644713803,980,916
3331335383,3037375725,1658658578,1658659204,626,1476
3311252249,3242088486,1654905707,1654906406,699,16
3018149057,3574740304,1661954410,1661954993,583,203
3080679691,3894454988,1667651906,1667652855,949,2481
3526798607,3163708045,1653615675,1653616261,586,704
3890852478,3600977488,1649266479,1649267453,974,508
3364586923,3375279811,1654863520,1654863971,451,1703
3135119423,3946068928,1648611227,1648611709,482,641
3055145919,3541942422,1668180914,1668181147,233,2109
3322287315,3668441547,1658346068,1658346442,374,1419
3681489851,3133153956,1645207914,1645207960,46,1544
3423825173,3488151008,1643593911,1643594273,362,294
3867115890,3026035554,1665120077,1665120794,717,698
3272555962,3424476490,1643600701,1643600940,239,2421
3848963466,3828833040,1669405141,1669405595,454,1248
3839369127,3626345917,1644773395,1644774225,830,1907
3650471605,3522621112,1642050020,1642050346,326,1432
3130594039,3881956491,1657044517,1657044981,464,975
3323783108,3855900879,1668239547,1668239976,429,730
3289696366,3469583371,1653903506,1653904358,852,1258
3093773162,3603092087,1655378236,1655378455,219,1123
3107501731,3895542691,1653665000,1653665188,188,1286
3649036403,3220405755,1659458000,1659458273,273,1668
3734035973,3218798966,1657125884,1657126442,558,2150
3030630339,3940222685,1644249531,1644249920,389,1361
3648975076,3534218813,1664997783,1664998133,350,734
3074412412,3961672171,1669669295,1669669354,59,345
3172619193,3620522583,1659854435,1659854949,514,1183
3581470040,3115669693,1643255809,1643256106,297,123
3562104036,3220424979,1659110017,1659110058,41,2175
3918812791,3090354216,1645697686,1645697750,64,4
3449352254,3922358932,1669759218,1669759541,323,773
3586489382,3288016190,1653778917,1653779746,829,517
3426899836,3729321195,1667669469,1667669539,70,832
3194796707,3660732427,1654657543,1654658199,656,517
3272981808,3250253670,1650612934,1650613271,337,811
3625979408,3997312356,1664747157,1664747247,90,322
3648447244,3231501792,1646884918,1646885246,328,1510
3007446724,3309684706,1643091353,1643091967,614,1421
3970753504,3737772457,1662733080,1662733533,453,1859
3407778626,3692095366,1657222646,1657222663,17,81
3988264152,3374174584,1642249797,1642250431,634,2225
3740404190,3370120843,1646065566,1646065937,371,2149
3921451192,3620725243,1660059087,1660059689,602,1489
3443190053,3217923322,1665332130,1665332797,667,2170
3257947713,3405319002,1665921860,1665922102,242,1260
3645850762,3211945942,1652787048,1652787718,670,2423
3986963711,3744347272,1663335207,1663335289,82,355
3399604947,3979203926,1641145617,1641145683,66,1470
3746243275,3809642935,1663795948,1663796941,993,2302
3535467955,3585553252,1649013002,1649013362,360,2315
3981331110,3921261515,1668020038,1668020709,671,1614
3976757440,3745419810,1647983207,1647983713,506,2209
3203153576,3850178015,1658903452,1658904388,936,1090
3196403466,3966056341,1662517408,1662518214,806,2031
3420137628,3808397193,1654197130,1654197280,150,1880
3148041041,3258460512,1648736794,1648737552,758,1271
3917601622,3439799907,1660070213,1660070591,378,2154
3188726102,3029451399,1657506091,1657506120,29,375
3004160380,3129594470,1645931001,1645931760,759,1869
3001037251,3494746675,1644520719,1644521339,620,1064
3830975217,3255149739,1658054508,1658055167,659,879
3556648442,3935210171,1660288413,1660289054,641,1864
3133153956,3452275962,1650221152,1650221823,671,1457
3434090231,3521081470,1644759019,1644759857,838,2488
3319782337,3457317780,1653562521,1653562865,344,143
3134436515,3413781764,1657738071,1657738649,578,141
3716415183,3269294562,1645277931,1645278858,927,1154
3405955824,3949947697,1659996844,1659997631,787,238
3530286335,3955685340,1645645538,1645646155,617,714
3861123581,3574486853,1644597020,1644597236,216,2060
3664930564,3577276558,1655803576,1655804154,578,2444
3541200701,3603594711,1656013268,1656013529,261,158
3460572652,3011985525,1658905334,1658906144,810,1666
3572276937,3855734814,1662267426,1662267584,158,2167
3094147044,3570152654,1668301738,1668302028,290,1833
3820225206,3278819973,1663536836,1663537774,938,460
3407460146,3395525819,1646152170,1646152814,644,186
3972441567,3149046961,1663723838,1663724133,295,2099
3977317498,3572224210,1655529688,1655530501,813,2151
3683739941,3393911160,1645235602,1645236209,607,585
3289255457,3318654389,1660113333,1660114321,988,1888
3993076833,3733649713,1656747352,1656748231,879,2205
3812034379,3109390601,1662210432,1662210456,24,2108
3450228800,3650041115,1654713562,1654714308,746,491
3015253917,3634624974,1654128481,1654129139,658,496
3837065973,3216092524,1646951366,1646952029,663,238
3313687025,3063969367,1649210407,1649210990,583,1089
3602924213,3200978578,1663761621,1663762601,980,1274
3139268488,3554409625,1667663096,1667663565,469,507
3057922933,3733004020,1661366592,1661367091,499,1310
3307185651,3015876104,1651335036,1651335672,636,1451
3359212197,3214282155,1656365771,1656366140,369,1349
3635487786,3927660473,1656912850,1656913664,814,629
3351610798,3744386868,1641176312,1641176993,681,796
3106732056,3664898256,1649143372,1649143543,171,241
3698521503,3761201412,1662322639,1662323325,686,2089
3594777411,3359078190,1652031078,1652031855,777,664
3666179764,3894431064,1663546109,1663546125,16,1077
3972677516,3187291408,1657083550,1657083697,147,584
3715540162,3129034897,1652758083,1652758142,59,1506
3686249771,3739490721,1641976858,1641976878,20,1960
3151938386,3166521010,1664441154,1664441977,823,2254
3881861537,3675481622,1653059319,1653059659,340,1620
3333665805,3173909495,1668209484,1668209975,491,831
3756778635,3419809319,1655790263,1655790356,93,318
3423522480,3079905449,1661502804,1661503730,926,1449
3491356699,3060522981,1665941463,1665941972,509,767
3622062401,3331604266,1661143942,1661144659,717,1424
3990233750,3085921604,1646126948,1646127821,873,1701
3023025075,3558894912,1657411331,1657412079,748,1017
3936122118,3985486150,1666065611,1666065853,242,1316
3371063992,3551243497,1657880594,1657881146,552,602
3829201459,3801736024,1653161953,1653162335,382,113
3510166785,3631732813,1647337106,1647338028,922,259
3451479071,3155807587,1655146428,1655147086,658,2296
3419751912,3499182342,1657795469,1657795702,233,1355
3440778681,3924838447,1647565343,1647565483,140,2148
3833618667,3437221963,1650734002,1650734260,258,1840
3435578430,3727618645,1650258965,1650259266,301,1291
3153391276,3510247235,1667164042,1667164266,224,562
3824845857,3098667748,1652377368,1652377486,118,2028
3143452523,3376266236,1665199125,1665200044,919,1362
3721340009,3785426867,1646761422,1646762282,860,2464
3163973134,3960450011,1643306653,1643307151,498,2055
3546034581,3872691076,1667503699,1667504508,809,472
3252187190,3321105707,1657115505,1657115808,303,1207
3831338864,3317318302,1661664107,1661664206,99,1287
3947704522,3253589940,1661954968,1661955626,658,1522
3952282084,3098276544,1657933392,1657934274,882,1424
3211956216,3014552263,1654865870,1654865966,96,2420
3189759788,3431082237,1659770697,1659770884,187,522
3396524452,3773434774,1642276357,1642276860,503,1891
3863665550,3620311248,1667818292,1667818534,242,1826
3157496248,3366192341,1652375996,1652376929,933,1574
3844939526,3713693431,1649951322,1649951844,522,779
3067641822,3393199571,1647716973,1647717566,593,1555
3595713931,3374692305,1661542774,1661543449,675,407
3137350861,3661462228,1667452708,1667452878,170,1309
3021968850,3417328370,1666698034,1666698868,834,2473
3094418033,3820302319,1645734998,1645735297,299,522
3785725492,3582859001,1646035679,1646036345,666,1885
3949002357,3692861248,1657251189,1657251429,240,1086
3833618667,3490286406,1656141958,1656142014,56,2102
3377826578,3478741068,1652928827,1652929806,979,1919
3898495918,3680841490,1647683781,1647683904,123,1054
3697322167,3636528701,1661102197,1661102292,95,2123
3005356433,3671974600,1642591617,1642592349,732,2007
3229368997,3607393629,1648596008,1648596267,259,932
3702345362,3670550887,1647363489,1647364117,628,2262
3740807524,3450811740,1667917205,1667917791,586,2189
3559176364,3635938446,1651431749,1651432545,796,1292
3579684205,3431562624,1660069457,1660070286,829,2151
3506345760,3379259059,1658605541,1658605876,335,2354
3941642636,3797769846,1668045192,1668045782,590,783
3661559275,3463973561,1651288307,1651289062,755,2344
3218686367,3559023463,1653624548,1653625448,900,1735
3166483466,3833333678,1661392813,1661393533,720,1305
3903886201,3294478149,1641774119,1641774336,217,830
3333103680,3149336644,1657265764,1657266240,476,671
3933450798,3340427847,1664737024,1664737700,676,2253
3824353209,3230277243,1646304087,1646304816,729,1524
3410737355,3397397223,1642720045,1642720670,625,1396
3660575608,3017740025,1665443726,1665444542,816,2230
3929901413,3387247558,1646832488,1646832936,448,1163
3151704655,3877638741,1667104579,1667104901,322,2492
3149313426,3755236966,1651620370,1651620465,95,489
3665148560,3734367959,1662862525,1662863069,544,1603
3231794234,3793117012,1667298648,1667299395,747,2114
3292010262,3603702697,1645216180,1645216902,722,2081
3385246088,3363944559,1644293763,1644294581,818,2294
3798631691,3866993832,1646754152,1646754400,248,961
3460229906,3607393629,1644322976,1644323813,837,724
3289108426,3282168599,1641791738,1641791873,135,2458
3771758356,3925344243,1652662324,1652662787,463,1417
3446519765,3829149174,1655023943,1655024569,626,42
3125818794,3535941714,1661576653,1661576971,318,1232
3619529955,3148549210,1656854646,1656855267,621,1184
3066362135,3934386586,1660944277,1660944853,576,1986
3855769157,3678541527,1641767591,1641768330,739,1960
3143962586,3790406016,1658420512,1658420936,424,2106
3572689902,3350891476,1665048935,1665048982,47,622
3058855369,3473505436,1648035015,1648035466,451,2390
3157821920,3568614629,1652165337,1652166237,900,114
3607352755,3794074656,1654851941,1654852638,697,850
3986963711,3047001138,1648421114,1648421155,41,2130
3454135300,3059068631,1669452304,1669453215,911,857
3351802314,3582046255,1663957602,1663957956,354,1509
3524315738,3127616448,1643189999,1643190849,850,303
3500216283,3834954155,1646620701,1646621055,354,1955
3821299576,3721571243,1654613949,1654614826,877,555
3339911597,3573583612,1667761219,1667762178,959,1780
3044161404,3476903669,1654321543,1654321677,134,1208
3796348557,3292636621,1649834543,1649834611,68,1657
3676690161,3298676228,1653704188,1653705006,818,823
3836855857,3351441481,1655429781,1655430538,757,1090
3447555067,3750949753,1660744209,1660744872,663,73
3404034127,3834954155,1658926748,1658927156,408,1658
3104816625,3698156103,1648578340,1648578786,446,1692
3180836532,3201213219,1651873526,1651874138,612,430
3355184225,3304282571,1653566436,1653566574,138,2248
3774725066,3106437492,1658948080,1658949072,992,486
3415041326,3804657904,1660604474,1660604642,168,1868
3262711330,3467686942,1666273115,1666273988,873,339
3395782360,3603131487,1668882932,1668883231,299,1283
3930242126,3174722772,1662305841,1662306243,402,1302
3080195715,3236325866,1659801793,1659802393,600,1313
3984818292,3067150549,1641244502,1641244869,367,1730
3621379912,3389309088,1643829654,1643829771,117,346
3118443010,3997050001,1662936600,1662937140,540,2343
3394220993,3915494041,1642779248,1642780118,870,2317
3405319002,3542832965,1651986973,1651987675,702,1508
3789727449,3964524277,1665342459,1665342596,137,1917
3488506620,3136564426,1649578118,1649579108,990,132
3649649514,3539303536,1655514747,1655515721,974,1316
3432765814,3878573707,1646774856,1646775153,297,213
3404904674,3403024728,1643318366,1643318791,425,524
3255492165,3641729236,1664726701,1664727428,727,258
3947229430,3393314546,1669752364,1669752939,575,1725
3638527581,3244997486,1667976146,1667977118,972,1264
3862122399,3667684695,1665787657,1665788518,861,2051
3284958290,3293416862,1665781534,1665781861,327,1678
3009635817,3863652254,1654660322,1654660573,251,1398
3267089074,3948219301,1652148532,1652148928,396,2370
3878876305,3267319115,1660407370,1660407866,496,131
3640915578,3371970996,1646010042,1646010154,112,462
3432059238,3637292465,1657034362,1657034490,128,362
3091008161,3752176146,1645662476,1645662673,197,644
3417532235,3021129414,1663896635,1663897504,869,1704
3249627758,3496318579,1663874642,1663874720,78,91
3708337100,3770641398,1660876453,1660877413,960,2421
3784698616,3666268915,1658294620,1658295536,916,2114
3264673951,3185118961,1654791040,1654791171,131,696
3680694926,3696205962,1660520216,1660520374,158,1232
3361694981,3935259918,1668885079,1668885319,240,1468
3531842620,3400000869,1668973249,1668974096,847,123
3064831559,3732456028,1650338921,1650339664,743,1722
3590627159,3093599187,1668593620,1668594425,805,2076
3630744403,3256566881,1645014489,1645015357,868,1594
3385430413,3759986276,1655778235,1655779154,919,2226
3605195406,3007357837,1661890330,1661890616,286,1735
3590735151,3896866052,1661478246,1661479206,960,719
3261866390,3007339106,1657161121,1657162085,964,1387
3894431064,3306252501,1668058899,1668059844,945,462
3878698797,3500053511,1664757642,1664758430,788,1608
3705755036,3787298788,1641393555,1641394053,498,548
3848860153,3881206954,1649561290,1649561416,126,1
3866414868,3102669962,1660602672,1660603253,581,479
3736911154,3030551637,1645498316,1645498845,529,2434
3884704204,3766595984,1645366256,1645366893,637,1787
3036448305,3769786489,1663734548,1663734963,415,2188
3125289160,3900876329,1650118186,1650118738,552,171
3497507557,3017504746,1651139849,1651140313,464,1616
3611657912,3073924620,1665663600,1665663686,86,937
3924607271,3537735224,1665259055,1665259196,141,1465
3186207758,3479401831,1650111961,1650112740,779,314
3797769846,3962453693,1647456014,1647456832,818,1397
3712630492,3757189761,1656121722,1656122465,743,185
3948260526,3458971289,1663108648,1663108805,157,1139
3307033178,3956796805,1653070040,1653070454,414,593
3529681535,3253759705,1662051642,1662051853,211,2241
3580908290,3814577253,1668342079,1668342282,203,452
3670519908,3502947486,1657221489,1657221957,468,168
3744386868,3586950573,1650812904,1650813386,482,1245
3377798373,3546859493,1644877142,1644877413,271,62
3543668840,3168535205,1650901902,1650902706,804,1977
3237674968,3223694966,1661704123,1661704258,135,2276
3093178960,3232304638,1666262673,1666263168,495,234
3504911583,3597557082,1659692332,1659693204,872,3
3963547295,3317748904,1647425201,1647425898,697,1905
3957216784,3900356013,1643923270,1643924128,858,1158
3735277639,3450023391,1655047638,1655048053,415,894
3136174856,3593861215,1648918541,1648918919,378,1029
3927388172,3607978764,1657287367,1657287450,83,1325
3315402916,3173809486,1645265222,1645265238,16,1072
3640613606,3355848120,1662030203,1662030235,32,2127
3091275117,3300456889,1651056960,1651057137,177,1064
3371707067,3960908616,1660686545,1660687073,528,1596
3167737446,3659752387,1644698887,1644699169,282,385
3779236518,3075001202,1664938192,1664938228,36,952
3623936873,3401611149,1660434262,1660434698,436,1256
3902543996,3215453691,1668667053,1668667963,910,1415
3254174311,3311303975,1668289332,1668290086,754,1075
3300015174,3069881077,1666246946,1666247234,288,469
3243059921,3804094924,1660703872,1660704355,483,291
3705809622,3822187489,1649549398,1649550013,615,175
3561572123,3934386586,1650259698,1650260353,655,2399
3905999483,3323698166,1658177646,1658177941,295,2412
3163921304,3212707122,1662409207,1662410036,829,1707
3856080546,3609799738,1664132848,1664133710,862,2353
3852704822,3804824307,1650860344,1650860428,84,1390
3359417056,3428889808,1657606145,1657606824,679,2088
3616651934,3096740365,1668791825,1668791925,100,1789
3519003851,3379366812,1647068699,1647069015,316,1395
3879325408,3865529150,1644300729,1644301719,990,2034
3521944506,3934199220,1646554134,1646554981,847,913
3244763805,3040889811,1650695183,1650695192,9,1698
3316237227,3954297181,1663807717,1663808313,596,529
3936193189,3375799029,1649665308,1649666277,969,498
3049913617,3630448266,1662422872,1662423731,859,2427
3762690279,3608079336,1655266137,1655266555,418,2163
3443490373,3479401102,1651392118,1651392410,292,136
3898603481,3259166637,1644501477,1644501650,173,1972
3770393539,3828196026,1648929215,1648929689,474,905
3411272565,3086871623,1656025549,1656025836,287,1583
3472820961,3951158399,1646699026,1646699618,592,701
3129899259,3589366986,1642626388,1642626515,127,254
3659326501,3550218169,1657424752,1657425092,340,1890
3998850502,3149668198,1651373474,1651373756,282,553
3036488445,3057574793,1652676559,1652677184,625,2445
3640585545,3419809319,1662657265,1662657759,494,218
3079013365,3377774902,1656161086,1656161679,593,953
3224715818,3755228064,1661388763,1661388845,82,2280
3664627036,3090179745,1650759715,1650760670,955,2447
3442735570,3203153576,1655371057,1655371625,568,336
3558493130,3830015015,1666186789,1666187182,393,121
3508514571,3785721693,1648574548,1648575441,893,1801
3977359273,3756806050,1644887174,1644887296,122,1549
3294569676,3789727449,1663010869,1663011309,440,291
3982644241,3608450611,1658296923,1658297507,584,1480
3291819950,3104472516,1668453811,1668454117,306,838
3634041831,3158834421,1651367224,1651367869,645,1237
3604755020,3599795440,1646083830,1646084377,547,1100
3828503026,3989646368,1668791586,1668792571,985,2054
3653069495,3093178960,1654439869,1654440466,597,1768
3445469609,3086135849,1668341393,1668341642,249,2321
3600573063,3047001138,1651339061,1651339885,824,1611
3242785599,3989563375,1665993204,1665993482,278,1554
3948577391,3327504995,1668491366,1668491619,253,303
3834011879,3994844749,1664451378,1664451994,616,37
3766966794,3171906034,1657327502,1657327614,112,2037
3751411767,3237563954,1659954561,1659955061,500,1858
3039962870,3855218155,1656404948,1656405803,855,2360
3011567148,3994577207,1649178381,1649178865,484,1690
3270453709,3927284839,1657304181,1657305073,892,1352
3114812192,3901360663,1663619492,1663619553,61,173
3296957627,3965629952,1669411918,1669412628,710,1934
3271876104,3597557082,1645697012,1645697441,429,1512
3694210631,3424368056,1645530088,1645530153,65,2412
3886521075,3181237998,1656574781,1656575304,523,1890
3071765048,3897976617,1667004364,1667004462,98,798
3399055713,3636237325,1660478566,1660478989,423,419
3582076532,3201629659,1661204044,1661204497,453,1725
3264121565,3581216621,1665943702,1665944081,379,1295
3038644033,3130561868,1651159351,1651159386,35,634
3029956642,3679522128,1658438358,1658438860,502,1554
3873218862,3886720244,1644979271,1644980102,831,1611
3456239535,3435292986,1660481187,1660481332,145,376
3980926444,3595738872,1657266176,1657266706,530,901
3760432849,3285333536,1641842888,1641843372,484,1196
3342082281,3086835861,1652790600,1652791564,964,1031
3487756836,3617200235,1663671954,1663672880,926,64
3167074299,3534752391,1650478944,1650479399,455,1295
3670709726,3114605564,1645478036,1645478431,395,474
3417176290,3796559738,1656526642,1656527509,867,1367
3968337751,3665075758,1655385939,1655386692,753,366
3308353096,3581449963,1644224574,1644225121,547,1837
3980050310,3015715378,1646266093,1646266169,76,78
3883176560,3066714195,1664520368,1664520400,32,424
3051404798,3599327423,1660255944,1660256469,525,305
3657391976,3446914685,1643841167,1643841387,220,1412
3836535079,3957053810,1659767284,1659767358,74,2256
3350566867,3298676228,1658011957,1658012163,206,1300
3213039478,3276618988,1649876125,1649876780,655,752
3222060578,3411347712,1650714552,1650715265,713,2253
3142899759,3236522609,1666353372,1666353385,13,184
3338020076,3578068647,1645264920,1645265769,849,1238
3374134461,3555912894,1662534434,1662534974,540,1768
3896019652,3335976452,1664688075,1664688242,167,1519
3885162740,3567926021,1652185716,1652186064,348,1334
3443435826,3005472311,1656028936,1656029539,603,676
3350852842,3646544919,1642944637,1642945172,535,453
3101669976,3553301078,1658018489,1658018948,459,517
3729600228,3341300979,1646697805,1646698318,513,2457
3786194675,3655135775,1664136240,1664136882,642,210
3234064099,3609804397,1663400110,1663400917,807,2022
3397052856,3315593278,1667775439,1667775565,126,2426
3570423127,3003321686,1668849886,1668850118,232,1455
3730984573,3172825605,1642225581,1642225869,288,2088
3853056907,3816779135,1659058534,1659059450,916,1169
3965863452,3866993832,1642897370,1642897549,179,221
3446547180,3054639823,1660784919,1660785886,967,2164
3776063818,3619045997,1660278031,1660278242,211,1319
3714538351,3616890026,1649390734,1649391482,748,1854
3594231530,3267045921,1660515818,1660516730,912,673
3023265778,3888757366,1648880110,1648880151,41,437
3429684538,3383179408,1669272934,1669273437,503,1047
3481308282,3631587282,1669585646,1669586460,814,1634
3576579408,3770393539,1669220162,1669221104,942,2127
3235049473,3667684695,1654599807,1654600801,994,587
3481881323,3367865740,1668085879,1668086232,353,1537
3081188307,3825971737,1652074033,1652074356,323,1820
3750083020,3366155048,1651027385,1651028136,751,462
3569401888,3959651432,1647236249,1647236393,144,2358
3291667893,3997215508,1646269101,1646269908,807,556
3645666563,3000725837,1655085681,1655086461,780,1546
3429660049,3565287194,1648371868,1648372270,402,2016
3539364028,3430090428,1646267213,1646267616,403,1475
3791107997,3434833146,1655314085,1655314496,411,706
3079905449,3030074344,1655843763,1655844691,928,1625
3057028614,3698906761,1647720572,1647721160,588,970
3686594925,3680100111,1656747230,1656748072,842,510
3433237569,3533274758,1649605904,1649606352,448,742
3375847073,3286473367,1658396031,1658396263,232,2140
3241392393,3142160799,1662258915,1662259466,551,1545
3326881805,3571991159,1642033396,1642033574,178,2489
3152438109,3259071830,1642689436,1642689583,147,401
3413334821,3470482542,1664535010,1664535219,209,2231
3124321462,3705247337,1641423796,1641424132,336,630
3722817789,3783992161,1659855788,1659856479,691,1336
3771460646,3208220195,1645752767,1645752905,138,1288
3168984273,3106429728,1654314225,1654314446,221,1047
3074044425,3779459643,1665146936,1665147476,540,1160
3562004989,3752297066,1641646059,1641646368,309,166
3363611494,3229881750,1649721052,1649721797,745,95
3293865251,3541920859,1652115897,1652116302,405,1857
3916226073,3161999632,1661356385,1661357256,871,994
3588728644,3764078507,1655194132,1655194395,263,188
3490381305,3969241066,1651436249,1651436805,556,297
3962034507,3868701805,1648874319,1648874977,658,1011
3344143432,3494990710,1657825549,1657825708,159,2400
3282079727,3863697907,1642956336,1642956481,145,733
3341042744,3095834081,1645181675,1645182162,487,992
3487547990,3728160519,1666749970,1666750127,157,312
3643173963,3431595099,1655304588,1655304928,340,2456
3190035679,3359895223,1651285795,1651286280,485,2060
3730337290,3790783685,1668619603,1668620190,587,177
3665591394,3135579253,1657251463,1657251590,127,1599
3709681519,3306515955,1644162164,1644162412,248,1062
3369330833,3787550831,1642949591,1642949628,37,2339
3779590261,3341591226,1663691779,1663691824,45,726
3591551688,3634624974,1644138530,1644139330,800,132
3945611603,3266270844,1654526355,1654527013,658,899
3659285822,3150582711,1668130720,1668130895,175,334
3945607460,3628583147,1658265483,1658266448,965,1889
3284840023,3978728021,1643335946,1643336655,709,2058
3798512184,3177762456,1664598479,1664599348,869,1409
3067403592,3121651540,1663757573,1663758315,742,1435
3894382679,3183259139,1668123907,1668124425,518,1446
3412047712,3134793811,1664905477,1664906032,555,35
3069536467,3012929490,1652063042,1652063525,483,1672
3563343479,3953118937,1643070958,1643071873,915,588
3206198477,3412927884,1651535083,1651535895,812,882
3943221472,3754139010,1665931311,1665931816,505,997
3140971443,3678541527,1665634046,1665634599,553,2371
3232737784,3745248673,1656462686,1656463234,548,749
3169072505,3256317082,1652080238,1652081079,841,125
3003422357,3890448806,1653813067,1653813975,908,856
3433576059,3012119082,1645500625,1645501428,803,158
3568599890,3527067891,1661734804,1661735425,621,1019
3612061421,3045691620,1649234843,1649235773,930,1789
3948695100,3379105646,1647613240,1647613650,410,1788
3594009328,3892142252,1665633190,1665633373,183,1825
3769868188,3365134626,1654391587,1654392144,557,672
3060633640,3680703930,1664159185,1664159383,198,425
3442735570,3406595083,1669604677,1669604792,115,425
3447887397,3725903222,1654703232,1654703541,309,2094
3665668423,3838136289,1659501751,1659502561,810,1548
3049869003,3716246985,1660732626,1660733515,889,2321
3311113773,3206149175,1662373844,1662374091,247,974
3364059276,3555560595,1649284796,1649285644,848,1751
3999390272,3423825173,1651576903,1651577285,382,2347
3106781266,3920875021,1667542250,1667542555,305,679
3014975304,3250484759,1646438348,1646438718,370,42
3821391381,3083388257,1650126256,1650126747,491,1451
3446987671,3023140319,1652445929,1652446458,529,884
3200827648,3592596587,1647962053,1647962964,911,1798
3404394014,3427225872,1666655783,1666656774,991,140
3593861215,3771623134,1642922066,1642922455,389,1718
3801736024,3351218513,1662556271,1662556951,680,2157
3971093415,3089325315,1653129164,1653129417,253,1085
3650902153,3176608983,1653599243,1653599972,729,125
3826827617,3773996198,1645631306,1645631774,468,149
3375759020,3451131159,1655600955,1655601895,940,2037
3111823829,3910712536,1665015973,1665016699,726,879
3085136451,3890781778,1646906444,1646906458,14,2283
3576579408,3510634049,1658991148,1658991169,21,1736
3278612503,3214282155,1651800805,1651800908,103,2363
3175929512,3666579485,1668642651,1668643490,839,451
3956878212,3351182329,1647185497,1647185644,147,2019
3621571402,3823682564,1642935234,1642935401,167,1863
3425490548,3799624292,1657570432,1657570856,424,1744
3956027073,3581216621,1667510225,1667511012,787,1464
3280717680,3735547050,1668512208,1668512955,747,243
3415522797,3463800741,1664348387,1664348964,577,1223
3810573183,3972195042,1662474089,1662474126,37,1274
3832144696,3772406671,1645688485,1645688769,284,1773
3408604990,3290860752,1656783476,1656784374,898,299
3055020688,3935125903,1649831679,1649832285,606,1994
3859634422,3995365519,1665801233,1665802118,885,376
3264831577,3162844882,1648082919,1648083854,935,810
3144175285,3291984936,1646534368,1646534448,80,594
3176753600,3925481419,1662657617,1662657709,92,1378
3345458354,3320039544,1656718087,1656718623,536,2463
3993637202,3311921613,1652655941,1652656739,798,2196
3293387588,3857434991,1647956441,1647957358,917,1345
3285757325,3943221472,1665356494,1665356631,137,346
3139931020,3244398882,1662137881,1662138869,988,2106
3193657080,3482406705,1643142874,1643142885,11,1336
3404908537,3446289365,1662611189,1662612022,833,1510
3701668957,3816567987,1659690709,1659690733,24,1170
3855223575,3988790434,1656655353,1656656083,730,1303
3553328177,3022916032,1645427818,1645428273,455,2441
3088595440,3409823179,1668732618,1668733131,513,860
3319224567,3117732598,1669086597,1669087443,846,1134
3637129082,3832336338,1669174696,1669175108,412,2242
3047126246,3514894244,1658342446,1658342448,2,1674
3550261012,3806652632,1661316507,1661317414,907,974
3728240849,3586025172,1648815772,1648816087,315,1546
3507644528,3590384867,1653969762,1653970680,918,787
3224792502,3832296106,1644379108,1644379348,240,1182
3098264219,3948074176,1656441147,1656442118,971,2167
3579404607,3199892178,1666163778,1666164124,346,1852
3900588986,3624103484,1647092266,1647093199,933,2488
3383110959,3214282155,1643588656,1643588769,113,2238
3104210284,3636879699,1644161453,1644162167,714,1892
3943927246,3414224162,1662928296,1662928548,252,1123
3153831709,3922358932,1646320679,1646321586,907,964
3809642935,3019572992,1643120738,1643121384,646,1711
3272981808,3401134518,1654342077,1654342186,109,2050
3962617141,3112739600,1664284936,1664285162,226,2377
3908153195,3159897010,1658953319,1658953507,188,444
3032018734,3214698363,1666776595,1666776906,311,1039
3857590396,3276010368,1664459013,1664459402,389,1918
3622259711,3724157579,1656426488,1656426773,285,108
3106804099,3991477345,1646032298,1646032658,360,2188
3876377964,3882038749,1646476772,1646476774,2,25
3779319466,3140407144,1661543410,1661544263,853,468
3113423573,3300104659,1667740387,1667740427,40,49
3481689842,3991727598,1665551503,1665552075,572,1113
3469359731,3508311968,1644582750,1644583609,859,180
3567637602,3991087724,1653479386,1653480250,864,500
3163326257,3474558723,1665658269,1665658426,157,2230
3164467795,3594707374,1662687700,1662688066,366,708
3293387588,3389114774,1665360564,1665361303,739,2104
3128318593,3544772636,1653876505,1653876841,336,1833
3970645989,3056173313,1652550569,1652550999,430,771
3707867178,3072277927,1650209661,1650210380,719,1418
3562104036,3936292699,1653892613,1653892987,374,1438
3915772795,3673524018,1655960482,1655961043,561,865
3156522255,3599915754,1662564721,1662565242,521,451
3807478002,3503394389,1661310296,1661310763,467,991
3269699819,3105789496,1645700511,1645700512,1,2099
3731437059,3595284541,1668271106,1668271378,272,1539
3329154834,3206386504,1641209907,1641210087,180,443
3020446596,3937197371,1662895387,1662896127,740,1272
3560053389,3581454117,1643505950,1643506366,416,1268
3740274448,3760047951,1651673948,1651674560,612,657
3401138486,3023254734,1646119002,1646119491,489,1853
3606749014,3799287196,1662668249,1662669010,761,1481
3585816096,3663155034,1659863587,1659864100,513,962
3965000413,3110639083,1664345920,1664346740,820,2472
3705601482,3915111520,1659484871,1659485371,500,1534
3685505113,3870574001,1666407082,1666407152,70,2123
3450672463,3456799118,1654978362,1654978496,134,1
3372334548,3805742408,1668782006,1668782479,473,1985
3471797400,3593988999,1652440419,1652441097,678,2458
3521410258,3594038673,1654941870,1654942272,402,2143
3634282428,3790635482,1650753807,1650754700,893,2181
3798527829,3574240169,1668954712,1668955249,537,1615
3349847682,3572594221,1645114944,1645115701,757,2324
3740854424,3893170545,1666637736,1666637834,98,2051
3423043196,3725042810,1662003610,1662003874,264,907
3929774793,3133647753,1667649286,1667649636,350,1106
3061814600,3677064508,1658791979,1658792169,190,2228
3508311968,3053134032,1660866705,1660867044,339,2345
3117575075,3382693942,1667156558,1667156660,102,911
3530491537,3878808489,1657519884,1657520507,623,411
3219899577,3147210428,1652376292,1652377233,941,2492
3621379912,3344285047,1667402824,1667403612,788,241
3539571109,3631587282,1667854542,1667855146,604,20
3664989774,3452248216,1663387205,1663387381,176,1377
3345733128,3944493334,1666150581,1666150876,295,2293
3655135775,3049869003,1648427495,1648428186,691,1935
3515170949,3017712081,1649325832,1649326097,265,625
3735081666,3165845148,1648997804,1648998166,362,139
3802545642,3462744404,1646887472,1646888233,761,794
3024268753,3244969283,1647757518,1647758027,509,1706
3724806243,3341591226,1655305266,1655305923,657,1893
3692772256,3862138776,1649517388,1649517485,97,723
3391426421,3333516284,1662944514,1662944688,174,1609
3364938815,3794715398,1663645321,1663645379,58,1298
3745289284,3310970237,1659385651,1659385771,120,444
3909278547,3939480099,1657331505,1657331873,368,1953
3805921576,3938025728,1656273720,1656274466,746,733
3762744269,3922675517,1647632099,1647632287,188,814
3878274883,3924559198,1648044856,1648045835,979,896
3828890005,3766160943,1668314880,1668315422,542,1037
3333543321,3796936978,1645463136,1645463270,134,2426
3427937915,3580901513,1660411977,1660412908,931,1244
3806664868,3010819705,1662585164,1662585965,801,2270
3111163302,3093131372,1665250636,1665250936,300,2498
3693652924,3392535031,1662822515,1662822734,219,1296
3048077825,3965118569,1648600718,1648601289,571,1657
3915986965,3094291821,1645794138,1645794230,92,1859
3069536467,3098083694,1653172550,1653173360,810,64
3649724545,3890448806,1647758492,1647759273,781,179
3366896849,3064804156,1646267615,1646267969,354,494
3071023164,3846585557,1660995127,1660995168,41,1495
3744788361,3625938415,1644496609,1644496623,14,202
3933892798,3317241023,1664801232,1664801630,398,2219
3044450059,3054659800,1647650585,1647650630,45,1075
3933752482,3248900308,1663285936,1663286709,773,1243
3251106195,3021289375,1653278506,1653279296,790,2247
3036801405,3510323514,1653414311,1653414443,132,2158
3229080104,3562004989,1651956960,1651957597,637,1069
3251808759,3113608489,1663634993,1663635322,329,814
3235476099,3109980927,1654765165,1654765513,348,307
3003087336,3595612540,1648062852,1648063722,870,1106
3352005808,3889112055,1647903126,1647903704,578,704
3870349696,3432942151,1655902248,1655902861,613,2098
3046707177,3194721041,1659119780,1659120718,938,248
3456080836,3307933176,1667556494,1667557471,977,594
3060757458,3011466658,1652306756,1652307739,983,390
3582138072,3078216798,1657460008,1657460105,97,1803
3718375865,3190035679,1668218083,1668218504,421,1304
3806520351,3431117217,1662387753,1662388535,782,778
3972195042,3578219289,1666421744,1666421973,229,1073
3677539420,3743136976,1667081866,1667081968,102,1427
3772980352,3712276884,1665126257,1665126966,709,1879
3099102864,3435518470,1658230829,1658231035,206,2030
3580594125,3393000047,1662003621,1662003682,61,1996
3879299283,3673850585,1665288138,1665288490,352,312
3809623566,3942520090,1645820206,1645821056,850,1700
3742005806,3478166190,1657716587,1657717584,997,837
3384222838,3960772879,1655262238,1655262966,728,2499
3175478710,3280491285,1651912903,1651913005,102,732
3516089114,3548028995,1649996428,1649996713,285,888
3126417218,3015876104,1668581829,1668582674,845,375
3832585790,3037048394,1652979715,1652980370,655,771
3224952698,3964738114,1645472117,1645472546,429,1121
3171569619,3693102953,1661680968,1661681843,875,2338
3100716894,3355135607,1650910224,1650910372,148,2131
3649724545,3270273033,1643592963,1643592989,26,727
3963793916,3639307843,1658911289,1658912189,900,1727
3530278315,3677674125,1645294242,1645294932,690,2145
3852555743,3216241275,1662470075,1662470188,113,1223
3856756422,3368322774,1656729369,1656729433,64,1481
3386918140,3273243249,1662862636,1662862987,351,1105
3475846394,3223154180,1669270936,1669271133,197,530
3263033338,3988546259,1651929779,1651930002,223,1569
3153902371,3042360618,1645686451,1645687283,832,2061
3017758671,3002631535,1664720245,1664720633,388,2422
3786540807,3370867881,1644045144,1644045495,351,414
3670709726,3828503026,1663568336,1663568736,400,1863
3678340379,3863652254,1643395869,1643396021,152,1030
3980851662,3106705860,1662431718,1662432141,423,2062
3364540592,3268225181,1657834316,1657834448,132,3
3334207071,3657251975,1657470738,1657471607,869,47
3591834837,3817548425,1648342926,1648342970,44,878
3880620233,3668456327,1654479898,1654480822,924,2416
3792027887,3522132687,1645538017,1645539011,994,528
3449115415,3154653229,1650583513,1650584230,717,974
3915439541,3975075818,1656787611,1656788386,775,76
3039972849,3060893703,1653917696,1653918085,389,191
3487756836,3072834944,1651695327,1651695584,257,396
3891518316,3679939578,1668846360,1668847337,977,752
3329135548,3116777827,1662999457,1662999503,46,387
3481482238,3734893217,1669178307,1669179249,942,104
3097563397,3379259059,1641144555,1641144721,166,2000
3799480079,3971391515,1665288696,1665289388,692,455
3115777637,3045302814,1651167935,1651168835,900,1675
3330058679,3272811357,1660719381,1660719888,507,1134
3947604616,3254194915,1657648274,1657648954,680,790
3143679923,3094277549,1654989126,1654989468,342,1778
3870485916,3494498890,1668155230,1668155282,52,246
3846477373,3717137928,1648586782,1648587601,819,383
3889840253,3533414032,1664524340,1664524364,24,1738
3709607250,3061594029,1657738521,1657739307,786,881
3569006301,3085136451,1649459902,1649460495,593,12
3631732813,3048045312,1664355996,1664356130,134,2352
3647216166,3913071406,1661237575,1661238354,779,1688
3672123230,3222870125,1650274570,1650274661,91,1950
3347832946,3610577318,1651435247,1651435889,642,1242
3417248496,3656654582,1641370461,1641371155,694,2265
3714105777,3445469609,1645593156,1645593295,139,2353
3501568597,3802325069,1665463439,1665463916,477,865
3359078190,3109127825,1660044446,1660045249,803,33
3913071555,3825023321,1666518560,1666519009,449,773
3349666443,3142463511,1646202735,1646203031,296,2332
3571972204,3436768933,1646156785,1646157502,717,646
3562021711,3905922866,1643077717,1643077901,184,1190
3260246509,3198195956,1652787045,1652787765,720,406
3251808759,3656654582,1655256170,1655256808,638,745
3766914780,3272555962,1648881384,1648881575,191,2317
3994844749,3362972722,1655228640,1655229035,395,91
3243018622,3712581685,1650319616,1650320269,653,1437
3698898645,3962440297,1664150703,1664151536,833,2160
3814608487,3661136551,1646604479,1646605194,715,1468
3563972468,3039081980,1645489802,1645489838,36,1480
3678336055,3344177563,1661717221,1661717439,218,2264
3371063992,3041632417,1663604834,1663604967,133,2303
3696716300,3133694612,1667555850,1667556562,712,731
3108805085,3611269407,1658509289,1658509738,449,9
3151564731,3289693932,1645388882,1645388948,66,134
3912803496,3206549691,1644980943,1644981479,536,2315
3349718189,3021727735,1666786785,1666787702,917,630
3343249545,3157965235,1667947361,1667948178,817,1159
3022916032,3375782922,1662507572,1662508073,501,145
3450228800,3692095366,1644121405,1644122361,956,1040
3486810833,3635921511,1643719687,1643719845,158,1435
3150503842,3286555567,1667052693,1667053565,872,2138
3719507293,3563967528,1649507869,1649508369,500,2248
3977495302,3442477300,1657718369,1657718735,366,1226
3659285822,3114812192,1665609411,1665610298,887,2378
3476971345,3320488617,1668055829,1668056013,184,1514
3108500091,3310512172,1669098510,1669099231,721,1139
3028780744,3956878212,1666968318,1666968385,67,2481
3064758483,3675683512,1662966814,1662967447,633,509
3947083981,3666494756,1669251984,1669252005,21,292
3408978529,3164702890,1650354963,1650355201,238,1837
3067150549,3878657197,1642845216,1642845732,516,1274
3602497998,3401382792,1645737545,1645737710,165,1311
3324611610,3385806632,1659255775,1659256435,660,848
3332144974,3512100935,1666785835,1666786661,826,648
3384200089,3440324329,1647730374,1647730973,599,2234
3627886263,3651058536,1663756416,1663756632,216,383
3895991710,3658516535,1647716229,1647716321,92,1188
3216243579,3247688800,1659872377,1659872996,619,1448
3255149739,3354055639,1656316750,1656317227,477,484
3761584126,3064522150,1664254005,1664254764,759,721
3603853942,3442244098,1648515944,1648516285,341,445
3328993418,3691032308,1665012196,1665012575,379,2075
3315218003,3827431944,1642478524,1642479087,563,2173
3124964775,3634044438,1668140344,1668140749,405,2415
3323698166,3348234563,1647330935,1647331707,772,1521
3948310967,3128514837,1667794521,1667794675,154,472
3073969560,3487030175,1652454742,1652455026,284,1731
3429328367,3641493201,1664464635,1664464875,240,886
3316398180,3671296032,1651459653,1651460107,454,1529
3387785849,3370867881,1665337412,1665337573,161,764
3722948390,3420298161,1652862019,1652862039,20,134
3983610735,3411921561,1665339280,1665339757,477,1388
3587171844,3133601374,1658676718,1658677201,483,1289
3936943386,3123677020,1659081769,1659082732,963,1702
3779590261,3978720869,1647617564,1647617895,331,1481
3595049641,3127616448,1661288807,1661289759,952,1563
3878925459,3266270844,1664942687,1664942917,230,2435
3008417861,3821391381,1651423849,1651424272,423,926
3600879855,3901468403,1662910370,1662910723,353,503
3470049551,3116281998,1646266531,1646267354,823,961
3458252541,3742145726,1654574745,1654575189,444,855
3478771172,3264831577,1665030170,1665031073,903,83
3292507015,3534752391,1644038536,1644038800,264,2077
3882030333,3323698166,1641771394,1641772033,639,507
3901026791,3371289776,1653958974,1653959635,661,1468
3319605191,3400730635,1648159223,1648159270,47,1838
3103681676,3449352254,1658959721,1658960271,550,747
3513576000,3074385503,1653784779,1653785350,571,257
3249554278,3377774902,1652471938,1652472744,806,1431
3036448305,3469722588,1648340781,1648341045,264,168
3981379416,3708101315,1655332630,1655333243,613,1953
3866601790,3639695113,1667059495,1667059505,10,1468
3468633309,3982736205,1645856699,1645856922,223,1768
3762208346,3481466662,1653063446,1653064324,878,1747
3010161936,3280328195,1645769804,1645770613,809,1131
3611062566,3441206388,1650365586,1650366395,809,2221
3049869003,3558281313,1654367977,1654368829,852,1119
3087612913,3656770582,1646960624,1646961080,456,2089
3364661787,3355798436,1656728451,1656729326,875,1839
3188384391,3711576021,1661564533,1661564721,188,1607
3570050230,3042836639,1661050439,1661051072,633,1370
3167121088,3466473464,1668787491,1668787754,263,137
3539402223,3159900056,1661474359,1661475343,984,504
3216470508,3615359439,1649699726,1649700613,887,2230
3488962022,3993332175,1665331025,1665331529,504,1
3806652632,3828503026,1662946289,1662947051,762,1405
3474625275,3114744245,1665003814,1665004550,736,1787
3582471153,3986631065,1665122393,1665123246,853,1338
3148400970,3250235938,1660905887,1660905887,0,139
3461628724,3592026567,1641581867,1641582255,388,946
3661494924,3576862500,1647166455,1647166967,512,1525
3281803406,3941266037,1652648839,1652649160,321,523
3066168441,3927886349,1646817715,1646818587,872,1828
3239469849,3698898645,1644317000,1644317581,581,906
3689231617,3942656665,1652618156,1652618369,213,4
3195534254,3604755020,1665744601,1665745428,827,1541
3890181496,3067220098,1663680170,1663680961,791,155
3340464785,3997312356,1663192916,1663193335,419,1617
3195504067,3820070209,1654930122,1654930591,469,1295
3350345176,3864414449,1667646732,1667647155,423,1143
3189396065,3552101140,1659496853,1659497416,563,1176
3302344507,3535941714,1641955296,1641956031,735,1771
3805665502,3861123581,1651059214,1651059719,505,705
3764492400,3360051725,1653346781,1653347151,370,747
3659701814,3804948415,1663148780,1663149262,482,728
3293761762,3713404433,1651481122,1651481715,593,1156
3933892798,3629225227,1657352243,1657352929,686,524
3707199669,3884704204,1663388045,1663388515,470,607
3261333996,3135707503,1653016315,1653016637,322,814
3445226012,3047477485,1657591459,1657592057,598,86
3955307397,3452275962,1656986210,1656986683,473,359
3992226673,3963303057,1647385516,1647385920,404,1913
3956191936,3276666399,1652546302,1652547254,952,1625
3454062338,3842413213,1665328788,1665329769,981,2141
3145045320,3404034127,1645158801,1645159321,520,1705
3540550798,3245247493,1650897154,1650898148,994,1335
3743687544,3112287858,1666102405,1666103297,892,449
3901360663,3863922323,1642515942,1642516232,290,40
3193403424,3097789994,1654869044,1654869271,227,2174
3095743155,3652728312,1659750053,1659750086,33,294
3478166190,3053693777,1654732068,1654732573,505,1524
3828857457,3851327758,1659795438,1659795759,321,1853
3100239217,3597904540,1652933133,1652933885,752,2113
3969241066,3050341848,1652095698,1652095796,98,1114
3555452314,3576100130,1666212438,1666213185,747,1622
3344891111,3241033604,1655509904,1655510693,789,949
3309767670,3215088423,1655417807,1655418051,244,1372
3079809630,3548351680,1667241291,1667241370,79,98
3736085476,3591088164,1665050325,1665050503,178,1757
3101669976,3592320524,1649043686,1649044421,735,1415
3574394407,3636879699,1668504859,1668505591,732,2009
3261403182,3322287315,1655823904,1655824347,443,2389
3862528538,3902543996,1667261236,1667261964,728,659
3329618048,3793901427,1650565535,1650565816,281,2144
3420266147,3898699023,1648258868,1648259176,308,239
3668174777,3020108220,1667087832,1667088064,232,1921
3866681013,3240249176,1645187430,1645188428,998,1770
3066362135,3896960517,1662840567,1662841518,951,2091
3913366963,3486541605,1649043883,1649044775,892,718
3351610798,3755473771,1667631052,1667631911,859,1033
3741681613,3641682706,1665986115,1665986546,431,280
3550299952,3898229065,1647109649,1647110437,788,795
3839947308,3678624517,1659968782,1659969559,777,2467
3587508502,3069881077,1649177474,1649178456,982,2241
3537735224,3522621112,1651324208,1651324378,170,750
3010649870,3418276734,1652068228,1652068669,441,1544
3981348782,3403911906,1643935898,1643935934,36,2389
3107482740,3938097708,1668868423,1668868806,383,2008
3389546736,3563407459,1654691919,1654691999,80,574
3065434950,3018651462,1658510715,1658511218,503,360
3195032074,3618397647,1665877771,1665878447,676,2184
3222563704,3751975877,1668971374,1668971411,37,1507
3309106486,3185785923,1648795168,1648795560,392,491
3899301205,3630318253,1642656119,1642656415,296,124
3309684706,3006388757,1662976021,1662976358,337,2440
3772788087,3176317370,1642144876,1642145571,695,1600
3442725932,3970049421,1658925384,1658925809,425,423
3653925331,3127403665,1642147879,1642148201,322,1826
3032779815,3576315042,1646232557,1646232729,172,236
3710851755,3917721165,1651231745,1651232337,592,2008
3612269633,3812231046,1652009169,1652009326,157,1527
3097457183,3149534519,1657357593,1657357662,69,2085
3467401235,3587324906,1665611109,1665611543,434,1036
3884878006,3659917344,1651649433,1651649536,103,32
3482763584,3102526783,1657415492,1657415817,325,2007
3013457125,3622230392,1650264967,1650265566,599,37
3304728211,3186569725,1645609688,1645610246,558,2424
3468455079,3880638655,1642593920,1642594420,500,2034
3379598529,3086444841,1660488527,1660488666,139,52
3443773400,3198022110,1660596003,1660596415,412,2257
3576411084,3042838406,1654572703,1654573273,570,1880
3548609816,3130462571,1646671878,1646672795,917,703
3710466773,3243502165,1666676952,1666677274,322,1970
3739613077,3865511945,1654076513,1654077244,731,1375
3715994986,3158894896,1664764547,1664764574,27,2489
3341591226,3668456327,1648678016,1648678217,201,519
3745513680,3302700303,1669583620,1669584014,394,1351
3948969420,3498740809,1643543547,1643544276,729,1860
3439129317,3244514632,1652049257,1652049545,288,1136
3126778118,3265364405,1645891676,1645892334,658,1275
3681170705,3640508439,1642590523,1642590692,169,2037
3639121807,3102332016,1641440176,1641440516,340,979
3264317816,3175832070,1658580086,1658580792,706,1739
3894801934,3132349279,1641436597,1641437022,425,1905
3284958290,3882412784,1656520935,1656521061,126,622
3052279761,3825023321,1643812089,1643812703,614,2289
3041296119,3641372344,1654844182,1654844208,26,926
3161784330,3391282493,1643380256,1643381201,945,2361
3220424979,3184615246,1650690852,1650691528,676,1724
3149304177,3950146840,1664261805,1664262589,784,1928
3196934109,3903947013,1649310511,1649311383,872,191
3983391279,3357403419,1649005941,1649006374,433,95
3235476099,3006508919,1669187049,1669187438,389,588
3558492617,3696096099,1646524048,1646524637,589,1863
3349566530,3101363863,1666112416,1666112867,451,623
3782941796,3104459009,1666238717,1666238871,154,471
3452773006,3470570814,1663364344,1663364533,189,264
3869794122,3496617169,1651126156,1651126344,188,1529
3815718297,3103417672,1645504932,1645505615,683,1313
3727981782,3822146001,1665814470,1665814492,22,1470
3514894244,3780654306,1651646594,1651646933,339,1142
3796275634,3572792752,1657828943,1657829531,588,2042
3488001885,3562104036,1645681357,1645682140,783,2086
3336965818,3968682824,1667291473,1667291784,311,2013
3181778467,3887791096,1668526162,1668526446,284,2077
3810320285,3411921561,1643941893,1643942352,459,1320
3642314622,3758115218,1646170919,1646171553,634,2388
3878180077,3903588940,1644306681,1644307049,368,1423
3021129414,3031649001,1654208623,1654208699,76,1706
3216439052,3269763687,1646777791,1646777834,43,1066
3098276544,3061556470,1645420834,1645420865,31,118
3176608983,3351218513,1642109558,1642109760,202,1720
3434817228,3434182192,1645427272,1645427565,293,246
3241341174,3684537058,1665928265,1665928858,593,1575
3741983763,3997886077,1655426038,1655426695,657,763
3045925816,3485526833,1656993031,1656993557,526,2164
3644128961,3210279328,1648528074,1648528142,68,1998
3067930449,3748061416,1664750743,1664751417,674,2213
3594254200,3617200235,1649388812,1649389035,223,916
3797653596,3653335612,1649161927,1649162204,277,1778
3452219424,3641703512,1644455879,1644456647,768,1801
3284892894,3375359100,1644172009,1644172323,314,1867
3612460883,3592520398,1644786147,1644786551,404,346
3661462228,3875440466,1661586509,1661586794,285,486
3018838603,3712115076,1654658540,1654659491,951,41
3556000533,3163973134,1667578539,1667578599,60,406
3868630067,3377086230,1656083502,1656083807,305,2096
3040416131,3869355507,1669326402,1669327242,840,259
3019854226,3139376524,1641382552,1641383146,594,1382
3364390232,3947229430,1654427364,1654428234,870,1833
3403337910,3738359725,1659690581,1659691048,467,691
3780546851,3250528764,1648957988,1648958194,206,1351
3149560686,3430145466,1655292708,1655293366,658,2317
3022594569,3942520090,1657998259,1657998496,237,132
3308071201,3447887397,1649404635,1649405078,443,1623
3062464540,3153851884,1642526870,1642527217,347,1291
3018946311,3622978712,1661999716,1662000186,470,1133
3952286494,3586778995,1648455786,1648456417,631,2130
3538039823,3851780195,1652366774,1652367725,951,293
3774264905,3419430775,1653275363,1653275663,300,1597
3163395401,3307393195,1666381476,1666381712,236,2313
3613188168,3777609973,1664540911,1664541765,854,1424
3301119536,3392569339,1648725879,1648726544,665,1487
3104303534,3426585956,1643941684,1643942194,510,1343
3183079019,3975065378,1646088718,1646088919,201,2005
3057085790,3284284605,1642629557,1642630046,489,1016
3321971009,3796343532,1658429284,1658430167,883,2092
3095559156,3759787118,1654016779,1654017651,872,1823
3190226527,3930205120,1666773176,1666773388,212,617
3880835949,3156942626,1653653522,1653654521,999,369
3365615023,3395307809,1665651358,1665651840,482,2078
3435578430,3727020814,1646493712,1646493923,211,2273
3232285701,3216439052,1662677119,1662677775,656,609
3523099697,3011466658,1644705193,1644705311,118,165
3048328762,3959872101,1648666446,1648666970,524,876
3998763119,3168625610,1652412992,1652413292,300,451
3418635865,3508858140,1653702531,1653702838,307,1542
3218798966,3475612329,1656046170,1656047109,939,2103
3005283650,3508133844,1642962007,1642962594,587,294
3707867178,3371063992,1649139269,1649139978,709,1074
3775146250,3963257683,1665239701,1665240281,580,2375
3222254600,3415761431,1658205291,1658205785,494,1735
3421078448,3287078889,1651553750,1651554379,629,790
3285516363,3486907422,1668291825,1668292246,421,588
3201933010,3986353377,1653118378,1653119047,669,1165
3218964640,3541157955,1655142605,1655143536,931,917
3645625556,3062423981,1665039957,1665040244,287,407
3336947163,3846060378,1649192513,1649192637,124,2431
3575457804,3462714323,1668348721,1668349466,745,1283
3614952111,3258417294,1658714563,1658715041,478,21
3960417596,3849816711,1646332093,1646332819,726,999
3538466951,3306934792,1651547268,1651547638,370,2460
3408300554,3373806425,1667000359,1667000904,545,2060
3354395496,3784123884,1662447362,1662447566,204,512
3573961768,3581570568,1660600468,1660600499,31,2419
3000600578,3235992794,1641577203,1641577616,413,2243
3178728299,3310520005,1659445125,1659445690,565,2417
3979203926,3377774902,1661692224,1661692359,135,973
3488813245,3899618702,1661195869,1661196457,588,1228
3137594486,3578655079,1648393664,1648394343,679,1435
3703825153,3991963732,1645405937,1645406627,690,156
3645484554,3180252962,1665785827,1665786731,904,1293
3733619028,3086076310,1648299030,1648299206,176,82
3374692305,3974630210,1641439477,1641439849,372,695
3893671286,3811337280,1653073458,1653074159,701,1200
3072734804,3652765431,1656049403,1656050254,851,2196
3882414600,3759986276,1653132927,1653133178,251,1071
3173108957,3645585393,1656183861,1656184410,549,573
3361514629,3622478840,1643474349,1643474786,437,2360
3353500391,3479778946,1645422827,1645423782,955,1490
3408903285,3521081470,1661149135,1661149471,336,1097
3617958907,3120949338,1652811612,1652812308,696,870
3388515499,3806570797,1656783478,1656784263,785,1381
3390431277,3190969092,1648992208,1648992992,784,1395
3430375744,3053991932,1649344346,1649345110,764,614
3790896269,3707258240,1651140419,1651141172,753,2248
3163921304,3026244912,1649519971,1649520590,619,797
3994014690,3250023388,1667405187,1667405276,89,1957
3005231138,3120186347,1646290934,1646291404,470,1130
3374134461,3145669202,1667755275,1667755896,621,1810
3881216721,3662578193,1668050810,1668051013,203,1314
3231938844,3157496248,1647404887,1647405874,987,152
3660839110,3319334426,1663259339,1663259742,403,1227
3127771930,3008968100,1665146133,1665146750,617,1875
3890940747,3868440818,1648834547,1648835531,984,357
3089962675,3366155048,1647516384,1647517151,767,1617
3390441234,3057756725,1656946302,1656946452,150,32
3359417056,3367915131,1663700047,1663700757,710,1853
3707892765,3836597583,1660782400,1660783193,793,692
3813811121,3781580109,1660589727,1660590380,653,2164
3000275416,3721571243,1655575946,1655576394,448,1344
3262711330,3880046311,1649842956,1649843822,866,1926
3862102577,3633382140,1642661603,1642661804,201,681
3493447321,3466204914,1660973413,1660973425,12,1650
3705943924,3787048351,1664727175,1664727522,347,1
3707552735,3003402470,1667747644,1667747992,348,1364
3408115806,3356728242,1662420339,1662420925,586,1148
3687151281,3612061421,1642292462,1642293419,957,285
3183165788,3478166190,1659823585,1659823920,335,657
3027558279,3315544584,1648885304,1648885612,308,1796
3564599618,3151288415,1648807895,1648808425,530,1267
3506345760,3655566080,1658261621,1658262428,807,365
3582204843,3154823834,1648363977,1648364131,154,2278
3264339209,3939181696,1650234855,1650235599,744,1134
3312124839,3850304083,1647411338,1647411984,646,1895
3017484255,3311252249,1669112026,1669112999,973,206
3501972053,3735817368,1651426041,1651426202,161,1211
3080876844,3698025795,1647339395,1647339878,483,1624
3872444916,3361365460,1656955734,1656956390,656,1433
3712332461,3096662890,1666535317,1666536122,805,2231
3049869003,3788336754,1645334413,1645335233,820,2269
3365134626,3242897765,1641161459,1641162055,596,807
3069992620,3421728246,1647571811,1647571890,79,554
3013457125,3657597585,1645300172,1645300644,472,596
3355418256,3579404607,1651858052,1651858373,321,359
3778848529,3195813968,1642268329,1642268602,273,1553
3451227417,3948002281,1666640970,1666641671,701,116
3868348947,3003116947,1647435456,1647435652,196,1596
3747929255,3772792062,1647685240,1647685358,118,1361
3532594788,3114605564,1668888033,1668889028,995,1281
3890335277,3691879230,1658878445,1658879134,689,1567
3051876837,3398840886,1667019204,1667019590,386,209
3735547050,3442087752,1654028328,1654028808,480,478
3077238667,3710043628,1652110612,1652111270,658,1907
3669789756,3003321686,1648754963,1648755097,134,1994
3320742371,3670266153,1666996817,1666997118,301,2436
3938679223,3981817077,1653120261,1653121061,800,394
3229448014,3254194915,1657068439,1657068736,297,411
3993438914,3370834194,1642526616,1642526955,339,1739
3106804099,3242406857,1660668963,1660669814,851,2197
3243133485,3526747987,1656310103,1656310877,774,1388
3501520918,3573252143,1643738359,1643738532,173,303
3035992910,3804768140,1666734432,1666734713,281,858
3942656665,3897433648,1643236174,1643236514,340,670
3595469152,3273379502,1656003429,1656003953,524,1776
3917956140,3375253810,1654813734,1654814019,285,1809
3672524498,3628675820,1667620859,1667621028,169,1048
3549752945,3931789231,1646665624,1646665858,234,1959
3005773066,3761587047,1669373873,1669374262,389,2383
3404200815,3936360658,1645873534,1645873882,348,694
3648072719,3234355426,1645512845,1645513063,218,341
3648118736,3191460519,1660533456,1660534155,699,438
3994348053,3256736613,1650747543,1650748391,848,2386
3800337461,3162524259,1641355995,1641356782,787,1322
3816309635,3038424212,1666784106,1666784263,157,1283
3624644696,3082359035,1649368457,1649368805,348,680
3811672443,3241190614,1667921850,1667922152,302,542
3074460772,3399552669,1661266080,1661266198,118,432
3557087358,3276771725,1656033215,1656033932,717,933
3764078507,3103856643,1658323631,1658324098,467,2439
3145669202,3164702890,1663876733,1663877504,771,579
3534201448,3702064029,1651516691,1651517657,966,62
3252421501,3838774657,1647047792,1647048554,762,983
3975462879,3070117232,1661521207,1661521568,361,162
3748988849,3378325026,1647711848,1647712185,337,666
3308071201,3704517188,1652252336,1652252874,538,146
3141503682,3447077543,1651932083,1651932988,905,1620
3141048645,3028710587,1651155785,1651156060,275,914
3827431944,3644951156,1654854747,1654855221,474,1592
3308353096,3456364565,1667612270,1667612440,170,1169
3346860393,3656654582,1650821062,1650821067,5,221
3423073970,3997215508,1647675388,1647676127,739,116
3715231431,3963334554,1644530613,1644530663,50,645
3622997863,3626020948,1643628689,1643629568,879,1135
3039198774,3574834673,1666515895,1666516085,190,2486
3259367927,3964565126,1649881315,1649881435,120,264
3332721407,3900051900,1647102395,1647103080,685,615
3462410204,3790329301,1654718870,1654719761,891,371
3808397193,3744955044,1655818360,1655818476,116,1311
3181074947,3314901091,1666292248,1666292985,737,1951
3178728299,3345543859,1645427102,1645428020,918,1893
3361870766,3866601790,1668203020,1668203810,790,1622
3924969388,3581470040,1648906354,1648906717,363,1065
3910837040,3875440466,1652899517,1652900170,653,2085
3967372197,3814641263,1667250824,1667251430,606,673
3669789756,3844416504,1654843542,1654844254,712,277
3922423821,3722569299,1665729582,1665730396,814,1470
3380822514,3241425701,1659069952,1659070454,502,2323
3855218155,3474242977,1660704781,1660705444,663,1761
3156331863,3150627841,1663315572,1663315717,145,1779
3457284809,3827557826,1659624208,1659624483,275,2382
3297123407,3839688715,1663005761,1663005768,7,2101
3202984277,3691925367,1664929736,1664930195,459,1953
3089034472,3773207612,1663383757,1663384341,584,2194
3531256735,3542827244,1649623543,1649623922,379,1892
3646908383,3670158499,1654759989,1654760101,112,1459
3983158937,3554832209,1647995478,1647995826,348,509
3401597507,3464595898,1654428770,1654428819,49,716
3243018622,3777022057,1643604860,1643605415,555,1254
3358242037,3545658442,1654651725,1654652084,359,2330
3526315797,3900535275,1652164961,1652165782,821,2464
3599007187,3467383586,1668597073,1668597119,46,1339
3813854723,3139035952,1649384868,1649384963,95,1940
3865950417,3352376449,1658886462,1658887379,917,245
3098290557,3166521010,1645920701,1645921243,542,1188
3506822540,3848963466,1642891528,1642891825,297,1717
3776906254,3906309759,1660286395,1660286703,308,1559
3122246747,3031827531,1659769101,1659769487,386,457
3875570780,3247959785,1667817590,1667818260,670,1331
3566347637,3170547321,1658987430,1658987761,331,1042
3986963711,3072911780,1658073118,1658073703,585,482
3886184659,3629412022,1649959414,1649959525,111,1995
3407460146,3750474676,1663067299,1663068249,950,1867
3388490960,3710681792,1642397916,1642398523,607,1808
3496617169,3575512492,1646308474,1646309163,689,2419
3055050795,3118443010,1642765614,1642766123,509,465
3415761431,3066093153,1662944007,1662944401,394,1345
3469583371,3148284665,1653182311,1653182358,47,1967
3102027139,3546006441,1644573838,1644574815,977,2231
3185360566,3892850406,1644283799,1644283807,8,867
3105636655,3958710935,1657659626,1657660040,414,161
3974065082,3179651539,1651039191,1651039531,340,1610
3338376656,3179280029,1658269108,1658270050,942,1549
3399604947,3108123256,1653819100,1653819965,865,2193
3428499342,3691925367,1656718245,1656718283,38,1290
3669386720,3929638122,1650301625,1650302122,497,7
3914601322,3364540592,1646743908,1646744643,735,935
3649660430,3291394293,1665806575,1665807160,585,1718
3862854265,3696512728,1652353068,1652353831,763,1036
3196616254,3995412026,1648901721,1648902666,945,926
3828713812,3334171572,1644435187,1644435959,772,45
3947921257,3216241275,1662731952,1662732022,70,1426
3043180716,3566824993,1665464867,1665465174,307,1367
3124964775,3689231617,1647284431,1647284474,43,410
3894616795,3456602518,1649728676,1649729113,437,779
3055710852,3122293667,1648472265,1648472919,654,1074
3842362489,3792924517,1664901351,1664902030,679,1018
3164789962,3154729703,1669131204,1669131808,604,1468
3852205498,3278843111,1649040299,1649041177,878,1261
3814017798,3096710771,1643186898,1643187460,562,590
3398508681,3439303987,1651260478,1651261366,888,2007
3370771897,3488551185,1655507626,1655507777,151,2156
3020683788,3490381305,1669469923,1669470794,871,2187
3963787394,3579642249,1660147277,1660148217,940,851
3977317498,3492247995,1656468451,1656469289,838,291
3679867888,3744829701,1655588360,1655588578,218,385
3536443756,3221031593,1649305040,1649305950,910,362
3591264259,3261195333,1642946283,1642947146,863,305
3132376039,3435915872,1650922569,1650923341,772,1249
3469740343,3279069375,1662787232,1662787919,687,632
3739406554,3428557602,1669672579,1669673555,976,1471
3690633750,3348113823,1659499130,1659499584,454,1174
3455537522,3023421632,1661121931,1661122359,428,150
3657464089,3423782681,1648219810,1648220800,990,1347
3648370843,3112602434,1665399934,1665400609,675,2407
3104459009,3761587047,1655991279,1655992107,828,1190
3884878006,3719763865,1659034727,1659035549,822,1449
3390441234,3625691221,1648361587,1648362444,857,1762
3407746149,3357048496,1648012072,1648012137,65,640
3131025611,3479580096,1667160215,1667161041,826,2002
3845801721,3426753006,1643690234,1643690575,341,1825
3639804787,3265181921,1643398770,1643399338,568,675
3540730645,3834152797,1642933207,1642933919,712,1641
3140488273,3097489594,1645011855,1645012824,969,652
3612973191,3557215676,1650746713,1650747633,920,2160
3798563042,3169955779,1654333821,1654334590,769,1291
3698633384,3210986714,1659866403,1659866526,123,855
3878657197,3038630181,1645994917,1645995678,761,2485
3142765587,3513925385,1653049600,1653050128,528,436
3713482005,3142765587,1648748567,1648749167,600,210
3265324040,3467215587,1652813918,1652814503,585,1173
3504398546,3198999623,1660938964,1660939395,431,398
3382159828,3501770020,1648648803,1648649427,624,1768
3410258020,3818453534,1648971672,1648972119,447,854
3367279073,3639121807,1669724206,1669724533,327,1860
3742159503,3350872529,1658552345,1658553082,737,1323
3510634049,3314901091,1651154134,1651154813,679,2046
3012822525,3856080546,1655797389,1655797525,136,2120
3976817467,3585100772,1660771819,1660772271,452,819
3590672346,3132802864,1642349845,1642349896,51,2095
3306290309,3277883706,1642480338,1642481079,741,1841
3389161785,3791894034,1653224442,1653224563,121,543
3616901816,3167290048,1661153373,1661153441,68,1604
3508060901,3818549518,1641532008,1641532095,87,2077
3556033785,3078628091,1666644349,1666645074,725,2321
3653183152,3321835417,1649726439,1649726647,208,2439
3771588829,3750123961,1653420336,1653420794,458,1116
3491398730,3438188875,1646123100,1646123708,608,2424
3164462099,3721110937,1647095378,1647095590,212,1326
3202783831,3442209140,1659735446,1659735787,341,559
3113608489,3242752835,1655048842,1655049577,735,1222
3417143667,3400121766,1666779919,1666780002,83,1036
3753998489,3339385127,1655658954,1655659216,262,921
3598223917,3109465057,1651733000,1651733848,848,2
3568965374,3143679923,1669724700,1669725316,616,1859
3290481654,3003641311,1659702500,1659702658,158,1544
3472375572,3680060067,1650290495,1650291152,657,107
3923635120,3361051044,1660779987,1660780336,349,972
3887305908,3257492375,1669367777,1669368724,947,690
3868460834,3759909818,1644089796,1644090461,665,429
3105250340,3219181477,1655206418,1655206539,121,2374
3365316758,3236132865,1666652060,1666652247,187,2359
3400211756,3508718004,1661856609,1661857514,905,2289
3412307376,3990233750,1643413361,1643413472,111,1848
3586778995,3841672169,1664866845,1664866973,128,595
3248892530,3521160717,1658468220,1658468621,401,2400
3634936481,3612642897,1666316326,1666316680,354,767
3688345244,3415917688,1646307492,1646308187,695,1319
3875440466,3907635993,1653363047,1653363429,382,1347
3333223237,3712276884,1649967171,1649967959,788,2157
3048077825,3927214415,1646122520,1646123191,671,252
3561692706,3529764378,1644026920,1644027028,108,1444
3788785252,3150884811,1658242865,1658243208,343,145
3211003582,3117230173,1641790882,1641791761,879,47
3808082891,3884067849,1659368028,1659368268,240,2383
3717781013,3698906761,1645052917,1645053586,669,2416
3345413125,3542078032,1644626463,1644626892,429,627
3445530012,3997810649,1668620319,1668620930,611,530
3477363517,3149135097,1650121296,1650121849,553,721
3381398230,3050229164,1666947021,1666947880,859,1351
3990264315,3055710852,1668374761,1668375116,355,1850
3110395191,3876687977,1652312838,1652313461,623,1532
3208215579,3270325529,1664377760,1664378325,565,935
3069992620,3161784330,1663312467,1663313374,907,2315
3658099781,3784948704,1662492197,1662492604,407,765
3649465172,3306457934,1648184506,1648185227,721,429
3482763584,3927864902,1650763874,1650764274,400,376
3434833146,3817057878,1648115197,1648115212,15,439
3925496970,3707676798,1664703147,1664704077,930,1125
3496369924,3757518149,1646605580,1646605874,294,1448
3089590512,3708309303,1654448618,1654449006,388,1406
3749282990,3337108824,1663697464,1663697497,33,918
3400121766,3401156180,1652026125,1652026342,217,339
3006603067,3162405135,1641389802,1641390510,708,1404
3691474413,3431283022,1650938084,1650938631,547,791
3029263333,3556425071,1661441300,1661441899,599,2487
3905581902,3131629372,1657585118,1657586058,940,1696
3438474821,3125717667,1653539705,1653540667,962,813
3985734621,3873218862,1662615719,1662616456,737,1934
3575375841,3904445895,1658619749,1658620683,934,781
3115245083,3777091595,1651071920,1651072886,966,10
3743835099,3913162487,1660684065,1660684357,292,1413
3751411767,3623433422,1659784574,1659784839,265,2392
3185360566,3779331078,1666941445,1666941609,164,851
3327873529,3952185527,1664148524,1664148793,269,566
3066362135,3696243779,1660138553,1660138930,377,39
3092800496,3852685738,1663741113,1663742048,935,649
3063791472,3346948485,1649915158,1649915945,787,1894
3261174036,3820585135,1658765064,1658765935,871,59
3494746675,3897030063,1664478444,1664478906,462,1277
3959783422,3141196312,1661232864,1661233793,929,1749
3475846394,3746979257,1649184470,1649184944,474,662
3919196366,3027651085,1664280076,1664281019,943,792
3791894034,3168600862,1659204715,1659205662,947,1966
3934453508,3412673526,1662166386,1662166463,77,2083
3641682706,3707892765,1656697433,1656698326,893,1397
3046132590,3699625300,1644370771,1644371244,473,1487
3412927884,3817057878,1646051375,1646052314,939,2018
3645314586,3419465829,1650081614,1650081953,339,1822
3352595765,3712869836,1665287841,1665288713,872,2456
3997810649,3033523546,1645721341,1645721707,366,1525
3556549065,3223374226,1651694548,1651694834,286,1717
3102332016,3187291408,1644848884,1644849754,870,568
3769868188,3962261300,1647610113,1647610151,38,2089
3769391036,3909309427,1643288781,1643289603,822,1700
3581470040,3726788021,1647605830,1647606227,397,859
3294446147,3111080178,1668704921,1668705277,356,608
3562814356,3710043628,1647849567,1647849867,300,1443
3357699960,3155871721,1648423246,1648423580,334,2483
3664264570,3733143454,1658017976,1658018635,659,212
3533954093,3413300274,1662085995,1662086208,213,322
3287784262,3801205465,1654880197,1654880547,350,113
3198654347,3853644964,1647677088,1647677364,276,2438
3011158212,3027129249,1646560829,1646561697,868,923
3633080652,3647539125,1652227148,1652227794,646,2008
3482473663,3156980878,1644415461,1644415877,416,1341
3046738951,3037375725,1656429215,1656429284,69,2071
3192194263,3057300178,1641498562,1641499022,460,701
3621452884,3714026701,1657782115,1657782965,850,467
3927660473,3832243899,1659842450,1659842741,291,2078
3798833025,3924607271,1653810586,1653811169,583,1662
3586600196,3778228977,1660601163,1660601206,43,1472
3918552618,3639804787,1654012055,1654012559,504,1120
3625869317,3344394548,1647017786,1647018752,966,1091
3590735151,3204302089,1643577316,1643577346,30,1998
3858911279,3347397074,1647462467,1647462791,324,1909
3647255060,3770948247,1643222677,1643223469,792,537
3843078363,3318466045,1648134582,1648134789,207,1627
3138801114,3539797487,1654291373,1654292197,824,1678
3269357443,3068239649,1652759607,1652760336,729,2241
3846628868,3301202561,1649278629,1649278675,46,1684
3298635617,3593861215,1642835053,1642835552,499,160
3163662966,3402880726,1666507972,1666508726,754,2452
3098264219,3654527501,1661377654,1661377824,170,1446
3474723005,3038823274,1666401676,1666402460,784,2454
3972917056,3039255124,1661501691,1661501892,201,2084
3087394554,3786724835,1661369707,1661370348,641,40
3350566867,3246024635,1664004371,1664004439,68,1203
3373729748,3786811867,1657753135,1657753538,403,859
3074832079,3637408266,1644332093,1644332548,455,1152
3169601604,3867860336,1668522342,1668522487,145,1283
3346604377,3529056509,1668045934,1668046266,332,773
3948946969,3621571402,1655767071,1655767569,498,1566
3430165544,3359403467,1649779628,1649779944,316,743
3088595440,3227567293,1648209768,1648210555,787,678
3480905975,3602238630,1668079132,1668079967,835,2222
3842445140,3870032753,1664993518,1664994436,918,1846
3191265442,3977860015,1647626410,1647626778,368,1394
3695935038,3137195290,1648782646,1648783129,483,1302
3062464540,3146634302,1655382567,1655383239,672,1324
3566936390,3127771930,1649116758,1649117530,772,1332
3470128186,3512720372,1644933742,1644934512,770,478
3562547940,3290681709,1652672099,1652672976,877,21
3706304663,3500320805,1655874566,1655874949,383,1741
3221850819,3798527829,1669716719,1669717245,526,1766
3057721767,3792027887,1659320789,1659321203,414,1571
3672059189,3567926021,1643903012,1643903910,898,25
3674349184,3006456611,1643124088,1643124152,64,21
3086324092,3100239217,1651196821,1651197529,708,1584
3071667890,3177491349,1661205737,1661206149,412,1733
3815692931,3296957627,1665398442,1665399046,604,2346
3223917351,3012155922,1662859959,1662860935,976,2433
3606270024,3629984199,1668293635,1668294557,922,1130
3882748527,3290844621,1647381887,1647382210,323,1934
3146634302,3592471391,1657927054,1657927538,484,674
3532756620,3303698845,1644654589,1644654614,25,996
3701668957,3114744245,1647687426,1647688296,870,906
3811389743,3754795349,1658167313,1658167728,415,806
3285747162,3105259495,1655971918,1655972012,94,608
3906964033,3336947163,1668311093,1668312063,970,1701
3296419150,3129899259,1645286121,1645286783,662,840
3117262222,3107482740,1654033767,1654033907,140,1202
3921451192,3660548799,1658886872,1658887575,703,2193
3651286291,3316855337,1652676305,1652677048,743,1013
3452258976,3708032127,1641137778,1641138088,310,2083
3069841199,3343153937,1653035742,1653036208,466,1482
3761576790,3635921511,1651833688,1651833794,106,1291
3973226891,3303358502,1661619795,1661620587,792,554
3502050886,3845886572,1646950264,1646950355,91,611
3963134791,3318594125,1655745021,1655745854,833,401
3399631396,3640957872,1656414960,1656415569,609,35
3578075354,3019761756,1650716563,1650717355,792,1171
3347397074,3933332705,1663932709,1663932968,259,620
3438574719,3520107804,1655967623,1655968522,899,830
3037867406,3802040767,1654846781,1654847363,582,50
3182643672,3392156471,1648007877,1648007909,32,672
3252021647,3840306405,1667671314,1667671924,610,1435
3289402711,3041563987,1663500277,1663501229,952,2351
3321609692,3829201459,1668642105,1668642810,705,204
3879299283,3148549210,1655488056,1655488970,914,2158
3105815944,3574708692,1660815393,1660815872,479,2050
3826502515,3765660727,1661945941,1661946745,804,19
3969036937,3451307942,1652352624,1652353169,545,631
3283671920,3061462743,1651598706,1651599272,566,2375
3753985186,3822935707,1660927499,1660928216,717,1322
3101363863,3757624193,1646205369,1646206347,978,1946
3334483625,3088465843,1645483280,1645484276,996,1348
3341283434,3627503494,1662803489,1662804352,863,1183
3318466045,3055644463,1650711223,1650712132,909,1577
3959086145,3773177927,1655709517,1655709571,54,1906
3807785088,3365440817,1656940812,1656941577,765,510
3577276558,3741024153,1655695312,1655695785,473,2000
3415686543,3167074299,1662031290,1662031680,390,796
3664267954,3780546851,1648237696,1648237781,85,1415
3232333937,3890335277,1648313062,1648313390,328,1458
3166518187,3592453741,1646829932,1646830903,971,756
3197497279,3473394094,1649322405,1649322667,262,1688
3270919620,3313192018,1649918742,1649919453,711,1697
3797259426,3444313610,1651302320,1651302425,105,142
3434662490,3259430206,1663416886,1663417405,519,1644
3663554395,3595499905,1651582025,1651582675,650,1247
3201446016,3096740365,1650533915,1650534204,289,1207
3962031345,3795269127,1659324381,1659324413,32,1075
3458493864,3427225872,1660423801,1660424331,530,178
3787465946,3268216928,1661415421,1661415565,144,1050
3820254686,3261333996,1659343885,1659344566,681,2190
3122109326,3771623134,1647171797,1647172132,335,2472
3280328195,3450628929,1652314696,1652315189,493,2229
3647479988,3490155787,1644190039,1644190739,700,2319
3403925711,3248733503,1647744248,1647744572,324,205
3834706710,3295316821,1660365450,1660365633,183,1194
3497045946,3412047712,1662511009,1662511940,931,1337
3192375486,3395457102,1661847035,1661847904,869,1081
3094291821,3686249771,1665768002,1665768540,538,1768
3045981034,3235476099,1651399475,1651399846,371,1652
3489473144,3936360658,1648854524,1648855338,814,974
3165835560,3009169806,1642458197,1642458269,72,1264
3515367610,3547365303,1661375663,1661376402,739,1933
3780652187,3387568587,1653333154,1653333964,810,1380
3992817916,3802072416,1653952766,1653953457,691,2496
3166492454,3066639403,1643747614,1643748143,529,1908
3732256987,3280223679,1659736747,1659737603,856,1145
3662876111,3458209928,1653045001,1653045177,176,166
3056267922,3241021396,1648934046,1648934879,833,2199
3612642897,3029460549,1642662844,1642663283,439,667
3420733881,3735801716,1653214555,1653214721,166,908
3542293606,3574285791,1652224329,1652225209,880,2104
3860446106,3810320285,1667461078,1667461720,642,1046
3712332461,3577114014,1649869726,1649869983,257,927
3882315040,3701668957,1655330891,1655331586,695,2328
3814045699,3182243157,1668190490,1668190668,178,1389
3739320901,3448459810,1651146192,1651146614,422,2372
3658423327,3885235661,1649527845,1649528461,616,2130
3249261763,3745960708,1655595220,1655595830,610,545
3524831718,3923683467,1654553865,1654554812,947,1956
3867603056,3840533238,1653489224,1653490112,888,2213
3504457520,3534545428,1666191601,1666191602,1,1336
3559176364,3811235183,1654007652,1654008496,844,1070
3433261355,3148259657,1659014798,1659015659,861,2118
3441680015,3895332326,1667443113,1667443763,650,821
3095430228,3401568650,1661253238,1661254144,906,1847
3617128437,3410719383,1659491002,1659491998,996,2103
3648924087,3040219251,1662976193,1662976790,597,1066
3228319450,3117322872,1659286057,1659286949,892,1182
3119718471,3790996735,1648083747,1648084663,916,1160
3817513264,3096710771,1646859040,1646859501,461,2380
3859680527,3691607111,1656474544,1656474590,46,2488
3696211720,3587497382,1667554742,1667554809,67,1807
3511593307,3399055713,1651484526,1651484994,468,134
3605519659,3802790977,1646516023,1646516408,385,124
3000600578,3650431460,1650895194,1650895581,387,1262
3124044009,3300104659,1664377251,1664378092,841,2051
3715231431,3742275397,1660932300,1660932957,657,154
3608843912,3798369315,1644563865,1644564049,184,1397
3964664117,3881851624,1650567523,1650568406,883,528
3710708040,3134380066,1641072414,1641073174,760,2490
3565056675,3686298420,1653476822,1653477443,621,420
3115303809,3102251970,1650983277,1650983345,68,2333
3292010262,3854737938,1648717891,1648718547,656,457
3899618702,3551371020,1665163371,1665164337,966,355
3144068102,3842560828,1642634682,1642635074,392,2342
3347226466,3770393539,1657216291,1657217032,741,643
3042739113,3564395523,1666789250,1666789320,70,2153
3780885377,3831380073,1667650198,1667651065,867,893
3707342422,3002029298,1658883810,1658884804,994,1457
3489466063,3365807352,1654244883,1654245301,418,821
3338376656,3788785252,1645201823,1645201846,23,1021
3662300962,3174425370,1644761618,1644762448,830,1568
3405319002,3890821469,1666307142,1666307717,575,671
3223174482,3349870020,1658188613,1658188708,95,752
3239620599,3718026583,1667237409,1667238121,712,404
3481548873,3177036721,1656568724,1656569273,549,1266
3603965318,3149534519,1643186260,1643187052,792,1573
3536954029,3662578193,1669260987,1669261884,897,135
3021320868,3442408044,1650970733,1650970947,214,2339
3681631482,3457451540,1641275635,1641276133,498,979
3371063992,3009781198,1658109566,1658109807,241,204
3383791217,3115245083,1656198650,1656199209,559,2210
3886720244,3534752391,1652990899,1652991568,669,1034
3318345517,3999390272,1649030073,1649030899,826,903
3259039915,3711048943,1660854948,1660855227,279,297
3246321113,3236132865,1661874360,1661874682,322,1431
3792834070,3543150979,1641050447,1641051385,938,2122
3818508802,3808415962,1660489207,1660489487,280,1208
3880439495,3344177563,1642305408,1642305918,510,8
3570955260,3722380765,1647741052,1647741846,794,2085
3329825235,3825849470,1666482453,1666482462,9,514
3035135381,3640756400,1662653207,1662653519,312,2477
3337738889,3526197227,1646047859,1646048037,178,1520
3668441547,3610577318,1642318187,1642318312,125,2342
3587903968,3899247202,1655632100,1655632524,424,1395
3858951131,3599915754,1650472816,1650473050,234,1481
3146645864,3096662890,1658864590,1658864652,62,1556
3639352352,3617715231,1646129440,1646129660,220,1502
3787817814,3215622264,1648945799,1648946042,243,2147
3165470497,3592520398,1656305068,1656305479,411,823
3588684575,3423640116,1656084133,1656084446,313,614
3991727598,3690349378,1661613534,1661613863,329,1306
3419336769,3284433811,1661045391,1661046318,927,2432
3845522882,3287440691,1643951960,1643952737,777,61
3194618871,3689518345,1657713706,1657714423,717,1871
3565278029,3285757325,1643415349,1643415956,607,1702
3180973124,3391658891,1645425422,1645426274,852,1728
3460552791,3173788210,1664046840,1664047544,704,521
3487104766,3328024680,1664556833,1664557721,888,1972
3318717113,3071971535,1669473844,1669474779,935,2185
3154991935,3672059189,1657605163,1657606091,928,582
3496318579,3784646522,1648427082,1648427868,786,2015
3238081511,3639090741,1655211068,1655211537,469,1157
3363125076,3768984387,1656551873,1656552578,705,2295
3559208316,3166343569,1666716542,1666717170,628,168
3788819111,3735943539,1667249243,1667249500,257,396
3931677547,3219637680,1663955922,1663956362,440,1043
3402804885,3701537998,1663279253,1663279592,339,805
3504446959,3690001044,1648574086,1648574463,377,1369
3697066162,3888141694,1661942097,1661942246,149,297
3667028828,3763317740,1659543067,1659543644,577,2118
3925523737,3202783831,1652047906,1652048297,391,1945
3128571119,3731437059,1647129371,1647129589,218,116
3743886187,3669324531,1658534262,1658534993,731,627
3183165788,3762538736,1647605343,1647605772,429,1219
3058855369,3533403208,1654407696,1654408259,563,1466
3987423059,3861499264,1644627369,1644627505,136,713
3836331716,3114277786,1662930250,1662930909,659,581
3777938800,3686968293,1660898838,1660899739,901,1196
3177762456,3534450842,1663910984,1663910988,4,95
3351921075,3265895976,1663733306,1663733904,598,1375
3791547480,3088854267,1644661427,1644661556,129,268
3932002704,3428595992,1661107957,1661108558,601,2440
3065246027,3543696190,1662002505,1662003426,921,75
3766205598,3179405209,1666103441,1666103591,150,1149
3840416991,3875908590,1657780510,1657781325,815,1657
3520385284,3228574805,1644556812,1644557163,351,1143
3241584825,3843953645,1645512533,1645513099,566,170
3227462918,3901026791,1644042740,1644042946,206,1569
3733072964,3061594355,1664041319,1664041506,187,1937
3023980378,3074412412,1650570946,1650571260,314,1273
3261866390,3337845468,1647835316,1647836241,925,2488
3459830291,3673948643,1652627080,1652627665,585,1339
3480314503,3800337461,1650254889,1650255332,443,1337
3323809275,3633239646,1661177963,1661178451,488,1233
3518322544,3450535254,1669517751,1669518233,482,1027
3356154602,3988674966,1667620881,1667621488,607,1032
3835784338,3673850585,1647649222,1647649666,444,1846
3412109130,3826823415,1668906860,1668907761,901,867
3767983934,3443773400,1650690084,1650690964,880,470
3707778731,3118533471,1668282010,1668282442,432,1457
3182502852,3368860003,1648865172,1648865984,812,2023
3148549210,3553146922,1647249853,1647250140,287,1318
3140055258,3228709105,1654773747,1654774306,559,218
3272428764,3864485247,1667109499,1667109732,233,1152
3407579711,3814572709,1667429518,1667430456,938,713
3215870665,3529946433,1655446464,1655447203,739,2259
3006085284,3542688397,1651845138,1651845726,588,210
3765827886,3240839516,1664883938,1664884496,558,1903
3751418832,3591290407,1662680135,1662680353,218,1399
3189300345,3948180125,1642747161,1642747498,337,1134
3074412412,3104210284,1665320052,1665320932,880,62
3228073924,3734381035,1652948599,1652949144,545,927
3222870125,3616218859,1665439912,1665440138,226,1750
3384536407,3996963058,1645017433,1645018319,886,1748
3483553551,3867860336,1646889933,1646890884,951,1769
3555903175,3032498591,1660511759,1660512103,344,2185
3108805085,3283211870,1653555205,1653556028,823,676
3089590512,3993798870,1656569181,1656569844,663,339
3057837723,3367510444,1653617807,1653618097,290,2190
3177943874,3357579618,1660864568,1660865243,675,1422
3630614328,3102588374,1664972224,1664972893,669,2014
3693000511,3169955779,1665183787,1665183927,140,134
3939469152,3914429910,1643716999,1643717670,671,1985
3504398546,3677064508,1657589161,1657589230,69,242
3964711138,3854219185,1641694066,1641694486,420,506
3678197665,3163326257,1657915806,1657916471,665,1418
3696607958,3993513856,1644850790,1644851713,923,869
3419465829,3072347750,1653049575,1653049832,257,536
3600015858,3947158263,1645388698,1645388946,248,1941
3515460273,3755513433,1652607659,1652608269,610,3
3807922855,3852205498,1665594741,1665594804,63,1161
3184344401,3413334821,1647600277,1647600764,487,121
3485801867,3246796194,1646803285,1646804028,743,1862
3753659944,3883846613,1650130769,1650131182,413,758
3112217806,3132207782,1661427622,1661428324,702,331
3554862003,3942393978,1667590093,1667590257,164,985
3184178717,3300412448,1663295342,1663295364,22,1366
3939098308,3537787770,1668667533,1668668471,938,882
3640605424,3189358030,1651000370,1651001321,951,2367
3392534730,3724523438,1650893338,1650893424,86,769
3935022176,3034919553,1643620230,1643620626,396,862
3570335491,3840449491,1659751155,1659752114,959,1938
3963334554,3403925711,1648907636,1648908473,837,2140
3903321481,3363611494,1664670727,1664670984,257,1200
3690015481,3826502515,1652502445,1652503338,893,1148
3195534254,3120823401,1664128296,1664128849,553,2346
3585919417,3449125023,1646827383,1646827494,111,1593
3338715388,3804657904,1654685367,1654685771,404,496
3105449263,3151923668,1660781139,1660781559,420,670
3863190883,3878274883,1653064690,1653065403,713,1954
3157155319,3124004516,1656902007,1656902457,450,1069
3620748135,3128009914,1656537096,1656537106,10,1823
3340125949,3647210250,1659993959,1659994598,639,2221
3084030782,3573158941,1663133091,1663133960,869,541
3738981251,3301994647,1648157939,1648158837,898,515
3354999072,3359296227,1667512792,1667513596,804,1992
3244071979,3952663430,1664378252,1664378806,554,542
3619490574,3095559156,1641465500,1641465575,75,56
3174425370,3068129646,1656130711,1656131153,442,1191
3712195438,3821864560,1647405674,1647406383,709,1390
3491346910,3377798373,1649831407,1649832027,620,705
3324003851,3943184820,1658664995,1658665125,130,997
3457468984,3205864966,1646263159,1646264011,852,2146
3034750166,3435540149,1644465323,1644465896,573,2465
3755413351,3891027417,1648278340,1648278892,552,339
3716415183,3279454391,1648211282,1648211903,621,1735
3848936636,3154009016,1652629240,1652629847,607,2240
3661243199,3002415281,1656523989,1656524648,659,515
3407139317,3521302995,1653019444,1653019967,523,548
3917721165,3052789625,1660782273,1660782985,712,1461
3972917056,3222438717,1656918468,1656918630,162,744
3718710270,3607622692,1642454100,1642454749,649,975
3961973688,3760930897,1651177541,1651177801,260,1948
3606749014,3721395445,1667448771,1667449216,445,2148
3206243555,3061299464,1661727491,1661727753,262,288
3043598133,3711059561,1647887509,1647887510,1,2104
3736535657,3761576790,1644881635,1644881872,237,950
3690043318,3022256617,1648365217,1648366207,990,912
3112357538,3177628377,1654547948,1654548437,489,1340
3743835099,3097982496,1645356957,1645357708,751,312
3788785252,3965434074,1657785235,1657785437,202,1947
3294984880,3058834310,1669544694,1669545399,705,426
3815507952,3090057747,1641427061,1641427834,773,294
3890852478,3884100790,1646204206,1646204663,457,1839
3014363081,3489915638,1644532522,1644532769,247,981
3969728585,3619704547,1641983599,1641984174,575,1245
3097489594,3589571844,1656797953,1656798497,544,2007
3712549911,3975663862,1658957811,1658958675,864,2038
3420489464,3217494787,1667108004,1667108296,292,2452
3747621620,3205543673,1667075206,1667076089,883,81
3409978701,3791302710,1651745792,1651745827,35,490
3136810446,3558492617,1661450787,1661451105,318,1579
3915315003,3097426944,1646710266,1646711099,833,1424
3297477157,3565052722,1665409976,1665410098,122,1943
3902705203,3856080546,1646650799,1646651720,921,1019
3330817237,3518079213,1653804849,1653805716,867,2454
3299607426,3034159032,1651858247,1651858733,486,1830
3418998927,3818823702,1659647985,1659648186,201,2210
3678624517,3939722468,1652402913,1652403397,484,2058
3174639274,3144405714,1651284230,1651284732,502,584
3867603056,3091817310,1655328881,1655329876,995,1917
3034827961,3896281957,1655953162,1655954021,859,2091
3042739113,3757020498,1642757406,1642757875,469,869
3554778587,3214558994,1659582963,1659583136,173,1542
3176653619,3034088160,1664158910,1664159427,517,918
3030641135,3168984273,1662846750,1662847580,830,805
3641618845,3052861028,1663691782,1663692524,742,1034
3447310943,3182878730,1658949681,1658950156,475,701
3273243249,3257594028,1661943902,1661944061,159,185
3938583443,3448409263,1647692522,1647692548,26,2157
3821157240,3349724698,1660279533,1660279602,69,597
3840502377,3039081980,1651023070,1651023146,76,1025
3815692931,3264339209,1644023101,1644023181,80,2266
3019204329,3771528397,1651812525,1651812632,107,1289
3306515955,3026209549,1657779524,1657780235,711,1197
3080889735,3506187447,1643783908,1643784862,954,2185
3998221237,3299362427,1660688494,1660688757,263,1134
3071410684,3413369567,1661200072,1661200758,686,1477
3224491185,3049307137,1652426024,1652426636,612,644
3878083942,3391056146,1646975937,1646976144,207,2259
3665931760,3753998489,1669569332,1669570282,950,1550
3647255060,3724116295,1664889743,1664889792,49,1883
3822458181,3776398060,1663687036,1663687473,437,1591
3172773924,3580531210,1652647218,1652647237,19,59
3672194570,3746550027,1666524588,1666525326,738,1738
3158338043,3438553592,1660082018,1660082608,590,566
3064461314,3801956152,1648790982,1648791976,994,585
3004708023,3685473604,1659057258,1659057934,676,85
3117575075,3089126812,1667258743,1667259635,892,1147
3281597338,3975864053,1658907053,1658907775,722,1543
3621966073,3270919620,1648472866,1648473191,325,1803
3103871966,3384222838,1642611022,1642611867,845,603
3973666003,3295806447,1654710377,1654710673,296,445
3928867307,3447887397,1654244507,1654244597,90,1464
3701370209,3629824081,1655917210,1655917507,297,1835
3060522981,3143318519,1655329513,1655329537,24,1575
3195504067,3570152654,1659311489,1659311599,110,2088
3182097979,3620223775,1648380191,1648380841,650,1257
3037583613,3421294150,1659582473,1659583437,964,1703
3850214790,3424650360,1647543495,1647543942,447,1942
3395753607,3439129317,1667376152,1667377054,902,2051
3501972053,3634624974,1658137394,1658137834,440,15
3124964775,3696432858,1665278323,1665279178,855,1825
3536903033,3267107046,1642175323,1642175657,334,1532
3055545326,3786861325,1660311596,1660312270,674,1286
3385183586,3153541916,1664753342,1664754012,670,1841
3250208944,3840003483,1661283276,1661283787,511,775
3810798932,3682006274,1648922370,1648922916,546,2409
3730984573,3094361527,1642679504,1642680216,712,1968
3732585972,3702178313,1665358421,1665358492,71,2010
3890580849,3872626198,1655147022,1655147359,337,1456
3781394729,3403925711,1653229113,1653229736,623,868
3342685325,3132611388,1669672186,1669672938,752,1353
3327061038,3309922968,1668434738,1668435627,889,876
3444313610,3867101565,1642932953,1642933623,670,732
3747621620,3097242351,1648695895,1648696315,420,33
3154653229,3197176680,1654438114,1654438728,614,1389
3499481975,3860422016,1651511359,1651512113,754,1951
3866215730,3518583464,1668870886,1668870942,56,2375
3324041559,3547072063,1646718201,1646719016,815,1133
3243059921,3306290309,1643712204,1643712656,452,1625
3213115605,3055545326,1647428697,1647429337,640,1926
3153858233,3248733503,1647580130,1647581072,942,186
3444067052,3402155812,1663477480,1663478337,857,1235
3095772004,3007446724,1657889569,1657889614,45,1268
3634018428,3222438717,1664508480,1664508490,10,2464
3532021354,3936193189,1658824229,1658824776,547,2376
3355418256,3075088680,1642969647,1642970260,613,1728
3737420070,3833553454,1647572809,1647573350,541,592
3653218860,3829209875,1666876454,1666877422,968,1566
3898946519,3897212070,1658723639,1658724207,568,492
3322083266,3406239480,1647901134,1647901194,60,454
3897412947,3045570288,1664245257,1664245947,690,849
3505761464,3734035973,1652669756,1652670315,559,166
3386846556,3246759301,1660250331,1660250358,27,2159
3682928814,3795508879,1653016800,1653016888,88,2189
3632335400,3172619193,1651569200,1651570011,811,640
3075465136,3042034210,1657667412,1657667793,381,2197
3339962549,3424431005,1664991340,1664991640,300,246
3055211808,3829149174,1652938000,1652938670,670,1915
3465406980,3628034615,1656705674,1656706645,971,1039
3884247169,3119802700,1660472039,1660472065,26,935
3444067052,3608893234,1650593241,1650593998,757,305
3147896698,3645073300,1646946326,1646947155,829,1786
3521160717,3900309643,1667221109,1667221759,650,210
3935822380,3351691261,1649480111,1649480455,344,1429
3197466224,3591264259,1641664285,1641664484,199,1545
3122144249,3929305160,1667629577,1667629967,390,896
3375404573,3809698347,1668517187,1668517699,512,104
3503842077,3535941714,1662112529,1662112941,412,206
3789380087,3882254802,1662171982,1662172316,334,1410
3364945349,3592235229,1645354958,1645355663,705,11
3969036937,3693652924,1658458224,1658458372,148,1606
3532675680,3581449963,1652072672,1652072956,284,235
3786148014,3177036721,1669577628,1669577692,64,585
3942273552,3656654582,1666460965,1666460994,29,480
3576661425,3643939596,1657074445,1657075429,984,584
3558912751,3405358639,1653012064,1653012472,408,1997
3020452542,3890159677,1662206378,1662206422,44,734
3816015403,3263350346,1665173421,1665173645,224,2369
3201276259,3972955608,1644762602,1644762924,322,1613
3006603067,3580774207,1652943517,1652943539,22,1407
3534224607,3714322007,1641430324,1641431017,693,548
3936122118,3423971586,1643463562,1643464006,444,2243
3869711224,3115344578,1665425435,1665426007,572,167
3509167906,3516107650,1642347179,1642348051,872,1583
3017484255,3712195438,1655843812,1655843965,153,1243
3891270072,3343941091,1642886650,1642887477,827,2176
3038849431,3894593426,1661086711,1661087461,750,1153
3693041370,3689544534,1647840828,1647841361,533,511
3486582851,3375290121,1653275040,1653276035,995,1577
3279370751,3222119601,1647137136,1647138028,892,2261
3520758396,3398412701,1659508545,1659508879,334,154
3272879760,3579728276,1647430638,1647430690,52,1210
3687215472,3687919265,1662233490,1662234049,559,2010
3710756423,3840801648,1651692844,1651693088,244,1409
3125436993,3946833004,1650220460,1650220497,37,2336
3753657577,3753998489,1657316934,1657317808,874,1507
3065298582,3533414032,1663445308,1663445684,376,363
3707199669,3548609816,1653812457,1653813269,812,911
3788498920,3108427765,1663880654,1663881424,770,1003
3287175350,3031249180,1667427795,1667428386,591,764
3129641154,3786516095,1658036047,1658037005,958,541
3840801648,3052681277,1661798256,1661798473,217,1519
3428325312,3646687421,1641673100,1641673349,249,970
3891235779,3195138141,1641041116,1641041246,130,1099
3115928790,3333764188,1657402342,1657402584,242,1701
3465500045,3815236635,1659763879,1659764175,296,1392
3132207782,3908209550,1653550378,1653551121,743,1801
3325962611,3767724034,1654245788,1654246268,480,741
3435292986,3299362427,1646688019,1646688413,394,981
3303418943,3012152244,1658596443,1658596707,264,740
3772035177,3892800106,1665965037,1665965591,554,544
3184344401,3489811088,1662691851,1662692529,678,2133
3457361080,3927284839,1668612110,1668612320,210,146
3761584126,3986885276,1651731911,1651732272,361,171
3993623323,3941986034,1642655950,1642656409,459,1100
3958733956,3388814754,1649626967,1649627826,859,188
3262379384,3205077454,1659770464,1659771315,851,120
3724116295,3695292102,1659084034,1659084500,466,2494
3490415118,3839688715,1643926401,1643927014,613,1139
3383754736,3265725715,1641181521,1641182122,601,2234
3513193858,3112074335,1655029551,1655029686,135,1041
3540279517,3553146922,1667219956,1667220660,704,1388
3066531358,3682028611,1658152792,1658152911,119,674
3353956873,3250627439,1656711268,1656711836,568,2028
3303025505,3440598942,1667102197,1667102217,20,509
3255252214,3388490960,1669247498,1669247718,220,1925
3089548621,3416076001,1657201358,1657202270,912,1911
3323217825,3713693431,1658263947,1658264940,993,1703
3287714636,3500152600,1664573784,1664574500,716,222
3508311968,3867026366,1665369696,1665370553,857,351
3228805720,3734331528,1666445101,1666445111,10,248
3093024844,3913398460,1642435121,1642435195,74,1758
3860745004,3477363517,1658676630,1658677268,638,1948
3647480411,3145389444,1658012255,1658012812,557,1745
3556647439,3759787118,1659068446,1659068761,315,389
3867857893,3793901427,1655998842,1655999184,342,2267
3471703914,3366192341,1647624572,1647624959,387,2084
3526327974,3721060604,1651564702,1651564869,167,666
3506045470,3003641311,1647517012,1647517252,240,1242
3641703512,3593553797,1652735104,1652735966,862,1054
3785586097,3793086361,1669674141,1669674635,494,382
3803606691,3603853942,1643540481,1643540695,214,2425
3869692733,3677539420,1661186219,1661186270,51,2229
3639376136,3338020076,1664212978,1664213568,590,1080
3922385616,3549105154,1642465290,1642465884,594,454
3742012582,3775665997,1664470714,1664471081,367,1837
3762538736,3286065477,1669122279,1669122880,601,921
3377473764,3134872743,1649835841,1649836738,897,1889
3409034003,3415124478,1654757877,1654758753,876,2496
3835601308,3943892886,1657272036,1657272129,93,150
3932786032,3842273000,1669661170,1669662088,918,1837
3304497399,3862102577,1668178553,1668179528,975,1831
3516547882,3950982431,1669559667,1669560637,970,1347
3089034472,3782266220,1653318086,1653318290,204,2250
3160906988,3952663430,1666647986,1666648613,627,1662
3271409183,3461674303,1660166875,1660166969,94,1361
3149688689,3778147762,1644801966,1644802226,260,1214
3542293606,3490942401,1644624694,1644624835,141,1499
3409332035,3562472924,1660628845,1660629670,825,1994
3757044916,3051863550,1647720752,1647721323,571,1580
3841672169,3991552312,1659794756,1659795219,463,887
3309106486,3443084089,1645908994,1645909747,753,2215
3618013844,3032834107,1641476778,1641477644,866,1362
3379366812,3793086361,1658430565,1658431398,833,1427
3707767360,3502484697,1656904447,1656905193,746,1015
3379105646,3856080546,1654823182,1654823323,141,1633
3749208805,3273243249,1665480689,1665481144,455,1616
3261419893,3491562484,1648958878,1648959699,821,1241
3182243157,3994007098,1665568382,1665568493,111,336
3558539337,3752858965,1661833342,1661833597,255,911
3057314040,3937698731,1650221010,1650221721,711,1139
3513349474,3369356299,1660376591,1660377023,432,877
3188468802,3019761756,1664604702,1664605327,625,2134
3319128889,3176252124,1667660515,1667661019,504,1154
3913905115,3201587444,1661173163,1661173167,4,2392
3154009016,3744829701,1666695959,1666696753,794,164
3850089310,3954297181,1663855419,1663855604,185,2430
3921261515,3179280029,1646109488,1646110315,827,2290
3536954029,3796348557,1669337754,1669338019,265,839
3137942933,3204333859,1643055566,1643056280,714,701
3164942448,3532634291,1646978417,1646979205,788,2116
3074385503,3963995256,1668297349,1668298130,781,1039
3561543601,3232128014,1657935696,1657936502,806,1774
3353388722,3707940691,1653083024,1653083917,893,379
3002631535,3125436993,1669047829,1669048680,851,819
3083519927,3880295026,1644265519,1644266130,611,845
3367915131,3868460834,1649776593,1649777566,973,194
3261128926,3948219301,1668523970,1668524574,604,588
3818028118,3651421358,1647784123,1647784561,438,1390
3310582583,3545150522,1667239524,1667239926,402,1279
3946614568,3739555068,1647667479,1647667929,450,262
3890940747,3915772795,1661796915,1661797167,252,555
3562814356,3504796283,1669201165,1669201768,603,354
3038832798,3799287196,1645561140,1645561818,678,2299
3428482789,3985513037,1663859512,1663860355,843,943
3299607426,3264865965,1656538818,1656538923,105,1633
3688790539,3767508362,1650934916,1650935789,873,1783
3126038266,3379598529,1655859475,1655860030,555,1355
3556647439,3492258334,1662807368,1662807691,323,2156
3474242977,3487030175,1656939818,1656940273,455,863
3153085443,3478288963,1658990893,1658990951,58,531
3641928180,3132674107,1650473382,1650474371,989,1976
3151564731,3057721767,1644682160,1644682382,222,1236
3927284839,3505196729,1661271755,1661271913,158,1991
3430165544,3832144696,1662537769,1662538502,733,2008
3850392190,3889498156,1649563342,1649563792,450,723
3595612540,3690586350,1645449174,1645449974,800,2139
3535575355,3295316821,1651483637,1651483962,325,2078
3833345079,3956878212,1653079712,1653080272,560,959
3711059561,3727794902,1644399695,1644400484,789,1931
3563407459,3933196862,1642525271,1642526079,808,1521
3181329363,3913288832,1659140142,1659141110,968,2003
3204336699,3786194675,1662455659,1662455798,139,175
3114744245,3198022110,1659473789,1659473804,15,1120
3172825605,3084855451,1660682015,1660683010,995,873
3823288349,3998329857,1653434912,1653435697,785,946
3864301593,3594038673,1655980543,1655980897,354,1794
3983610735,3278792522,1661329571,1661329818,247,921
3536421569,3609310097,1664618433,1664619422,989,384
3842413213,3934988354,1656676483,1656677061,578,1991
3909173527,3979558738,1648775139,1648775954,815,1195
3697650296,3819584735,1654429268,1654429841,573,797
3398583773,3829986472,1657051107,1657051918,811,174
3570050230,3674059710,1655054126,1655054321,195,1971
3232781077,3817513264,1647637083,1647637270,187,1437
3952283751,3617200235,1653903529,1653904203,674,641
3748360490,3088571651,1651983400,1651983875,475,1871
3300983140,3089325315,1650005226,1650005941,715,2405
3313608055,3379756257,1647524621,1647525336,715,1118
3282168599,3787071341,1660938566,1660938985,419,1738
3976346769,3415185806,1662342389,1662343069,680,2354
3995299995,3186787984,1650370473,1650371065,592,84
3771758356,3444067052,1660971233,1660972097,864,1167
3065405448,3105357126,1647675067,1647675251,184,1366
3515837186,3458815526,1648628871,1648629414,543,1602
3907299052,3929988329,1641544395,1641544880,485,517
3941528766,3884959127,1666708452,1666708910,458,2179
3184455755,3248724095,1666939152,1666939264,112,209
3796954140,3969046292,1643341268,1643342249,981,1825
3005125326,3825173498,1648448293,1648448875,582,1139
3210080881,3560132016,1668084532,1668084842,310,1404
3786811867,3317961564,1645280132,1645280815,683,906
3358745496,3018760022,1642874244,1642874487,243,440
3835922991,3057028614,1647622310,1647622869,559,1712
3145552419,3936360658,1649155872,1649156210,338,1557
3708754161,3679983127,1660633958,1660634005,47,1255
3868701805,3799078288,1668752971,1668753132,161,2183
3014462663,3125911793,1655750537,1655751057,520,2159
3025014828,3463121212,1667473687,1667473853,166,1459
3415584739,3203153576,1651573546,1651574516,970,2227
3012034151,3091418450,1656521666,1656522093,427,600
3286463125,3637292465,1652181486,1652181736,250,1541
3080829502,3689680251,1667458216,1667458531,315,2332
3382943055,3228518080,1662544351,1662545205,854,2147
3010546611,3573193288,1648922702,1648923404,702,1605
3358374850,3848272906,1667202266,1667203154,888,1671
3899890592,3112742999,1646756904,1646756996,92,1536
3863697907,3658656847,1650318863,1650319471,608,2331
3636141899,3407409307,1647476736,1647477003,267,1260
3547072063,3709263457,1657891643,1657892115,472,1718
3849816711,3380930960,1645414221,1645414295,74,2415
3073966897,3877902487,1651057232,1651057805,573,44
3088562105,3625979408,1665847685,1665848247,562,2085
3830579550,3630744403,1664509665,1664510208,543,901
3140608489,3606749014,1653037142,1653038097,955,1387
3418276734,3361319934,1646156168,1646157043,875,780
3205077454,3112070783,1661814910,1661815868,958,2496
3562104036,3182396653,1650865824,1650866516,692,1937
3182396653,3429887771,1646748344,1646748614,270,129
3095772004,3392395230,1658329009,1658329154,145,1605
3498441448,3909859344,1655932193,1655933127,934,1332
3998641184,3217137285,1647835834,1647836243,409,2256
3968635893,3156942626,1668219253,1668220091,838,503
3424944206,3228737899,1663545973,1663546208,235,657
3723784545,3903560788,1652361341,1652362139,798,640
3639035607,3684883542,1657713631,1657714546,915,712
3142777936,3047400344,1646518666,1646519354,688,1287
3484710507,3502587181,1648031212,1648031546,334,552
3861247260,3265611656,1659946077,1659946709,632,628
3106429728,3505026131,1653747884,1653748005,121,547
3150627841,3339633388,1641976379,1641976619,240,2134
3608201278,3913366963,1647768061,1647768085,24,299
3647597870,3795440618,1650782242,1650783124,882,875
3156942626,3981331110,1644074317,1644074723,406,1246
3953444491,3099224416,1653769246,1653769559,313,633
3084882941,3432942151,1655409002,1655409947,945,128
3727859047,3268446099,1645683910,1645684709,799,1900
3153541916,3003243547,1668940850,1668941721,871,1512
3817252660,3634936481,1642984806,1642985481,675,1928
3012892515,3659285822,1661652066,1661652283,217,1693
3422046745,3829901682,1662263761,1662264306,545,1001
3134337442,3819584735,1660067853,1660067893,40,155
3318345517,3392534730,1665443559,1665443633,74,1676
3660732427,3627385112,1646942804,1646943637,833,373
3842413213,3541942422,1667466080,1667466442,362,1481
3050341848,3126455934,1645791618,1645791985,367,2175
3983113289,3028803724,1645197089,1645197554,465,396
3143324065,3406042920,1648734422,1648734778,356,558
3471744546,3914275771,1667269800,1667269948,148,2044
3991727598,3196407951,1660688767,1660689743,976,702
3947921257,3766160943,1651869776,1651870628,852,2417
3063520189,3704871253,1654481919,1654482057,138,2121
3208220195,3537592483,1660656779,1660657094,315,893
3751346675,3001889220,1667811888,1667812850,962,462
3049124672,3114733025,1657090064,1657090955,891,357
3323936820,3639618179,1649757152,1649758069,917,1152
3088132769,3938154365,1662595826,1662596788,962,681
3211401798,3901468403,1641552956,1641553008,52,526
3763093748,3148259657,1649543203,1649543611,408,322
3917684798,3128805218,1648592875,1648593149,274,1552
3973010524,3545214789,1654200005,1654200407,402,2059
3447527130,3918234060,1641310181,1641310799,618,182
3183435456,3842413213,1643339190,1643339754,564,2267
3154288650,3108805085,1642545345,1642545451,106,765
3337845468,3861764050,1651104468,1651105366,898,1660
3961903747,3506045470,1655509620,1655509890,270,872
3804145408,3014363081,1643865483,1643866296,813,898
3405358639,3265434991,1653746339,1653747028,689,327
3750474676,3339025394,1658884988,1658885855,867,1386
3394695318,3466735449,1655403055,1655403471,416,664
3066854514,3636808827,1659124939,1659125638,699,2498
3487547990,3903560788,1668680214,1668680665,451,155
3995288261,3112074335,1649152774,1649153156,382,1294
3996989799,3307225202,1662323172,1662323286,114,1983
3012457192,3113516667,1641970389,1641971381,992,2032
3065810858,3582033850,1665868323,1665869319,996,1829
3666268915,3828890005,1668305945,1668306501,556,478
3572276937,3404785260,1667564434,1667565091,657,2325
3121336226,3690349378,1647429743,1647429789,46,960
3389812297,3640957872,1664347489,1664347785,296,2399
3351803423,3446652020,1658131166,1658131585,419,1236
3607580736,3710708040,1643844165,1643845009,844,187
3644531526,3641493201,1642702540,1642703407,867,764
3511194169,3660732427,1661312958,1661313273,315,758
3115303809,3070395663,1643909470,1643909727,257,415
3083182515,3262811174,1656513900,1656514030,130,2316
3562104036,3153851884,1655918512,1655919177,665,1175
3837550746,3069818047,1662440679,1662441117,438,247
3440778681,3686968293,1642587873,1642588837,964,394
3595284541,3628675820,1644910992,1644910997,5,920
3369792484,3365807352,1647653478,1647653885,407,2040
3361508949,3133030655,1665056310,1665056691,381,2382
3003705867,3232835207,1665828458,1665829037,579,458
3957798687,3037984397,1647096847,1647097246,399,960
3662876111,3526315797,1666022242,1666022739,497,332
3919162177,3301202561,1651344421,1651344452,31,716
3878274883,3634735892,1641298437,1641298859,422,2205
3608512295,3184455755,1649736196,1649736222,26,1965
3328024680,3176346935,1649249377,1649250215,838,2336
3539866422,3687239883,1643610520,1643611311,791,1743
3758115218,3017484255,1641993243,1641993944,701,1203
3232497890,3960450011,1651295831,1651295926,95,1329
3410513846,3075465136,1654055316,1654056160,844,619
3170102962,3850546468,1659521004,1659521055,51,1693
3254592040,3625034951,1660714022,1660714837,815,27
3691062084,3617715231,1647185331,1647186318,987,15
3994721189,3766274699,1665899924,1665900712,788,1728
3379937268,3172825605,1656342800,1656342957,157,767
3031816406,3232469999,1657546354,1657546556,202,2370
3608071362,3120186347,1652229304,1652229628,324,660
3849201069,3108998670,1651065253,1651065267,14,885
3845131231,3936154124,1654726264,1654726479,215,1046
3114348300,3934890046,1664639103,1664639958,855,1254
3933558253,3997215508,1659582126,1659582408,282,114
3435540149,3500201376,1653469323,1653469683,360,2053
3898641431,3605699054,1648670837,1648671192,355,1107
3962676436,3021769525,1644308604,1644309319,715,1531
3070810251,3799249782,1645637718,1645638508,790,670
3980803977,3751022139,1645816566,1645817080,514,2383
3112419355,3908209550,1659904252,1659904734,482,2490
3734004050,3241007838,1657625949,1657626533,584,84
3639117164,3520699413,1666830442,1666831342,900,1865
3816493730,3361223822,1645668141,1645668617,476,1640
3603702697,3811337280,1653789497,1653790274,777,1127
3034807560,3445031830,1665443806,1665444318,512,1609
3026025743,3727794902,1659085669,1659086305,636,1715
3240369434,3261013545,1663871634,1663872482,848,341
3776148003,3385183586,1647045817,1647045971,154,459
3935822380,3748492935,1651128916,1651129451,535,1789
3797294746,3789999187,1654232596,1654233223,627,638
3475322181,3384452997,1645830369,1645831188,819,1975
3242948145,3458389447,1641064886,1641065322,436,2423
3721110937,3139455252,1653856748,1653857505,757,1451
3673850585,3766205598,1646407724,1646408665,941,683
3478101953,3707342422,1663714238,1663714733,495,403
3289696366,3051642574,1666798746,1666799221,475,2489
3515837186,3147376468,1645469847,1645470806,959,498
3547334414,3939973483,1643340437,1643341303,866,1522
3266751679,3601187603,1666470993,1666471157,164,970
3140682569,3003861871,1661233178,1661233357,179,1464
3197371652,3267650986,1647836371,1647836762,391,1520
3393552322,3976730264,1641898468,1641898884,416,305
3428325312,3796954140,1649928703,1649928904,201,2484
3186371475,3993504996,1668782982,1668783975,993,2395
3787550831,3922927380,1666450445,1666451316,871,1307
3542824458,3469648387,1646263254,1646263503,249,1540
3049727234,3214969929,1643257604,1643258081,477,436
3619714539,3478921948,1643023341,1643023815,474,2326
3570230022,3849379963,1645828812,1645829122,310,1319
3710422072,3699152541,1651611458,1651612154,696,1125
3202453519,3804328787,1653951164,1653951672,508,1270
3771758356,3113427537,1663681512,1663682292,780,454
3802040767,3849902434,1651823152,1651823341,189,554
3356028416,3367457506,1664726101,1664726171,70,442
3885786333,3853448159,1642652965,1642653431,466,18
3376673600,3069746677,1667699065,1667699598,533,1313
3779319466,3979352608,1643960835,1643961108,273,2341
3265611656,3603786519,1650488766,1650489289,523,45
3321346285,3471993716,1647245859,1647246670,811,2292
3759230876,3970970054,1657660908,1657661462,554,2493
3880139481,3194712532,1644457954,1644458859,905,1612
3012119082,3659620596,1651932346,1651932710,364,2178
3490155787,3313292041,1659115239,1659115411,172,181
3920261171,3540251095,1658769412,1658769844,432,1408
3943892886,3930852270,1656454150,1656454699,549,431
3999180921,3842362489,1650786484,1650787351,867,2210
3039255124,3527106895,1665289862,1665290132,270,1725
3244918124,3595500034,1648646176,1648646305,129,1276
3184404815,3343059553,1660634171,1660634513,342,100
3265655534,3130973015,1645549351,1645549454,103,703
3956054666,3045070182,1667481731,1667482164,433,315
3991552312,3909997437,1647001185,1647002045,860,2108
3160061122,3091709202,1651446863,1651447244,381,1299
3881956491,3706085200,1641178368,1641178995,627,2324
3985879853,3054606477,1642309000,1642309325,325,1955
3418338710,3781307416,1647261518,1647262201,683,973
3938973292,3286078112,1669138523,1669138732,209,359
3415020400,3360342048,1663734129,1663734709,580,2173
3176252124,3678336055,1669266116,1669267066,950,270
3437707461,3687689210,1658703084,1658703324,240,1648
3505100409,3678482446,1658524366,1658525046,680,1088
3487030175,3537457982,1660028186,1660028440,254,2280
3117230173,3413040065,1661247385,1661247857,472,2131
3962617141,3274588728,1662294629,1662295054,425,482
3016568360,3370120843,1645681471,1645682440,969,177
3032018734,3950936299,1647470142,1647470764,622,2176
3142160799,3958507300,1663864058,1663864698,640,741
3606643671,3041809783,1659530929,1659531790,861,241
3715894883,3561692706,1648067467,1648068129,662,255
3897659334,3880835949,1653585469,1653585938,469,2399
3114605564,3711701083,1659582769,1659582813,44,305
3481482238,3443297756,1658321281,1658322082,801,1223
3889498156,3969563324,1645233638,1645233804,166,2078
3499182342,3809458973,1663855021,1663855711,690,1018
3849379963,3327166880,1651681613,1651681935,322,2315
3120705176,3534218813,1646178548,1646178956,408,2446
3557215676,3618545572,1650531904,1650532820,916,321
3825484587,3277343126,1655033830,1655034361,531,1564
3856882586,3555105048,1644501381,1644501644,263,1983
3972955608,3528439013,1668339935,1668339969,34,918
3693183129,3036046331,1668561346,1668561668,322,115
3788717673,3687151281,1659479320,1659479903,583,508
3214558994,3502432342,1658895643,1658895826,183,963
3131683456,3120208739,1664749885,1664750575,690,2217
3995412026,3381900638,1663549751,1663549889,138,1887
3419422052,3759421049,1655427338,1655427814,476,1631
3256736613,3933196862,1669277238,1669277332,94,764
3431175768,3718909055,1652132470,1652133388,918,775
3635938446,3642498039,1652446477,1652447448,971,1967
3274507247,3646797040,1654949868,1654950577,709,2211
3152518339,3362598320,1643394825,1643395202,377,1955
3549604297,3717137928,1646417927,1646418017,90,2149
3957411858,3714698686,1652107037,1652107599,562,395
3445031830,3277343126,1666701898,1666702032,134,2245
3276142713,3164836342,1656140927,1656141923,996,1929
3048045312,3815718297,1654260374,1654261056,682,564
3386846556,3794074656,1643684008,1643684154,146,2294
3876097800,3815774397,1657386315,1657386613,298,1109
3382159828,3159897010,1643228011,1643228096,85,7
3314583046,3362972722,1652946938,1652947248,310,269
3897030063,3487526777,1648675920,1648676714,794,2213
3542078032,3432899117,1665266213,1665266997,784,697
3485526833,3798223043,1651940683,1651940914,231,1526
3895332326,3850089310,1652252538,1652253355,817,2294
3796587240,3878808489,1651408612,1651409150,538,297
3604762599,3331335383,1643635112,1643635133,21,1178
3095594016,3984370468,1656996206,1656996900,694,1164
3858951131,3599915754,1652310394,1652310945,551,1553
3446547180,3481672220,1668322830,1668323211,381,427
3707578213,3899782287,1641008595,1641009374,779,1438
3285333536,3688056726,1642962117,1642962458,341,281
3743934334,3545188902,1658133911,1658134597,686,930
3118443010,3513847916,1649822249,1649823042,793,337
3505753274,3554822566,1657660353,1657660923,570,462
3934953223,3526218972,1658249900,1658250062,162,1406
3230775095,3978720869,1653421662,1653421678,16,2189
3572746096,3095221133,1646776791,1646777130,339,1156
3237339326,3717926703,1658715248,1658715844,596,656
3321818923,3095594016,1650987424,1650987927,503,1411
3382110972,3103228367,1667792408,1667792903,495,966
3645850762,3165208023,1657663724,1657663814,90,677
3098316380,3060727793,1665117873,1665117961,88,334
3963385029,3268916307,1643155550,1643155625,75,283
3506971803,3304087986,1644335772,1644335810,38,1788
3739233756,3586489382,1642264095,1642264492,397,991
3157546931,3636237325,1642734741,1642735293,552,1901
3283056652,3907635993,1653504072,1653504997,925,863
3964987979,3178643457,1653812961,1653813522,561,70
3197693984,3106490071,1652091818,1652092473,655,2027
3984467207,3634871077,1650236622,1650237377,755,139
3689518345,3142923526,1659868508,1659869160,652,2064
3404317985,3097242351,1643210450,1643211280,830,369
3784105182,3181578884,1651216036,1651216277,241,621
3018946311,3190972776,1659689167,1659689436,269,2196
3130134092,3070557341,1659546106,1659546296,190,1836
3152036409,3504457520,1648332813,1648333226,413,6
3320841904,3544227988,1652742695,1652742929,234,1135
3442967650,3019773309,1654048223,1654049205,982,1691
3184680353,3438756008,1666039294,1666040230,936,1572
3825900664,3292667822,1668271434,1668271540,106,1959
3976156173,3993756491,1658861197,1658861955,758,1180
3736681866,3618352797,1658837760,1658838225,465,886
3066007042,3102820806,1645447819,1645448207,388,634
3879520142,3968683220,1660397498,1660397795,297,220
3225466850,3094562402,1662817863,1662818698,835,193
3561573044,3777091595,1662392587,1662392612,25,429
3608200385,3714026701,1666132645,1666132729,84,2162
3655981198,3222254600,1656330873,1656331292,419,1239
3834843479,3754139010,1669280274,1669280851,577,1654
3832275392,3993637202,1660398911,1660399332,421,2116
3560020610,3646159351,1648559962,1648560074,112,1584
3621969167,3595560993,1661416980,1661417923,943,1613
3120208739,3720381616,1650348760,1650348879,119,2148
3106584115,3833722302,1649580477,1649580921,444,2449
3165536332,3445031830,1643000501,1643001492,991,2137
3618352797,3870359885,1651547935,1651547939,4,212
3543150979,3256648307,1666421667,1666422045,378,936
3215819425,3689375835,1653175776,1653175907,131,2289
3227368879,3169688960,1645862504,1645863290,786,620
3329498574,3541920859,1664728347,1664728462,115,805
3663228098,3260246509,1661195410,1661195482,72,864
3774325139,3698133773,1649927316,1649927588,272,2204
3558370114,3089962675,1647602999,1647603545,546,1494
3733051386,3796065026,1667003466,1667003784,318,2317
3292275609,3289061595,1666292315,1666292609,294,1249
3713126710,3036046331,1642457688,1642458283,595,1088
3354055639,3170058626,1654756048,1654757033,985,2292
3203153576,3041155430,1669103975,1669104349,374,817
3675353745,3098165935,1652722818,1652723184,366,2183
3022594569,3248892530,1664963475,1664963804,329,331
3580901513,3922341165,1666274210,1666275065,855,405
3344957789,3204575281,1650355482,1650355514,32,1238
3006738164,3084783158,1661182308,1661182513,205,886
3595612540,3202625372,1649944356,1649944996,640,1626
3544020942,3610239794,1667849360,1667849849,489,431
3034216304,3873218862,1655057645,1655058318,673,1973
3548670552,3224792502,1647880362,1647881336,974,645
3242406857,3895274115,1658107709,1658108575,866,233
3016568360,3859221152,1660101691,1660101987,296,2249
3156098708,3678805802,1655495782,1655495820,38,1795
3086084685,3089525434,1645163441,1645164114,673,1057
3886917024,3613730980,1660629620,1660630170,550,2177
3285019414,3449114289,1662037635,1662038572,937,2139
3103627338,3814608487,1650212863,1650213448,585,1414
3276617814,3554089401,1661477543,1661478293,750,2469
3903193601,3697650296,1669153553,1669153742,189,633
3880298832,3286129059,1647283137,1647283291,154,2389
3039198774,3108123256,1644311591,1644312481,890,1323
3363125076,3039035602,1662289893,1662290661,768,77
3793032912,3874913687,1642375364,1642376304,940,1976
3477243904,3289153734,1665083262,1665083526,264,1611
3641460659,3587508502,1641016483,1641016494,11,1504
3090666521,3983988321,1655825641,1655826394,753,172
3699263886,3223174482,1655606430,1655606775,345,1938
3461630480,3809698347,1657453623,1657454290,667,774
3038606123,3573450428,1663267114,1663267989,875,1380
3000600578,3700412611,1659955361,1659955578,217,1050
3461263871,3766160943,1663398175,1663398653,478,291
3770061469,3792117640,1654931425,1654931820,395,1184
3664989774,3459708884,1668030360,1668030937,577,2145
3053026624,3710851755,1655101162,1655101676,514,891
3659204779,3696243779,1647013362,1647013885,523,61
3855063597,3532450192,1647920605,1647921464,859,1345
3329154834,3337673105,1648797303,1648797670,367,1094
3576422890,3487547990,1644006271,1644006289,18,2070
3392469094,3476405785,1652723556,1652724448,892,84
3439129317,3366155048,1642065218,1642065673,455,511
3849379963,3298879351,1641078016,1641078247,231,2415
3375177760,3273752842,1667534723,1667535423,700,2296
3510281371,3580398545,1660510373,1660510880,507,892
3171734482,3841108033,1659976821,1659977214,393,1069
3109500957,3676592387,1641862759,1641862823,64,2001
3771623134,3569244680,1668246745,1668247247,502,1743
3624103484,3667718430,1642742826,1642743315,489,1647
3266681677,3280328195,1641440548,1641440570,22,585
3607393629,3544133682,1642517761,1642517920,159,1035
3414488975,3171307709,1654521020,1654521399,379,1511
3469783180,3406953156,1649315575,1649315948,373,1936
3754292816,3161586578,1651613853,1651614174,321,1912
3996587507,3979558738,1653574345,1653574881,536,593
3003872692,3856985099,1669689863,1669690266,403,1078
3068400634,3791462728,1652153192,1652153975,783,614
3553530817,3225909236,1648349860,1648350000,140,1511
3827867076,3580774207,1663786283,1663786609,326,428
3536832504,3823161778,1669244602,1669245483,881,1167
3939477257,3738359725,1644958357,1644958548,191,106
3564026629,3692441467,1644591443,1644592389,946,1678
3400730635,3828722911,1641926476,1641926899,423,1763
3700813458,3898012654,1650591103,1650591483,380,1326
3964738114,3110733657,1644889055,1644889612,557,2386
3562547940,3349030618,1647098091,1647098906,815,1582
3069225011,3205864966,1669363487,1669363888,401,1975
3327873529,3404008086,1666783261,1666783790,529,2255
3475686271,3755473771,1652598547,1652598630,83,1669
3724523438,3624911947,1663111002,1663111355,353,1644
3111817334,3828722911,1663365719,1663366276,557,316
3456386287,3243231806,1669029784,1669030733,949,1483
3694618653,3209332658,1645943406,1645943877,471,1740
3784594026,3774325139,1656005816,1656006562,746,1222
3845334081,3964690423,1649669021,1649669191,170,2497
3827954829,3832463052,1650334097,1650334886,789,2414
3341042744,3229368997,1666985558,1666985623,65,972
3636141899,3716861274,1643136792,1643136826,34,1836
3663155034,3801579775,1661955693,1661956374,681,43
3695935038,3647210250,1661056360,1661056707,347,1789
3687278591,3965629952,1644318645,1644319164,519,789
3790783685,3966056341,1659457855,1659458157,302,455
3489453670,3432608968,1646670203,1646670453,250,2302
3859634422,3027829599,1664742788,1664743336,548,1354
3115777637,3359724083,1666674140,1666674934,794,982
3812385830,3161234904,1646438626,1646439389,763,1756
3585526520,3833342718,1668539277,1668539738,461,2164
3835202206,3598645736,1662403892,1662404397,505,1486
3153446106,3085936525,1660257087,1660258031,944,930
3411128747,3586101932,1662470893,1662471351,458,609
3261866390,3509619062,1663818693,1663818878,185,904
3296957627,3028643875,1662235762,1662236499,737,2424
3822935707,3084940745,1659689232,1659690017,785,1519
3834166808,3018149057,1663588943,1663589079,136,1658
3785728567,3896866052,1643735792,1643736598,806,609
3332206707,3470287808,1646049353,1646049967,614,220
3595726436,3311329069,1646580991,1646581339,348,2270
3009141852,3696432858,1642834573,1642834787,214,2011
3757305418,3230775095,1646929189,1646929996,807,607
3845743542,3064701445,1669750364,1669750806,442,1724
3451106027,3844964880,1663510476,1663511034,558,1846
3867554012,3967255191,1653534384,1653534434,50,344
3533274758,3490942401,1662609556,1662609585,29,475
3622259711,3714259747,1645323537,1645323943,406,1013
3284159385,3043598133,1653832103,1653833096,993,1553
3367768003,3755085868,1651084334,1651084678,344,672
3733440098,3508060901,1646868342,1646868745,403,873
3870779720,3072219388,1669476290,1669476322,32,379
3113423573,3351182329,1661293134,1661293644,510,1850
3287082352,3966881800,1668079272,1668080186,914,1611
3346832945,3846585557,1667760089,1667760193,104,1573
3028364856,3620311248,1650502255,1650502779,524,403
3485298583,3713482005,1669327241,1669327255,14,1502
3592487083,3371289776,1659109950,1659110226,276,908
3135951344,3771841105,1646826168,1646826825,657,1227
3468436735,3718714231,1655999806,1656000506,700,1717
3296919195,3088465843,1665909529,1665910194,665,1159
3575277293,3612269633,1669438351,1669438760,409,67
3738624659,3986970365,1665343761,1665344257,496,842
3981778568,3596454426,1649421123,1649421914,791,1677
3277875103,3935259918,1663946401,1663946642,241,189
3613188168,3674005769,1651624723,1651625452,729,2489
3921754282,3206422081,1659268558,1659269391,833,1006
3804768140,3897491493,1651634035,1651634367,332,508
3769786489,3025611145,1661437414,1661438103,689,241
3961903747,3556848299,1653305506,1653306211,705,274
3256317082,3257821708,1657864153,1657864758,605,560
3364893066,3254952204,1666709926,1666710672,746,2111
3731116644,3793032912,1646272377,1646273076,699,984
3866260144,3886368625,1662976882,1662976937,55,1960
3758577708,3763455710,1651455699,1651455886,187,363
3596951808,3983694493,1645454731,1645455074,343,357
3070404759,3352444293,1664442458,1664442935,477,1672
3417248496,3624748073,1657697140,1657697227,87,1959
3467810757,3646687421,1655507242,1655507632,390,2221
3885493402,3986885276,1654725519,1654726223,704,2010
3935656272,3968412854,1669471634,1669472145,511,588
3965434074,3868474839,1641568397,1641568875,478,288
3888764578,3218686367,1642962220,1642962717,497,1918
3893828389,3468586613,1654832639,1654832897,258,776
3512662328,3780182766,1662068827,1662068978,151,117
3898188404,3705247337,1662982384,1662983099,715,995
3713455058,3618095446,1651323519,1651323865,346,2103
3446741935,3319037937,1646892417,1646893160,743,2279
3705733070,3280717680,1663578469,1663579364,895,134
3272981808,3592026567,1643353884,1643354728,844,464
3953258545,3817513264,1662018545,1662018557,12,411
3812997079,3759787118,1645301319,1645301831,512,1413
3664112134,3170844702,1645486630,1645487237,607,1529
3621462507,3811785839,1664207822,1664208056,234,2012
3893709526,3986955632,1660576901,1660577881,980,363
3424655507,3641703512,1663201248,1663201763,515,2251
3446481380,3749282990,1658173076,1658173126,50,2298
3370889279,3518079213,1669045678,1669045930,252,243
3423298470,3241392393,1667118332,1667119127,795,1924
3258399411,3876687977,1667994784,1667995109,325,1104
3680255689,3277372807,1645938630,1645939035,405,1403
3441581446,3785638958,1658508875,1658508984,109,711
3698521503,3281725583,1663174387,1663174705,318,1678
3620311248,3486606390,1657184890,1657185889,999,103
3810823450,3230277243,1661430479,1661431382,903,2394
3086894794,3583918364,1643989466,1643989708,242,1734
3945332462,3949841652,1645068486,1645069184,698,1247
3578298884,3439660528,1649258851,1649259455,604,250
3409804938,3747062640,1647632742,1647632743,1,2142
3555105048,3577114014,1659350188,1659350378,190,1382
3029807207,3304559201,1655494370,1655494413,43,2237
3943927246,3301708925,1661261968,1661262158,190,2449
3201276259,3948862720,1659287255,1659287957,702,305
3746969288,3739613077,1655413449,1655413667,218,236
3389472671,3175478710,1661630824,1661631145,321,619
3629207282,3998221237,1651092753,1651093651,898,215
3885786333,3012323943,1666577579,1666577844,265,1335
3037867406,3260802289,1651314006,1651314228,222,726
3967517584,3827810459,1645309201,1645309596,395,1313
3375585327,3246159564,1661699980,1661700694,714,1091
3889541754,3587903968,1663996863,1663997445,582,729
3197201691,3269763687,1656383348,1656383378,30,284
3642314622,3944398168,1644215551,1644215771,220,2206
3409332035,3801358344,1668788734,1668789697,963,32
3315539995,3718905579,1658915345,1658915649,304,1207
3828722911,3521408145,1665698167,1665698657,490,1575
3792924517,3185118961,1660783548,1660784025,477,900
3795940241,3284838720,1651561241,1651561471,230,1290
3989646368,3430165544,1650260274,1650261032,758,430
3439510951,3102588374,1659808765,1659809649,884,60
3516410980,3167034499,1655913513,1655913615,102,614
3361016803,3856600876,1656124573,1656125204,631,277
3278346826,3261837009,1667546814,1667546906,92,347
3061461510,3310294122,1656581021,1656581565,544,1565
3971588399,3969241066,1652888909,1652889714,805,2352
3407770585,3010488834,1646753163,1646753279,116,1803
3311280180,3554676369,1643843465,1643843650,185,2116
3256787088,3753985186,1657216081,1657216569,488,2490
3705247337,3629933310,1650896249,1650896654,405,1790
3241033604,3351218513,1660087557,1660088060,503,2329
3110649041,3173642675,1653164557,1653165429,872,2080
3945086462,3645341350,1645491092,1645491096,4,1090
3519233850,3553048423,1653141507,1653142379,872,2431
3482826953,3351245855,1668206708,1668207339,631,2187
3675341264,3890940747,1661786265,1661786727,462,1602
3085931016,3269865212,1651663529,1651663573,44,1725
3210071519,3722078855,1667319682,1667320406,724,2000
3405373154,3432765814,1642069355,1642070297,942,2232
3961721758,3176753600,1654646623,1654646754,131,2163
3328471090,3732349114,1651515972,1651516439,467,2112
3502074085,3788688228,1658457868,1658458740,872,763
3958507300,3864930473,1653890553,1653890713,160,69
3952654862,3881143383,1643487242,1643487704,462,2370
3518717396,3091008161,1665073533,1665073741,208,358
3577627752,3963547295,1665088480,1665089221,741,1806
3095728444,3476060971,1658572115,1658572341,226,653
3989550849,3304728211,1660505843,1660506773,930,1091
3177879837,3458493864,1645112406,1645112419,13,2498
3302455172,3479322514,1663838557,1663839378,821,754
3592596587,3736871918,1654072217,1654072337,120,927
3761218329,3870458690,1650078535,1650079180,645,506
3499787925,3903068218,1662213626,1662214048,422,139
3386490201,3590656592,1664360811,1664361459,648,1752
3975065378,3633544934,1661376701,1661377386,685,1863
3316625530,3152438109,1643321073,1643321082,9,814
3821064356,3834401696,1660193333,1660194248,915,2333
3377901268,3756028002,1646012604,1646012794,190,1331
3194259307,3790829012,1641625017,1641625827,810,840
3811672443,3946815972,1663873375,1663874037,662,1219
3780117215,3293416862,1659704095,1659704822,727,703
3834954155,3190417421,1661199648,1661199821,173,1662
3271201418,3796255141,1659127380,1659128168,788,2348
3044345094,3404200137,1658908087,1658908705,618,1826
3749529134,3335915365,1649961828,1649962128,300,2296
3808082891,3178728299,1649935970,1649936913,943,310
3977139394,3949480596,1644342697,1644342985,288,856
3773488272,3165845148,1641244782,1641244868,86,993
3260246509,3990037235,1668497422,1668497513,91,1475
3703457098,3904625406,1659145114,1659145508,394,127
3893709526,3139268488,1649648070,1649648536,466,1674
3447077543,3333037570,1650298980,1650299774,794,2472
3309305862,3873840731,1669273979,1669274724,745,258
3940310287,3811482837,1644146984,1644147654,670,1781
3725480364,3143741876,1666417182,1666418048,866,2200
3661462228,3769836039,1647502872,1647503237,365,2187
3152109348,3991340294,1654762972,1654763276,304,614
3559023463,3223159718,1644978513,1644979225,712,1724
3097128642,3909997437,1660002184,1660002705,521,1700
3254866960,3404020970,1656319105,1656319570,465,298
3406595083,3181237998,1641141348,1641141975,627,2146
3925688803,3538692457,1668160698,1668161594,896,1133
3409502765,3361319934,1665127531,1665128347,816,2235
3213995449,3815507952,1651833635,1651834264,629,1214
3682922389,3911439857,1658126487,1658127392,905,309
3354574342,3486606390,1656817171,1656818088,917,1082
3594707374,3461263871,1648524575,1648525212,637,405
3625586912,3015814199,1655151982,1655152305,323,1689
3506952427,3054432255,1643783026,1643783379,353,2292
3525152477,3748850384,1656763984,1656764905,921,2452
3777568712,3894382679,1645187757,1645188063,306,1333
3354233805,3995299995,1647640706,1647641617,911,1525
3677379196,3547672806,1660428151,1660428673,522,2148
3612556887,3855521057,1642228275,1642229006,731,1081
3471651838,3862918742,1652709994,1652710131,137,393
3168983812,3536118453,1647269144,1647269626,482,16
3382777450,3832995595,1651745419,1651745916,497,1492
3570335491,3622656083,1661346154,1661346990,836,1231
3243231806,3515332061,1669697734,1669698104,370,1061
3620223775,3849816711,1662998599,1662999209,610,2289
3771931468,3800337461,1666663531,1666663689,158,1630
3989206811,3404432145,1642426104,1642426868,764,2115
3247551122,3159950284,1652904325,1652904921,596,1223
3736459302,3725903222,1648104075,1648104099,24,473
3688345244,3539364028,1642976405,1642977316,911,1941
3209332658,3668753730,1654581701,1654581796,95,2084
3531256735,3363097423,1668364308,1668364570,262,878
3355078629,3533497399,1665366480,1665367157,677,1489
3993917332,3982715838,1648927957,1648928541,584,827
3570335491,3056982737,1657784649,1657785224,575,2230
3464235741,3920910995,1655769128,1655769543,415,1876
3583029647,3036801405,1658067448,1658068086,638,2105
3899932297,3131930167,1641918328,1641918361,33,1445
3536219260,3062435759,1659872685,1659872945,260,830
3163395401,3969241066,1649735489,1649735914,425,2025
3410150990,3741907389,1642029602,1642029736,134,2419
3188726102,3161586578,1645722337,1645722849,512,1965
3089613411,3504398546,1648505270,1648505391,121,455
3379548317,3294478149,1645596322,1645596351,29,2133
3397972687,3383751042,1662521284,1662521970,686,189
3246701704,3528475061,1644972803,1644973084,281,2029
3895542691,3192005711,1644077683,1644077734,51,630
3079415495,3169265310,1663240073,1663240940,867,2295
3720012234,3524109178,1645214152,1645214491,339,1362
3038529026,3720475877,1642231189,1642231398,209,388
3093024844,3714259747,1644908400,1644908560,160,1914
3523508617,3311303975,1644661778,1644662612,834,178
3578075354,3340464785,1660507816,1660508124,308,1569
3782457642,3134872743,1659188525,1659188746,221,1052
3639352799,3715231431,1660019875,1660020157,282,335
3349626057,3707867178,1662600860,1662601496,636,593
3023980378,3759668586,1651975018,1651975599,581,1974
3330924198,3882438892,1665727488,1665727649,161,1101
3929774793,3644951156,1660810432,1660810773,341,119
3909078383,3040742963,1659837586,1659838249,663,1064
3231971396,3046190454,1664905689,1664906510,821,575
3777684793,3881206954,1643262157,1643262300,143,2045
3504398546,3135116989,1661634436,1661634688,252,415
3533898881,3172524712,1656841702,1656842315,613,1267
3522963106,3095221133,1666261335,1666261898,563,2397
3565805050,3518864357,1651419142,1651419697,555,378
3795250558,3915942384,1653231655,1653232515,860,1540
3196304056,3486793392,1653210759,1653211521,762,1041
3244599174,3205282165,1654071676,1654072509,833,734
3811648493,3796954140,1651799062,1651800009,947,1199
3275298041,3176317370,1667104249,1667104793,544,77
3265324040,3211641180,1642436654,1642437540,886,88
3761142574,3769198196,1643242253,1643242615,362,133
3878695242,3108566218,1666023669,1666024335,666,456
3124562368,3209150433,1660543924,1660544725,801,2459
3956547336,3864930473,1645626840,1645627816,976,275
3830303170,3266498789,1642842169,1642842290,121,40
3102776006,3960727778,1641827970,1641828852,882,517
3936029875,3524545245,1667771262,1667771823,561,893
3648370843,3802790977,1654668142,1654669001,859,2245
3661136551,3641455530,1664885294,1664885710,416,1765
3530930024,3268821463,1646652699,1646653408,709,1309
3679141266,3882030333,1650349025,1650349374,349,1
3452181736,3922766043,1645204809,1645205507,698,2234
3066360181,3243873593,1659212018,1659212940,922,2229
3995654203,3562859716,1653293536,1653293972,436,846
3216439052,3398508681,1644762790,1644763499,709,1842
3244514632,3686320266,1641491066,1641491610,544,1289
3115777637,3438247915,1655613789,1655613883,94,500
3095503795,3820302319,1662718409,1662719315,906,2318
3185985712,3535414109,1642073670,1642073926,256,2445
3240839516,3884551317,1658326417,1658326736,319,2442
3464653044,3289402711,1669252002,1669252250,248,1013
3434182192,3630012590,1655898233,1655898684,451,278
3140971443,3281445213,1657365471,1657365595,124,270
3368294774,3892469874,1657871106,1657871629,523,733
3807576323,3400329831,1667469582,1667470417,835,2398
3222870125,3874664424,1656308924,1656309429,505,232
3885694482,3487526777,1645110117,1645110174,57,312
3456602518,3518202698,1661849106,1661849289,183,1343
3179405209,3903779058,1652309089,1652309645,556,1419
3029468819,3548132533,1664874583,1664875402,819,2410
3404563689,3699427202,1655703536,1655704276,740,1193
3282950540,3883338335,1658707772,1658707996,224,2066
3347990376,3687617825,1667416625,1667416884,259,478
3661136551,3391426421,1655265878,1655266005,127,572
3203319376,3523546928,1657329444,1657330385,941,1289
3451285207,3633830454,1656609369,1656609901,532,248
3445558523,3398876044,1656373941,1656373969,28,1776
3375404573,3860745004,1664042162,1664042934,772,2140
3356302136,3401611149,1651706480,1651707186,706,144
3157765022,3099976032,1656504720,1656504761,41,2481
3918552618,3291286959,1642040765,1642041645,880,1795
3794548376,3842844573,1658749629,1658750207,578,2311
3040563913,3910149883,1648044153,1648044834,681,1256
3262978596,3830053941,1658883987,1658884000,13,194
3829084330,3631703207,1663997898,1663998022,124,99
3672276184,3702965571,1652089748,1652090188,440,2079
3998987664,3540550798,1666677967,1666678015,48,2411
3287078889,3957689713,1650959365,1650960018,653,1730
3091882022,3495919793,1654476675,1654477671,996,1227
3110753111,3357858376,1653872659,1653872767,108,564
3538039823,3377855107,1660823093,1660824084,991,99
3804914454,3449365489,1657662853,1657663024,171,2402
3538863873,3858876644,1660039190,1660040021,831,512
3234861737,3929774793,1641132274,1641133052,778,895
3221850819,3743136976,1661027870,1661028023,153,1231
3453736515,3693581710,1641939346,1641939603,257,1842
3273258651,3231501792,1652864959,1652864988,29,345
3513576000,3968412854,1668104489,1668105459,970,2226
3671699977,3539510682,1663118533,1663118742,209,467
3893601176,3129927926,1648899131,1648900048,917,586
3019512245,3008283469,1669122650,1669123137,487,1699
3401597507,3832275392,1665760412,1665760819,407,1263
3061982327,3368654717,1667641296,1667641520,224,242
3860422016,3500320805,1666819813,1666820345,532,1255
3470102638,3448203668,1668349584,1668349991,407,2417
3038211411,3816567987,1665233866,1665234103,237,1722
3264401846,3561529281,1647785418,1647786210,792,535
3568289450,3721751204,1658662240,1658662456,216,947
3827170233,3414669089,1652381822,1652382433,611,1906
3997050001,3824517920,1644256533,1644256818,285,2225
3597251704,3103943430,1663242810,1663243738,928,1248
3304596274,3096746005,1662975023,1662975589,566,2232
3504457520,3195159288,1641651907,1641652169,262,1054
3014354609,3653069495,1663165214,1663166184,970,586
3175478710,3411636309,1656708481,1656708633,152,509
3866431229,3098513510,1655019411,1655020025,614,1401
3557751532,3797930164,1652340333,1652340878,545,553
3933607460,3638822670,1667967571,1667968549,978,204
3793901427,3262864867,1653380494,1653380686,192,1812
3178235505,3813690540,1645200838,1645200864,26,737
3705601482,3660839110,1658665043,1658665267,224,428
3222254600,3125436993,1647268315,1647268664,349,1361
3344891111,3615359439,1659440872,1659440916,44,2399
3438084709,3644334498,1667571871,1667572384,513,1228
3686207600,3857215319,1663396134,1663397031,897,2271
3298770258,3486262024,1663711786,1663712281,495,2463
3035737560,3767581542,1669317952,1669317992,40,706
3347226466,3353257973,1668361518,1668362417,899,1788
3154158203,3364855872,1669272623,1669272965,342,1581
3517556603,3574240169,1656769698,1656770435,737,6
3524831718,3137529896,1664470925,1664471210,285,585
3756028002,3213169891,1645628310,1645629011,701,49
3465064732,3168600862,1643318157,1643318918,761,15
3455209070,3470404771,1664616738,1664616968,230,2415
3471703914,3784168038,1666765238,1666766189,951,2309
3755580356,3239265546,1663980546,1663981116,570,821
3965118569,3839788123,1661800821,1661801482,661,469
3565128218,3934890046,1658841269,1658841374,105,1773
3998987664,3521408145,1641755496,1641755866,370,243
3432059238,3124574350,1651564799,1651565381,582,596
3320841904,3487104766,1646217139,1646217416,277,1031
3713129998,3702983168,1647268713,1647269042,329,1758
3513399148,3195629628,1658343581,1658344115,534,672
3132863382,3375847073,1666628351,1666628736,385,1459
3423088497,3201446016,1657561026,1657561215,189,547
3341573446,3408396410,1667139745,1667140171,426,2219
3645666563,3447257561,1651900890,1651901479,589,1763
3218798966,3673561332,1667904617,1667905513,896,1863
3080735392,3411340387,1647952613,1647952701,88,1934
3295385873,3277810331,1644061688,1644062617,929,1305
3701214753,3080889735,1650899450,1650899572,122,1501
3208464348,3189673990,1652058018,1652058213,195,763
3431892611,3434575449,1655097731,1655098206,475,2059
3245491745,3079447248,1663739617,1663739863,246,1465
3055169776,3918581818,1653004528,1653004575,47,912
3714719241,3580330506,1646749528,1646750311,783,2336
3680255689,3481085072,1655780924,1655781444,520,24
3450228800,3501287522,1668186308,1668187133,825,1042
3548132533,3093254727,1667698191,1667698565,374,1305
3952620083,3960417596,1650973461,1650973843,382,1224
3017005264,3783325820,1651384336,1651384518,182,2431
3800451074,3045070182,1657008495,1657008495,0,2475
3475686271,3893018254,1651655214,1651655410,196,1340
3255182489,3954490536,1643414481,1643415147,666,1640
3481085072,3691879230,1662984925,1662985840,915,369
3319506258,3419430775,1664017096,1664017299,203,612
3156452001,3211839563,1660673005,1660673024,19,1975
3833679984,3312344118,1643778517,1643778924,407,1423
3486727273,3875748779,1647346598,1647346845,247,1893
3885235661,3463405011,1664909691,1664910400,709,1029
3022082086,3178728299,1641584267,1641584786,519,411
3521944506,3325313312,1648444822,1648445405,583,1111
3157546931,3581454117,1656186398,1656186583,185,2239
3437254567,3388257945,1652227975,1652228243,268,859
3835612256,3112615469,1649223801,1649224546,745,1013
3886736668,3601240692,1659751157,1659751309,152,138
3185977048,3084855451,1663873659,1663873867,208,470
3947521897,3696437293,1668643860,1668644097,237,1119
3725283025,3457361080,1663062119,1663062869,750,1045
3012032774,3978330638,1662914153,1662914398,245,489
3166274990,3287508774,1643558014,1643558470,456,491
3502587181,3807887781,1641164362,1641165140,778,1344
3620616287,3908727190,1648161460,1648161621,161,288
3619126886,3310582583,1666322970,1666323130,160,1523
3114277786,3277327180,1647180862,1647181077,215,1548
3163662966,3163470555,1666897222,1666897732,510,1686
3224952698,3049247811,1661176901,1661177006,105,492
3314932010,3917721165,1663297053,1663297276,223,1037
3446946900,3332506866,1651004283,1651004823,540,24
3973440480,3286424440,1641393662,1641394224,562,1745
3207283619,3118976994,1647085863,1647086806,943,1437
3120762596,3311118815,1665982515,1665983484,969,541
3763723423,3066426534,1661099469,1661100032,563,159
3111965011,3765472006,1664643012,1664643774,762,1806
3138001926,3894115655,1645366918,1645367474,556,1676
3283947136,3790549304,1654260165,1654261074,909,551
3884256882,3046380642,1668344466,1668345023,557,1476
3646536668,3615595663,1656121048,1656121477,429,1657
3194617168,3345138946,1652871434,1652871551,117,862
3885393767,3489909547,1663654642,1663654993,351,939
3882415224,3818039978,1648855607,1648855952,345,902
3608297293,3522211010,1656710752,1656710809,57,1064
3287210562,3205809646,1657847361,1657847976,615,832
3698906761,3541942422,1661247815,1661248065,250,280
3807478002,3673950693,1663501596,1663502198,602,652
3715894883,3519726741,1642121633,1642121655,22,537
3413777646,3185250646,1649392519,1649392744,225,1738
3414834461,3325334366,1651636425,1651637097,672,2287
3285030317,3284443787,1641576830,1641576930,100,2496
3401611149,3414328029,1653448231,1653448444,213,1268
3337673105,3291512173,1644468075,1644468447,372,149
3460428731,3702983168,1664766891,1664767405,514,1536
3771504908,3925344243,1647524152,1647524161,9,1687
3331336589,3086084685,1669212177,1669212222,45,746
3696243779,3610930903,1666874633,1666875095,462,62
3649142704,3765962960,1655925344,1655926155,811,1569
3610480358,3104396432,1641800296,1641800645,349,1272
3500097822,3100402840,1665434262,1665434667,405,1872
3100572176,3630621507,1648126792,1648127694,902,2445
3812481438,3056721560,1664718290,1664718628,338,1112
3823206701,3979550486,1669335569,1669336254,685,1421
3277343126,3171731237,1668724809,1668724918,109,433
3249261763,3901086549,1642917230,1642917816,586,1689
3095124554,3967372197,1655245119,1655245175,56,1263
3977043818,3057201124,1655113470,1655114138,668,46
3548133562,3120490643,1653378776,1653379316,540,2484
3663814997,3772340083,1656499302,1656499892,590,1337
3658562439,3623936873,1662270623,1662271156,533,453
3855476133,3899782287,1649629818,1649630090,272,500
3194618871,3950428741,1655014307,1655014401,94,841
3206425813,3372334548,1645529481,1645529820,339,1584
3634639424,3081028310,1643389718,1643389990,272,866
3966130885,3936360658,1657597630,1657597696,66,806
3884750087,3537151295,1667318120,1667318653,533,1150
3777846262,3608893234,1659779544,1659780012,468,1025
3377774902,3865529150,1655165079,1655165590,511,2304
3774722709,3272663489,1642608371,1642608983,612,1475
3952107057,3063520189,1656599199,1656600140,941,1838
3252157235,3826737259,1645702252,1645702444,192,1224
3351218513,3817548425,1665695618,1665696575,957,2252
3141392063,3115236500,1665411256,1665411903,647,687
3170579908,3647951580,1659765274,1659766264,990,663
3790407401,3577627752,1662160751,1662160820,69,1509
3155756336,3928894030,1653035254,1653035779,525,1314
3138001926,3876097800,1642771147,1642771740,593,2096
3704604706,3278104266,1654846157,1654846206,49,678
3768211591,3710202750,1663013633,1663013775,142,2033
3866534454,3606111278,1647762952,1647763907,955,2314
3250627439,3707676798,1667627435,1667627823,388,2075
3295518987,3562365612,1642592572,1642592783,211,2007
3986247608,3634871077,1643267721,1643268095,374,556
3701151902,3338882756,1643133169,1643133717,548,1954
3096746005,3981932099,1658879662,1658879789,127,1582
3426565803,3596500107,1663543143,1663544061,918,933
3381769309,3918383192,1663625288,1663625570,282,845
3526166184,3595713931,1660128271,1660128504,233,2010
3396365443,3526197227,1643657993,1643658691,698,1889
3505761464,3084730908,1657586860,1657587570,710,959
3301471485,3976147939,1651532931,1651533000,69,633
3825824228,3083182515,1643025128,1643025885,757,1950
3965220830,3378325026,1668423828,1668424609,781,324
3742344076,3537629569,1665253995,1665254514,519,2168
3638847705,3061979919,1641997818,1641998180,362,1337
3415788314,3702345362,1668664664,1668665160,496,314
3255248380,3203153576,1655380610,1655381427,817,1047
3634999231,3997312356,1644072731,1644072968,237,1587
3787590278,3258577325,1649309823,1649310625,802,138
3307926705,3913608544,1659866423,1659867036,613,2182
3003330774,3316625530,1665450103,1665450157,54,1621
3271182009,3785584501,1661063833,1661063899,66,1178
3435224460,3798597128,1667968577,1667969423,846,2405
3324003851,3480905975,1650476766,1650476828,62,1548
3491272857,3713455058,1666770900,1666771036,136,280
3897433648,3017715856,1669567326,1669567777,451,1139
3064522150,3018013930,1643284080,1643284492,412,1762
3735538229,3455808094,1658878043,1658878703,660,604
3077145114,3426017820,1648023189,1648024131,942,1478
3612878721,3627385112,1666048593,1666048670,77,345
3058846696,3793966136,1657839630,1657840407,777,1538
3143962586,3411708498,1657508272,1657508939,667,653
3441383531,3575715668,1653488618,1653489575,957,790
3064831559,3644128961,1664132101,1664132627,526,1741
3320742371,3328798665,1646431429,1646432156,727,822
3850546468,3352376449,1641154089,1641154800,711,2211
3576425783,3002631535,1662484697,1662485242,545,455
3948074176,3904625406,1651430000,1651430956,956,1621
3852253700,3617958907,1669622002,1669622038,36,520
3011863548,3411921561,1652621119,1652621139,20,2389
3617349707,3227368879,1644653020,1644653125,105,1480
3223463387,3224364206,1643887250,1643887669,419,189
3600879855,3151386327,1659547142,1659547514,372,967
3839642166,3592596587,1658275896,1658276386,490,2103
3887586447,3887290680,1651560392,1651560955,563,2238
3908727190,3019657030,1650306189,1650306287,98,1182
3223917351,3057028614,1664645199,1664645353,154,1575
3796348557,3398795724,1650146808,1650146894,86,108
3755085868,3053855376,1663337088,1663337952,864,496
3959261742,3557400406,1654306309,1654307290,981,2310
3782752586,3491356699,1669360745,1669360782,37,607
3687724937,3100535469,1654927068,1654927116,48,407
3748812993,3641618845,1655696512,1655697478,966,1222
3962617141,3790406016,1668298808,1668299009,201,1413
3800014504,3527349190,1668097678,1668098578,900,463
3006456611,3480308437,1663269745,1663270654,909,237
3820855275,3818655962,1666220030,1666220987,957,900
3747062640,3373684030,1660386411,1660386746,335,983
3415888174,3812732557,1663480490,1663480811,321,1475
3882038749,3994014690,1662339766,1662339883,117,503
3685665978,3087662482,1659368175,1659368188,13,710
3423971586,3348390759,1643096278,1643096382,104,1252
3033925963,3875118670,1665655742,1665656577,835,231
3248900308,3634018428,1648005634,1648005975,341,2165
3448378304,3156210736,1648750953,1648751248,295,2039
3536421569,3584139105,1656911552,1656911928,376,1922
3129792187,3465842758,1647920895,1647921766,871,1808
3767409219,3112270906,1647088258,1647089077,819,1885
3790298140,3519233850,1658445081,1658445587,506,2063
3858911279,3372271387,1645605731,1645606085,354,136
3837904800,3973401658,1654513732,1654513860,128,2010
3344664961,3084334078,1664751363,1664751914,551,1258
3046006152,3643382802,1642058972,1642059670,698,1175
3030290445,3603594711,1649429747,1649430212,465,1698
3081641451,3408048729,1661408675,1661408944,269,2232
3718652649,3656878544,1641689374,1641690205,831,448
3206061644,3282166903,1641477845,1641478657,812,2330
3465842758,3396524452,1668299973,1668300491,518,1312
3891579335,3875892624,1650234001,1650234584,583,1941
3358968691,3212038287,1663101328,1663102163,835,138
3816011687,3199119655,1647467444,1647468253,809,2351
3437109709,3696448766,1651443990,1651444485,495,587
3878177076,3984259471,1661413312,1661413471,159,2374
3240347468,3726378645,1666448011,1666448490,479,1952
3161063958,3383573457,1644129080,1644129732,652,1080
3611286809,3816170686,1654294418,1654295393,975,1276
3929307105,3616890026,1662521914,1662522407,493,262
3177491349,3389309088,1651413862,1651414342,480,1394
3492727050,3055145919,1663757918,1663758445,527,726
3206106614,3187779586,1661549162,1661549543,381,1114
3242785599,3942393978,1666363556,1666364422,866,1514
3443084089,3109980927,1653114751,1653115602,851,2156
3422046745,3181047536,1653066515,1653067305,790,1123
3666338218,3585816096,1651428025,1651428606,581,1213
3789314517,3066053770,1648600517,1648601030,513,772
3647685310,3451771672,1648514362,1648514378,16,1966
3442447509,3029481461,1667787569,1667787588,19,2415
3753998489,3104396432,1647953397,1647954129,732,437
3973853235,3718375865,1649573019,1649573215,196,2361
3915637706,3906903088,1667919815,1667920494,679,2165
3696184358,3106804099,1644233065,1644233255,190,605
3830579550,3021006721,1659279368,1659279751,383,273
3463509445,3961183307,1664889226,1664889362,136,1023
3202881162,3517260537,1667392857,1667393616,759,1866
3941903445,3333223237,1666335670,1666335800,130,832
3557556781,3757719267,1652302604,1652303312,708,511
3612612273,3876829785,1649507407,1649508127,720,419
3614952111,3348278635,1645806967,1645807546,579,1404
3428176980,3835202206,1657673838,1657674491,653,1758
3572214339,3191133743,1663785519,1663785724,205,2336
3447887397,3640957872,1652328885,1652329459,574,2458
3929887239,3993995217,1648327092,1648327247,155,626
3357403419,3154823834,1665726239,1665726927,688,266
3104405785,3596951808,1641309423,1641310304,881,1405
3283671920,3061643986,1664237066,1664237604,538,2292
3796348557,3582683989,1658585450,1658586171,721,506
3471376255,3718562533,1657603619,1657604210,591,1510
3973440480,3052279761,1643265021,1643265869,848,1027
3979899306,3011993360,1647981103,1647981856,753,1908
3852810875,3194204306,1661926667,1661926797,130,1647
3014363081,3655135775,1641235973,1641235990,17,134
3409779636,3442087752,1651313109,1651313333,224,1110
3056030317,3519375692,1652933456,1652934225,769,608
3555105048,3658099781,1663920159,1663920359,200,1895
3494544431,3882329817,1661374573,1661374873,300,457
3958920817,3242857629,1652691771,1652692451,680,357
3942965206,3879182220,1665658260,1665658430,170,1014
3962031345,3556197400,1667641321,1667641460,139,472
3598409790,3145961063,1666287703,1666287894,191,2123
3995428703,3424944206,1660251469,1660252342,873,1939
3867799694,3929638122,1644739773,1644740506,733,1641
3687689210,3084730908,1656048592,1656049550,958,1950
3693920541,3338882756,1666704263,1666705246,983,2175
3886344418,3968683220,1641403826,1641404694,868,1674
3912858275,3997051818,1654621505,1654621587,82,2258
3342082281,3244071979,1642687412,1642688405,993,680
3321391869,3593704176,1645526230,1645527019,789,1833
3329987086,3604236901,1646107444,1646107550,106,234
3534752391,3682922389,1659269336,1659270134,798,957
3666179764,3631152825,1641876327,1641877244,917,171
3979522310,3683739941,1657358324,1657359033,709,1966
3640585545,3840694563,1660691898,1660692693,795,1023
3930474522,3149313426,1664216211,1664216433,222,2361
3092941538,3913071406,1653886215,1653887118,903,2020
3299472791,3662409391,1644876014,1644876870,856,930
3407139317,3168329235,1664964481,1664964774,293,2345
3304523843,3338376656,1645648574,1645649475,901,603
3816538905,3733649713,1662430274,1662431188,914,1741
3283171763,3044117851,1648581739,1648581977,238,1143
3646908383,3426017820,1641651024,1641651793,769,1980
3314240169,3822404633,1664158662,1664159311,649,675
3122109326,3115777637,1669647180,1669647458,278,1403
3542153652,3580398545,1650132463,1650133365,902,1915
3677574672,3751300388,1658671371,1658671748,377,2319
3150884811,3847237978,1645550140,1645551023,883,1901
3781368357,3887290680,1660724590,1660725411,821,469
3368204842,3213115605,1647631682,1647632121,439,1904
3941548978,3135665687,1666212932,1666213414,482,2213
3070841779,3442967650,1652923919,1652924739,820,387
3332144974,3796875669,1652252736,1652253129,393,261
3906024837,3276846453,1656254322,1656254870,548,938
3658451605,3108288045,1654532225,1654532515,290,52
3857931113,3354200745,1665993167,1665993255,88,2332
3912803496,3119869652,1645418783,1645419345,562,1986
3865463499,3285331142,1667446618,1667446951,333,2407
3094414065,3354233805,1651249612,1651250436,824,216
3022102664,3866921322,1665700389,1665701368,979,2019
3163202728,3763188005,1666629076,1666629797,721,348
3467650879,3961672171,1665050346,1665050479,133,1559
3319583055,3310262408,1664102469,1664103046,577,288
3069989068,3264401846,1659401262,1659401513,251,2348
3286466102,3132210207,1650257589,1650258115,526,1504
3645585393,3752669447,1667324110,1667324612,502,104
3620817271,3736535657,1659935819,1659936215,396,992
3023265778,3569051470,1658171003,1658171683,680,1363
3168084964,3566534974,1665072140,1665072705,565,953
3917662641,3001480546,1655567893,1655568818,925,1482
3962261300,3620939715,1665274970,1665275083,113,1782
3070795112,3310462353,1648947932,1648947959,27,219
3900951859,3018149057,1650931407,1650932398,991,993
3845802546,3817579913,1650700602,1650700830,228,299
3821391381,3260802289,1665934273,1665935188,915,1983
3753659944,3657699213,1643227027,1643227798,771,2201
3812800144,3118959727,1667530049,1667530266,217,611
3258739109,3091595739,1667984850,1667985487,637,2083
3048402049,3359600983,1669010637,1669011095,458,1290
3864249446,3190064020,1666125966,1666126297,331,1609
3023880168,3750756562,1662196052,1662196865,813,1512
3713520914,3928930330,1653342251,1653342720,469,258
3325735696,3348802129,1645925683,1645926385,702,1474
3671054235,3994168332,1668544072,1668544848,776,135
3911439857,3250208944,1646130739,1646131596,857,790
3694762938,3092365114,1665379158,1665379370,212,316
3260157601,3732795074,1651020079,1651020256,177,1819
3721374677,3868440818,1648434414,1648434932,518,895
3386918140,3554089401,1657698784,1657699186,402,2297
3422728078,3460572652,1661711462,1661712369,907,418
3950047958,3706206403,1664603103,1664603888,785,34
3634282428,3527201198,1667832819,1667833630,811,1365
3278819973,3918988651,1668192940,1668193038,98,122
3158871377,3873218862,1641546985,1641547704,719,1486
3584402021,3348234563,1653163174,1653164112,938,145
3678404361,3314528450,1664478139,1664478561,422,36
3099785418,3368420871,1645321918,1645322163,245,305
3026244912,3638297718,1649893359,1649894233,874,1760
3343729897,3888757366,1655924045,1655924739,694,520
3478097925,3907213401,1659900577,1659901453,876,1790
3028803724,3989208740,1650605183,1650605749,566,2329
3528418687,3708754161,1653013060,1653013665,605,1738
3456295243,3659771853,1647565401,1647566015,614,1629
3614741796,3010161936,1645412072,1645412304,232,88
3998209085,3158988425,1659836651,1659836825,174,2061
3616794499,3772035177,1663188253,1663189093,840,792
3550677109,3225500469,1646199773,1646200411,638,91
3976453338,3004964162,1645324187,1645324753,566,989
3699947490,3790406016,1663619549,1663620470,921,2241
3546284533,3575512492,1649377590,1649378340,750,41
3888312656,3251854206,1648539251,1648539702,451,564
3690665509,3349566530,1669466239,1669467060,821,1349
3470482542,3678505160,1647823441,1647823955,514,994
3771111014,3995358434,1651778941,1651779610,669,1094
3785638958,3733072964,1655132026,1655132687,661,2008
3870384331,3922766043,1652011747,1652011988,241,1323
3293761762,3981515277,1650547305,1650547584,279,1999
3984414020,3205418435,1654976365,1654976577,212,1804
3142101976,3798343786,1642907690,1642908048,358,2364
3852017463,3169394495,1641776607,1641777606,999,647
3242897765,3371026826,1656447733,1656448075,342,1057
3623206706,3591551688,1667120256,1667120566,310,725
3584925664,3601604629,1659206761,1659207533,772,676
3357247840,3296556189,1666123897,1666124041,144,458
3819547274,3448409263,1644295541,1644295821,280,902
3149336644,3443384698,1648531819,1648532426,607,827
3332458882,3824860461,1667690672,1667691072,400,184
3265571367,3945607460,1654193358,1654194138,780,2367
3920028342,3349879521,1656293095,1656293788,693,2015
3656158144,3638233110,1656047755,1656047830,75,1081
3336991621,3421178618,1656672690,1656672896,206,2288
3872493238,3711576021,1666963152,1666963219,67,498
3884704204,3501729913,1651558433,1651559134,701,1026
3894431064,3497911447,1644257050,1644257216,166,2483
3727131221,3641542734,1650128388,1650129034,646,26
3762422234,3366385571,1652740362,1652741022,660,2318
3157600969,3124941982,1649332636,1649332797,161,451
3711100517,3588376802,1654334861,1654334982,121,44
3090804084,3361482296,1663126356,1663127075,719,1364
3503394389,3306460846,1645787122,1645787789,667,767
3407746149,3586489382,1663093215,1663093853,638,384
3089699104,3422046745,1667564632,1667565229,597,1534
3524482926,3094562402,1657959798,1657959878,80,828
3609799738,3815507952,1650472796,1650473746,950,1822
3285757325,3327253070,1647083254,1647083651,397,2078
3294635633,3287210562,1663955368,1663955570,202,781
3488813245,3149688689,1666998197,1666998589,392,2228
3079029428,3289850617,1648039336,1648039385,49,1694
3316978783,3572689902,1652722082,1652722165,83,151
3149143223,3131938458,1668553748,1668554739,991,975
3531642816,3857460953,1661589754,1661590058,304,2381
3557791528,3842560828,1641212959,1641213745,786,2212
3947921257,3262811174,1651565441,1651566076,635,2121
3864143186,3055918856,1645325060,1645325864,804,720
3996993457,3616712503,1646837881,1646837974,93,797
3993637202,3089574886,1647739595,1647740569,974,353
3449622291,3874626130,1642186437,1642186900,463,350
3469600523,3476728930,1657934857,1657935157,300,2411
3006456611,3326881805,1658442516,1658442918,402,771
3666380447,3241847877,1654530051,1654530535,484,503
3607608267,3048296949,1662303104,1662303662,558,445
3554741157,3389560959,1645992312,1645992334,22,2176
3436975295,3969110896,1654383249,1654383306,57,664
3840155828,3133788020,1643570360,1643570812,452,1723
3651058536,3351863157,1668630014,1668630206,192,255
3206198477,3465238210,1648625656,1648626539,883,1169
3309869716,3547483148,1657677593,1657678022,429,1328
3577276558,3766818968,1653020549,1653021000,451,2403
3115245083,3307067721,1658627216,1658627931,715,906
3281445213,3335040022,1659976474,1659976589,115,974
3650041115,3646151081,1659213898,1659214866,968,2422
3046738951,3428987981,1651429226,1651430225,999,2305
3466942824,3601604629,1657766969,1657767283,314,1557
3820466728,3673735088,1667373105,1667373583,478,480
3680677416,3396146110,1650290782,1650291728,946,553
3637944484,3970286228,1669418140,1669418563,423,47
3361319934,3804257503,1641924954,1641925739,785,744
3749379310,3522715448,1662897176,1662897410,234,166
3073540574,3264865965,1654110837,1654111300,463,1133
3400434269,3205282165,1653553498,1653553982,484,1189
3883286458,3888260346,1642679609,1642680603,994,1804
3339264241,3150474600,1654780301,1654780605,304,2367
3308256167,3027295354,1656282131,1656282147,16,355
3890054358,3637609349,1664765292,1664765768,476,1451
3524482926,3153989234,1648895241,1648895307,66,2169
3028063669,3057102903,1660773602,1660773793,191,181
3670063835,3558493130,1652095159,1652095436,277,559
3984461468,3906455689,1647852866,1647852999,133,2027
3046132590,3833572466,1646721070,1646721081,11,1025
3066531358,3021320868,1651174008,1651174094,86,1406
3493447321,3308531560,1651537187,1651537855,668,1838
3665714575,3677674125,1645841443,1645841652,209,1962
3870779720,3622656083,1660583693,1660583898,205,209
3445530012,3581207584,1647228845,1647229509,664,1844
3935259918,3653780780,1642313828,1642314391,563,188
3703534908,3167142908,1655423071,1655423718,647,874
3308015697,3228497776,1664326241,1664326758,517,1065
3370966526,3503489321,1657336744,1657337176,432,1705
3630012590,3106395050,1669150219,1669150864,645,2060
3141963631,3968412854,1661252659,1661253261,602,1576
3095170532,3720307988,1643177530,1643178478,948,1997
3308015697,3664273227,1661024467,1661025139,672,1665
3687919265,3987431029,1651439478,1651440200,722,1009
3404908537,3710708040,1655555204,1655556148,944,1539
3006738164,3093599187,1648617092,1648617676,584,2210
3927273567,3501972053,1642245438,1642246275,837,350
3095728444,3847297747,1660710575,1660711474,899,226
3873002836,3018013930,1658855172,1658855191,19,1643
3573193288,3707767360,1642024016,1642024729,713,1621
3759787118,3105558193,1661153501,1661154041,540,1312
3737400101,3494544431,1654102843,1654103168,325,647
3964738114,3964830238,1652088232,1652089046,814,2300
3757370089,3044772882,1646295116,1646295536,420,906
3394999152,3049969877,1649654967,1649655926,959,2143
3465796988,3350345176,1659318259,1659319223,964,1474
3946409673,3716977635,1666477584,1666477820,236,865
3260571568,3596007538,1649275344,1649276124,780,2472
3903193601,3022082086,1664231403,1664231678,275,177
3381845607,3502815865,1647640819,1647641100,281,230
3026727334,3976405875,1644856056,1644856399,343,241
3944476586,3945370501,1645996790,1645997396,606,448
3791406454,3878657197,1661086194,1661086986,792,1995
3989991456,3904634428,1654130767,1654130866,99,2288
3053026624,3377826578,1661379402,1661380142,740,2198
3889537515,3473102313,1645225103,1645225980,877,1707
3648924087,3626345917,1641853435,1641853456,21,2192
3488551185,3694591547,1664387560,1664388373,813,820
3002438521,3930474522,1642978196,1642978437,241,211
3465064732,3426017820,1653242466,1653242736,270,1838
3145669202,3235672444,1650439733,1650440559,826,1968
3939244771,3542927039,1655804609,1655805041,432,1898
3083494718,3121651540,1651386522,1651386891,369,1191
3269699819,3849977339,1647184369,1647184427,58,1640
3685715658,3725848338,1648123485,1648124324,839,18
3352729606,3325962611,1655004171,1655004709,538,1879
3538972815,3464235741,1647651062,1647651157,95,66
3187644022,3028910693,1662079420,1662079954,534,2485
3570050230,3785361012,1656498573,1656499427,854,1861
3602497998,3749702246,1652099198,1652099739,541,1327
3747929255,3269622220,1651291405,1651292277,872,1432
3364586923,3328993418,1658258524,1658258979,455,641
3144405714,3228574805,1644229960,1644230514,554,2181
3817000379,3649442188,1665681990,1665682072,82,1050
3822869749,3566534974,1659259888,1659260540,652,945
3317411967,3319506258,1656348251,1656348575,324,2020
3796343532,3339633388,1659577631,1659578118,487,772
3272563093,3375799029,1649679127,1649679666,539,2025
3061850950,3998316020,1665105510,1665106346,836,1861
3962658092,3386868280,1658457599,1658458421,822,1890
3063715610,3603594711,1661315463,1661316462,999,2003
3362972722,3696205962,1667949215,1667950015,800,1335
3710318693,3546284533,1653176711,1653176711,0,1354
3358277498,3348390759,1662666861,1662667298,437,467
3087333030,3055211808,1664142734,1664143057,323,1475
3574708692,3750698244,1665286082,1665287020,938,837
3647210250,3911439857,1665002086,1665002984,898,2146
3997051818,3367510444,1641513214,1641513517,303,659
3124574350,3147210428,1660611170,1660611428,258,1663
3791486887,3383110959,1644987659,1644988141,482,1472
3452843457,3705919583,1665552781,1665553520,739,464
3099013723,3383755219,1664942699,1664942979,280,776
3513576000,3533497399,1659418642,1659419158,516,581
3984215552,3668421848,1653280223,1653280258,35,152
3676634608,3022767670,1654316442,1654317200,758,1614
3690633750,3917526154,1659778527,1659778724,197,1005
3715894883,3113608489,1653602068,1653602272,204,268
3497079704,3151704655,1660759448,1660759692,244,378
3533172784,3565805050,1660902644,1660902876,232,1940
3826530948,3880295026,1656210448,1656211231,783,596
3516019563,3880139481,1650890415,1650890745,330,2068
3246900158,3647210250,1656121491,1656122423,932,1301
3911392700,3089034472,1648725101,1648726003,902,560
3370488301,3372197177,1669073695,1669074672,977,1178
3969728585,3280491285,1641405457,1641405971,514,97
3270923168,3926088173,1644300256,1644300369,113,1438
3796159106,3226234284,1645013061,1645013770,709,2464
3996993457,3174658362,1642374235,1642374366,131,1839
3203734562,3768846820,1644012817,1644013057,240,1098
3200875282,3173034893,1648821680,1648822124,444,1390
3685505113,3315951327,1641273725,1641274460,735,484
3434351368,3926612159,1659937615,1659937911,296,465
3778675824,3271039091,1646347744,1646348352,608,1837
3010790966,3210331889,1667433682,1667434385,703,1994
3956500972,3189759788,1651963356,1651963701,345,1870
3837447685,3207994528,1667935972,1667936482,510,2142
3969103555,3821864560,1652168770,1652169630,860,2411
3797182963,3785256634,1659244269,1659245064,795,198
3227584428,3285757325,1658357249,1658358178,929,2034
3616218859,3304087986,1652726546,1652726547,1,2182
3636001595,3284940142,1660269363,1660269957,594,301
3555452314,3510634049,1647383765,1647383977,212,728
3809458973,3924559198,1646342926,1646343809,883,2269
3745420516,3033692011,1661535703,1661536495,792,1657
3494990710,3998850502,1656957533,1656957610,77,1524
3536118453,3126499590,1669300818,1669301173,355,1242
3398876044,3823917098,1646773717,1646773952,235,449
3012339110,3766205598,1668758371,1668759346,975,2315
3272506285,3743569811,1659938873,1659939431,558,1111
3679867888,3036953061,1665663005,1665663371,366,1467
3284159385,3165492854,1650999163,1651000055,892,195
3469524230,3563134874,1660952470,1660953082,612,1013
3563246157,3917721165,1667110577,1667110961,384,1164
3846628868,3317241023,1661267503,1661268066,563,2454
3907213401,3686249771,1645299341,1645300040,699,1677
3105259495,3967517584,1644996477,1644997177,700,1671
3414834461,3895334140,1668707139,1668707678,539,1591
3036381764,3865422787,1650347961,1650348208,247,1660
3644272268,3520385284,1653962708,1653962737,29,28
3771146763,3974092782,1655600235,1655600728,493,1543
3106371588,3337765684,1659861106,1659861857,751,2451
3521408145,3531256735,1647744475,1647744900,425,921
3469740343,3977107209,1669200613,1669201386,773,694
3493226566,3439325479,1650448539,1650448813,274,2309
3929464797,3205077454,1652950522,1652950900,378,1915
3988674966,3908443461,1651571238,1651571916,678,822
3986970365,3915111520,1659473659,1659474145,486,1589
3569006301,3861123581,1653354681,1653354998,317,306
3889126069,3622334419,1653637943,1653638884,941,754
3665931760,3210080881,1661082951,1661083279,328,995
3839688715,3704120553,1650120551,1650120956,405,753
3154991935,3180051747,1663089819,1663089986,167,621
3438130685,3560132016,1665954563,1665955108,545,687
3847561511,3378814600,1646801419,1646801440,21,1436
3122818832,3120419076,1655215147,1655215827,680,1018
3115177011,3536118453,1649812135,1649812501,366,1241
3080214168,3707070213,1660941935,1660942146,211,911
3963351842,3602340127,1651589126,1651589946,820,1447
3508809990,3043656500,1643438214,1643438683,469,1888
3825484587,3951692395,1657083150,1657084023,873,463
3119802700,3828219822,1657638964,1657639059,95,94
3937728696,3911290843,1666532406,1666532628,222,1875
3901616267,3319583055,1655479628,1655480469,841,982
3268670465,3225989431,1655215075,1655215448,373,1611
3882414600,3434351368,1657486134,1657486721,587,848
3910712536,3117816089,1651891742,1651892334,592,2008
3744737373,3563103144,1667818443,1667819374,931,252
3725963743,3570480973,1654826334,1654826336,2,1420
3569006301,3779299713,1657547128,1657548091,963,1641
3128133737,3609104298,1651273564,1651274080,516,81
3449365489,3485459472,1660975437,1660976424,987,512
3828833040,3903193601,1646281384,1646282115,731,2308
3251744109,3114605564,1658173671,1658173742,71,1745
3402019498,3609310097,1657688097,1657688459,362,1732
3660754603,3657391976,1650523499,1650524079,580,1497
3803959008,3276763839,1665542963,1665543773,810,2457
3746969288,3075780193,1658825494,1658825875,381,439
3912858275,3093534312,1657152015,1657152978,963,1075
3818655962,3391711118,1648917167,1648917233,66,1665
3993756491,3811318665,1669014183,1669014915,732,1560
3768099353,3930994715,1662010796,1662010883,87,2115
3541413511,3192367201,1644128567,1644129166,599,1330
3525261242,3377847710,1657871397,1657871846,449,892
3164462099,3719507293,1642825234,1642825286,52,1722
3431117217,3204302089,1647143941,1647144921,980,2480
3802749978,3521112560,1669516393,1669516414,21,374
3121128511,3127419046,1658213768,1658214232,464,1296
3428325312,3915494041,1646216890,1646217762,872,1054
3816561204,3864414449,1652038768,1652039422,654,714
3651571335,3194140038,1651681757,1651681806,49,229
3351087116,3016971363,1643795306,1643796202,896,85
3506307976,3233375810,1657245984,1657246050,66,539
3812034379,3113321914,1658045533,1658046397,864,979
3266270844,3085936525,1648366441,1648366735,294,1582
3722859316,3025215569,1650764780,1650765431,651,1484
3349879521,3542369467,1650121532,1650122082,550,1083
3935379393,3646687421,1653177751,1653178224,473,1838
3364938815,3271689881,1664856241,1664857098,857,941
3471463543,3842677051,1668871791,1668872624,833,2201
3108998670,3249512921,1641768460,1641769184,724,962
3790648941,3864301593,1654179744,1654179865,121,608
3080735392,3447051833,1655029826,1655030460,634,2320
3532756620,3469648387,1652393068,1652393917,849,1599
3658295713,3412715210,1667281616,1667281628,12,864
3421600026,3769391036,1651980161,1651980841,680,1844
3902705203,3275223689,1644643612,1644644372,760,2123
3894431064,3815507952,1651484940,1651485319,379,1146
3786480807,3432765814,1648483814,1648484405,591,1634
3254194915,3998200859,1660301539,1660301845,306,1703
3049124672,3898495918,1643832974,1643833224,250,2403
3297684978,3085799189,1664184215,1664185068,853,538
3421344639,3790783685,1661921847,1661922427,580,44
3099546139,3703615574,1667010996,1667011757,761,2007
3255751346,3980851662,1646586608,1646587071,463,1176
3867543887,3504893701,1642007773,1642008484,711,333
3701370209,3967250644,1664858166,1664858855,689,593
3707552735,3472706088,1661408904,1661409185,281,1743
3879936194,3864044700,1659980821,1659981336,515,1177
3958508676,3785256634,1658218062,1658218196,134,1648
3593553797,3613730980,1642819548,1642820208,660,1511
3970286228,3487992433,1651378719,1651379545,826,172
3242897765,3922827209,1658165125,1658165293,168,329
3827810459,3416945471,1650369653,1650370378,725,692
3930794939,3315182095,1658102925,1658103842,917,2345
3503393955,3816935536,1656589698,1656590513,815,1162
3287901684,3857211245,1668065658,1668065920,262,1312
3456799118,3269680998,1645481749,1645482529,780,470
3952286494,3097033729,1668407950,1668408763,813,1256
3831039944,3897756969,1642731585,1642732156,571,1777
3343162937,3049869003,1645878469,1645878972,503,466
3166483466,3393552322,1650832191,1650832753,562,1720
3941586762,3164410972,1660606115,1660606562,447,36
3531859919,3845122668,1657527878,1657528814,936,1172
3987606604,3513576000,1666718957,1666719662,705,247
3741907389,3080454518,1667403540,1667403846,306,1937
3370834194,3749211785,1656148050,1656148220,170,2120
3407331091,3331604266,1646269394,1646270285,891,1702
3698521503,3333764188,1658344863,1658344869,6,155
3772035177,3491333253,1661188961,1661189624,663,2112
3308353096,3168084964,1650642109,1650642788,679,293
3067641822,3156538951,1658189481,1658189751,270,871
3997177535,3790650118,1661197484,1661197836,352,2270
3810573183,3105931624,1662283183,1662283327,144,2304
3697650296,3707778731,1651456732,1651457218,486,123
3708426776,3892850406,1644386932,1644387189,257,2339
3580398545,3798447157,1657585359,1657586153,794,1605
3966770982,3996963058,1664433634,1664434274,640,1390
3456791834,3072347750,1658803865,1658804167,302,1811
3655087982,3382777450,1666299526,1666300188,662,1959
3376742833,3450102071,1650384788,1650385753,965,365
3731437059,3035976552,1669528416,1669529367,951,85
3547749057,3444149733,1650368655,1650369051,396,952
3564198089,3620787716,1663229496,1663229641,145,2188
3524589150,3597485446,1656394863,1656395832,969,1778
3035992910,3088602459,1662015552,1662016058,506,2435
3835922991,3465796988,1655191146,1655191189,43,1204
3701103798,3907700603,1665199860,1665200376,516,687
3124079349,3562110382,1656641203,1656642107,904,918
3419751912,3363651899,1654462030,1654462638,608,976
3474081200,3786924052,1643018492,1643019148,656,239
3422046745,3784828021,1647630722,1647631207,485,238
3267600229,3355848120,1644595919,1644596533,614,398
3414488975,3250786481,1648384103,1648384658,555,749
3252421501,3112270906,1669350421,1669351374,953,2012
3044450059,3284380221,1663687107,1663687995,888,1255
3306934792,3131025611,1664108901,1664109663,762,1803
3453143238,3678152024,1659478368,1659479245,877,1521
3012457192,3501287522,1665901180,1665901941,761,1356
3014438377,3148284665,1652684454,1652685149,695,1639
3113214024,3821391381,1651808438,1651809235,797,1641
3034750166,3554832209,1661531849,1661532669,820,1146
3894193367,3423971586,1654414611,1654414650,39,315
3707778731,3950763153,1641966819,1641966837,18,374
3083494718,3714026701,1664294476,1664294533,57,91
3814588354,3849201069,1667851651,1667852419,768,901
3638803969,3540104512,1652775047,1652775857,810,143
3371970996,3606368289,1656553721,1656554547,826,1799
3963385029,3493232103,1648843996,1648844762,766,90
3687239883,3452219424,1667982196,1667982210,14,2293
3382974723,3264345880,1654333491,1654334013,522,933
3180836532,3289850617,1653641445,1653641592,147,593
3877090261,3592487083,1657074713,1657075561,848,1912
3642339062,3264673951,1662206763,1662207014,251,1398
3209462413,3602891052,1653929116,1653929369,253,617
3734576015,3289017659,1661772666,1661772787,121,1437
3574773588,3752176146,1656163435,1656164034,599,2243
3734381035,3354579861,1652432151,1652432931,780,1119
3659732080,3044483301,1664929818,1664930217,399,1286
3651271289,3833987128,1641684086,1641684470,384,1694
3333543321,3639819433,1654232707,1654233452,745,918
3128318593,3886184659,1656099179,1656099844,665,1924
3163921304,3967517584,1659909107,1659909811,704,1550
3349879521,3950433378,1656305936,1656306672,736,910
3734035973,3293761762,1647605650,1647606530,880,1992
3098264219,3345543859,1656022714,1656023619,905,115
3182643672,3473102313,1664596011,1664596516,505,491
3714259747,3123522446,1656963788,1656964143,355,1950
3007480776,3586734200,1657916044,1657916244,200,745
3507952797,3657380279,1659929908,1659930693,785,1531
3555571916,3927646653,1659463804,1659464148,344,334
3400899022,3650041115,1669475665,1669476274,609,2146
3345186165,3752669447,1643674988,1643675651,663,1927
3651847351,3206399216,1667127748,1667128532,784,2253
3042461816,3382015551,1650103936,1650104658,722,156
3726117061,3199395221,1652209861,1652210042,181,1451
3561037966,3982058383,1648902363,1648902743,380,535
3993623323,3706027798,1662189185,1662189213,28,1031
3251854206,3123166182,1643981031,1643981321,290,466
3658477943,3787230225,1654163524,1654163822,298,313
3782673553,3562456307,1647712076,1647712281,205,1431
3938505582,3821039922,1645461589,1645462335,746,464
3227652803,3722726470,1657018636,1657019575,939,811
3643372353,3909330778,1659590896,1659591419,523,1031
3169688960,3714535860,1645239726,1645239864,138,2003
3707362025,3129283198,1652170287,1652170679,392,1976
3182703869,3235476099,1650789979,1650790508,529,1633
3383755219,3310935085,1655480507,1655481333,826,1581
3647216166,3224864814,1652962174,1652963102,928,1889
3780039563,3370164589,1657951360,1657952160,800,866
3933332705,3663038239,1641449842,1641450126,284,199
3439510951,3441206388,1664933343,1664933784,441,2210
3022256617,3359212197,1669533224,1669533862,638,1889
3320381981,3207757416,1643814605,1643815189,584,555
3556647439,3454297726,1643533543,1643533971,428,1636
3907213401,3909292537,1658558294,1658559162,868,730
3442779071,3182396653,1668090733,1668090942,209,1261
3708654413,3889288487,1664496207,1664497136,929,704
3927952722,3418988797,1652977749,1652977989,240,1542
3139434250,3744955044,1641691099,1641691309,210,531
3241944871,3615595663,1663195812,1663196449,637,2329
3696856656,3071850041,1656699379,1656699962,583,1467
3223313152,3224960669,1657799826,1657800082,256,2258
3776906254,3867126446,1642139885,1642140405,520,1058
3860430252,3911588238,1665612020,1665612801,781,138
3080007856,3958710935,1643044402,1643045132,730,668
3823650698,3678340379,1641334086,1641334462,376,2281
3504911583,3105299236,1646947293,1646947912,619,175
3246321113,3896239645,1655817434,1655818420,986,44
3802790977,3772853715,1664077852,1664078018,166,2121
3354395496,3703056224,1643718107,1643718144,37,39
3904634428,3625869317,1659285630,1659286504,874,1894
3241033604,3758622438,1662914390,1662915013,623,2242
3506148228,3259430206,1654675265,1654675682,417,1627
3510761729,3038244365,1643728487,1643729106,619,513
3356332328,3201587444,1652251298,1652251530,232,2359
3035135381,3808952164,1648700389,1648700651,262,2455
3097563397,3248452729,1651316464,1651317047,583,926
3310715907,3192142540,1650234291,1650234503,212,989
3469879706,3065548516,1642173601,1642174463,862,756
3962138330,3677893619,1669110899,1669111806,907,1447
3641460659,3401382792,1649665710,1649666612,902,2286
3131629372,3928685907,1663346398,1663346477,79,1746
3255485773,3055020688,1647380789,1647381722,933,766
3213400022,3702284586,1655435291,1655435446,155,861
3156331863,3103625074,1650002448,1650003235,787,2470
3911588238,3233375810,1668857954,1668858660,706,2495
3245491745,3906026429,1645032224,1645032932,708,277
3577878798,3518246885,1664349426,1664350046,620,909
3208346862,3364661787,1644177893,1644178536,643,1274
3480115115,3197661010,1655782072,1655782721,649,1324
3423306122,3795990774,1669312790,1669312857,67,1689
3032834107,3802790977,1652239891,1652240117,226,1383
3423825173,3677893619,1657672286,1657673159,873,2062
3932613929,3063566522,1651011796,1651012534,738,459
3733072964,3795264165,1661508579,1661508861,282,1357
3945943527,3040563913,1657897792,1657898635,843,2416
3176346935,3247688800,1657928219,1657928446,227,1372
3032498591,3562814356,1664648205,1664648841,636,789
3738981251,3518079213,1641947253,1641948047,794,2238
3799480079,3660489961,1640995036,1640995958,922,1267
3766528617,3695935038,1653959721,1653960180,459,106
3357034260,3130973015,1648125960,1648126915,955,673
3954185607,3741273371,1659884129,1659884924,795,2354
3784828021,3178728299,1665167730,1665167882,152,1239
3528271389,3674005769,1664531067,1664531263,196,1799
3659620596,3820302319,1642366792,1642367243,451,780
3565001530,3619800237,1656843603,1656843713,110,1153
3454276568,3725963743,1651535159,1651535240,81,965
3916928531,3635938446,1658724128,1658724942,814,398
3568141696,3880608911,1658075275,1658075641,366,1996
3555966791,3875118670,1656061419,1656061660,241,1107
3734035375,3325962611,1642057163,1642058026,863,4
3878083942,3014983064,1665338341,1665339105,764,1911
3223094463,3327061038,1656413020,1656413837,817,1529
3406239480,3852344377,1658666495,1658666863,368,530
3142747577,3097469330,1646799557,1646799640,83,1242
3015814199,3602955685,1659757618,1659757655,37,392
3415686543,3271201418,1667389039,1667389181,142,413
3341573446,3447077543,1657098686,1657099141,455,1371
3982644241,3603594711,1665816315,1665816891,576,1149
3947921257,3474975781,1643105771,1643106760,989,2380
3590259850,3492657889,1651625231,1651625500,269,801
3971934050,3086357122,1668533253,1668533516,263,173
3959081575,3308454699,1666764084,1666764410,326,1994
3888141694,3087612913,1651852137,1651852405,268,300
3663871563,3135665687,1642179811,1642180026,215,1678
3704604706,3585495750,1649672278,1649672757,479,1676
3457417743,3694206371,1645261545,1645261870,325,352
3425282516,3442735570,1654314882,1654315818,936,529
3142848483,3416945471,1663155438,1663155785,347,881
3161586578,3288441459,1660765156,1660765705,549,1520
3568162481,3627503494,1659785523,1659786170,647,1643
3800451074,3105636655,1667828797,1667829788,991,788
3686407290,3760304580,1643851564,1643852116,552,1358
3498740809,3052396813,1660476866,1660477095,229,875
3974481828,3813287023,1666286182,1666286515,333,546
3880638655,3772910484,1659746558,1659746794,236,2085
3128613298,3179651539,1658845783,1658846412,629,2114
3782377691,3825900664,1650634614,1650635127,513,453
3665931760,3849201069,1665577099,1665577362,263,1416
3070241461,3102992210,1655430409,1655431218,809,46
3726117061,3008062664,1646995862,1646996068,206,1582
3008760173,3455209070,1653551143,1653551829,686,2058
3450672463,3980139195,1667201391,1667202314,923,1662
3204359619,3703943697,1663453730,1663453778,48,2434
3585816096,3742275397,1658853488,1658854093,605,1478
3551792540,3643372353,1667490791,1667491644,853,96
3674729672,3206248943,1650271299,1650271866,567,1752
3852205498,3343177837,1659280364,1659281269,905,71
3017758671,3121391240,1659087583,1659088245,662,967
3599299457,3571897260,1666161148,1666161903,755,953
3768549498,3724977571,1665263042,1665263829,787,2268
3167737446,3633830454,1662146256,1662146944,688,1790
3483827042,3583345509,1664392156,1664392576,420,1549
3736118442,3048386186,1649283920,1649284596,676,654
3565083183,3003087336,1646083510,1646083632,122,1563
3280657282,3233222399,1665168270,1665169033,763,1802
3920437320,3320381981,1642931009,1642931761,752,1473
3345875910,3896777982,1645597854,1645598408,554,2337
3922728266,3991963732,1665772524,1665773125,601,357
3773830646,3956054666,1644704996,1644705429,433,226
3149688689,3036470049,1642024409,1642024874,465,903
3784594026,3458116043,1642532549,1642533165,616,358
3816194055,3015956370,1659548239,1659548999,760,1405
3222871111,3415768719,1643713163,1643714034,871,800
3306934792,3046006152,1665616099,1665616195,96,2497
3798708209,3991859515,1652647444,1652647654,210,1598
3421671936,3455198360,1662167925,1662168469,544,942
3576579408,3010546611,1649762750,1649762995,245,448
3692512390,3168655636,1642093003,1642093928,925,1592
3402019498,3878059612,1646470188,1646470680,492,1194
3991859515,3268182022,1646541766,1646542624,858,825
3116751960,3114361358,1662630769,1662631758,989,336
3047126246,3445714649,1648296320,1648297143,823,2138
3174722772,3871137970,1652260810,1652261361,551,1262
3549033213,3988466264,1665951855,1665952732,877,1262
3805928545,3816538946,1651042624,1651042760,136,786
3112357538,3486286893,1642650102,1642650456,354,927
3657251975,3623936873,1644297889,1644298864,975,302
3406595083,3948219301,1646554024,1646554345,321,2009
3556803718,3428889808,1652765728,1652766714,986,2493
3200897172,3215342018,1660973889,1660973953,64,540
3492215792,3402155812,1643172045,1643172853,808,1186
3039081980,3166805288,1643064442,1643064949,507,553
3815774397,3487972666,1661190603,1661190978,375,1406
3891258957,3175418311,1647377609,1647378086,477,2289
3200875282,3472706088,1669559295,1669559708,413,817
3410865372,3813811121,1664760786,1664760949,163,1296
3854351732,3112357538,1667339421,1667339423,2,589
3893170545,3561062307,1662420641,1662420890,249,840
3564440153,3914166761,1644273191,1644273873,682,2346
3615387566,3343048708,1659342180,1659342354,174,412
3434224349,3457390239,1642229703,1642230061,358,1310
3245723038,3126746702,1652823877,1652823905,28,504
3566834497,3425720812,1668443617,1668443941,324,1424
3027110508,3680100111,1665265756,1665266010,254,1289
3661243199,3173406646,1645337643,1645337707,64,2201
3776685300,3055020688,1650967800,1650967827,27,1530
3328024680,3212038287,1643563124,1643564026,902,2239
3148203422,3443360830,1645511841,1645512574,733,2021
3491306285,3272187328,1642086489,1642087353,864,1621
3128839608,3668625909,1664299813,1664300364,551,1159
3287175350,3560053389,1651092095,1651092704,609,1734
3088604045,3200059644,1663233216,1663234191,975,1824
3122818832,3540251095,1666404181,1666405074,893,1080
3720248207,3854219185,1649662760,1649663225,465,983
3630744403,3301994647,1659560556,1659561241,685,795
3299840986,3672164838,1648235300,1648236221,921,393
3091882022,3431595099,1653995278,1653996099,821,1920
3232160942,3968000691,1647427129,1647428029,900,1787
3829149174,3232737784,1664284293,1664284355,62,1279
3329190028,3742159503,1656346708,1656347520,812,2231
3255460937,3119036139,1666943181,1666943255,74,1558
3445023517,3635487786,1669678213,1669679069,856,827
3898012654,3214711870,1666897638,1666898278,640,1147
3559696066,3119345546,1654938639,1654939119,480,1297
3785361012,3607717009,1642100442,1642101401,959,2005
3603786519,3806466784,1654833064,1654833125,61,2201
3091062283,3963702135,1667919182,1667919405,223,1425
3522861132,3764492400,1646414548,1646415089,541,1282
3657044188,3277926691,1642638179,1642638256,77,1244
3009177873,3095849365,1668826407,1668827357,950,632
3749529134,3615595663,1649319347,1649319640,293,2272
3884704204,3964524277,1665637928,1665638730,802,1332
3768253081,3251854206,1657874470,1657875142,672,568
3531898771,3729553337,1655059424,1655059589,165,541
3491562484,3564089463,1657152700,1657152855,155,931
3428325312,3853056907,1643366664,1643366999,335,1004
3135116989,3806167216,1644936931,1644937782,851,306
3369865184,3644128961,1661385991,1661386409,418,1432
3611763388,3430165544,1667453162,1667453516,354,1757
3314823389,3152555864,1663040760,1663040842,82,2460
3994130271,3903588940,1648242994,1648243403,409,849
3832438123,3030630339,1657688432,1657689418,986,896
3922827209,3493138014,1643605353,1643605920,567,2037
3577878798,3197497279,1652616019,1652616731,712,1276
3340486436,3421772590,1649133596,1649133622,26,551
3456080836,3625606853,1654691208,1654691718,510,2042
3718905579,3653429754,1649513181,1649513245,64,498
3732456028,3215342018,1642781920,1642782045,125,112
3276341369,3619399873,1655033742,1655034403,661,223
3028705386,3362395200,1669094769,1669094865,96,1179
3646159351,3245919207,1646057857,1646058444,587,2358
3126746702,3134793811,1662445262,1662445429,167,546
3255252214,3025215569,1645305644,1645306589,945,1313
3592453741,3643615690,1645935768,1645936734,966,1117
3956394849,3905067771,1669723857,1669724309,452,2027
3031026970,3054606477,1661792528,1661792880,352,1785
3291780380,3447470600,1668831553,1668831786,233,61
3741692259,3818319301,1643260704,1643260778,74,1338
3280657282,3842431875,1668393772,1668394515,743,1896
3575816255,3111167324,1667893901,1667894105,204,270
3573826666,3584139105,1646444548,1646444832,284,931
3661462228,3000275416,1660361807,1660362710,903,846
3983166385,3657305306,1664239219,1664239281,62,1370
3900843323,3439325479,1649098373,1649098752,379,1683
3571477883,3956054666,1643011434,1643012217,783,1642
3085311533,3049307137,1643854945,1643855828,883,2266
3502432342,3415761431,1646060902,1646061879,977,74
3809010705,3528467648,1656594721,1656595309,588,942
3203128336,3035245517,1656971374,1656971943,569,1619
3377847710,3481090623,1655236340,1655236760,420,1876
3364911803,3035794185,1648794583,1648795360,777,1469
3930565588,3294319716,1655034702,1655034956,254,553
3992919381,3777872237,1662359597,1662360541,944,1751
3220432369,3230248695,1649221118,1649221724,606,2456
3812800144,3370889279,1644840767,1644841024,257,257
3877638741,3343741687,1651115719,1651115765,46,2150
3979558738,3751975877,1656751358,1656751385,27,2456
3760432849,3011690678,1652548923,1652549027,104,941
3320187187,3999788546,1643697291,1643698181,890,316
3091709202,3542927039,1662814262,1662815121,859,1148
3809010705,3442244098,1660677856,1660678300,444,1967
3307067721,3995654203,1659988724,1659989585,861,898
3589157304,3680694926,1641037258,1641037403,145,1331
3884412861,3613021322,1649934802,1649934827,25,1035
3664989774,3696184358,1646363720,1646363771,51,1949
3761142574,3776918350,1669099527,1669100424,897,1930
3932212405,3529381895,1667640067,1667640999,932,1667
3618441418,3054160201,1660580923,1660581540,617,800
3524217572,3834706710,1650466943,1650467810,867,1573
3816533759,3415351222,1666875184,1666875235,51,2287
3106705860,3466204914,1662637802,1662638020,218,718
3634936481,3264434341,1644970786,1644971614,828,290
3776954666,3515941468,1664427986,1664428364,378,2306
3583591867,3890161181,1644713578,1644714203,625,1369
3442725932,3713404433,1659209716,1659210387,671,2361
3703825153,3662876111,1666146049,1666146250,201,1179
3417411117,3776334300,1647642406,1647642994,588,1338
3673735088,3517260537,1651105783,1651105905,122,489
3120081486,3447447895,1651875085,1651875695,610,1025
3699533383,3805665502,1652289770,1652290666,896,1992
3599299457,3660489961,1666288296,1666289258,962,1841
3200978578,3883976824,1645283649,1645284402,753,2411
3161243271,3611286809,1650697081,1650697940,859,492
3108427765,3619126886,1667897145,1667897451,306,1714
3601851578,3263372197,1664959020,1664959555,535,596
3681843847,3120490643,1667017503,1667018387,884,1414
3433768649,3258460512,1663037358,1663037369,11,169
3382693942,3432864859,1668840934,1668841710,776,1260
3470112947,3821049069,1646325522,1646325623,101,1357
3852506516,3945633602,1663663305,1663664303,998,1864
3209480732,3256648307,1668612620,1668612795,175,224
3864239870,3277875103,1658531501,1658531809,308,2131
3431175768,3948002281,1644673665,1644673939,274,521
3917500425,3266681677,1656303371,1656303730,359,667
3572224210,3466473464,1669362322,1669363265,943,1055
3465500045,3228277648,1668843190,1668843992,802,62
3449352254,3716415183,1661523196,1661523882,686,1695
3349692109,3321699949,1648413569,1648414557,988,1381
3266751679,3383573457,1648961404,1648961630,226,1992
3719273348,3934141269,1658408525,1658409016,491,565
3883176560,3682747704,1643614052,1643614259,207,87
3362148197,3556823098,1664314839,1664315431,592,427
3447203087,3795794957,1648395165,1648395756,591,2273
3883265629,3222446672,1648398273,1648398761,488,727
3993653521,3272428764,1663270784,1663270976,192,964
3446547180,3219435736,1645937337,1645938004,667,1240
3990379463,3897293094,1669223991,1669224098,107,1571
3320187187,3857400676,1644510261,1644510415,154,640
3024268753,3916226073,1656539331,1656539743,412,2472
3331977197,3127549843,1646529358,1646529531,173,338
3095170532,3298521381,1648195465,1648195993,528,1884
3876127195,3836331716,1645109632,1645110108,476,2473
3833345079,3450074680,1665028258,1665028350,92,962
3816533759,3146072606,1664273311,1664274304,993,2121
3829901682,3387170357,1660093923,1660094375,452,2161
3600247537,3027812492,1659623132,1659623425,293,356
3184669033,3003941040,1657287195,1657287560,365,405
3761201412,3783622486,1641063618,1641064494,876,1426
3067985831,3292797747,1668567980,1668568268,288,1587
3434182192,3188384391,1643902577,1643902720,143,659
3497171741,3446987671,1659622921,1659623086,165,600
3102669962,3928867307,1648685602,1648685906,304,1493
3344394548,3737420070,1664570255,1664571219,964,384
3400211756,3863190883,1653891786,1653891991,205,532
3014511835,3840558415,1649571492,1649571928,436,1795
3375404573,3242912660,1658673920,1658674392,472,1035
3717899735,3937729247,1644794776,1644795561,785,734
3442244098,3784808734,1668093622,1668094245,623,1466
3449993526,3886780901,1643621291,1643621577,286,275
3763093748,3020106315,1660043455,1660044059,604,28
3148284665,3429887771,1655920139,1655920863,724,1456
3784646522,3692904228,1661957817,1661958423,606,2117
3207757416,3669380667,1649092130,1649092687,557,1919
3606368289,3043354217,1645272642,1645273214,572,1524
3647479988,3968635893,1664704541,1664704563,22,382
3361482296,3362647814,1643720605,1643720648,43,842
3935936621,3746443510,1665185202,1665185898,696,766
3948743692,3694127985,1651206670,1651206798,128,148
3428499342,3034040451,1642698964,1642699303,339,1942
3912858275,3668174777,1662998694,1662998773,79,972
3879967963,3883976824,1646726269,1646726611,342,290
3709607250,3681170705,1647994924,1647995362,438,355
3745513680,3176410131,1647709067,1647709644,577,1130
3997353499,3028679133,1663560461,1663560812,351,606
3799459873,3018262582,1649741186,1649742133,947,2359
3265324040,3365807352,1643073918,1643074419,501,926
3325288212,3265181921,1649515528,1649515792,264,1429
3474088124,3812481438,1643479475,1643479702,227,2148
3167034499,3795817960,1651290221,1651290635,414,214
3996978717,3052789625,1642467842,1642468245,403,1779
3532021354,3072741474,1650240507,1650241365,858,152
3343279177,3884067849,1656526675,1656527450,775,35
3187982526,3311252249,1663372484,1663372694,210,766
3293387588,3885694482,1656272647,1656272863,216,678
3806167216,3242912660,1662413280,1662414272,992,867
3748627476,3183313787,1659999711,1660000522,811,2024
3959383415,3797294746,1669175019,1669175607,588,1881
3140486428,3554680554,1668394934,1668395194,260,600
3486727273,3654381548,1663727889,1663727916,27,91
3481030779,3047629830,1665153483,1665153924,441,1874
3732256987,3996587507,1655016621,1655016888,267,1469
3555187890,3488551185,1652766608,1652766976,368,769
3659299466,3394999152,1662166240,1662166416,176,1552
3736681866,3161999632,1659510014,1659510798,784,1695
3046132590,3600879855,1644955857,1644956684,827,199
3371002443,3541423460,1664062207,1664062752,545,862
3067229796,3928290954,1657583084,1657583503,419,802
3511192827,3104396432,1652512825,1652513540,715,738
3033079935,3442354739,1666802538,1666802649,111,119
3189435516,3526166184,1667722605,1667722912,307,479
3498685499,3975663862,1661326145,1661327121,976,1112
3520523282,3094940809,1644307097,1644307285,188,10
3835864517,3558517913,1669428746,1669428860,114,951
3556647439,3704980935,1647129067,1647129431,364,260
3098316380,3485578733,1658017267,1658017861,594,1024
3176432386,3910029798,1657302958,1657303560,602,2444
3941642636,3829593597,1647510562,1647510814,252,1168
3902543996,3234861737,1658697607,1658698259,652,1036
3474315750,3867799694,1659438238,1659438779,541,2351
3141196312,3673950693,1657061938,1657062423,485,154
3423306122,3056982737,1646164967,1646165849,882,1937
3580178697,3275298041,1656292986,1656293420,434,1464
3693920541,3730428171,1645842938,1645843881,943,1035
3123522446,3104870555,1653393370,1653393896,526,239
3114128222,3234030791,1665951544,1665952356,812,2098
3370834194,3635616513,1658084340,1658084664,324,2266
3012323943,3268570857,1652189996,1652190700,704,2277
3033029762,3074269946,1645874601,1645875216,615,2035
3798369315,3165835560,1662857127,1662857222,95,1192
3055402951,3733770591,1653555761,1653556509,748,2260
3061850950,3166206557,1656714297,1656714760,463,1763
3561573044,3229497695,1664361360,1664361528,168,233
3557215676,3447407380,1649881187,1649881885,698,1495
3964636806,3452258976,1658442866,1658443696,830,578
3040889811,3594038673,1662571399,1662571815,416,911
3566825897,3319545220,1664341993,1664342751,758,354
3900051900,3909765076,1648396737,1648397337,600,1741
3024228189,3193991721,1665925465,1665925676,211,1783
3841287368,3596839317,1649756760,1649757098,338,1822
3646079529,3293237543,1656240698,1656241116,418,1292
3523236646,3288309878,1651491180,1651491385,205,824
3265725715,3250253670,1658631546,1658631772,226,1648
3071602516,3173535458,1641197002,1641197566,564,233
3140682569,3187779586,1645249608,1645249611,3,36
3878083942,3486059916,1649955267,1649956080,813,2436
3367510444,3285030317,1646956249,1646956592,343,1905
3373806425,3810573183,1664263515,1664263813,298,1578
3681631482,3034040451,1647781643,1647782593,950,31
3712804229,3091008161,1664516702,1664516726,24,1067
3452275962,3537151295,1666962115,1666962547,432,1643
3372334548,3702178313,1644115537,1644116151,614,397
3343033950,3823133313,1661249965,1661250189,224,88
3747302768,3007446724,1662980225,1662980364,139,417
3385430413,3402155812,1662777366,1662777493,127,900
3229495084,3188567155,1645766599,1645767350,751,1866
3292111100,3600573063,1655245102,1655245651,549,88
3685049252,3777597419,1667995073,1667995811,738,2251
3389097842,3449915970,1667212735,1667213079,344,43
3744575844,3661462228,1657673516,1657673927,411,2117
3271479070,3726367604,1645811373,1645812152,779,343
3112074335,3032888380,1653818834,1653819797,963,152
3850214790,3311118815,1665855704,1665855818,114,2404
3156483651,3733484132,1664040425,1664040785,360,1405
3720248207,3776954666,1646114969,1646115461,492,1478
3275436235,3298857826,1668890123,1668890785,662,478
3264345880,3189358030,1652855120,1652856051,931,1891
3157212376,3225909236,1642418143,1642419109,966,54
3100113266,3674059710,1652487087,1652488036,949,2075
3236308141,3078216798,1646517404,1646517726,322,1439
3596951808,3398257086,1660457087,1660457746,659,191
3420676198,3286424440,1653274400,1653275260,860,1672
3014275222,3765827886,1651823157,1651823678,521,2168
3014275222,3279239799,1642653250,1642653253,3,2354
3766914780,3008062664,1668661592,1668661806,214,1853
3735855753,3275223689,1650221125,1650221571,446,2353
3920910995,3796198742,1654005040,1654005752,712,2014
3269966376,3021253966,1657484529,1657485492,963,1205
3356689959,3886368625,1643372356,1643373093,737,2150
3967439884,3450353368,1645247818,1645247964,146,1865
3303561746,3758622438,1652783166,1652783348,182,1330
3082075242,3021727735,1657636637,1657636804,167,2168
3049567508,3805742408,1645898648,1645899205,557,1591
3337765684,3494372287,1668611344,1668611797,453,1419
3168084964,3098907787,1660401063,1660401757,694,2024
3620303845,3331255997,1666107749,1666108282,533,2124
3284380221,3581570568,1657818240,1657818877,637,431
3370701718,3084783158,1657036961,1657037397,436,1854
3019694538,3304523843,1664437698,1664437957,259,1842
3117816089,3014993252,1642974052,1642974586,534,1689
3663155034,3242064640,1664760439,1664761297,858,740
3300983140,3870035420,1641106379,1641107366,987,1037
3266042074,3943184820,1652905909,1652906773,864,757
3609310097,3439120258,1663651312,1663652165,853,1695
3392271707,3061461510,1641384386,1641384602,216,1732
3375404573,3454297726,1652153594,1652153709,115,2131
3904881288,3686144397,1664107186,1664107276,90,801
3051903509,3069881077,1648759360,1648759727,367,2100
3298635617,3651900802,1642934164,1642934442,278,1884
3635616513,3553146922,1646063062,1646064011,949,780
3546290525,3872574112,1659129251,1659129479,228,1124
3721110937,3576862500,1665801579,1665801689,110,1997
3896922629,3909173527,1653829632,1653829955,323,2273
3014392598,3636446257,1647607201,1647607601,400,1435
3163552496,3172305265,1666314307,1666314730,423,305
3008372630,3374692305,1658500354,1658500499,145,645
3595469152,3763300182,1648919496,1648920394,898,900
3572896327,3894115655,1662466906,1662467166,260,1614
3564033398,3034325039,1647072576,1647073111,535,2031
3542078032,3310037244,1660778896,1660779307,411,2111
3649154395,3651110510,1642901513,1642901884,371,1693
3822917630,3265725715,1651236996,1651237248,252,1306
3776398060,3553725082,1651025739,1651026204,465,781
3035803277,3039544352,1663298136,1663298293,157,1864
3641618845,3689680251,1667216718,1667217688,970,29
3775501779,3814045699,1649299686,1649300555,869,2459
3309242036,3432209746,1641770080,1641770089,9,179
3761587047,3925344243,1661357757,1661358699,942,1781
3820885067,3010790966,1656050968,1656051004,36,1923
3085311533,3507500782,1662468486,1662469210,724,180
3878852082,3993653521,1655356199,1655357086,887,1974
3366354894,3401962895,1648206322,1648207064,742,1863
3651812819,3513925385,1650455685,1650456647,962,792
3972294801,3348620933,1646871971,1646872729,758,1078
3203319376,3916557399,1668658099,1668658440,341,657
3718182841,3661037098,1653473357,1653473888,531,1094
3709518724,3861173090,1665262917,1665263400,483,1821
3221850819,3949947697,1642245633,1642245712,79,162
3340125949,3531842620,1645312564,1645313315,751,1014
3840306405,3358959910,1659996960,1659996968,8,1413
3110395191,3522963106,1667318633,1667319435,802,445
3938679223,3412955545,1644817955,1644818442,487,330
3252790120,3187982526,1663659798,1663660522,724,1422
3057102903,3361652898,1656960550,1656960728,178,358
3671637527,3399552669,1642592098,1642592413,315,1207
3352751731,3207994528,1653013220,1653014029,809,33
3828485006,3005700539,1647076830,1647077639,809,1601
3176252124,3325565610,1644945896,1644946678,782,1832
3972687424,3540029077,1666478091,1666478413,322,669
3199892178,3423043196,1644705748,1644705988,240,2045
3071341023,3407156969,1643911241,1643911481,240,2162
3604852600,3533172784,1645372707,1645373086,379,1653
3876344592,3327311623,1649245338,1649246115,777,2230
3181237998,3628830127,1652183957,1652184007,50,747
3282168599,3659326501,1659554914,1659555586,672,333
3524131973,3797295915,1654406377,1654407098,721,1642
3954185607,3075780193,1643534014,1643534602,588,1928
3014975304,3547672806,1643565836,1643566034,198,1218
3346986628,3304559201,1642428443,1642429107,664,1670
3945633602,3264460374,1662016016,1662016807,791,1734
3931854815,3524589150,1641595648,1641596454,806,696
3463734539,3273752842,1666496317,1666496799,482,1219
3589366986,3627981146,1647608467,1647608922,455,1836
3525152477,3351216955,1655213960,1655214681,721,1031
3954434825,3241584825,1660043549,1660044459,910,920
3553712893,3114863942,1661042743,1661043721,978,367
3760972512,3153541916,1643629779,1643629875,96,2330
3520511256,3276526689,1654634290,1654634499,209,1974
3898641431,3649442188,1658147579,1658148473,894,319
3073969560,3046991819,1653720105,1653720191,86,2098
3266991557,3139935588,1646141711,1646142164,453,2283
3457317780,3946569604,1662483857,1662484226,369,1281
3170985187,3415041326,1655869365,1655869431,66,1701
3993994586,3605699054,1665145503,1665146040,537,1116
3912828190,3315583401,1652551275,1652551565,290,499
3795264165,3899585675,1650590115,1650590727,612,155
3905356323,3345875910,1647392572,1647392597,25,1784
3015814199,3338376656,1667886422,1667886865,443,2316
3344713569,3904546701,1669077958,1669078729,771,1593
3388004574,3599568023,1653163623,1653163908,285,2387
3819468348,3413810353,1667989640,1667990297,657,1886
3494498890,3205282165,1651807351,1651807758,407,1544
3876427301,3469648387,1666667851,1666668142,291,1248
3775146250,3991963732,1657677118,1657677812,694,2153
3723957807,3210331889,1650965697,1650966674,977,1948
3204575281,3967506765,1658834662,1658834768,106,1224
3017484229,3701501875,1654540210,1654540589,379,1558
3012323943,3898403925,1668430864,1668431602,738,720
3069313994,3224715818,1644351551,1644352243,692,644
3577530061,3173406646,1665450533,1665450863,330,2027
3129582333,3507431231,1654505616,1654506425,809,1826
3068296722,3945358150,1653230858,1653231364,506,1929
3492376573,3796065026,1641278567,1641278950,383,2445
3118526217,3168434098,1663345933,1663346015,82,1573
3152438109,3626156541,1646742213,1646742857,644,622
3271648296,3357966828,1658305733,1658306106,373,1675
3297001171,3197545162,1658783841,1658784207,366,2206
3736260750,3284159385,1667061712,1667061966,254,1244
3153413554,3816170686,1650269484,1650269592,108,251
3084007689,3025135840,1663311815,1663312715,900,716
3125008218,3365939940,1641656057,1641656514,457,1454
3750277600,3540717336,1661776877,1661777411,534,794
3382983805,3159525512,1646559956,1646560412,456,396
3729299306,3718905579,1653984716,1653985329,613,1483
3986016860,3493232103,1662359011,1662359842,831,701
3815462032,3073762858,1642161059,1642161241,182,1704
3203128336,3779236518,1651059289,1651059552,263,768
3970654045,3490430582,1643166398,1643166616,218,403
3274752508,3008550397,1665949342,1665950221,879,1026
3928727074,3678805802,1666212779,1666213249,470,2017
3170158934,3987510303,1651878689,1651879659,970,2444
3120056957,3879605776,1648978466,1648978692,226,771
3133030435,3250852254,1663185926,1663186829,903,1286
3092564684,3984414020,1659616290,1659616544,254,2199
3987567381,3880580622,1646118393,1646119353,960,1913
3133030435,3894801934,1646076722,1646076971,249,1845
3579684205,3696149430,1669287826,1669288323,497,1378
3759165741,3127403665,1655616652,1655617566,914,1306
3808415962,3204346356,1668744110,1668744503,393,755
3194069746,3309767670,1650018258,1650018740,482,1043
3077143208,3085921604,1668265244,1668265666,422,434
3925393914,3083519927,1664417944,1664418863,919,2257
3214558994,3533497399,1663121369,1663121964,595,1934
3921560605,3199635800,1663657270,1663657490,220,5
3679045431,3556197400,1657121850,1657122595,745,2466
3497045946,3351441481,1659791697,1659791979,282,1225
3056053831,3143318519,1660035937,1660036171,234,1903
3489473144,3563967528,1657897936,1657898784,848,1738
3063969367,3804458349,1644843370,1644844060,690,1558
3501568597,3105829075,1654194051,1654194236,185,1921
3638847705,3136172164,1669527264,1669527966,702,1379
3752797217,3066645531,1649076167,1649076619,452,1235
3879299283,3230248695,1667508738,1667508812,74,321
3442854678,3212043381,1665306248,1665306520,272,2014
3162947685,3447257561,1663377515,1663377887,372,1459
3881216721,3661016961,1668907721,1668907763,42,500
3303561746,3907705988,1664567096,1664567501,405,324
3694618653,3944398168,1666912447,1666912506,59,2458
3786840082,3857081560,1669404023,1669404803,780,434
3709263457,3841287368,1641538104,1641538127,23,1519
3295806447,3431000503,1644855277,1644856199,922,101
3157765022,3861764050,1643124861,1643125789,928,2282
3346986628,3883703576,1669710234,1669710782,548,267
3136172164,3422046745,1646326161,1646326356,195,423
3389097842,3177915558,1663049427,1663049827,400,1647
3827810459,3758695244,1643284347,1643284988,641,607
3944914500,3084855451,1663629640,1663630520,880,1461
3072834944,3991859515,1657500508,1657501143,635,2405
3353855658,3681001652,1664240266,1664241054,788,1324
3640387984,3746550027,1661736944,1661737008,64,1730
3611982999,3017484229,1644444240,1644444583,343,2182
3927273567,3757624193,1668127789,1668128342,553,943
3417176290,3183299670,1660402186,1660403094,908,1067
3881554146,3526218972,1649058762,1649059537,775,405
3910839994,3238081511,1664966367,1664966617,250,2147
3865200739,3261837009,1665863111,1665863692,581,702
3773434774,3829593597,1648613155,1648613787,632,1705
3794447092,3392395230,1663927452,1663927535,83,617
3947083981,3028705386,1664801894,1664801989,95,773
3787514151,3587324906,1652331270,1652331278,8,1396
3797294746,3319583055,1663460586,1663461230,644,1609
3776918350,3310499607,1665743733,1665743910,177,205
3888392286,3053100790,1668813713,1668813863,150,2401
3635624917,3565803867,1657022954,1657023098,144,2436
3516865615,3118419220,1664908340,1664909262,922,1598
3591724433,3427127427,1664200048,1664200697,649,502
3791460437,3766160943,1666993740,1666994475,735,73
3168535205,3985159412,1646582516,1646583463,947,1168
3825824228,3427520419,1664677570,1664678199,629,1698
3254227672,3679617161,1661780341,1661780736,395,1550
3518864357,3224960669,1664783610,1664783931,321,2106
3672194570,3232141615,1655628861,1655629567,706,1336
3659563225,3131930167,1662112970,1662113659,689,2488
3228565452,3365316758,1661440158,1661440899,741,2041
3132210207,3345733128,1655736230,1655736662,432,750
3816921514,3805928545,1653627085,1653627959,874,1842
3190969092,3310523513,1669439519,1669439658,139,680
3524466015,3382526428,1655238453,1655239274,821,1485
3780182766,3521408145,1667438651,1667438737,86,2116
3961183307,3955307397,1643196630,1643197404,774,1600
3809312897,3695558824,1642632524,1642633405,881,1223
3628830127,3892686083,1649221760,1649222548,788,1109
3578002057,3415185806,1647544128,1647544572,444,1178
3442293538,3467686942,1643884221,1643884868,647,1681
3131025611,3987162833,1643943554,1643943977,423,2316
3407150254,3118754726,1641414833,1641414998,165,437
3031209415,3356028416,1669730667,1669730799,132,328
3696205962,3188126815,1648715847,1648716517,670,2175
3144551332,3286424440,1655375886,1655375962,76,1652
3612720177,3878695242,1662768429,1662768677,248,1784
3979522310,3716757245,1649255868,1649256307,439,2359
3582683989,3871736180,1663907370,1663908001,631,1367
3983610735,3038630181,1667081734,1667082074,340,779
3604593541,3614627046,1660722769,1660723675,906,600
3219637680,3621969167,1658328803,1658329058,255,545
3049869003,3080889735,1658372774,1658373150,376,1543
3761556948,3542285714,1662477571,1662478212,641,1349
3696184358,3074832079,1658370918,1658371013,95,1020
3636960130,3576961863,1658530238,1658530754,516,1786
3295146156,3205153391,1660521007,1660521266,259,342
3192142540,3112856155,1646790459,1646790907,448,2464
3022283384,3086084685,1662506181,1662506793,612,853
3490430582,3593487418,1649336974,1649337395,421,1226
3439905167,3051642574,1652482647,1652483388,741,2336
3471587065,3859221152,1651139701,1651140425,724,1109
3816561204,3013484024,1647603878,1647604685,807,2089
3420205343,3895976556,1659816128,1659816821,693,2118
3765693461,3311280180,1649678382,1649679161,779,100
3855063597,3579486534,1657860887,1657860983,96,1773
3180973124,3052861028,1665812499,1665812610,111,1914
3942656665,3571766829,1645881087,1645881312,225,1358
3971524060,3201479561,1665455932,1665456545,613,1380
3393406422,3364925703,1669379266,1669379917,651,629
3669647019,3692772256,1652515590,1652515943,353,1466
3198527442,3463540687,1648366550,1648366677,127,631
3870243569,3243005694,1644478413,1644479073,660,1791
3466473464,3977539783,1667763840,1667764502,662,26
3586524207,3565128218,1649340094,1649340159,65,1445
3093523046,3275223689,1665505704,1665506637,933,2103
3468914867,3976817467,1655103965,1655104423,458,1894
3884878006,3086871623,1658842091,1658842421,330,793
3165307890,3223917351,1650408530,1650409492,962,1972
3240037909,3945881377,1660152620,1660153036,416,1402
3963793916,3710422072,1649631722,1649632377,655,344
3234851871,3797617787,1644190059,1644190560,501,1599
3134425396,3387264235,1656464355,1656464994,639,506
3257973966,3498758411,1645069700,1645070182,482,669
3264753140,3921490578,1667626729,1667626853,124,2245
3340331761,3866532806,1656141271,1656141445,174,631
3374636126,3435253366,1664115877,1664116636,759,1727
3656789430,3005101248,1650533134,1650533666,532,302
3836762535,3024813851,1645938900,1645939398,498,831
3337684100,3671907089,1658072330,1658072545,215,1589
3984977278,3691830908,1659419079,1659419231,152,762
3935379393,3919478201,1667878435,1667879095,660,993
3393458100,3307462662,1646444392,1646445036,644,2319
3267248595,3231938844,1649621491,1649622012,521,583
3964636806,3760304580,1664818195,1664818453,258,905
3367510444,3252664436,1656012443,1656013287,844,2038
3063782933,3248324593,1651671545,1651671675,130,2036
3910837040,3822458181,1654245954,1654246110,156,1227
3626156541,3882414600,1652914876,1652915380,504,2262
3445031830,3679939578,1645972961,1645973447,486,1163
3628554134,3068913990,1661690791,1661690930,139,1425
3344455273,3328015314,1642696355,1642697092,737,2092
3023075779,3794481759,1655168444,1655168835,391,2433
3692441467,3092956442,1642409715,1642410018,303,496
3870485916,3049869003,1642089088,1642089479,391,2492
3135707503,3429010148,1667195852,1667196501,649,1235
3407156969,3652029135,1650435120,1650435566,446,2111
3835621921,3074460772,1663821560,1663821966,406,293
3344077337,3714105777,1651715160,1651716053,893,2499
3722422633,3862685266,1650441800,1650441978,178,1248
3512353520,3153552268,1664976865,1664977852,987,1982
3952185527,3339027368,1647278057,1647278169,112,697
3548759819,3087850405,1650294052,1650294990,938,1032
3516140957,3000650426,1652239922,1652240560,638,1439
3321699949,3994130271,1666900737,1666901326,589,560
3409662195,3306457934,1641790803,1641791566,763,1084
3262811174,3234656999,1666622645,1666623360,715,27
3839688715,3995868243,1652205086,1652205420,334,1951
3743669526,3658451605,1666940484,1666941047,563,935
3264345880,3129677855,1643928775,1643929679,904,455
3515044837,3086273441,1641716232,1641716894,662,2242
3794462820,3268216928,1641173920,1641174016,96,1751
3099682661,3363651899,1663835085,1663835306,221,954
3065530519,3675418278,1646150688,1646151477,789,2493
3856756422,3734533600,1649729218,1649729644,426,1756
3066757468,3675418278,1667968781,1667968876,95,430
3933196862,3973050834,1657872464,1657872859,395,2390
3687689210,3887519119,1643039908,1643040490,582,1934
3816493730,3366155048,1642751096,1642751380,284,1918
3079415495,3984370468,1654124712,1654124913,201,185
3132611388,3308028752,1644801027,1644801324,297,2121
3959497834,3058789362,1651294444,1651294723,279,558
3122109326,3408104715,1657070372,1657071235,863,86
3980207883,3623433422,1668510715,1668511658,943,356
3568676955,3790648941,1662665108,1662665552,444,768
3636572173,3752773975,1648119348,1648120023,675,1574
3581083030,3898959510,1650105621,1650105804,183,228
3062789212,3832463052,1659266350,1659266548,198,1875
3642771281,3784123884,1660000225,1660000891,666,2213
3540029077,3058725687,1651047913,1651048656,743,491
3468455079,3019669727,1650046135,1650047083,948,2385
3969036937,3920669948,1649406884,1649406974,90,1852
3648257100,3878059612,1653380992,1653381986,994,1863
3656656446,3064574238,1643800750,1643801541,791,296
3271864656,3596839317,1643266262,1643266733,471,945
3604769442,3710043628,1656224351,1656225214,863,1500
3222871111,3623092479,1646323976,1646324673,697,1997
3435252882,3240502673,1662664477,1662665197,720,1117
3289108426,3675703241,1648465814,1648466657,843,82
3825930964,3137891271,1666693020,1666693921,901,461
3227368879,3132486699,1651044429,1651044591,162,1161
3334207071,3755413351,1651809534,1651810444,910,101
3988466264,3170325894,1657364502,1657365120,618,485
3845131231,3182878730,1668013149,1668013640,491,1564
3765617850,3142101976,1651337086,1651337899,813,2071
3529764378,3036527901,1653064385,1653064595,210,2272
3434608050,3443435826,1652156524,1652156616,92,1833
3800566657,3419809319,1659458677,1659458888,211,2254
3123677020,3560756539,1657749643,1657750149,506,130
3911849911,3701668957,1659503117,1659503522,405,2281
3790329301,3777022057,1646590968,1646591623,655,990
3938973292,3778625091,1666501285,1666502161,876,1595
3891027417,3515941468,1650401842,1650402705,863,1078
3070186247,3685505113,1668085265,1668085300,35,1085
3016299339,3249642950,1648303781,1648304489,708,2120
3727981782,3681795615,1657145589,1657145854,265,175
3884551317,3457361080,1641428158,1641428243,85,312
3923692475,3510634049,1642480913,1642481510,597,1488
3312203382,3772337054,1661895953,1661896940,987,404
3048328762,3919792223,1651306705,1651307327,622,1168
3672560021,3486832676,1664370088,1664370609,521,1884
3256787088,3729034883,1650944271,1650945062,791,523
3788018778,3866222795,1656171312,1656171924,612,94
3221031593,3923647484,1653347740,1653348143,403,1255
3927660473,3988546259,1664631979,1664631981,2,1451
3015593061,3837877764,1650304016,1650304492,476,64
3516410980,3516089114,1652835724,1652836695,971,2483
3393552322,3805665502,1663789811,1663790793,982,2194
3988790434,3512720372,1665428606,1665429307,701,1530
3943947223,3176432386,1656615639,1656616425,786,2456
3400121766,3582076532,1659104285,1659104465,180,1173
3711151849,3195274844,1644950092,1644950414,322,1045
3715106063,3775753518,1666096156,1666096962,806,471
3153413554,3401463703,1642918807,1642918965,158,323
3845818528,3288441459,1644285842,1644286483,641,996
3726892870,3112259657,1659215622,1659216534,912,2354
3593967802,3469437983,1646431946,1646432795,849,1821
3265571367,3263842575,1666877920,1666878156,236,1300
3425282516,3024447668,1657308214,1657308488,274,1298
3753659944,3740274448,1656641566,1656641661,95,1359
3466204914,3099976032,1641588359,1641588921,562,1508
3797295915,3660513601,1656514495,1656514692,197,559
3093254727,3625684557,1648190378,1648191302,924,1578
3722817789,3072277927,1652010312,1652011011,699,2028
3747889498,3384200089,1656384648,1656384993,345,982
3327795374,3179354869,1659835307,1659835647,340,1477
3362298218,3498707377,1665467573,1665467967,394,1170
3689303525,3693888320,1662603990,1662604561,571,1680
3153858233,3210422873,1661605624,1661606275,651,358
3231537700,3629207282,1664180440,1664180680,240,693
3228574805,3190003253,1659733720,1659734609,889,632
3356765270,3310294122,1653990855,1653991449,594,1817
3682279970,3163662966,1649199889,1649200364,475,2206
3610930903,3784912315,1660995109,1660995224,115,2274
3734579045,3641911946,1660709566,1660710059,493,1613
3255978821,3094759406,1652845121,1652845938,817,1627
3930142533,3021006721,1657337824,1657338518,694,1601
3550677109,3777684793,1654111828,1654112456,628,1933
3480314503,3096740365,1656037744,1656038155,411,993
3891053268,3874626130,1643315920,1643316146,226,2055
3922728266,3757044916,1669733856,1669734444,588,1304
3957210150,3411993487,1646234437,1646234823,386,1346
3547429967,3965000413,1660730515,1660730847,332,552
3673561332,3287171733,1666337374,1666337587,213,736
3851327758,3124476593,1664107657,1664107999,342,65
3023025075,3997051818,1664586604,1664586790,186,253
3280717680,3019854226,1668961483,1668961571,88,699
3814355412,3611777140,1647674124,1647674515,391,2333
3986955632,3649660430,1641899056,1641899696,640,580
3551111997,3257865090,1661524614,1661525397,783,176
3261837009,3952316985,1650109940,1650110782,842,2296
3004708023,3008576449,1667193243,1667193538,295,1895
3288937566,3139434250,1652728586,1652728657,71,2268
3823637809,3013073909,1641438755,1641439135,380,512
3872626198,3702541874,1643654133,1643655066,933,2299
3424211722,3199563620,1662771951,1662772496,545,450
3971391515,3042034210,1662587509,1662588164,655,421
3098264219,3065350513,1657391725,1657392474,749,199
3930142533,3528467648,1641694571,1641695430,859,1957
3833046871,3501946724,1668047911,1668048889,978,2134
3586600196,3230836206,1652572654,1652573432,778,1364
3542293606,3795609815,1643264453,1643265269,816,709
3344282962,3650172161,1646891991,1646892422,431,1619
3194871172,3345186165,1648133993,1648134508,515,1627
3196934109,3080200257,1653315634,1653316206,572,2321
3913680174,3283056652,1645870357,1645870623,266,1143
3282231108,3246260241,1658273281,1658273919,638,706
3508202949,3849910709,1657971327,1657971825,498,1055
3527106895,3211641180,1653570256,1653570303,47,2051
3499481051,3911588238,1645328402,1645329118,716,2239
3394220693,3637663893,1660385025,1660385732,707,1804
3391262941,3216470508,1648246629,1648247196,567,1880
3341890542,3522444883,1666939724,1666940618,894,1726
3490430582,3779459643,1642259427,1642259609,182,1061
3575535453,3676228617,1663850368,1663850575,207,2387
3689032543,3237339326,1644175947,1644176425,478,2163
3178640485,3717406689,1658134069,1658134794,725,1508
3728797277,3483254795,1668380566,1668381129,563,2342
3624683080,3021515419,1657767168,1657767206,38,1337
3631455637,3703615574,1651561285,1651561898,613,1365
3934141269,3083144170,1660429964,1660430830,866,1230
3068296722,3316485303,1658386767,1658387498,731,366
3540029077,3366321387,1666404492,1666404960,468,2034
3504457520,3296957627,1656751918,1656752095,177,881
3243231806,3910760009,1665144532,1665144922,390,290
3788769219,3486606390,1646237860,1646238017,157,281
3527291464,3814017798,1659839464,1659840288,824,1186
3630330540,3402804885,1646132464,1646132784,320,571
3604596896,3215402575,1669220786,1669221175,389,2161
3819380768,3744234480,1651206758,1651207716,958,1426
3985879853,3376673600,1655225433,1655225547,114,1898
3347896915,3237674968,1668846347,1668846625,278,1969
3028705386,3315759953,1645245963,1645246685,722,1743
3468682335,3059870015,1658669464,1658670435,971,2219
3397397223,3690667222,1646727589,1646728204,615,2271
3182643672,3935978133,1653890988,1653891348,360,1235
3471797400,3570429285,1664331479,1664331860,381,1588
3339185857,3047643464,1647644996,1647645312,316,721
3768211591,3410655469,1647793333,1647793339,6,886
3344957789,3721340009,1664746803,1664747319,516,1030
3473399101,3885194706,1654571977,1654572519,542,2100
3262645455,3067641822,1653165418,1653166233,815,1007
3225500469,3787514151,1652055830,1652056715,885,1148
3474376744,3189038779,1656456612,1656457543,931,36
3641455530,3713129998,1656011421,1656012319,898,2100
3815507952,3670579691,1656598425,1656598803,378,547
3592561930,3748511559,1662556479,1662556907,428,1366
3764724451,3117322872,1669008359,1669008805,446,1455
3490942401,3224952698,1664426908,1664427755,847,2271
3579514433,3183313787,1641267364,1641268353,989,1083
3929975862,3861173090,1660966562,1660966617,55,1255
3782457642,3809387134,1659280471,1659280595,124,406
3461674303,3106436957,1650415044,1650415133,89,144
3379105646,3837904800,1666759223,1666759520,297,2056
3952889735,3737772457,1662135141,1662135689,548,671
3416945471,3875343154,1668236412,1668237142,730,2095
3177951035,3289615980,1653558088,1653558674,586,362
3121932256,3189435516,1643314204,1643314620,416,224
3388004574,3436234030,1647711966,1647712759,793,1359
3036346251,3900755896,1648364542,1648364555,13,1959
3648924087,3940391939,1661658047,1661658731,684,713
3389161785,3604881190,1652646144,1652647017,873,1983
3939244771,3980781580,1646113458,1646113502,44,1131
3939768853,3592519306,1664569273,1664569939,666,1364
3924879744,3882415224,1646325589,1646326092,503,2244
3057201124,3682279970,1650319516,1650320358,842,441
3580774207,3474572698,1656032692,1656033132,440,2259
3032747459,3762816561,1655206773,1655207230,457,365
3959783422,3001509229,1645870413,1645870698,285,1096
3288937566,3110753111,1661760129,1661761071,942,716
3543696190,3832880789,1645720684,1645721258,574,2175
3288490513,3771811920,1666265309,1666265643,334,493
3891850013,3399503261,1644193327,1644193444,117,652
3529732289,3681843847,1653576796,1653577275,479,2168
3167737446,3917448920,1646358549,1646359073,524,1141
3117732598,3166343569,1663676565,1663676927,362,314
3515161257,3668441547,1664167860,1664168409,549,2177
3458478056,3762829533,1646654015,1646654139,124,2172
3552958954,3603068932,1669507283,1669507733,450,540
3517541359,3554778587,1661283678,1661284079,401,788
3861160074,3942965206,1648954248,1648954625,377,259
3125730442,3412989654,1665230354,1665230533,179,846
3428142421,3357474960,1647677099,1647677409,310,1495
3137891271,3276763839,1654847112,1654847849,737,1831
3524217572,3507992647,1644763743,1644764497,754,1884
3067403592,3233375810,1652337040,1652337505,465,1009
3081725518,3505197900,1641630596,1641631278,682,1641
3096408604,3330924198,1652539016,1652539654,638,508
3763991129,3503393955,1659717809,1659717907,98,2241
3912014286,3050229164,1643866113,1643866411,298,1337
3859164696,3707070213,1647501509,1647501819,310,1125
3578298884,3263372197,1649849058,1649849835,777,1637
3026244912,3053026624,1661317356,1661317474,118,2227
3758695244,3744196402,1654218066,1654218726,660,1808
3626505512,3744829701,1653734171,1653735054,883,1341
3708032127,3759668586,1652866304,1652866555,251,336
3159562411,3449125023,1658142987,1658143222,235,335
3153989234,3424721457,1668686989,1668687125,136,1701
3825332100,3858052316,1642016179,1642016809,630,680
3036381764,3310582583,1650970629,1650971620,991,2179
3030286864,3867868879,1663954849,1663955531,682,31
3008372630,3021006721,1669700299,1669700856,557,998
3386868280,3149896107,1658714123,1658714707,584,144
3194712532,3717926703,1655038111,1655038755,644,861
3980926444,3194603908,1654961823,1654962460,637,761
3393501277,3166754795,1667711039,1667711880,841,1141
3704818655,3660468597,1665498418,1665499268,850,1038
3957824946,3124964775,1651353591,1651354425,834,1397
3606749014,3375655129,1659564379,1659565208,829,1903
3109390601,3161234904,1649272604,1649273188,584,1552
3043736420,3097563397,1661078633,1661079117,484,46
3224128562,3927646653,1662090390,1662091116,726,309
3612061421,3376673600,1642350544,1642350754,210,1828
3961183307,3566936390,1659863312,1659863762,450,905
3498314038,3112389617,1659293360,1659293782,422,938
3387785849,3069353793,1661957330,1661957893,563,1719
3003087336,3866922475,1666477367,1666477794,427,432
3912828190,3735817368,1666458905,1666459626,721,1732
3979352608,3362388538,1651030127,1651030336,209,923
3697338181,3264339209,1667711873,1667712817,944,1033
3104793032,3727544443,1653543769,1653544739,970,1332
3404317985,3366192341,1646344816,1646345209,393,2332
3190417421,3604456101,1645044648,1645045207,559,2270
3751588241,3073966897,1648144922,1648145466,544,1750
3626505512,3897421758,1664814334,1664814601,267,126
3683793217,3668471634,1646185079,1646185122,43,784
3359212197,3823637809,1664372080,1664372749,669,795
3688056726,3415145597,1656348178,1656348491,313,2280
3039972849,3456799118,1669744491,1669745230,739,2291
3282449988,3449125023,1648540388,1648541154,766,2404
3891850013,3135579253,1666295003,1666295395,392,1553
3415788314,3068161140,1650941082,1650941331,249,1651
3237697952,3551243497,1653267256,1653267918,662,2371
3170102962,3529898997,1655634143,1655635039,896,2005
3132207782,3632155506,1655077828,1655078221,393,2425
3818453534,3929887239,1660189782,1660189879,97,233
3927657297,3013484024,1642382397,1642382640,243,2340
3967372197,3933332705,1666886976,1666887480,504,2106
3135134317,3501786397,1652945972,1652946002,30,355
3222563704,3481149583,1647729054,1647729572,518,1528
3497271227,3888563902,1651762369,1651762546,177,2401
3988935369,3151436331,1658698575,1658699569,994,904
3457998128,3828196026,1665116646,1665116941,295,75
3175295329,3392569339,1667972200,1667972420,220,1872
3703548595,3795250558,1655948718,1655949477,759,565
3678340379,3285243887,1643686087,1643686665,578,1283
3827551944,3730266625,1659180947,1659181866,919,1209
3213397142,3284137438,1660622729,1660623111,382,2261
3271689881,3217375075,1662830805,1662831173,368,478
3656846834,3532270724,1659786009,1659786707,698,1301
3175196290,3627191763,1641032840,1641033192,352,1261
3983166385,3959783422,1651595662,1651596033,371,139
3537031182,3936659399,1658411136,1658411811,675,2290
3156452001,3749282990,1663101529,1663101538,9,1696
3129283198,3486061006,1648969591,1648969798,207,112
3116451556,3305480485,1669640174,1669640660,486,190
3827557826,3117230173,1658392376,1658393179,803,40
3832243899,3264345880,1651238464,1651239138,674,646
3020446596,3769868188,1663744516,1663744540,24,1359
3518202698,3875750764,1648669242,1648669646,404,1315
3503489321,3760930897,1648089771,1648090554,783,115
3211521816,3840422094,1657938535,1657938661,126,1872
3546782886,3945611603,1644380078,1644380341,263,2244
3224364206,3624103484,1645776738,1645777419,681,174
3854351732,3604762599,1654379634,1654380597,963,2119
3120737114,3136810446,1641867340,1641868269,929,93
3474572698,3478280943,1650220852,1650221130,278,1219
3473852885,3292797747,1651867513,1651867960,447,2183
3139376524,3011567148,1664287738,1664287782,44,2380
3057159511,3309922968,1654621781,1654622395,614,127
3930909418,3204508195,1641479688,1641479816,128,1538
3432059238,3469783180,1661150814,1661150861,47,129
3118502732,3064574238,1651957611,1651957682,71,808
3490044613,3520825972,1657618558,1657618839,281,1179
3342538148,3358571434,1651059228,1651059249,21,678
3950982431,3208346862,1644671799,1644672437,638,1709
3718710270,3106630738,1658035404,1658035726,322,2247
3356034290,3356028416,1657230537,1657231522,985,2429
3547278175,3508202949,1650673694,1650674282,588,2094
3504641910,3815605229,1663764133,1663764464,331,1786
3204912218,3050229164,1669386457,1669386735,278,239
3467401235,3715731774,1648650529,1648650959,430,2074
3563428558,3322663101,1656838998,1656839795,797,850
3741907389,3691474413,1657147762,1657148207,445,2038
3379285136,3093178960,1656013588,1656013703,115,1370
3371790369,3790406016,1642159652,1642159667,15,2021
3604461797,3709736172,1669045606,1669045874,268,1776
3278980230,3926200409,1649491523,1649492433,910,699
3416230781,3165807050,1658037296,1658038201,905,85
3566824993,3370779634,1646893990,1646894720,730,2467
3048405710,3801847517,1665421329,1665422241,912,1090
3875008839,3659158165,1648988331,1648988859,528,826
3145344208,3513399148,1655073226,1655073938,712,1428
3239020709,3745960708,1658676218,1658676474,256,12
3349030618,3623869570,1663463174,1663463326,152,119
3382133724,3382453510,1643264859,1643265816,957,2101
3474081200,3311529434,1655917533,1655918022,489,1095
3641041716,3443297756,1667791392,1667792284,892,726
3651058536,3089844622,1654233096,1654233926,830,1771
3526315797,3351216955,1660962545,1660963253,708,875
3447447895,3380928920,1665610404,1665611029,625,1319
3783992161,3830850007,1654128221,1654128580,359,1686
3293504206,3366609475,1644438638,1644439451,813,383
3899247202,3227446097,1669480512,1669481174,662,1443
3657391976,3429684538,1665025028,1665025832,804,1346
3104719783,3788034142,1650348996,1650349971,975,2113
3223412894,3334743610,1642824668,1642824702,34,2467
3128287586,3501866086,1652008367,1652008924,557,993
3661016961,3103404280,1644862705,1644863293,588,25
3239527114,3999180921,1666985530,1666985537,7,2405
3135405364,3526166184,1663816926,1663817700,774,690
3695161514,3452248216,1666487617,1666487710,93,2059
3674005769,3019657030,1654629013,1654629292,279,1948
3883846613,3063674428,1641298391,1641298401,10,25
3368630986,3497045946,1663749421,1663749576,155,2087
3569443529,3732840219,1650656554,1650657119,565,1285
3211003582,3853163109,1653833356,1653833953,597,1973
3023530031,3767508362,1642399844,1642400666,822,629
3637861848,3876344592,1668673189,1668673480,291,1129
3835922991,3625504025,1652830151,1652830576,425,949
3090179745,3687938178,1666354752,1666354941,189,2390
3782878084,3640605424,1645252183,1645252249,66,2252
3797653596,3739595528,1653273388,1653273789,401,993
3675366639,3921261515,1660625542,1660626529,987,1786
3710043628,3625586912,1647829031,1647829523,492,1689
3968682824,3920327961,1656442447,1656442773,326,2085
3332797032,3929282989,1644511988,1644512626,638,1002
3082885404,3375769320,1644931115,1644931390,275,337
3095170532,3175498635,1647439071,1647439964,893,1469
3844666457,3612642563,1648397340,1648398064,724,1054
3347397074,3861247260,1646616083,1646616860,777,1331
3175118084,3957216784,1659639483,1659639911,428,1978
3828219822,3780182766,1656792138,1656792621,483,29
3061850950,3417532235,1662884881,1662885254,373,1153
3437221963,3347896915,1662010789,1662010993,204,1697
3991477345,3777568712,1662595819,1662596176,357,530
3271318708,3382159828,1649026457,1649027140,683,17
3857215319,3875750764,1643372841,1643373379,538,2436
3211064928,3054573274,1650675129,1650676101,972,869
3661016961,3787937000,1643685683,1643686672,989,825
3924865492,3850089310,1652863913,1652864094,181,1391
3335462055,3289684726,1644233255,1644233333,78,2123
3066750826,3126940487,1659858056,1659858810,754,538
3195504067,3094361527,1650185436,1650185960,524,212
3419117613,3494498890,1654874094,1654874337,243,680
3511397819,3621000186,1666341973,1666342317,344,1989
3413369567,3435252882,1667919051,1667919625,574,166
3819812955,3002350398,1664067899,1664068682,783,625
3261685435,3205162065,1645873119,1645873605,486,2136
3591290407,3363279084,1647606239,1647606264,25,2361
3573975424,3516140957,1649062630,1649063269,639,1503
3836597583,3965629952,1662947233,1662947961,728,1708
3972397754,3068239649,1655943097,1655943746,649,1497
3233282653,3302917137,1653788251,1653788574,323,2358
3329848036,3261447619,1664807954,1664808079,125,1537
3594471575,3452275962,1647186261,1647186831,570,2339
3169955779,3846323092,1646295106,1646295665,559,2308
3068242755,3109234948,1647442983,1647443064,81,2455
3638297718,3149191705,1641273737,1641274344,607,1234
3790896269,3619929187,1641041699,1641042280,581,2255
3389443435,3734576015,1662959143,1662959488,345,1569
3196009998,3348113823,1645873387,1645873720,333,155
3538039823,3779331078,1652761824,1652762186,362,151
3773207612,3993572792,1660753439,1660753819,380,217
3737504606,3682793223,1656107407,1656108220,813,1529
3262811174,3380930960,1643960116,1643960686,570,1199
3354200745,3287440691,1655007780,1655007895,115,357
3095728444,3610480358,1665180518,1665180848,330,47
3740009683,3191133743,1644175832,1644176342,510,474
3983694493,3692861248,1658365243,1658366183,940,887
3429052801,3548484912,1662473810,1662474560,750,2105
3790650118,3624662198,1648290370,1648290856,486,422
3442209140,3736085476,1664051541,1664052473,932,688
3480905975,3034750166,1649766841,1649767608,767,2115
3178837482,3282261851,1665552172,1665552412,240,1587
3876696308,3726367604,1659251941,1659252668,727,2026
3975405530,3399604947,1669222069,1669223048,979,2317
3889288487,3361694981,1659434004,1659434615,611,131
3680810431,3426433476,1648446624,1648446802,178,847
3881206954,3683246538,1644714026,1644714620,594,228
3917448920,3414719919,1651128013,1651128351,338,2067
3611139716,3021727735,1653204376,1653205202,826,990
3629942160,3183259139,1647290404,1647291345,941,1638
3598665921,3591724433,1658654269,1658654886,617,1421
3309305862,3184270447,1661060884,1661061348,464,169
3195504067,3281907019,1661748540,1661749374,834,2116
3669864539,3658423327,1646586758,1646587157,399,1157
3660839110,3546034581,1667226903,1667227101,198,11
3383686911,3216912897,1651695452,1651696236,784,738
3091008161,3056721560,1654222098,1654222385,287,1792
3171906034,3015593061,1641590726,1641590744,18,298
3279069375,3090731052,1648707269,1648707934,665,40
3227446097,3277284318,1650212738,1650213729,991,118
3431909978,3030290445,1664186423,1664187283,860,968
3228110844,3980207883,1657952507,1657952543,36,2159
3257203631,3015593061,1660373996,1660374563,567,1243
3430638959,3843157491,1652339585,1652339601,16,266
3414488975,3554409625,1641779557,1641780053,496,969
3394220993,3710769510,1660870821,1660871703,882,1047
3151704655,3107482740,1654754673,1654755148,475,1420
3436888201,3287175350,1644448347,1644449317,970,1002
3413514902,3941903445,1643888910,1643889029,119,1375
3224364206,3271182009,1667406063,1667406239,176,1438
3615359439,3742159503,1651752867,1651753329,462,1371
3010488834,3175118084,1663038588,1663039434,846,99
3734381035,3528439013,1642998402,1642998506,104,2086
3120949338,3017715856,1663022864,1663023037,173,1266
3680453323,3229448014,1647397752,1647398409,657,1954
3845980646,3402439234,1645962752,1645963300,548,402
3269726483,3822213532,1641137593,1641137599,6,285
3870032753,3563407459,1656240842,1656241626,784,1038
3542153652,3869293895,1647326932,1647327741,809,1357
3622997863,3880608911,1666263023,1666263495,472,539
3276846453,3429004715,1666242197,1666243174,977,1958
3409779636,3272250396,1653953949,1653954405,456,299
3768482482,3312805786,1652330430,1652331079,649,1876
3233536885,3349716508,1644112456,1644112678,222,2291
3266681677,3000725837,1659002021,1659002440,419,2236
3421078448,3838136289,1644774219,1644774279,60,1545
3343048708,3446914685,1644867515,1644867724,209,1225
3487756836,3908443461,1651861217,1651861266,49,2211
3173108957,3025333750,1650558209,1650559022,813,218
3899858422,3830303170,1648868853,1648869200,347,1857
3347679085,3801410751,1661726306,1661727129,823,919
3541060382,3332592315,1648512775,1648513491,716,193
3227951880,3152988371,1652896267,1652896280,13,1369
3207013037,3838774657,1653335121,1653335952,831,3
3035895563,3344177563,1653992786,1653993063,277,938
3710331536,3796784054,1647138002,1647138813,811,1278
3991673197,3116684420,1661652123,1661652930,807,647
3309286736,3401138486,1669107284,1669107538,254,1151
3356028416,3329618048,1649564153,1649564269,116,880
3127419046,3010767150,1664639198,1664639216,18,996
3995868243,3463800741,1661826661,1661827416,755,1062
3773488272,3283059949,1641470024,1641470807,783,2020
3750069283,3148763328,1643905210,1643905597,387,944
3553950534,3348620933,1663937283,1663938102,819,444
3152555864,3385846184,1664506203,1664506487,284,1936
3066588932,3492629459,1660035079,1660035144,65,2249
3363802434,3219509030,1664076649,1664077269,620,1708
3157821920,3126995401,1657061372,1657062082,710,1672
3887290680,3003861546,1646654437,1646654830,393,2108
3761269014,3795794957,1656680523,1656681029,506,2211
3623936873,3785222888,1659808068,1659808148,80,2433
3967255191,3205077454,1664745686,1664746388,702,74
3617545187,3281753784,1665829575,1665830185,610,2155
3665931760,3701979416,1663097912,1663098874,962,2293
3109234948,3807323401,1663015817,1663016096,279,1306
3540279517,3316485303,1667783050,1667783408,358,2061
3362647814,3785256634,1659259446,1659259895,449,163
3041897048,3495691991,1644094155,1644094719,564,2007
3776918350,3787550831,1660780531,1660780966,435,224
3281146609,3963257683,1659580261,1659580578,317,51
3112622637,3186584232,1656652324,1656652897,573,1881
3706027798,3371790369,1644037036,1644037799,763,740
3026701207,3285225403,1645408479,1645409143,664,2153
3414857456,3348278635,1661272890,1661273791,901,1884
3985159412,3476826459,1650478868,1650478971,103,362
3565128218,3871137970,1657825611,1657825712,101,191
3984467207,3406595083,1659832177,1659832570,393,2353
3825900664,3122144249,1651033887,1651034073,186,347
3868873330,3180252962,1656032584,1656033149,565,1081
3729820423,3683198772,1662958840,1662959117,277,1157
3256787088,3689680251,1654745158,1654745289,131,111
3409823179,3776942930,1656958857,1656959292,435,77
3840659531,3499091436,1668164708,1668164930,222,1289
3539839307,3447946570,1652984978,1652985085,107,1213
3050244048,3982268438,1649652905,1649652950,45,411
3398865388,3820070209,1642831705,1642832558,853,987
3482235012,3931294653,1642133204,1642133834,630,204
3062261092,3967439884,1648914736,1648914843,107,878
3552282443,3506733308,1664976375,1664977341,966,2040
3656448203,3983391279,1660172144,1660173143,999,1933
3085182687,3612460883,1643858364,1643858780,416,1777
3568289450,3095621927,1647688679,1647689447,768,1252
3071023164,3325842490,1664612039,1664612395,356,1154
3085676024,3563259493,1641176176,1641176704,528,718
3939480099,3929988329,1644011948,1644012255,307,1116
3400329831,3648975076,1646841502,1646842223,721,501
3886158471,3617453316,1668201173,1668202158,985,475
3935057012,3401597507,1652204022,1652204909,887,1032
3390134392,3198195956,1660335381,1660335620,239,393
3081370961,3703457098,1645759354,1645760100,746,356
3547358965,3701668957,1669323406,1669323761,355,953
3653335612,3204735172,1647380616,1647380861,245,1153
3953258545,3434650074,1643565083,1643566044,961,849
3543668840,3930565588,1644587635,1644587897,262,47
3939098308,3936179181,1666114277,1666114830,553,1988
3100176230,3746050591,1663172755,1663173187,432,1500
3562105236,3451299629,1668100166,1668100626,460,482
3872691076,3057090135,1642255505,1642256040,535,112
3812997079,3306934792,1659482240,1659482984,744,476
3415041326,3928044191,1655790681,1655791522,841,638
3533740602,3713116694,1664964271,1664965058,787,98
3048386186,3921560605,1651295855,1651296246,391,1053
3046006152,3805314214,1659117572,1659117912,340,536
3723944830,3693129961,1651164815,1651165153,338,1386
3255149739,3524482926,1654622203,1654622595,392,504
3285030317,3365381632,1641852125,1641852988,863,2083
3622596133,3010649870,1666263119,1666263729,610,1081
3706178319,3839695294,1648131356,1648132223,867,1216
3711048943,3546824914,1656646119,1656646865,746,1068
3173369021,3541060382,1658378399,1658378692,293,2491
3264018414,3619800237,1667986868,1667987681,813,1993
3450353368,3795342940,1659436586,1659436721,135,1939
3092360885,3771826410,1661359247,1661359643,396,2028
3051395031,3841170833,1665856534,1665857292,758,2017
3911671645,3351277781,1659615949,1659616610,661,456
3666174374,3217494787,1654554552,1654554834,282,1158
3017883382,3381692213,1641612062,1641612291,229,1901
3505761464,3875343154,1642551336,1642551602,266,2306
3928361511,3995299995,1666090145,1666090798,653,1208
3502947486,3531898771,1661440910,1661441240,330,479
3495919793,3628675820,1657967189,1657967707,518,2388
3267319115,3795990774,1668519923,1668520729,806,2424
3270923168,3803000258,1660742827,1660743355,528,778
3948946969,3636879699,1642090321,1642090480,159,451
3902705203,3081369661,1659130367,1659130515,148,551
3084969131,3625606853,1646716932,1646716991,59,923
3646596750,3832773624,1651628337,1651628377,40,2428
3716977635,3526088150,1641405475,1641406406,931,102
3326882521,3036527901,1652007586,1652008380,794,876
3050341848,3098667748,1645477997,1645478471,474,1470
3046617108,3604596822,1664298678,1664298741,63,316
3557400406,3468324129,1659125911,1659126342,431,1848
3819547274,3730845439,1667414832,1667415460,628,852
3856882586,3252421501,1648863678,1648864332,654,1384
3220405755,3446481380,1653483973,1653484464,491,418
3279538648,3291175188,1657189295,1657189477,182,1090
3036448305,3288834634,1657845066,1657845478,412,1646
3259260257,3113793993,1669127406,1669127667,261,2077
3405955824,3304523843,1641491763,1641492015,252,272
3361870766,3865511945,1657788261,1657788900,639,1552
3410513846,3833342718,1658560767,1658560960,193,568
3413320652,3183165788,1653390121,1653390359,238,1643
3169559952,3466473464,1661828290,1661828622,332,1711
3462280366,3099785790,1641321706,1641321708,2,794
3178529360,3804824307,1645947398,1645948339,941,1224
3847104925,3514894244,1659356446,1659356582,136,2053
3189300345,3269966376,1667650479,1667650995,516,1276
3574773588,3275436235,1666057625,1666058309,684,1657
3086575348,3725653558,1642358937,1642359472,535,1425
3467613173,3211064928,1646472907,1646473195,288,943
3800861252,3282079727,1669416320,1669416797,477,2221
3140608489,3266666808,1659924620,1659925289,669,2323
3164355501,3726520685,1641814693,1641814923,230,168
3643637605,3332506866,1644262923,1644263090,167,1292
3224952698,3762538736,1644738690,1644739215,525,1830
3834826280,3345733128,1645374522,1645374816,294,172
3603096470,3639117164,1669096202,1669096803,601,65
3536156667,3918988651,1658406236,1658407186,950,2499
3722301598,3793772897,1664605039,1664605969,930,87
3596567072,3310169810,1656199260,1656199423,163,870
3764318951,3094596605,1642005796,1642006260,464,2012
3586025172,3003872692,1648655583,1648655962,379,2410
3885555985,3356690610,1651382081,1651382822,741,2443
3046526062,3268182022,1653099166,1653100077,911,1391
3183299670,3959228076,1641043771,1641044435,664,1920
3014646091,3897739549,1653283247,1653283505,258,2320
3000780515,3207210781,1663945724,1663945889,165,1932
3712727713,3299211422,1656927385,1656927588,203,1399
3989206811,3902437090,1662300179,1662300573,394,1518
3428299424,3479385096,1650192214,1650192801,587,1432
3157212376,3798631691,1662261343,1662261527,184,1590
3668625909,3271759672,1664698664,1664698820,156,1724
3133788020,3649154395,1651582922,1651583805,883,583
3496040749,3447440058,1646435613,1646436497,884,1457
3953796727,3363768036,1657799736,1657800265,529,483
3252760026,3901579796,1655210994,1655211359,365,198
3988337484,3316855337,1654939455,1654940260,805,828
3649036403,3943836795,1647821524,1647821968,444,1541
3417532235,3337684100,1655149065,1655149224,159,648
3114863942,3891477592,1652263691,1652264003,312,1340
3856080546,3573583612,1643195122,1643196111,989,2246
3756778635,3616218859,1655256697,1655256794,97,2072
3183313787,3003422357,1660121791,1660122342,551,552
3200897172,3451285207,1661477423,1661477798,375,1299
3545730764,3574773588,1641963506,1641964263,757,1810
3081213963,3276118203,1648722525,1648723365,840,2372
3621416999,3719965258,1644787373,1644787658,285,152
3413111275,3651803323,1643997368,1643997538,170,824
3275649997,3835036552,1661273218,1661273461,243,1727
3898495918,3995365519,1646181096,1646181553,457,929
3886651871,3884802599,1644068161,1644068306,145,1013
3012930968,3639121807,1653326383,1653327177,794,2030
3957689713,3293387588,1667837163,1667837503,340,1478
3815236635,3784414098,1663015326,1663016101,775,2179
3071410684,3673735088,1665484532,1665485422,890,131
3771788181,3776027879,1661287212,1661287290,78,2063
3102027139,3196975901,1649063059,1649063737,678,598
3154288650,3222119601,1662370625,1662370825,200,1400
3933874233,3093523046,1646768409,1646768601,192,101
3875118670,3247959785,1643182107,1643182521,414,596
3627730665,3344637531,1667374666,1667375560,894,1643
3178529360,3796990042,1653852286,1653852957,671,2341
3149688689,3147896698,1664455246,1664456232,986,236
3808191596,3325842490,1644426032,1644426418,386,1717
3299607426,3687215472,1641575053,1641575134,81,780
3615848654,3099102864,1658624321,1658624747,426,1968
3065530519,3453552267,1657478433,1657479198,765,1121
3676690161,3722817789,1659457760,1659458579,819,2349
3735691730,3178749877,1641675298,1641675593,295,153
3475846394,3419430775,1667422129,1667422783,654,2256
3933607460,3446547180,1642023118,1642023623,505,1128
3350872529,3269294562,1645261692,1645261977,285,788
3074269946,3922385616,1657372531,1657372699,168,1738
3307251676,3749529134,1654233067,1654233801,734,1304
3618441418,3513368682,1667520222,1667521076,854,1509
3548484912,3148041041,1660734147,1660735103,956,636
3526630913,3761775611,1666028415,1666029244,829,1770
3918552618,3160906988,1657178103,1657178287,184,1154
3524315738,3721060604,1648567088,1648567420,332,697
3424254328,3834573240,1645054538,1645055048,510,741
3805665502,3788034142,1643688059,1643688097,38,752
3997038651,3490435539,1663003938,1663003944,6,1512
3763270952,3066892936,1641554983,1641555826,843,1871
3554680554,3936193189,1660057931,1660058565,634,905
3480314503,3003723782,1652475390,1652476195,805,2257
3386868280,3393552322,1641984771,1641985116,345,1828
3439510951,3060633640,1667023297,1667023541,244,1178
3989550849,3405373154,1643160393,1643161173,780,618
3446156273,3727995134,1649329763,1649330454,691,427
3053134032,3947879014,1647122588,1647123213,625,401
3493232103,3338882756,1654281911,1654282365,454,1634
3898391169,3768846820,1644964283,1644964605,322,624
3830330372,3307393195,1646628460,1646628466,6,2024
3565392717,3022283384,1653153323,1653153630,307,435
3112739600,3688196978,1661263862,1661264255,393,59
3322801895,3721870717,1662463958,1662464855,897,2476
3381769309,3438247915,1661354025,1661354841,816,579
3016283694,3698156103,1642298167,1642298626,459,577
3781446747,3788911315,1666581904,1666582386,482,1600
3058290794,3414328029,1650453839,1650454072,233,82
3298770258,3333223237,1665171800,1665171977,177,2469
3095503795,3639352799,1656821332,1656821408,76,2165
3244599174,3209097023,1641251700,1641252508,808,1390
3488813245,3592235229,1666571192,1666571271,79,374
3779998740,3197661010,1666401758,1666402695,937,917
3769269484,3266270844,1652771269,1652772069,800,1847
3276350975,3962211697,1651194220,1651195028,808,564
3775968124,3620395885,1648055897,1648056680,783,1944
3537943189,3879766152,1641814724,1641814796,72,1730
3868460834,3244997486,1656668705,1656669356,651,1781
3397987502,3327857419,1641749322,1641750211,889,506
3634936481,3711314965,1651468277,1651469114,837,2156
3617349707,3687691090,1665307191,1665308081,890,2283
3558281313,3206399216,1668499706,1668499921,215,96
3602340127,3034919553,1643936815,1643936995,180,1531
3011981503,3668552386,1667854588,1667855502,914,1622
3973948700,3451771672,1655259580,1655259817,237,1959
3885084129,3037279735,1652583967,1652584563,596,620
3264345880,3967255191,1654660882,1654661531,649,2393
3750474676,3324618357,1641623564,1641624372,808,1483
3001480546,3280630861,1666135525,1666135633,108,1989
3631732813,3680427036,1661580465,1661580971,506,1139
3312336013,3304490341,1645858476,1645859032,556,839
3987318292,3612612273,1650792297,1650793089,792,1195
3014185506,3160963185,1652383543,1652384450,907,950
3790883274,3293761762,1651576006,1651576915,909,1882
3565056457,3658513045,1661011813,1661011817,4,2393
3365094410,3142230569,1648589655,1648590409,754,1752
3435399012,3435253366,1650202381,1650202598,217,1657
3849379963,3026244912,1662954941,1662955780,839,1755
3009141852,3274985034,1648897776,1648898290,514,793
3915817603,3864133914,1665969068,1665969524,456,776
3395236647,3366321387,1643880002,1643880554,552,550
3657305306,3980108258,1653438812,1653439023,211,1924
3332721407,3070520574,1657880616,1657881376,760,787
3746872131,3661767118,1645926091,1645926638,547,1898
3946614568,3935383578,1658028454,1658028468,14,1491
3581216621,3398785571,1642648346,1642649216,870,1216
3065434950,3642318884,1657842142,1657842629,487,723
3835355277,3526197227,1662453187,1662453641,454,437
3466642935,3808022912,1648960738,1648961081,343,1868
3206243555,3334171572,1652842915,1652843334,419,496
3165807050,3901468403,1646590963,1646591728,765,1198
3343177837,3059322626,1663590147,1663590179,32,1193
3035158102,3986081370,1648441624,1648441694,70,621
3689232908,3293924278,1648551369,1648551903,534,1944
3243133485,3885926991,1661012536,1661012894,358,1942
3924141950,3815774397,1643620547,1643620736,189,350
3921962724,3939477257,1669144453,1669144588,135,1955
3193344217,3510660628,1648209690,1648210213,523,1418
3886521075,3084030782,1662911699,1662912075,376,1450
3760224151,3772853715,1642754089,1642754173,84,613
3415761431,3905969199,1658456030,1658456262,232,1687
3064461314,3696211720,1653735304,1653735597,293,717
3781368357,3989206811,1650121222,1650121389,167,818
3595560993,3639035607,1663621049,1663621167,118,1815
3667414511,3952252601,1653497792,1653498608,816,2210
3573826666,3127565673,1644079861,1644079880,19,2098
3795508879,3568097363,1644765222,1644765521,299,1613
3060893703,3987606604,1650808171,1650808557,386,1439
3917500425,3209462413,1669241485,1669241605,120,2086
3607717009,3524109178,1651425785,1651425802,17,1058
3573158941,3042120123,1645134508,1645134736,228,1170
3437109709,3900535275,1648820272,1648820876,604,1718
3776906254,3864414449,1659309613,1659310425,812,294
3428325312,3346530861,1641901183,1641902140,957,240
3254952204,3201142543,1655563664,1655564385,721,2371
3608201278,3695419353,1641843583,1641843864,281,696
3037844343,3402439234,1657185311,1657185442,131,1728
3106371588,3190003253,1669284046,1669284527,481,1458
3216092524,3453076338,1667210136,1667210885,749,2400
3476903669,3697822889,1666332742,1666333245,503,1387
3934386586,3501962027,1661639313,1661639515,202,1934
3680427036,3734533600,1651736479,1651736809,330,1312
3141392063,3734035973,1651657192,1651657338,146,673
3065216937,3050244048,1652954157,1652954990,833,2109
3888563902,3829597039,1662307338,1662308173,835,835
3308028752,3999128559,1644727229,1644728121,892,1273
3997353499,3706605056,1643184410,1643185022,612,1895
3067380299,3483670734,1656771193,1656771852,659,1666
3875118670,3168600862,1649003458,1649004218,760,2034
3277883706,3572896327,1660703756,1660704400,644,2197
3267089074,3034147055,1645270597,1645271141,544,1907
3325565610,3997215508,1642705170,1642705885,715,1342
3718731864,3106788261,1659828395,1659829166,771,640
3053005521,3914926954,1644768027,1644768399,372,1196
3795794957,3025014828,1641813241,1641813819,578,2155
3328737379,3345458354,1644477456,1644478088,632,1108
3420733881,3468455079,1657008309,1657008986,677,2440
3233507128,3777846262,1643168583,1643169565,982,899
3853163109,3414700083,1662340178,1662340944,766,2402
3012822525,3370867881,1659682589,1659683417,828,425
3759393612,3298748343,1658779186,1658779301,115,1651
3072276713,3404330776,1660560418,1660560814,396,2260
3179651539,3246900158,1656870585,1656871161,576,1897
3260783577,3212043381,1643273267,1643273282,15,1446
3481672220,3043604048,1668871306,1668871361,55,1521
3518583464,3012264999,1661191084,1661191270,186,2169
3480314503,3601562567,1656622770,1656623193,423,2130
3223094732,3431595099,1642720838,1642721131,293,845
3172619193,3046738951,1656525773,1656526265,492,577
3102251970,3879299283,1650368973,1650369935,962,618
3118518203,3577627752,1644604627,1644605232,605,1459
3034815361,3580774207,1656856485,1656857241,756,1393
3476283460,3108139225,1658836516,1658837108,592,2035
3284838720,3879182220,1652242033,1652242088,55,940
3019302226,3311015405,1641114045,1641114203,158,1151
3995412026,3564395523,1664536063,1664536214,151,328
3241425701,3774413169,1644679515,1644680032,517,2323
3941266037,3112859411,1668208672,1668208922,250,1754
3074412412,3450502369,1657698125,1657698553,428,2382
3023421632,3720934127,1661956518,1661957297,779,1417
3068296722,3199315199,1648343206,1648343606,400,263
3510634049,3605412707,1663983470,1663984019,549,2068
3615419444,3445558523,1650492243,1650492379,136,1332
3409949315,3169601604,1655135300,1655136014,714,1163
3278397100,3571972204,1665725172,1665725427,255,255
3617533561,3785725492,1657294171,1657294361,190,285
3670835955,3291780380,1666375164,1666375214,50,1139
3113516667,3362836351,1655300673,1655301318,645,2386
3774958505,3728631423,1658733553,1658734195,642,388
3205423909,3069841199,1659912554,1659913020,466,467
3978720869,3681993008,1642722803,1642722986,183,2033
3020683788,3403512366,1647173365,1647174111,746,1236
3982715838,3165208023,1646008722,1646008837,115,971
3468703620,3623351962,1665149265,1665149868,603,954
3691032308,3281562391,1661879930,1661880468,538,617
3543696190,3526793212,1649801837,1649802155,318,1946
3692772256,3191265442,1659826073,1659826947,874,2326
3177427428,3378221943,1665448706,1665449289,583,552
3522444883,3787920743,1661335180,1661335430,250,408
3419465829,3568097363,1663486887,1663487646,759,123
3875750764,3392213771,1668397058,1668397783,725,69
3938615588,3243873593,1666317136,1666317926,790,1611
3981778568,3182703869,1644961849,1644962335,486,1144
3657587705,3761142574,1650168353,1650169261,908,2035
3303719777,3441206388,1653365980,1653366639,659,1032
3249554278,3653577731,1647472946,1647473364,418,568
3267045921,3093146280,1666261425,1666261687,262,87
3828322397,3499541432,1661627481,1661627929,448,266
3429887771,3609043475,1656223649,1656223961,312,665
3491346910,3716626172,1651884562,1651885180,618,161
3771841105,3077145114,1662728814,1662729352,538,46
3656092578,3964524277,1652188750,1652189094,344,1235
3139198469,3027812492,1656521575,1656521908,333,1401
3572325072,3091595739,1644820103,1644821080,977,2440
3693453006,3104472516,1649048125,1649048562,437,1147
3552335293,3806664868,1648806122,1648806633,511,1937
3310970237,3050370620,1659134512,1659135317,805,157
3774916473,3225500469,1646902106,1646902659,553,1239
3176536531,3723700913,1642530154,1642530838,684,1635
3698521503,3540717336,1641301215,1641301402,187,1303
3530278315,3124051904,1666024751,1666025147,396,975
3994651874,3260036272,1659381196,1659381367,171,2218
3052822229,3056721560,1663212219,1663212630,411,7
3709788465,3750765878,1660661835,1660662483,648,927
3295518987,3993756491,1657616764,1657617513,749,197
3335242048,3258352640,1642950003,1642950678,675,1771
3905999483,3022594569,1641381937,1641382600,663,2151
3982210988,3315951327,1667376751,1667377558,807,2313
3756806050,3650471605,1665764369,1665764591,222,1110
3310582583,3655135775,1662406762,1662407554,792,1492
3355429456,3972441567,1643971589,1643972318,729,10
3089525434,3836331716,1650086484,1650086849,365,140
3121651540,3540735539,1655656145,1655657091,946,645
3477522732,3773505782,1659081045,1659081624,579,2090
3080829502,3793503160,1655513545,1655513667,122,305
3877811036,3297434061,1662868653,1662868722,69,2304
3359601528,3835378465,1661172785,1661172939,154,1630
3506273643,3775103844,1667821512,1667821549,37,722
3413810353,3194069746,1664197635,1664198342,707,658
3852253700,3277550058,1643622382,1643622660,278,872
3308001923,3749593178,1668095647,1668096031,384,2264
3260783577,3442854678,1663054351,1663054400,49,2241
3766062750,3855476133,1664480945,1664481311,366,2063
3264865965,3467211844,1657855186,1657855230,44,852
3276118203,3313295291,1667929336,1667929954,618,1557
3821180393,3868336757,1646829253,1646829721,468,300
3576425783,3635487786,1666985473,1666985817,344,1210
3686298420,3232128014,1656641741,1656642230,489,872
3102526783,3405346555,1661013611,1661013799,188,1612
3595284541,3028886204,1668281515,1668281588,73,1099
3310294122,3648447244,1654994216,1654995122,906,690
3382110972,3836855857,1669591452,1669591508,56,1917
3574708692,3264753140,1645978131,1645978145,14,1046
3984215552,3067220098,1663740528,1663741473,945,218
3518932161,3103728720,1665738152,1665739031,879,684
3580531210,3578616050,1649715869,1649716337,468,1375
3080679691,3622062401,1647623622,1647623751,129,1098
3213995449,3192472683,1662776252,1662777083,831,1087
3258102756,3557835284,1667340621,1667340928,307,1738
3313265862,3048388831,1667076601,1667076969,368,2428
3362298218,3896239645,1641241461,1641242010,549,393
3123302108,3004951157,1654356419,1654357158,739,1035
3285030317,3673892525,1658414231,1658414817,586,523
3913984749,3452773006,1657286333,1657287071,738,212
3519233850,3324395012,1658615775,1658615994,219,829
3424368056,3870458690,1648643880,1648644088,208,2263
3097596187,3303418943,1641605304,1641605950,646,957
3490155787,3492247995,1652653406,1652653787,381,346
3161234904,3982210988,1664232608,1664232962,354,2444
3265895976,3368420871,1644125178,1644125438,260,736
3469887287,3224792502,1653625341,1653626188,847,1268
3475612329,3908209550,1659900984,1659901908,924,912
3225068874,3564883937,1665443941,1665444848,907,368
3661037098,3125289160,1657967121,1657967195,74,1336
3918602291,3344553610,1656198795,1656199071,276,1703
3337624186,3011985525,1657662729,1657663015,286,238
3819380768,3197352308,1655213499,1655213934,435,1715
3807440065,3110639083,1656700338,1656701111,773,2348
3178235505,3329190028,1643882188,1643882482,294,948
3300479839,3835784338,1656803043,1656803535,492,841
3917662641,3441383531,1650810348,1650810574,226,165
3623685885,3291324812,1659891573,1659892466,893,1447
3929794333,3481548873,1662681701,1662682198,497,747
3960727778,3931229167,1664052866,1664053396,530,386
3605308632,3014275222,1659618011,1659618437,426,2189
3981846169,3710189327,1661175020,1661175822,802,2264
3124277484,3492638245,1667079368,1667080086,718,2330
3921754282,3423782681,1641958554,1641958886,332,1443
3610577318,3522549719,1645248131,1645248391,260,2441
3304589206,3058064037,1649754364,1649754612,248,1383
3968683220,3437983939,1667591616,1667592022,406,400
3348735740,3343855888,1643664042,1643664775,733,1357
3936122118,3848963466,1669376375,1669377037,662,1927
3642498039,3492034029,1658204302,1658204602,300,1914
3492034029,3922675517,1660827612,1660828215,603,1458
3489225147,3305480485,1669330348,1669330551,203,2290
3379935974,3501770020,1644563929,1644564804,875,846
3191133743,3558232376,1644473253,1644473808,555,622
3447257561,3075765827,1643931742,1643931877,135,226
3276341369,3773505782,1657428522,1657429023,501,567
3121651540,3428499342,1663752120,1663752447,327,445
3908007955,3691834770,1653395079,1653395917,838,599
3706605056,3501866086,1668771846,1668772196,350,571
3744645350,3788688228,1652348129,1652348189,60,850
3365134626,3400211756,1661228320,1661228955,635,40
3286555567,3213400022,1654629550,1654630373,823,938
3227246451,3511569871,1650290095,1650290984,889,1076
3534715157,3962045766,1658874902,1658875328,426,2497
3599551667,3985513037,1652092484,1652092698,214,2220
3526747987,3807323401,1659327456,1659328371,915,575
3432942151,3891518316,1653113258,1653113681,423,1921
3793967785,3870877628,1652579058,1652579524,466,172
3300983140,3168434098,1669758356,1669758589,233,637
3335063983,3646544919,1663250725,1663251672,947,1711
3577627752,3453552267,1659138075,1659138871,796,1483
3297434061,3839967647,1648090554,1648090891,337,2384
3255978821,3924799278,1659444915,1659445609,694,662
3241847877,3242897765,1656148968,1656149966,998,1195
3788911315,3849028830,1652286527,1652286839,312,913
3078830914,3617545187,1668223788,1668223853,65,1233
3219181477,3426899836,1669417896,1669418808,912,2098
3565287194,3355184225,1656305618,1656305900,282,862
3708426776,3608893234,1644165417,1644165495,78,2376
3209544947,3834160941,1657911248,1657911957,709,2327
3031816428,3246759301,1651063567,1651063989,422,2003
3679939578,3402578446,1647998326,1647998687,361,2422
3997162156,3631660076,1642072373,1642072779,406,475
3135579253,3661016961,1659700637,1659700703,66,300
3504446959,3029481461,1647966952,1647966989,37,2282
3150884811,3917240832,1645994362,1645994444,82,2359
3187982526,3429052801,1648550037,1648550802,765,1099
3510528970,3569244680,1666202343,1666202964,621,664
3884256882,3205418435,1648311380,1648311723,343,790
3544365476,3225328547,1649410512,1649411472,960,1478
3899890592,3124723265,1655481204,1655481767,563,1846
3146481001,3884551317,1654419664,1654420438,774,2160
3845130884,3978925529,1647886799,1647887608,809,1818
3896594746,3692095834,1646739237,1646739542,305,2341
3337684100,3086084685,1657649573,1657649695,122,695
3862583365,3046043182,1641203092,1641203816,724,262
3373566394,3700737923,1644324381,1644324641,260,1442
3770948247,3039198774,1657597636,1657597823,187,103
3892336923,3993572792,1644069631,1644069929,298,1977
3989208740,3885026939,1647438487,1647438547,60,2214
3057159511,3994388981,1650232335,1650233124,789,1606
3036194601,3829546967,1645358968,1645359078,110,313
3912183552,3068161140,1651280334,1651280779,445,835
3609562862,3061924533,1661348366,1661349273,907,406
3164122941,3911439857,1652938199,1652938920,721,228
3832275392,3581449963,1657291192,1657291618,426,286
3716257088,3238270210,1651051861,1651052289,428,668
3647295073,3851879278,1653587934,1653588722,788,1712
3313782821,3499994307,1665878300,1665878805,505,502
3948942044,3978987003,1648033236,1648033422,186,1633
3649442188,3006507589,1666155156,1666155188,32,562
3881000980,3619660501,1647546520,1647546680,160,2493
3034919553,3318654389,1668667021,1668667940,919,1325
3760432849,3034088160,1652315790,1652315938,148,1425
3729356619,3407778626,1667021755,1667022740,985,2126
3141198072,3003145369,1649815354,1649815902,548,1064
3629797745,3289330422,1642719353,1642719417,64,2164
3481584783,3445689630,1654747090,1654747903,813,2449
3100239217,3526088150,1653419153,1653419964,811,1732
3485644295,3883338335,1665880232,1665881155,923,142
3763317740,3196794099,1660828115,1660829011,896,1657
3332506866,3320187187,1649968571,1649969282,711,1396
3184608724,3243018622,1650928868,1650929109,241,2490
3945397961,3539571109,1663597038,1663597150,112,1787
3714259747,3097457183,1669221032,1669221363,331,222
3386628594,3813697780,1667019770,1667020515,745,194
3034643506,3796198742,1656078496,1656078861,365,26
3283922234,3998763119,1658429131,1658429195,64,1763
3891477592,3711710728,1658884144,1658885047,903,1403
3609664184,3059447105,1641972371,1641972463,92,954
3277883706,3883057669,1658436063,1658436961,898,1063
3928989640,3400434269,1650079795,1650079999,204,1320
3157765022,3316398180,1652142376,1652143302,926,1516
3691834770,3979926306,1657183034,1657183068,34,848
3095124554,3843347515,1643723972,1643724572,600,100
3102588374,3081188307,1653584128,1653584799,671,2435
3726892870,3976757440,1660313650,1660314472,822,2465
3145948160,3266270844,1662654663,1662655405,742,1818
3754631129,3426899836,1655295801,1655296441,640,751
3063520189,3128532251,1655007495,1655008003,508,1074
3414719919,3296556189,1668999766,1669000685,919,1381
3480984393,3031249180,1664527241,1664527290,49,1205
3900755896,3237563954,1659836955,1659837112,157,636
3556819852,3170985187,1655020050,1655020165,115,2304
3800451074,3815507952,1659928293,1659928543,250,498
3342215329,3332721407,1646267501,1646268046,545,1752
3901736828,3086583569,1660044685,1660044880,195,1648
3660551283,3852344377,1663108788,1663109786,998,646
3927657297,3308891574,1643836083,1643836802,719,1572
3407150254,3775968124,1656624251,1656624735,484,2383
3129641154,3779590261,1665105291,1665106078,787,726
3722301598,3820070209,1661460922,1661461162,240,1227
3838250910,3284630826,1642324409,1642325134,725,1012
3817513264,3744196402,1665723843,1665724306,463,950
3376742833,3598117343,1658784338,1658784364,26,309
3286424440,3029758309,1647746928,1647747277,349,548
3523508617,3628956600,1650394391,1650394519,128,883
3735946925,3171906034,1652246809,1652247494,685,1125
3030192990,3885719823,1644910439,1644910723,284,58
3230843282,3980207883,1646867731,1646868545,814,928
3194871172,3676100322,1648658056,1648658872,816,1220
3927666827,3266127117,1667777628,1667778523,895,644
3110339164,3793901427,1654195164,1654195195,31,465
3760142759,3873840731,1650714912,1650715629,717,68
3117322872,3939477257,1657472037,1657472207,170,2207
3415686543,3206549691,1658304938,1658305197,259,579
3583029647,3704120553,1642351497,1642351764,267,1385
3372438676,3769290304,1654889312,1654890166,854,1800
3381769309,3250584606,1644668045,1644669018,973,1809
3579921083,3313619618,1655663480,1655664356,876,1324
3644961840,3805665502,1667337160,1667337204,44,2431
3416521015,3276142713,1649835620,1649835881,261,1048
3539364028,3884704204,1646263459,1646263928,469,743
3478959759,3016508907,1664688389,1664689341,952,500
3825332100,3708034201,1651194127,1651194604,477,1677
3602955685,3916290714,1642548856,1642549038,182,1788
3085136451,3091008161,1665869319,1665870176,857,1734
3495147813,3066362135,1656616609,1656617573,964,1123
3586950573,3237841242,1642541107,1642541154,47,98
3848272906,3431082237,1657576694,1657576941,247,426
3121336226,3634885711,1661736604,1661736829,225,190
3951751770,3685473604,1655787928,1655788882,954,1256
3183340735,3278980230,1645021727,1645022256,529,122
3777835723,3560043638,1666311587,1666312489,902,1212
3406332128,3822917630,1641413318,1641413350,32,2221
3192375486,3034325039,1662194222,1662194426,204,2095
3095151362,3442194248,1666149191,1666149761,570,2310
3337684100,3692247556,1668592549,1668593229,680,480
3688133320,3617453316,1645409735,1645410162,427,5
3630982131,3084982671,1649541223,1649542176,953,1775
3720240255,3866541862,1643299958,1643300042,84,2233
3406357109,3119345546,1646798017,1646798026,9,902
3501729913,3755473771,1665597305,1665597562,257,1587
3124321462,3070640991,1657437975,1657438410,435,1831
3481308282,3089034472,1644607266,1644607695,429,1151
3149304177,3200897172,1669598021,1669598087,66,554
3284940142,3917662641,1665039352,1665040268,916,647
3824625919,3127616448,1662539913,1662540128,215,2050
3303025505,3842560828,1655620026,1655620899,873,1012
3838993248,3715994986,1656044570,1656044677,107,1730
3310499607,3831346903,1657454613,1657455450,837,2415
3215819425,3463734539,1658697179,1658697773,594,1244
3894036055,3478362234,1654878961,1654879092,131,62
3884067849,3060633640,1657648423,1657648791,368,588
3569443529,3249554278,1656666196,1656667105,909,2260
3737153063,3487547990,1654198625,1654198865,240,1438
3267360802,3137891271,1661840728,1661840993,265,1213
3267411650,3773996198,1652884534,1652885324,790,2200
3716246985,3962211697,1650048083,1650048320,237,1205
3725439899,3269956451,1667621611,1667622253,642,1814
3678720106,3839642166,1664658128,1664658546,418,1748
3586524207,3124384203,1652098240,1652099227,987,1276
3952389962,3043256301,1659074244,1659074614,370,596
3530462613,3698898645,1661194408,1661194974,566,1912
3319601888,3616890026,1666303802,1666304198,396,1385
3259260257,3425490548,1643887115,1643887452,337,2220
3801736024,3176653619,1660739806,1660740433,627,43
3473055855,3711100517,1657080157,1657081024,867,145
3752000675,3132959520,1651976948,1651977566,618,508
3118526217,3630318253,1665827045,1665827203,158,500
3596661503,3554680554,1659987854,1659988557,703,923
3096740365,3118976994,1666169593,1666170316,723,1943
3251372174,3192367201,1644321664,1644321745,81,1780
3703615574,3466642935,1649093333,1649093508,175,1453
3404959548,3686025670,1653564027,1653564843,816,1895
3434363944,3963303057,1644544679,1644545271,592,199
3945397961,3291175188,1652721029,1652721969,940,1211
3142454040,3978720869,1643994530,1643994562,32,2417
3489909547,3705217157,1642214302,1642214693,391,912
3759510872,3007308564,1654906024,1654906744,720,1285
3260085949,3835842311,1654988888,1654989741,853,2000
3721374677,3330548469,1661723612,1661724358,746,1096
3965137487,3278104266,1650920445,1650921329,884,1529
3295352365,3140682569,1664419127,1664420096,969,2300
3344394548,3060728062,1659140806,1659140904,98,2002
3966881800,3536128186,1652755624,1652756154,530,1733
3499281518,3685715658,1649607026,1649607043,17,1835
3814355412,3149602037,1663256363,1663256373,10,547
3965629952,3319365305,1659077830,1659078416,586,2213
3007702341,3798714576,1650928283,1650928761,478,171
3356332328,3294094629,1658097217,1658097512,295,1864
3752133167,3967147343,1657078090,1657078846,756,1372
3089325315,3183313787,1657472082,1657472334,252,2426
3235476099,3265571367,1651531170,1651531707,537,1084
3636572173,3928852706,1656085120,1656085924,804,44
3410513846,3614399988,1642612768,1642613262,494,2042
3038035861,3619660501,1656918162,1656918937,775,607
3829856490,3377473764,1651182418,1651182771,353,1918
3773434774,3012272703,1647586996,1647587959,963,1319
3995428703,3935125903,1665875252,1665875396,144,710
3864044700,3565052722,1655046770,1655046850,80,1717
3797930164,3406953156,1644629699,1644630217,518,1933
3806520351,3841660750,1648039068,1648039382,314,390
3482576542,3561562385,1649030725,1649031656,931,2079
3581026789,3500152600,1643011656,1643012396,740,1047
3499026312,3935259918,1654928043,1654928309,266,1118
3594707374,3892469874,1642207294,1642207863,569,368
3414370730,3730533080,1648334341,1648335209,868,2370
3439129317,3721395445,1656996519,1656997315,796,779
3398583773,3885458258,1661303807,1661304009,202,143
3197282936,3463734539,1669534662,1669535340,678,1136
3137594486,3596932196,1655610073,1655610735,662,1894
3461017113,3486262024,1659565121,1659565838,717,96
3235586138,3542832965,1647699491,1647700476,985,992
3682608460,3281369687,1644464081,1644464116,35,272
3828485006,3012602506,1642941683,1642941813,130,825
3264081641,3599795440,1648656064,1648656959,895,1614
3583859826,3145344208,1647352258,1647352855,597,835
3829593597,3534517997,1641556426,1641557366,940,3
3870475008,3049579265,1658503338,1658504332,994,2095
3583985803,3431614426,1658695606,1658696378,772,1943
3469437983,3697650296,1646056680,1646057566,886,652
3999788546,3066053770,1666320117,1666320956,839,2075
3537735224,3585989542,1653758719,1653759325,606,1518
3400114442,3025014828,1657188128,1657188224,96,2329
3637861848,3956500972,1666674046,1666674805,759,1262
3639695113,3940310287,1644225061,1644225316,255,787
3672059189,3710422072,1667672921,1667673913,992,39
3177370273,3008609242,1652125154,1652125204,50,1964
3912511626,3371026826,1665788062,1665788549,487,584
3063659192,3096386556,1651901648,1651902306,658,1250
3640915578,3712869836,1653936264,1653936658,394,1522
3319946083,3007339106,1661442633,1661443414,781,1966
3101410977,3980824960,1655668518,1655668994,476,747
3347462301,3977139394,1648669226,1648670088,862,943
3080325374,3277284318,1664461815,1664461872,57,1747
3900876329,3337624186,1666638397,1666638995,598,660
3929887239,3482826953,1643379765,1643380285,520,669
3036953061,3427520419,1661512758,1661513379,621,1654
3769198196,3688758916,1669344964,1669345264,300,475
3889288487,3280251149,1669429478,1669429541,63,1122
3590243603,3788034142,1659929862,1659930173,311,643
3718823049,3215402575,1649528177,1649528372,195,1833
3991087724,3599694754,1649997800,1649997825,25,748
3926467866,3505480563,1666845126,1666845603,477,1148
3737809844,3056982737,1665507761,1665507777,16,560
3488001885,3405388298,1660180156,1660180960,804,1198
3408978529,3707258240,1647262636,1647263410,774,2354
3291394293,3875008839,1663694547,1663695463,916,942
3944476586,3339048327,1659423687,1659424075,388,630
3030286864,3004517047,1646067134,1646067512,378,560
3817960208,3500735220,1646566804,1646567153,349,131
3624294521,3057314040,1641840946,1641841564,618,2364
3342215329,3938776287,1664244866,1664245708,842,1562
3451227417,3046190454,1645945597,1645945912,315,115
3686704798,3388628484,1663799456,1663800374,918,1324
3575715668,3617545187,1668335986,1668336156,170,183
3440372055,3678305236,1642460358,1642461341,983,1586
3297681098,3742344076,1669071924,1669072374,450,1618
3542824458,3061814600,1656966271,1656967268,997,1533
3910581173,3452181736,1666391963,1666392386,423,1502
3785586097,3328146266,1653783523,1653784344,821,515
3403389913,3883265629,1642666472,1642666907,435,1790
3022916032,3203734562,1659382488,1659382558,70,1581
3782730026,3254262388,1644590207,1644591059,852,1123
3955663201,3293615945,1665490587,1665491179,592,750
3919562972,3526747987,1660696709,1660697139,430,2352
3842738399,3231701470,1641574648,1641575512,864,2364
3177943874,3931277047,1661828097,1661828208,111,249
3270395343,3949445116,1655486433,1655487156,723,1254
3269502320,3020683788,1643398744,1643399327,583,1064
3753863307,3719146348,1668581700,1668582522,822,1451
3698906761,3469462520,1667289874,1667290414,540,2284
3031560160,3687617825,1664664942,1664665847,905,1262
3273059265,3706027798,1660141988,1660142561,573,2040
3968795612,3626824650,1667138158,1667138309,151,1990
3715994986,3760817382,1651315111,1651316092,981,1505
3956836647,3336965818,1659016484,1659016986,502,725
3308256167,3906772132,1652059286,1652059967,681,1581
3182982515,3094596605,1665164899,1665165212,313,95
3088553332,3024979152,1641130855,1641131077,222,875
3160061122,3699730203,1657833745,1657834237,492,2460
3758323845,3831770571,1657658295,1657658836,541,1389
3462744404,3963134791,1651890763,1651891752,989,1809
3050271924,3069225011,1660684062,1660684912,850,762
3888141694,3401611149,1667086269,1667086282,13,2200
3497507557,3792708367,1657663034,1657663089,55,1676
3405319002,3012892515,1645481450,1645481975,525,2327
3121932256,3457451540,1662517490,1662518093,603,78
3158503756,3127412666,1644924728,1644925576,848,1391
3038606123,3689828648,1643834232,1643834775,543,602
3682274097,3609601814,1664505067,1664505709,642,1602
3426565803,3255904598,1655031639,1655032541,902,2313
3769868188,3110339164,1655500831,1655501186,355,160
3341573446,3702302181,1644190614,1644191586,972,648
3003402470,3634539557,1654877438,1654877600,162,2454
3611777140,3011993360,1655568293,1655569161,868,1723
3688056726,3107366519,1659977322,1659977958,636,2276
3363733362,3039932020,1650058552,1650059065,513,1775
3782708820,3839788123,1651332742,1651332840,98,967
3801107936,3566936390,1654634347,1654635319,972,662
3510247235,3226234284,1654069383,1654069487,104,2143
3878943307,3190003253,1647259603,1647260593,990,1786
3094125203,3871137970,1663610186,1663611146,960,474
3242857629,3920028342,1665868023,1665868424,401,1318
3192612662,3686944200,1647709458,1647709556,98,675
3893018254,3680677416,1644775140,1644775577,437,2341
3629942160,3791302710,1657765527,1657766157,630,4
3565805050,3237339326,1655739047,1655739595,548,44
3660577882,3265655534,1653370604,1653370745,141,2452
3128514837,3539797487,1659356419,1659356952,533,395
3544133682,3816995343,1645497211,1645497459,248,2294
3005101248,3859976372,1641905737,1641906215,478,1382
3974318707,3420205343,1668116442,1668116963,521,687
3715231431,3098891437,1663037984,1663038585,601,1649
3462280366,3362796099,1664298539,1664298736,197,1172
3696205962,3605492251,1657948540,1657948751,211,1813
3888851378,3093131372,1655022952,1655023333,381,2326
3298993308,3504398546,1669399501,1669399658,157,93
3849379963,3814017798,1660358334,1660358451,117,1668
3994130271,3309684706,1668420399,1668420996,597,1636
3790406016,3476566118,1663498183,1663499106,923,131
3456602518,3637269987,1659856922,1659857016,94,1713
3265078616,3949713678,1653678137,1653678610,473,1035
3741929805,3829971179,1646391539,1646392290,751,1320
3010819705,3010546611,1660401984,1660402781,797,194
3086534991,3032834107,1644837715,1644838508,793,450
3125350196,3076570841,1654125272,1654125561,289,1720
3813403697,3029460549,1645347692,1645348021,329,1197
3244918124,3748492935,1651168097,1651168513,416,953
3097031283,3224792502,1663479201,1663480064,863,2028
3153446106,3947092814,1667367858,1667367990,132,935
3280251149,3602238630,1653681667,1653681851,184,1292
3277883706,3370701718,1641588863,1641589589,726,1633
3443297756,3910837040,1648194095,1648194990,895,168
3651058536,3604853226,1654048308,1654049048,740,556
3426433476,3997397652,1662326048,1662326713,665,2139
3375359100,3518322544,1660861546,1660861692,146,644
3624171160,3730368703,1658326354,1658326488,134,574
3060728062,3349718189,1642934577,1642934825,248,951
3823692648,3426433476,1666025576,1666025751,175,74
3967506765,3737809844,1660711505,1660711639,134,1054
3211401798,3173788210,1667366539,1667367244,705,1163
3883265629,3336947163,1652424314,1652424349,35,1714
3051903509,3736260750,1646336538,1646337460,922,1787
3787071341,3689232908,1642910278,1642910557,279,333
3270240132,3390329949,1647947319,1647947684,365,484
3449395269,3477243904,1661499949,1661500715,766,1444
3509582460,3028780744,1667666684,1667667225,541,1769
3743886187,3415145597,1658103194,1658104088,894,224
3187257156,3114277786,1660494519,1660494856,337,1465
3697028552,3207875764,1658597796,1658598600,804,1928
3333665805,3909309427,1667190358,1667191255,897,1964
3735691730,3971024525,1652803951,1652804279,328,1172
3780182766,3799776825,1653777912,1653778703,791,2288
3274452346,3797270025,1647248634,1647248822,188,1142
3545730764,3006388757,1668507772,1668508618,846,1514
3937758732,3548670552,1663007437,1663008320,883,247
3278703976,3630750697,1669008339,1669009296,957,497
3141689539,3173406646,1668501330,1668502074,744,1339
3162836777,3434662490,1669296854,1669297822,968,2133
3052279761,3122109326,1654353193,1654353956,763,1605
3471797400,3785256634,1655369164,1655369718,554,1345
3979522310,3510247235,1664927911,1664928268,357,200
3997177535,3374134461,1650973968,1650973972,4,269
3676634608,3778575442,1660436338,1660437027,689,708
3543105564,3016568360,1653218138,1653218408,270,887
3828503026,3060728062,1646579550,1646580029,479,2251
3757518149,3257594028,1654250711,1654251411,700,255
3058855369,3523045898,1657353521,1657354132,611,1958
3216665855,3819770312,1642445620,1642446324,704,1966
3243883781,3136448234,1663134253,1663134482,229,1074
3336494171,3224800126,1661484562,1661484680,118,1369
3129667560,3505789435,1646591032,1646591414,382,1340
3827122476,3377781677,1669554011,1669554957,946,194
3510281371,3146072606,1650884679,1650885486,807,1733
3888563902,3839688715,1668965741,1668965934,193,36
3795269127,3728878635,1661864194,1661864386,192,1367
3682006274,3074795505,1644545569,1644546253,684,1386
3265262512,3142101976,1658505630,1658505753,123,1891
3464595898,3375655129,1653106305,1653106865,560,30
3408300554,3605308632,1649701154,1649701946,792,138
3244763805,3205543673,1663010737,1663011342,605,1807
3785725492,3859379131,1649736482,1649736496,14,1713
3734367959,3279351366,1654693493,1654693726,233,1563
3604426149,3297123407,1665384311,1665384758,447,171
3367457506,3230775095,1662291801,1662291824,23,1078
3355429456,3454297726,1641930653,1641930777,124,1216
3146072606,3945633602,1664173712,1664173921,209,950
3579486534,3609664184,1665655196,1665655335,139,857
3051654064,3840764880,1651063455,1651064038,583,2488
3569557301,3681795615,1651153860,1651153982,122,2352
3546859493,3433835303,1652461189,1652461348,159,425
3283211870,3759986276,1644136099,1644136635,536,2145
3682910702,3184720975,1644383203,1644384179,976,326
3860268588,3447926518,1665370380,1665370693,313,23
3143189190,3157821920,1659721520,1659721590,70,2130
3848740333,3032123620,1662790203,1662790868,665,1488
3657380279,3881519714,1667323050,1667323256,206,225
3870574001,3277978979,1642606060,1642606817,757,1564
3417328370,3314932010,1642549925,1642550384,459,2092
3893828389,3802545642,1662117491,1662117624,133,1686
3042943074,3078500208,1653892800,1653893629,829,424
3658113721,3061619114,1642072354,1642072937,583,2113
3402878567,3961721758,1667882739,1667883234,495,1514
3482268698,3412673526,1661772129,1661772850,721,1251
3468586613,3288529545,1655922380,1655922845,465,1392
3634018428,3820070209,1648876946,1648877083,137,1613
3885719823,3250248786,1644431222,1644431446,224,2205
3442927979,3310520005,1661047997,1661048763,766,2076
3586489382,3196934109,1656895680,1656896309,629,1484
3915336029,3464770966,1667632370,1667632985,615,365
3569401888,3486793392,1653372463,1653372678,215,899
3177433990,3080195715,1663129604,1663129664,60,986
3266666808,3044390847,1651785917,1651786820,903,2237
3388628484,3347832946,1655563869,1655564107,238,1508
3057028614,3832370690,1666257634,1666257657,23,167
3978330638,3614399988,1645846260,1645846472,212,1408
3644951156,3364842162,1668058180,1668058762,582,1288
3935210171,3048045312,1653351257,1653351628,371,2278
3031249180,3158503756,1652814080,1652815013,933,2287
3855223575,3739613077,1658826920,1658827091,171,2233
3189759788,3324998923,1652300145,1652300160,15,2126
3769944434,3320179826,1660769991,1660770310,319,1965
3626552836,3774325139,1646081973,1646082408,435,598
3260861147,3787298788,1655187609,1655188404,795,1101
3641666820,3766966794,1649927430,1649927982,552,699
3504457520,3159900056,1641675649,1641676317,668,2208
3373684030,3996963058,1645943706,1645944689,983,724
3048497124,3520344153,1646552929,1646553258,329,930
3863676573,3979926306,1652735404,1652735483,79,2493
3838250910,3927284839,1664750334,1664750967,633,157
3442194248,3647295073,1651734083,1651734134,51,2044
3084060274,3947521897,1655426585,1655426973,388,2496
3586770678,3370966526,1653866951,1653866990,39,2403
3208464348,3201479561,1656129956,1656130102,146,2407
3151346211,3150884811,1665829066,1665829354,288,1251
3474402148,3809387134,1661365040,1661365062,22,2103
3323797477,3844416504,1648614941,1648614955,14,1232
3952425376,3978330638,1657485823,1657486679,856,2285
3368884196,3582060994,1649431778,1649431951,173,1582
3382943055,3380313835,1662341520,1662341892,372,2028
3215870665,3970286228,1660871661,1660872659,998,2446
3186897818,3980283928,1656536368,1656536710,342,1295
3801107936,3204508195,1641280038,1641280812,774,1172
3529898997,3849902434,1650760892,1650761471,579,2363
3456546904,3879520142,1667283306,1667283537,231,478
3540735539,3623206706,1642790083,1642790174,91,1710
3141048645,3625393284,1661668773,1661668910,137,830
3963546042,3744759130,1642509076,1642509628,552,1646
3278792522,3336376139,1653924303,1653924742,439,1661
3090910630,3216171635,1655838941,1655839284,343,712
3298748343,3284840023,1662927885,1662928321,436,1317
3706206403,3550677109,1648224581,1648225337,756,1330
3327873529,3028910693,1654032126,1654032771,645,1828
3408460871,3627730665,1660793966,1660794293,327,1637
3394936535,3385760763,1665082587,1665083129,542,923
3134380066,3282231108,1650440720,1650440809,89,1793
3929464797,3267107046,1646076759,1646076767,8,1445
3602238630,3993122275,1651724467,1651724700,233,2063
3969744786,3819172879,1641800234,1641801137,903,2392
3901126730,3646433612,1641387114,1641387988,874,1504
3806936803,3226234284,1660365443,1660365807,364,576
3154435614,3834174227,1667868773,1667869256,483,1219
3165423009,3994383813,1645361487,1645362261,774,1478
3285757325,3217047921,1641318102,1641318692,590,513
3456239535,3311303975,1648644207,1648644525,318,1902
3705919583,3055390520,1650516235,1650517022,787,219
3257947713,3820225206,1668835621,1668836201,580,1701
3117322872,3105250340,1655047083,1655047370,287,191
3202225412,3718684083,1667253061,1667253215,154,1604
3138801114,3382396122,1667370510,1667370595,85,658
3975504102,3985243519,1661337862,1661338526,664,845
3971020365,3288309878,1655070993,1655071782,789,432
3659771853,3355184225,1649820398,1649820867,469,994
3728419832,3909523201,1662944151,1662944358,207,1678
3144175285,3697650296,1643675719,1643676392,673,1989
3294783182,3018756378,1643672789,1643672809,20,1598
3231971396,3353956873,1641405905,1641406318,413,1814
3930852270,3655786063,1657200390,1657200850,460,581
3563259493,3815774397,1659768738,1659769241,503,2445
3675359399,3468922263,1644902575,1644903193,618,57
3839642166,3139376524,1669051563,1669052054,491,538
3584668339,3987732407,1666720661,1666721135,474,1701
3606270024,3062844769,1660564813,1660565719,906,1175
3013862518,3647597870,1646671172,1646671918,746,1039
3476403398,3904881288,1651342294,1651342408,114,2215
3175595669,3272428764,1641281349,1641281914,565,1422
3254930364,3398508681,1664885293,1664885816,523,1866
3657305306,3505270174,1663564656,1663565440,784,325
3867857893,3420137628,1644548738,1644549488,750,358
3612973191,3623206706,1656106236,1656106703,467,1676
3073762858,3003617799,1655291065,1655291202,137,1716
3903560788,3660891061,1655260241,1655260395,154,1583
3231501792,3824845857,1659019281,1659019742,461,741
3847104925,3623685885,1657572007,1657572582,575,1449
3306619417,3712332461,1660809701,1660809731,30,654
3293611774,3298042916,1647911719,1647912668,949,1363
3253913009,3816567987,1653961490,1653961642,152,237
3055644463,3035838196,1645498901,1645499403,502,1404
3163551629,3886368625,1647617865,1647618645,780,1382
3016871175,3322801895,1648104833,1648105565,732,486
3021320868,3608512295,1662087599,1662088387,788,1854
3271885744,3340366291,1646129745,1646130448,703,1798
3371790369,3379366812,1659834151,1659834285,134,67
3779299713,3114036217,1654593132,1654593533,401,1263
3716977635,3964434363,1665428003,1665428849,846,1103
3554822566,3622848449,1647755157,1647755282,125,1113
3998641184,3167058279,1658441571,1658442255,684,2460
3192612662,3565700391,1651261500,1651261589,89,1654
3707578213,3021218084,1657472005,1657472200,195,1153
3703881738,3069881077,1669491788,1669492634,846,968
3215870665,3213124781,1653240605,1653240774,169,1434
3938583443,3556033785,1658400005,1658400679,674,2114
3735098036,3211956216,1654340049,1654340891,842,966
3812997079,3772853715,1657469457,1657469475,18,524
3084940745,3167290048,1651957744,1651958298,554,879
3131735006,3367849829,1655704770,1655705552,782,1938
3695292102,3442244098,1656368029,1656368207,178,868
3458478056,3645341350,1665679217,1665679596,379,857
3742145726,3206149175,1651152995,1651153168,173,2111
3970917362,3008062664,1655588250,1655588403,153,1737
3046006152,3439120258,1658712505,1658713164,659,1154
3594682644,3506971803,1654421152,1654421307,155,1146
3449915970,3223463387,1666363695,1666363902,207,1442
3113427537,3300015174,1653647052,1653647398,346,695
3115303809,3205543673,1650317255,1650318186,931,221
3499091436,3365134626,1662077870,1662078849,979,302
3340511048,3960633649,1654269634,1654270321,687,322
3991686619,3395307809,1656469039,1656469308,269,1863
3348282881,3163986082,1667956207,1667956297,90,2296
3639618179,3509328343,1646344314,1646344392,78,309
3829084330,3344337283,1652972213,1652972338,125,281
3842413213,3002631535,1649288545,1649288575,30,507
3039081980,3648975076,1669205824,1669206771,947,597
3623685885,3400211665,1659509774,1659509849,75,1408
3138755786,3550820934,1645182580,1645182778,198,1490
3555272427,3992817916,1648064600,1648064758,158,2076
3467650879,3565052722,1666689669,1666690288,619,24
3945397961,3309219121,1650456842,1650457195,353,381
3493489568,3861764050,1647687624,1647687920,296,1009
3308877364,3500201376,1644878095,1644878302,207,1328
3376552382,3502587181,1669651591,1669652016,425,31
3647640857,3509167906,1669153950,1669154937,987,977
3905581902,3524131973,1652422872,1652423476,604,1903
3745532894,3003861871,1662084226,1662084238,12,1295
3807549475,3818453534,1641029030,1641029546,516,977
3302294195,3180062640,1649842474,1649843027,553,1905
3527269010,3158503756,1651945881,1651946215,334,1334
3793840002,3184669033,1667476817,1667476934,117,64
3200827648,3867398861,1655330331,1655330614,283,1195
3201446016,3562814356,1645541678,1645541797,119,2042
3811308890,3939480099,1642278878,1642279134,256,1327
3928354041,3590384867,1655238043,1655238333,290,986
3606111278,3980851662,1645983630,1645983961,331,739
3567368088,3941903445,1654382112,1654382999,887,1510
3939768853,3536421569,1642666791,1642667354,563,2489
3085136451,3888856112,1642799665,1642800184,519,972
3278190233,3735943539,1657182850,1657183558,708,861
3973050834,3619929187,1665831022,1665831800,778,514
3201276259,3355798436,1650599751,1650600453,702,1205
3759230876,3880620233,1664748246,1664748555,309,41
3898494020,3273379502,1665113167,1665113732,565,2105
3058846696,3194560289,1651605741,1651606670,929,534
3779236518,3866922475,1668179035,1668179262,227,1826
3610577318,3226280658,1656791194,1656791930,736,2280
3848740333,3331295538,1656806302,1656807125,823,711
3118533471,3436582780,1661727817,1661727929,112,2303
3024431618,3459830291,1662255918,1662256385,467,1259
3855261620,3295806447,1667545037,1667545870,833,2041
3892336923,3907713562,1659735631,1659735999,368,31
3617128437,3774264905,1648813545,1648814190,645,1425
3663342046,3697322167,1641547480,1641547772,292,752
3210136888,3784629786,1652588271,1652589075,804,1122
3571348230,3190969092,1660805084,1660805298,214,2254
3682028611,3648118736,1654600461,1654600477,16,1807
3272856923,3691062084,1642345421,1642345943,522,707
3817960208,3167290048,1651384236,1651384839,603,1565
3472375572,3303698845,1669395466,1669396109,643,122
3755962729,3200116756,1660141088,1660141939,851,2298
3922972838,3538863873,1666992942,1666993009,67,567
3057300178,3796559738,1659513991,1659514291,300,1268
3449915970,3082255761,1646820219,1646820989,770,1861
3710043628,3506345760,1664331397,1664332249,852,1480
3126499590,3374174584,1651767949,1651768283,334,2261
3265262512,3001603320,1648405177,1648405581,404,1202
3254367735,3725963743,1669666960,1669666961,1,2333
3735167946,3587727278,1661045031,1661045568,537,1763
3648263372,3375966339,1668165768,1668165789,21,1466
3598665921,3106395050,1665996704,1665996975,271,1902
3786811867,3276576100,1650262641,1650263447,806,667
3185985712,3829878263,1656053585,1656053921,336,471
3790783685,3938679223,1663109054,1663109413,359,1037
3759415017,3548545695,1659019503,1659019681,178,2411
3412109130,3932786032,1668675529,1668676203,674,418
3863948017,3729321195,1667662480,1667662784,304,656
3672194570,3481881323,1657997204,1657998140,936,46
3392121294,3134872743,1656093527,1656093910,383,793
3845511281,3203904444,1667873576,1667873624,48,1969
3616803531,3915206176,1665950140,1665951017,877,4
3799624292,3523465225,1667276800,1667277471,671,1313
3336657547,3883812439,1655461681,1655461807,126,1038
3528505546,3740728884,1645971239,1645971988,749,1962
3645585393,3682910702,1643497432,1643498343,911,658
3486802233,3481922555,1667807369,1667808152,783,1673
3664408598,3264434341,1663782686,1663783064,378,466
3525261242,3703615574,1645334277,1645334772,495,1225
3142899759,3922827209,1660752436,1660753198,762,1861
3318345517,3451370887,1644500533,1644500684,151,475
3797182963,3592520398,1650168440,1650168820,380,2401
3975405530,3461263871,1651067257,1651068158,901,200
3442447509,3183340735,1666862810,1666862968,158,64
3178981589,3416076001,1652683505,1652684269,764,1061
3609562862,3901736828,1646867996,1646868964,968,791
3787654868,3275223689,1659438153,1659438531,378,1309
3459188746,3184955498,1668106364,1668106804,440,744
3932786032,3061924533,1661827134,1661827233,99,2117
3393606099,3859976372,1644219149,1644219789,640,23
3907705988,3313192018,1665886491,1665887089,598,694
3149304177,3842560828,1649375042,1649375144,102,1162
3789380087,3139268488,1647554269,1647555269,1000,335
3179405209,3023448006,1648973299,1648973678,379,463
3595144575,3493424957,1656583555,1656583805,250,149
3098667748,3137092101,1668585905,1668586333,428,30
3196079047,3887743057,1650122925,1650123735,810,1764
3899585675,3953796727,1641075159,1641075806,647,2416
3224960669,3329825235,1647061336,1647062123,787,1104
3761587047,3365134626,1664312371,1664312625,254,2412
3611763388,3400121632,1658921501,1658922467,966,1053
3152933136,3102672864,1647644505,1647644549,44,2129
3099559880,3247551122,1658479044,1658479223,179,70
3089548621,3719884534,1654516490,1654517311,821,121
3696184358,3875483766,1648963043,1648963623,580,1527
3749282990,3262645455,1651428530,1651428723,193,1663
3143962586,3372544937,1660337332,1660337861,529,351
3962536480,3702178313,1643834422,1643834573,151,1631
3207389119,3481881323,1653941412,1653942198,786,1494
3109980927,3366558556,1669661069,1669661844,775,1397
3791460437,3733440098,1653646936,1653647137,201,1146
3595270507,3544772636,1657612803,1657613769,966,2206
3744575844,3673892525,1661143462,1661143856,394,294
3391037775,3453839667,1657426320,1657427081,761,1581
3649724545,3869495480,1651336424,1651336919,495,2154
3629942160,3945611603,1666621519,1666622460,941,1976
3823692648,3035803277,1652181853,1652182099,246,1054
3866534454,3997541339,1641542611,1641542619,8,1259
3135665687,3019761756,1664243154,1664243668,514,922
3956547336,3452683650,1655576512,1655577147,635,50
3366410496,3426585956,1665266408,1665266490,82,1347
3250359001,3757518149,1654188994,1654189980,986,1703
3168329235,3028679133,1667208208,1667209122,914,1591
3927284839,3106630738,1654780771,1654780881,110,841
3025223556,3052889118,1668215298,1668215708,410,1964
3798597128,3319037937,1659781407,1659781517,110,1008
3016871175,3223154180,1657128713,1657128871,158,1930
3117234289,3306290309,1659581518,1659581794,276,821
3202161567,3941642636,1666060140,1666060559,419,1208
3443773400,3166517941,1641905313,1641905758,445,216
3707676798,3688196978,1650602027,1650602969,942,815
3982715838,3865200739,1652861005,1652861829,824,632
3719763865,3872444916,1641067575,1641068130,555,871
3389926670,3200795190,1647668422,1647669088,666,738
3171214894,3442779071,1641067563,1641067923,360,913
3293924278,3937628057,1662248562,1662248826,264,1588
3903550568,3728974462,1659574309,1659575019,710,234
3800566657,3060310842,1652148785,1652149649,864,314
3260306978,3360051725,1667056515,1667057384,869,1319
3285381118,3730533080,1652217674,1652217735,61,467
3629942160,3551771231,1650423059,1650423339,280,924
3429010148,3055644463,1663093278,1663093591,313,204
3115344578,3134436515,1665675317,1665676204,887,265
3474216203,3444809495,1656393293,1656393307,14,1956
3250852254,3814608487,1641401950,1641402551,601,2270
3178749877,3889126069,1643069371,1643070204,833,1377
3260867614,3562021711,1657114893,1657114934,41,1229
3551371020,3253059691,1664876959,1664877500,541,2197
3097596187,3924583665,1665947392,1665947535,143,1684
3320065223,3728498046,1650890537,1650891439,902,1576
3834954155,3206422081,1647903791,1647903937,146,1368
3663871563,3478219461,1667476933,1667477427,494,1804
3521160717,3885849262,1645321780,1645321881,101,1785
3670154961,3794575914,1647344864,1647345779,915,391
3701151902,3022388087,1658517546,1658517597,51,762
3131930167,3148259657,1665549291,1665550199,908,453
3002931773,3883537438,1642434747,1642435728,981,1945
3679533416,3998200859,1645709931,1645710439,508,887
3038644033,3287175350,1653474388,1653475059,671,2136
3555571916,3819468348,1641190742,1641191297,555,848
3128318593,3543239972,1663053627,1663053869,242,2245
3548670552,3168600862,1661559117,1661560054,937,1210
3163708045,3417248496,1645924942,1645925403,461,1830
3725117905,3766966794,1653157288,1653157685,397,2420
3090179745,3804328787,1668096292,1668096980,688,2178
3877483900,3964637208,1653348824,1653349076,252,1993
3790883274,3948969420,1646039785,1646040459,674,2226
3950433378,3398735443,1643555708,1643555749,41,1983
3360436723,3628034615,1661397613,1661397976,363,2201
3778894897,3711490719,1652802765,1652803059,294,529
3199255829,3258050916,1655568540,1655568625,85,1497
3331336589,3413369567,1663604657,1663605509,852,1096
3997758248,3645850762,1659744257,1659744812,555,35
3218798966,3672693214,1648933729,1648934715,986,1847
3576100130,3172305265,1651040025,1651040045,20,1477
3423593448,3608200385,1663775254,1663776062,808,84
3470049551,3516107650,1668604377,1668605360,983,597
3449136061,3750949753,1655137827,1655138179,352,122
3459188746,3228794031,1653981465,1653982144,679,1149
3639090741,3663985085,1646267364,1646267762,398,1652
3663228098,3290800332,1642425025,1642425377,352,241
3653218860,3934914335,1641948743,1641949098,355,46
3878695242,3005854023,1653450320,1653450422,102,2064
3446156273,3351786927,1666277835,1666278711,876,1851
3464770966,3297684978,1649476343,1649477139,796,62
3628927796,3029374380,1661823223,1661823741,518,872
3361319934,3526327974,1645902813,1645903599,786,246
3005101248,3082108681,1657133620,1657133968,348,298
3764318951,3629797745,1651443356,1651444299,943,1715
3696432858,3052279761,1654981087,1654981243,156,748
3941317555,3649774117,1658197270,1658197614,344,1103
3665591394,3031299470,1652344790,1652345174,384,989
3864301593,3354200745,1665834042,1665834719,677,1584
3450893865,3224491185,1657335432,1657336330,898,2337
3840306405,3587171844,1651651089,1651651681,592,1152
3164410972,3271648296,1654351388,1654351441,53,1174
3809041613,3708809295,1649418561,1649418588,27,869
3817548425,3915206176,1669415319,1669415355,36,1091
3309799085,3863427189,1645982207,1645982995,788,1369
3799459873,3984818292,1657381404,1657381730,326,1288
3069675415,3008283469,1664550828,1664551291,463,368
3469524230,3603071341,1661239587,1661239831,244,2241
3113427537,3053166522,1653386887,1653387842,955,2278
3370120843,3778824939,1652191799,1652192180,381,127
3845334081,3619175296,1641517364,1641517472,108,58
3857400676,3696359426,1666538338,1666538752,414,1913
3365807352,3998209085,1648797717,1648798632,915,2217
3352634974,3277875103,1650428964,1650429764,800,1515
3217494787,3477522732,1653360175,1653361140,965,678
3707676798,3766193314,1663593520,1663593558,38,2211
3119702215,3504446959,1647473247,1647473563,316,1980
3294276727,3786322776,1661064822,1661065027,205,1922
3523305140,3256317082,1658961843,1658962059,216,62
3903550568,3341897848,1650905606,1650906272,666,2282
3148691436,3750474676,1642101427,1642101463,36,1032
3879605776,3347646218,1658653286,1658653384,98,819
3359896430,3515332061,1655920879,1655921377,498,2094
3332592315,3121762934,1658636662,1658637659,997,393
3048497124,3454851350,1655677679,1655678035,356,1318
3007911826,3945358150,1647694825,1647695099,274,913
3339048327,3987005983,1669201627,1669202482,855,388
3112314644,3086135849,1663682369,1663682640,271,2159
3242857629,3018013930,1668823037,1668823629,592,1209
3025135840,3150067482,1668308750,1668309300,550,1437
3371536214,3503510962,1669688140,1669688614,474,2481
3683134571,3261128374,1645186694,1645187277,583,557
3118526217,3324073911,1641674999,1641675813,814,227
3032834107,3143226144,1660677403,1660678305,902,1313
3668174777,3414581321,1642836417,1642837150,733,1786
3306290309,3462412055,1663462576,1663463172,596,1984
3430916751,3856467502,1653788807,1653789444,637,913
3719507293,3352316809,1651559308,1651559639,331,130
3106328456,3605699054,1665928290,1665928787,497,2288
3844966905,3237674968,1651628876,1651629101,225,1479
3458209928,3583918364,1649722604,1649723311,707,2498
3643132014,3236522609,1644713517,1644713997,480,743
3467686942,3439280560,1643557361,1643557450,89,1111
3840306405,3384222838,1661403976,1661404461,485,1152
3045070182,3249252169,1652939616,1652940052,436,215
3605519659,3927214415,1644216831,1644216989,158,296
3470404771,3458209928,1652477717,1652478057,340,2188
3102332016,3502217263,1667409957,1667410365,408,308
3074051284,3000780515,1652494712,1652495708,996,517
3693862073,3224715818,1651125680,1651125687,7,1747
3337845468,3883703576,1654949458,1654949664,206,2372
3680841490,3678452420,1664995414,1664995555,141,1311
3641372344,3837877764,1651900505,1651901239,734,846
3199411589,3103856643,1667549851,1667550456,605,2342
3986016860,3856474495,1655465546,1655466316,770,1092
3690646467,3146555014,1643659554,1643659758,204,108
3802890793,3211003582,1669552432,1669552474,42,1862
3826823415,3564839908,1663478270,1663479052,782,684
3137195290,3459115924,1655679037,1655679073,36,736
3454851350,3569329621,1663131236,1663131489,253,571
3816935536,3793117012,1655229565,1655229637,72,1612
3771616536,3654861844,1654521835,1654521906,71,953
3817579913,3622997863,1648342349,1648342842,493,1845
3533274758,3833692711,1661017242,1661017847,605,1886
3117262222,3310496626,1649064800,1649064986,186,978
3201276259,3526315797,1642559947,1642560238,291,2163
3142101976,3762856505,1642675026,1642675434,408,1494
3700737923,3364945349,1662658211,1662658842,631,98
3253545861,3079038995,1646827746,1646828072,326,1331
3638297718,3450353368,1649057384,1649057517,133,1076
3246044882,3623769570,1651691828,1651692170,342,921
3237339326,3937077335,1657554690,1657555009,319,1450
3514354263,3152988371,1646004607,1646004983,376,1310
3048405710,3414719919,1656688765,1656689564,799,1145
3945266221,3061362091,1656466329,1656467102,773,1170
3522549719,3541200701,1654846026,1654846537,511,1329
3814017798,3392213771,1665573074,1665573970,896,1782
3942965206,3797617787,1656404715,1656405480,765,2045
3546954605,3806652632,1647189313,1647189494,181,2268
3141503682,3643939596,1657776010,1657776855,845,840
3768099353,3847561511,1663791686,1663792545,859,414
3450353368,3616441586,1642620677,1642621479,802,1656
3279454391,3017484229,1664565370,1664565590,220,1442
3250108907,3431117217,1659378125,1659378129,4,1002
3468987116,3908007955,1663232370,1663233313,943,1988
3986311619,3247590827,1654116732,1654116791,59,428
3651753987,3940387270,1656404620,1656405437,817,1622
3024268753,3653577731,1666754720,1666755427,707,565
3815537815,3597794683,1643967844,1643967879,35,1411
3903321481,3799480079,1659135759,1659136397,638,1150
3399334455,3835112188,1649207200,1649207766,566,1506
3842738399,3716461226,1652137614,1652138498,884,1197
3143962586,3989741708,1641613633,1641613932,299,2421
3180534430,3489254440,1660048823,1660049429,606,2058
3644128961,3785586097,1667856755,1667856772,17,1145
3782673553,3627886263,1641770092,1641770920,828,1456
3957577990,3936029875,1641452230,1641452355,125,2493
3878177076,3806664868,1649613925,1649614299,374,1111
3321202962,3034142016,1664399711,1664400487,776,49
3819541125,3772035177,1660844858,1660845720,862,1807
3072347750,3702284586,1651440326,1651441031,705,1888
3003402470,3153750267,1657013824,1657014488,664,1716
3849977339,3542153652,1657641154,1657641640,486,817
3172293659,3144405714,1643484964,1643485114,150,216
3029053911,3187807330,1645553062,1645553712,650,2002
3247688800,3091709202,1645860693,1645861367,674,748
3967439884,3531842620,1656522717,1656523252,535,1246
3283171763,3553721378,1644190560,1644191482,922,651
3306838717,3268216928,1654048421,1654049169,748,837
3227652803,3125818794,1667640607,1667641247,640,991
3021679982,3731206373,1653351768,1653352164,396,1184
3585674939,3603965318,1657964909,1657964923,14,1908
3219181477,3034216304,1665749382,1665749889,507,35
3021679982,3257821708,1643850871,1643851064,193,426
3634044438,3320841904,1657404441,1657405283,842,841
3929307105,3593244627,1648541196,1648541960,764,2056
3474666564,3876696308,1653784941,1653785073,132,1596
3292739128,3135707503,1658563449,1658564414,965,132
3242912660,3072599295,1666727104,1666727645,541,1229
3365129722,3630744377,1641568263,1641568817,554,216
3173535458,3734534401,1662482253,1662482940,687,2462
3429684538,3890194122,1653173981,1653174976,995,784
3774724683,3592887882,1643790925,1643791291,366,1491
3264317816,3858911279,1652420319,1652420529,210,2153
3762571799,3965629952,1647586785,1647587087,302,961
3809773923,3670519908,1658503003,1658503849,846,1258
3367685887,3478502336,1660534411,1660535019,608,1967
3810823450,3192193744,1654306644,1654307615,971,1701
3349566530,3013314607,1648011270,1648011421,151,1303
3687239883,3833572466,1647305360,1647305620,260,454
3091579646,3316485303,1660257138,1660257682,544,619
3002971802,3252664436,1666431096,1666431142,46,1539
3981817077,3272428764,1659112202,1659113163,961,1589
3349030618,3321971009,1649199585,1649200428,843,16
3628963667,3854219185,1665492317,1665492419,102,1282
3912858275,3124574350,1648134298,1648134955,657,413
3594269515,3223463387,1668492140,1668492267,127,2164
3314953470,3000863237,1667117150,1667117985,835,95
3381060534,3885026939,1641409608,1641410363,755,1232
3190778281,3946306714,1646612099,1646612432,333,1874
3870349696,3713129998,1655652443,1655653411,968,1176
3823682564,3080007856,1646851902,1646852275,373,587
3761147252,3617757019,1663549812,1663550603,791,2292
3644100988,3693888320,1647724230,1647724914,684,403
3620817271,3215870665,1648716380,1648717221,841,830
3504398546,3802325069,1654495856,1654496455,599,1309
3560053389,3961601633,1647152631,1647153600,969,1035
3901026791,3599694754,1650319711,1650319871,160,180
3943221472,3534752391,1667729458,1667729517,59,604
3291641388,3292454121,1659917851,1659918529,678,2340
3366410496,3971391515,1663553568,1663554049,481,766
3721374677,3678149544,1657028350,1657028370,20,1399
3690350377,3830015015,1652280569,1652280909,340,1276
3949841652,3924960579,1650120458,1650120534,76,841
3354574342,3925239812,1658475038,1658475265,227,156
3994388981,3995850572,1666120436,1666120658,222,1696
3936292699,3410258020,1645742161,1645742543,382,454
3736911154,3631152825,1669179719,1669180316,597,1665
3672693214,3958275419,1666610471,1666611322,851,1895
3653770219,3505100409,1641999571,1642000266,695,1631
3219656369,3540735539,1654817489,1654817703,214,1520
3306457934,3424584896,1667879088,1667879247,159,1535
3327795374,3088132769,1652847112,1652847956,844,1135
3228518080,3607978764,1649431037,1649431678,641,1045
3217060058,3625869317,1662299747,1662299787,40,167
3883057669,3450817021,1642343378,1642343825,447,2459
3362812887,3718684083,1645674298,1645674711,413,1469
3424884440,3911621945,1645272184,1645273153,969,1059
3003243547,3689544534,1654328164,1654328405,241,1059
3537592483,3784594026,1668500633,1668501499,866,651
3572325072,3950982431,1664768590,1664768797,207,1813
3669789756,3946409673,1641386372,1641386649,277,1581
3664426298,3043604048,1656231429,1656231461,32,1907
3492909923,3635854686,1668895673,1668896354,681,518
3625869317,3491562484,1648508211,1648508469,258,531
3498441448,3149688689,1649368853,1649369810,957,417
3650431460,3254083367,1663844012,1663844931,919,1104
3039962870,3266751679,1669723657,1669724268,611,2030
3216540367,3404317985,1654245123,1654245750,627,143
3793344397,3596932196,1650824783,1650825088,305,1991
3468654589,3890161181,1667697734,1667697876,142,1864
3329449985,3552282443,1655136085,1655136701,616,1348
3404432145,3503489321,1648822951,1648823895,944,417
3555571916,3433261355,1663850449,1663850810,361,1719
3882415224,3562110382,1649912044,1649912268,224,580
3345138946,3656770582,1660070100,1660070282,182,1606
3293416862,3821299576,1644392266,1644392642,376,1136
3078628091,3784912315,1668761639,1668761977,338,1693
3928235124,3117816089,1669053634,1669053830,196,554
3480984393,3763723423,1660574454,1660574975,521,937
3873002836,3152438109,1641926849,1641927638,789,269
3867115890,3530491537,1662362838,1662363461,623,321
3432321849,3249252169,1649715020,1649715210,190,735
3209480732,3063715610,1668706011,1668706310,299,808
3149668198,3177851224,1642826781,1642827720,939,227
3653757569,3432186900,1658200438,1658201169,731,883
3198149459,3102251970,1661133443,1661134442,999,2218
3289153734,3160242179,1647615406,1647615855,449,2166
3592264904,3061462743,1656184112,1656184371,259,2043
3839610928,3278843111,1645235000,1645235346,346,2115
3237807880,3868215944,1641891367,1641892175,808,558
3745737102,3898012654,1644802978,1644803047,69,1345
3671830270,3048405710,1666177978,1666178321,343,325
3545150522,3596841713,1641307203,1641307719,516,228
3328015314,3779459643,1650994398,1650995395,997,1708
3867115890,3451285207,1660670467,1660671269,802,497
3424368056,3518079213,1641751424,1641752315,891,1329
3349724698,3407778626,1652062869,1652063632,763,1965
3882748527,3316625530,1653461357,1653461523,166,1156
3099649164,3880849800,1652068910,1652069909,999,115
3970444667,3998641184,1664846799,1664846821,22,1124
3700109325,3143324065,1652948917,1652949535,618,590
3105871139,3762744269,1644864957,1644865855,898,1728
3492629459,3511325003,1649350497,1649350989,492,969
3070404759,3251744109,1649429506,1649430426,920,1612
3678505160,3456948150,1658819259,1658819481,222,2267
3369731959,3009801123,1668986943,1668987413,470,2
3915637706,3629412022,1653923982,1653924104,122,2269
3531642816,3591290407,1655569464,1655569509,45,2193
3265181921,3288347905,1655271856,1655272564,708,507
3802592493,3302917137,1657377078,1657377715,637,8
3802749978,3487387362,1641834507,1641835042,535,1774
3391118279,3063566522,1664390599,1664390711,112,27
3543732655,3710681792,1658997462,1658998195,733,2006
3875434702,3107541952,1660239093,1660239336,243,823
3434833146,3799459873,1664808523,1664809240,717,1738
3696096099,3910846571,1647501531,1647501560,29,1811
3801038758,3930852270,1642958746,1642959292,546,124
3097489594,3867857893,1647320885,1647321731,846,2063
3376579544,3982058383,1662895910,1662896807,897,1426
3058834310,3883497013,1646704351,1646704606,255,912
3385603289,3934326645,1657391075,1657391193,118,800
3899247202,3127412666,1668945502,1668945730,228,844
3961140276,3695161514,1652305346,1652305423,77,130
3190969092,3797237179,1653020518,1653021105,587,1773
3422046745,3814620482,1651919836,1651920256,420,1226
3460027343,3592487083,1659834377,1659834665,288,2168
3391622565,3327504995,1647146595,1647147322,727,461
3581216621,3669864539,1648163609,1648164182,573,1230
3029053911,3284630826,1647758125,1647758785,660,2487
3520511256,3335210480,1647014206,1647014674,468,2266
3132594209,3368860003,1650966598,1650966714,116,1099
3517631415,3559696066,1644889649,1644890328,679,2484
3915986965,3643637605,1667877100,1667877401,301,2348
3165929307,3865947139,1658426456,1658427365,909,748
3128133737,3640605424,1663987631,1663988071,440,2393
3526793212,3920875021,1661662886,1661663116,230,1517
3412675211,3009169806,1665606388,1665606905,517,1131
3914601322,3194069746,1642155631,1642155960,329,655
3511569871,3678149544,1644366677,1644366906,229,1827
3387247558,3890448806,1664018636,1664018695,59,1747
3179855785,3309219121,1642684031,1642684245,214,266
3487526777,3939098308,1654597880,1654598794,914,355
3751560053,3260036272,1655349510,1655350489,979,2448
3199375921,3821768923,1660128900,1660129045,145,468
3795990774,3597403559,1644503572,1644503802,230,618
3414488975,3594903436,1643718559,1643718820,261,1971
3909330778,3026209549,1658748651,1658749605,954,8
3733821292,3128248749,1659233299,1659234288,989,839
3422703729,3027287663,1664850238,1664850377,139,2432
3772853715,3663884600,1652263243,1652263352,109,1704
3773627036,3412715210,1666493333,1666493875,542,2306
3929774793,3205153391,1668826408,1668826423,15,2079
3741413739,3236819846,1654767614,1654767957,343,2033
3909168020,3310953839,1655433826,1655434790,964,11
3456602518,3737153063,1669500427,1669500888,461,2340
3345875910,3212218759,1646615203,1646615708,505,1576
3945633602,3837065973,1664470129,1664470690,561,1694
3066750826,3022388087,1649742859,1649743742,883,187
3329135548,3055020688,1666500336,1666500635,299,991
3295316821,3847297747,1648999905,1649000530,625,122
3711576021,3611657912,1650114232,1650115035,803,1211
3275810322,3400114442,1646023335,1646024063,728,2273
3011458038,3401568650,1658816167,1658817105,938,1373
3462280366,3580310329,1646277041,1646277609,568,792
3643730317,3907635993,1645046113,1645046599,486,2153
3858911279,3840659531,1642380400,1642380665,265,2396
3860268588,3891518316,1658052286,1658052694,408,639
3301994647,3061982327,1646883368,1646884082,714,2375
3486208738,3576961863,1649218445,1649218813,368,2447
3840558415,3934953223,1666908025,1666908909,884,1988
3337684100,3105648731,1649393910,1649394783,873,1126
3082828436,3196403466,1651322520,1651322980,460,1676
3474543664,3948710872,1660056431,1660057102,671,399
3503011690,3636132038,1654680449,1654680806,357,705
3074886612,3524545245,1644058619,1644059012,393,895
3021287506,3162405135,1667965075,1667965764,689,1720
3185785923,3365939940,1658244933,1658245228,295,2313
3012032774,3485801867,1650318202,1650318512,310,219
3029451399,3595713931,1664501629,1664501796,167,2115
3463405011,3352634974,1658402257,1658403027,770,1277
3700813458,3974481828,1644449229,1644449662,433,2492
3999228111,3712195438,1648884370,1648884391,21,108
3404330776,3725611236,1653463313,1653463428,115,126
3809965750,3898603481,1668656295,1668656434,139,1263
3387785849,3309242036,1668244651,1668245585,934,2283
3190859932,3097016405,1664607796,1664608473,677,1334
3387785849,3205282165,1655884453,1655884845,392,2172
3904012023,3532756620,1668530540,1668530709,169,453
3090804084,3638822670,1648952255,1648952524,269,1745
3120490643,3176818286,1643603600,1643604318,718,6
3437259542,3112960048,1649276371,1649277311,940,391
3566347637,3309106486,1667667575,1667667954,379,1868
3247980767,3358194777,1641772416,1641773306,890,579
3646687421,3818353360,1646984545,1646985215,670,483
3034014975,3450503481,1641226673,1641226922,249,218
3309242036,3612460883,1663943921,1663944280,359,1984
3324394622,3568756567,1657376913,1657377528,615,2166
3686826205,3637518238,1652498735,1652499219,484,2159
3728950700,3570480973,1663296029,1663296089,60,189
3272912522,3939948508,1644924473,1644925207,734,1300
3719084637,3793232281,1667351612,1667351953,341,449
3003022656,3221276652,1667174306,1667174641,335,623
3729820423,3675703241,1669123005,1669123886,881,1875
3271648296,3466473464,1650395653,1650395748,95,2000
3817668840,3118754726,1646037365,1646038086,721,1244
3639117164,3257449240,1663497584,1663497625,41,1046
3474543664,3302992244,1657601233,1657601488,255,453
3527067023,3046006152,1653766039,1653766490,451,512
3103421893,3561254848,1666019035,1666019562,527,1583
3728950700,3393501277,1653678104,1653678454,350,380
3082255761,3899782287,1645413575,1645414516,941,1236
3556000533,3758849561,1658578247,1658578432,185,959
3831346903,3418988797,1649449414,1649450286,872,1746
3384200089,3501520918,1653410797,1653411795,998,537
3923980052,3383755219,1643276280,1643277261,981,212
3086084685,3239162274,1644040483,1644040619,136,1123
3404043594,3764078507,1663241388,1663242338,950,417
3505761464,3938949913,1647611659,1647612446,787,620
3356302136,3582033850,1663480732,1663481105,373,1120
3922341165,3182765580,1663151771,1663151823,52,849
3666782310,3141689539,1649928527,1649928554,27,698
3553712893,3969355995,1649978812,1649979751,939,2180
3240037909,3628963667,1650929183,1650929713,530,1055
3087278716,3827867076,1642066974,1642067697,723,2044
3732456028,3944247629,1664767755,1664768059,304,876
3976055046,3060727793,1650721159,1650721189,30,646
3618441418,3894844173,1655405187,1655405496,309,1885
3111163302,3727544443,1652644610,1652644883,273,931
3193991721,3020683788,1663860788,1663861084,296,388
3412715210,3903947013,1646520793,1646521559,766,173
3674349184,3566347637,1647363940,1647364768,828,2296
3627981146,3280251149,1656645815,1656645886,71,884
3477827867,3510936211,1665297245,1665297751,506,926
3824517920,3740090157,1651048351,1651049039,688,344
3096076350,3671907089,1643353070,1643353629,559,633
3468586613,3901902653,1642860649,1642861060,411,2194
3635624917,3737400101,1660899108,1660899481,373,2289
3047629830,3068161140,1642095773,1642095879,106,1835
3691317999,3084969131,1647055286,1647055709,423,48
3452843457,3218117875,1643530958,1643531873,915,655
3293615945,3210080881,1650067917,1650068802,885,1025
3945611603,3502316165,1654931967,1654932197,230,922
3279671068,3368294774,1649333317,1649333599,282,1868
3998329857,3603092087,1659645564,1659646150,586,933
3745960708,3817252660,1644659952,1644660367,415,1468
3247590827,3069675415,1661936033,1661936391,358,2475
3948710872,3017758671,1661749825,1661750265,440,467
3738835445,3088553332,1668055387,1668055971,584,2070
3904546701,3035992910,1668630871,1668631575,704,428
3636619501,3971180079,1649457963,1649458156,193,1788
3605492251,3088587729,1662026862,1662027152,290,1583
3696947299,3695692085,1655071152,1655071180,28,1335
3228574805,3829971179,1648896777,1648897479,702,1469
3673549679,3145669202,1662826811,1662826973,162,428
3103856643,3504893701,1669006899,1669007410,511,270
3545730764,3056053831,1647547523,1647548466,943,2379
3122127756,3268216928,1663705067,1663705515,448,1265
3883057669,3752297066,1666263114,1666263668,554,476
3494680258,3469783180,1643849140,1643850049,909,1842
3996933937,3480523769,1658337687,1658337724,37,1905
3285303154,3284832227,1668141530,1668142034,504,2243
3666380447,3985326073,1659121359,1659122192,833,1394
3154680228,3393458100,1664464281,1664464592,311,2041
3206399216,3113251460,1645694808,1645695568,760,1076
3025611145,3693691265,1659967449,1659967586,137,1320
3175118084,3262543891,1644312677,1644313098,421,232
3315593278,3978893578,1643445943,1643446696,753,1674
3866215730,3404008086,1656135258,1656136236,978,871
3245723038,3994721189,1663177027,1663177821,794,2021
3196009998,3195716414,1642959407,1642959694,287,611
3354055639,3981019442,1658895262,1658895864,602,2399
3419751912,3205988899,1644437877,1644438518,641,1417
3030641135,3509167906,1662311333,1662312191,858,395
3705943924,3579642249,1652196351,1652196535,184,181
3153552268,3776429592,1660678315,1660678910,595,83
3426491499,3995270744,1661492535,1661493173,638,2320
3125900419,3098264219,1655235104,1655235612,508,210
3093773162,3828833040,1657006732,1657007428,696,2087
3502217263,3719785520,1667074009,1667074946,937,1041
3653030573,3855261620,1641043218,1641043507,289,1644
3335275571,3539402223,1650323293,1650324023,730,1232
3887036201,3311529434,1656966067,1656966746,679,386
3310542239,3678336055,1666498698,1666499632,934,232
3401738714,3188680599,1662052859,1662053787,928,1705
3675341264,3945943527,1643235118,1643235290,172,1207
3096471933,3156483651,1665681028,1665681512,484,1636
3443161524,3271689881,1661243333,1661243915,582,1897
3510416134,3124941982,1655816974,1655817499,525,680
3208215579,3331255997,1645040213,1645040804,591,300
3506585658,3866836302,1654096379,1654097114,735,2210
3577651077,3402155812,1645547574,1645547670,96,2059
3447407380,3327504995,1652997096,1652997605,509,969
3464235741,3416719967,1650259941,1650260334,393,2219
3284159385,3646536668,1664228091,1664229071,980,483
3663038239,3457191473,1656835474,1656835643,169,169
3901616267,3774325139,1656930794,1656931325,531,2282
3404563689,3736681866,1647021085,1647021437,352,2472
3150793263,3124723265,1647325625,1647325809,184,833
3728240849,3532634291,1652756611,1652757604,993,2298
3188468802,3651271289,1648263900,1648264748,848,630
3783325820,3333336166,1648377548,1648378280,732,2088
3324455158,3183507473,1667356470,1667357387,917,2330
3322226292,3891270072,1657666290,1657667237,947,990
3029500930,3167985603,1642410616,1642411421,805,419
3217137285,3579921083,1658735127,1658735736,609,350
3927646653,3806737055,1665614559,1665614869,310,2180
3211064928,3192367201,1663429185,1663429635,450,2461
3542615732,3942656665,1652954293,1652954713,420,1452
3374005704,3088602459,1649658228,1649659227,999,194
3718562533,3273827707,1645053795,1645053838,43,631
3225909236,3672070606,1667984310,1667985195,885,2479
3154309446,3024268753,1666615169,1666615489,320,56
3489811088,3651812819,1644804367,1644804608,241,418
3288016190,3382777450,1665953995,1665954110,115,2008
3633730527,3442753076,1659584709,1659585202,493,693
3139935588,3308071201,1660532508,1660532612,104,57
3597251704,3857434991,1655599363,1655599844,481,1479
3288555658,3507564472,1646905523,1646905961,438,1685
3139935588,3079031370,1661481519,1661481679,160,1558
3892850406,3847957207,1642821762,1642822525,763,1134
3296556189,3181237998,1667876435,1667877333,898,1703
3980851662,3395670756,1657481777,1657481811,34,2288
3535941714,3323217825,1661400215,1661401133,918,2158
3045879019,3728419832,1667022968,1667023872,904,2481
3024651290,3826573375,1643302831,1643303665,834,1588
3885786333,3118419220,1661058016,1661058897,881,239
3430145466,3283301166,1652225855,1652226623,768,602
3921962724,3256807270,1649991539,1649992177,638,1783
3558733181,3091072272,1658461676,1658462548,872,2324
3529732289,3138958890,1646096802,1646097031,229,2230
3714538351,3565805050,1665817298,1665818124,826,517
3058951367,3449133548,1643686837,1643686924,87,321
3339911597,3438550737,1651183094,1651183198,104,2288
3184000585,3062464540,1656382963,1656383413,450,2257
3084730908,3595469152,1665160785,1665161048,263,1160
3692954946,3187523092,1649484820,1649485356,536,1735
3244918124,3501786397,1652904634,1652904864,230,433
3385196866,3453076338,1651538462,1651539234,772,1530
3644961840,3034985161,1648389358,1648390232,874,344
3516585405,3254496907,1665211969,1665212845,876,1663
3783051630,3633856416,1642944475,1642944886,411,2162
3924559198,3429101401,1653729154,1653729631,477,426
3950982431,3167716044,1662170561,1662171370,809,2350
3224864814,3893709526,1652004180,1652004333,153,1638
3241944871,3894801934,1643194442,1643194525,83,112
3948862720,3613801852,1646026882,1646027376,494,1639
3493232103,3757139792,1649236925,1649237139,214,966
3922358932,3167121088,1649218954,1649219862,908,1863
3282561101,3351216955,1653472111,1653472880,769,891
3474666564,3071850041,1655741897,1655742442,545,507
3005125326,3799036179,1646195786,1646196003,217,393
3929282989,3613801852,1658835241,1658836041,800,1349
3313619618,3505480563,1666675503,1666676140,637,129
3569443529,3197352308,1643351355,1643351365,10,1108
3272879760,3567703076,1650571412,1650572150,738,1758
3133767042,3862371205,1659631524,1659632395,871,26
3061594029,3998200859,1656585099,1656585558,459,567
3065405448,3400730635,1657775449,1657776126,677,713
3659326501,3631732813,1643750089,1643751085,996,2292
3556577780,3167121088,1653688155,1653688577,422,1433
3924879744,3631568439,1655795299,1655795785,486,1253
3800014504,3796343532,1649437581,1649438563,982,1333
3983610735,3017504746,1649712828,1649713132,304,949
3349626057,3349433488,1651274349,1651274416,67,1189
3106276005,3277521554,1649654690,1649655491,801,2117
3761556948,3070557341,1661440011,1661440084,73,273
3637944484,3105829075,1659865525,1659866329,804,388
3662300962,3969563324,1651807389,1651808236,847,379
3042702763,3493040979,1647702067,1647703062,995,2116
3659224437,3344455273,1657143601,1657144493,892,875
3223174482,3114036217,1664632101,1664632552,451,861
3509167906,3676690161,1657831251,1657831548,297,1778
3489380093,3552457707,1655758412,1655759249,837,2127
3768253081,3241549340,1660518825,1660519100,275,591
3496040749,3323936820,1664951822,1664952485,663,123
3722329316,3262377052,1663075444,1663076161,717,2017
3785728567,3231938844,1661422181,1661422181,0,2171
3404908537,3965563922,1648782638,1648783112,474,1345
3264079501,3672693214,1641022256,1641022348,92,2208
3010488834,3279538648,1647422779,1647423610,831,365
3205601088,3978720869,1666975892,1666976788,896,684
3135951344,3549122378,1661066131,1661067029,898,1198
3094291821,3711151849,1661549572,1661550516,944,2308
3186207758,3661243199,1656994462,1656994915,453,1099
3890335277,3665798527,1666848097,1666849029,932,127
3555903175,3917067097,1648430704,1648430713,9,2236
3288106394,3382777450,1642892696,1642893691,995,52
3361482296,3126038266,1652097082,1652097580,498,1696
3585042042,3095834081,1658656127,1658656454,327,1653
3696947299,3570050230,1641683032,1641683467,435,2200
3952252601,3289017659,1662226625,1662227330,705,1424
3083791573,3210136888,1654052503,1654052903,400,482
3083144170,3254592040,1652503583,1652504156,573,365
3991087724,3801038758,1668879170,1668879177,7,1985
3344549344,3171214894,1669086383,1669086570,187,118
3936135558,3321105707,1664875879,1664876603,724,1338
3402019498,3940115951,1662234626,1662235344,718,138
3697291064,3267319115,1657253040,1657253051,11,872
3292739128,3234355426,1642895670,1642896240,570,2357
3508340066,3186207758,1659881793,1659882199,406,25
3742005806,3943184820,1652537353,1652537544,191,432
3218869856,3880620233,1651166865,1651167821,956,1410
3270240132,3175505409,1667099820,1667100806,986,1481
3010790966,3270935026,1653905030,1653905472,442,532
3551104975,3286696325,1646808882,1646808961,79,494
3777820691,3936029875,1650848891,1650849267,376,1878
3696243779,3858876644,1662338830,1662339543,713,973
3556803718,3261419893,1652659818,1652660703,885,1628
3721977473,3344664961,1659380930,1659381892,962,1717
3194796707,3955055535,1653635900,1653636182,282,706
3149545838,3855113371,1655629998,1655630365,367,1341
3765504986,3208464777,1667536076,1667536296,220,2448
3387774254,3037048394,1659354617,1659355146,529,517
3970886019,3211521816,1645572433,1645572452,19,671
3741494242,3896982954,1654365443,1654365615,172,2384
3682028611,3345733128,1656862643,1656862779,136,2208
3367768003,3682793223,1641976283,1641977035,752,190
3798708209,3780654306,1646565242,1646566092,850,1617
3118807144,3951354982,1662623341,1662623436,95,2093
3571428723,3093534312,1668931664,1668932127,463,1004
3912858275,3215342018,1641474511,1641474755,244,138
3808415962,3829201459,1654055410,1654055994,584,2207
3800312034,3268216928,1649437703,1649437947,244,1487
3598522904,3090588645,1641675967,1641676522,555,2303
3894454988,3066892936,1656631115,1656632111,996,124
3643132014,3039893721,1656287748,1656288015,267,568
3915439541,3415888174,1655521010,1655521030,20,513
3710708040,3537862606,1658282887,1658283002,115,1639
3242406857,3427342650,1666208631,1666209310,679,1761
3630744377,3972424804,1648714526,1648715098,572,1028
3108818977,3062435759,1654577236,1654578158,922,689
3139035952,3371707067,1657913816,1657914112,296,1014
3513169935,3646908383,1664823645,1664824186,541,1351
3306515955,3676634608,1645372002,1645372732,730,87
3458389447,3121336226,1645571199,1645571692,493,708
3540717336,3924969388,1646558337,1646558572,235,1567
3576425783,3141635102,1648466408,1648466964,556,1075
3691879230,3251948771,1646311334,1646312139,805,1418
3062789212,3590243603,1651323912,1651324496,584,2007
3262203147,3662526382,1658804186,1658804424,238,1654
3890781778,3153518026,1652904371,1652904718,347,1683
3312661854,3047922240,1660402703,1660403006,303,1966
3887305908,3688300477,1643265176,1643265886,710,1983
3086084685,3203153576,1646547559,1646548123,564,675
3441581446,3173034893,1649253189,1649253812,623,544
3448135160,3941317555,1643574399,1643574674,275,1015
3303025505,3873002836,1650607075,1650607861,786,1719
3714698686,3524482926,1662962643,1662963266,623,1193
3875750764,3769647112,1645885677,1645886384,707,1869
3249627758,3252843201,1655854548,1655854810,262,1406
3100670764,3855223575,1658760641,1658761295,654,747
3892023630,3053005521,1647693860,1647694458,598,7
3911621945,3185558387,1646698893,1646699822,929,13
3567614002,3232285701,1656366624,1656366653,29,1468
3348568561,3137803904,1667672395,1667672826,431,1915
3415888174,3410258020,1644291238,1644291541,303,1338
3298879351,3327145204,1641954375,1641954552,177,759
3061840033,3734367959,1663655474,1663655917,443,2348
3539866422,3704305860,1663992113,1663992646,533,1681
3432364009,3617958907,1643439067,1643440057,990,1833
3578075354,3188567155,1650617724,1650618349,625,396
3936029875,3017484229,1653990933,1653991410,477,1158
3909173527,3501732936,1667011532,1667012349,817,1428
3451089348,3776939860,1650212724,1650213393,669,1013
3321441782,3748944220,1658948364,1658949169,805,2087
3368884196,3026035554,1669199975,1669200188,213,1902
3269690639,3031241695,1659888677,1659888891,214,329
3686407290,3090666521,1661126776,1661126983,207,2473
3016068435,3288347905,1663094806,1663095063,257,254
3937129101,3612649935,1651834446,1651834526,80,703
3466494394,3958275419,1652773733,1652774428,695,1687
3928044191,3644127860,1641018141,1641018784,643,185
3107865208,3133805973,1654146235,1654146704,469,578
3359078190,3111514903,1648308057,1648309021,964,453
3432364009,3546866871,1656774608,1656774787,179,1390
3984461468,3431498601,1669480625,1669480847,222,2141
3738761840,3737420070,1644269593,1644270055,462,484
3418988797,3645850762,1653139968,1653140566,598,2378
3161063958,3725848338,1645734753,1645734920,167,1145
3014983064,3856882586,1652696242,1652696638,396,2216
3885493402,3603965318,1669526132,1669526708,576,507
3505270174,3731206373,1665442850,1665443774,924,2090
3352729606,3382943055,1664933628,1664934036,408,285
3339459948,3982538753,1645295462,1645296275,813,2307
3208220195,3696448766,1658644299,1658645128,829,1808
3656002043,3220432369,1641828667,1641828783,116,442
3892023630,3407156969,1665113512,1665113838,326,969
3859249968,3475612329,1661016959,1661017940,981,505
3479608671,3216171635,1655740254,1655741151,897,269
3580280923,3152554117,1659240446,1659241256,810,91
3421344639,3234064099,1646416014,1646416792,778,595
3233938614,3417298701,1652204396,1652205052,656,2245
3625979408,3179891006,1656104974,1656105973,999,179
3420266147,3243873593,1666503106,1666503609,503,1940
3688133320,3365663032,1662768408,1662768770,362,1522
3315569726,3280399460,1649834952,1649835004,52,2375
3588936901,3994383813,1669689965,1669690803,838,2415
3423965711,3773830646,1649334833,1649335492,659,1155
3497288872,3585097526,1663288465,1663289351,886,1711
3108342285,3510247235,1648633945,1648634602,657,266
3436636953,3110395191,1661914885,1661915306,421,1693
3777022057,3630966486,1656917179,1656917419,240,1124
3115343467,3242622170,1667294726,1667295108,382,2066
3733975709,3571991159,1657228279,1657228866,587,2270
3939755962,3673743780,1645296268,1645297155,887,1357
3651812819,3757693725,1658963231,1658963375,144,769
3284948113,3108139225,1666490628,1666490744,116,2479
3035464149,3347152834,1644427339,1644428147,808,349
3224309877,3572018229,1648540959,1648541104,145,96
3345186165,3154079557,1667463920,1667464918,998,204
3215870665,3826530948,1641156321,1641157201,880,2435
3749756110,3257080734,1646517029,1646517292,263,554
3021613958,3293416862,1662067997,1662068723,726,22
3808952164,3923907099,1644293526,1644293846,320,909
3753657577,3709518724,1669670464,1669670664,200,2107
3481085072,3788769219,1642041557,1642042223,666,1141
3182243157,3496807015,1642502746,1642503740,994,1916
3352595765,3101161243,1643844372,1643844418,46,980
3432942151,3212707122,1641666505,1641667432,927,869
3680810431,3462825977,1657756235,1657756353,118,1578
3089525434,3979522310,1669175720,1669176440,720,1682
3210331889,3039544352,1660269410,1660269526,116,948
3921816397,3201068600,1664990349,1664990911,562,824
3086534991,3924559198,1647510768,1647511584,816,312
3245773600,3133030655,1656242473,1656242562,89,1221
3807473345,3201968141,1643104033,1643104792,759,473
3141108539,3540029077,1654252307,1654252803,496,1526
3645943439,3113938510,1649715120,1649715201,81,1348
3585097526,3408978529,1655918602,1655919573,971,1576
3210279328,3695360424,1641559446,1641559952,506,2266
3911364139,3253827804,1641301488,1641302147,659,937
3156483651,3856386170,1668032898,1668033745,847,1896
3194618871,3088587729,1647436763,1647437538,775,1022
3626216693,3797484306,1645322204,1645322278,74,2084
3254866960,3835355277,1666102043,1666102466,423,1890
3799014776,3292010262,1646666134,1646666696,562,2405
3658099781,3138539283,1642782695,1642783348,653,1847
3679578513,3925523737,1657845742,1657846347,605,2091
3746050591,3136798128,1655106348,1655106850,502,2416
3215342018,3488878461,1665003174,1665003552,378,1555
3155044579,3270325529,1666865464,1666866211,747,1831
3097395182,3445863766,1662930960,1662931812,852,1295
3820070209,3609274729,1650396243,1650396287,44,774
3633498077,3314190424,1650879441,1650880309,868,394
3567926021,3364247623,1658059653,1658060631,978,1409
3347317107,3097609387,1643180642,1643181123,481,1234
3492134379,3576961863,1651650450,1651651297,847,154
3663871563,3309242036,1650916271,1650917041,770,451
3846323092,3895274115,1658788651,1658789138,487,1063
3994383813,3383686911,1642960731,1642961696,965,2261
3834826280,3789314517,1648476843,1648477704,861,1472
3074837048,3103856643,1662269703,1662270634,931,1354
3855734814,3055402951,1664468181,1664468362,181,64
3258057377,3087612913,1642871663,1642872607,944,519
3841459327,3898229065,1662700355,1662701281,926,1037
3662507847,3627981146,1645657213,1645657414,201,133
3261463305,3269889273,1662142097,1662142748,651,49
3055145919,3044161404,1665258712,1665258761,49,433
3327061038,3816935536,1654623462,1654624221,759,444
3855063597,3696437293,1651675803,1651676528,725,1021
3282275875,3438474821,1663040261,1663040589,328,2213
3254083367,3759421049,1648005070,1648005505,435,314
3928867307,3223463387,1658522852,1658523198,346,2356
3898229065,3771826410,1648485830,1648485900,70,1702
3296956444,3825332100,1657857197,1657857464,267,1864
3883537438,3469722588,1658287688,1658288059,371,65
3323684905,3007934266,1657117590,1657118471,881,671
3991477345,3240839516,1649927144,1649927491,347,2160
3995428703,3577114014,1642944139,1642944812,673,1535
3653925331,3738591594,1660387248,1660387602,354,1049
3872444916,3881578299,1660307868,1660308704,836,2228
3181086026,3206149175,1663076000,1663076907,907,1476
3339719117,3175196290,1661329379,1661329526,147,1838
3351610798,3761636372,1649635112,1649635380,268,3
3065298582,3606368289,1666212568,1666213167,599,2169
3663554395,3265655534,1644520223,1644520970,747,669
3952316985,3470112947,1647730536,1647730875,339,2131
3846323092,3130134092,1662282591,1662283209,618,2137
3333095694,3101669976,1657628765,1657629023,258,1815
3698521503,3624683080,1656377794,1656378167,373,661
3629984961,3047629830,1652583291,1652583533,242,680
3402578446,3296956444,1650531953,1650532224,271,1793
3855218155,3155797946,1668819159,1668820153,994,266
3827867076,3528146911,1666113711,1666114672,961,2007
3303986609,3512935575,1646412397,1646413281,884,140
3679615343,3971020365,1662078523,1662079260,737,2443
3821768923,3174425370,1664432776,1664433128,352,452
3808952164,3985879853,1642323927,1642324543,616,2431
3022428512,3556620301,1658241444,1658242263,819,513
3821312248,3525442421,1666815649,1666815849,200,2084
3152555864,3840558415,1649178119,1649178333,214,2263
3006603067,3044064258,1645466485,1645467267,782,2361
3562456307,3997215508,1658368700,1658369502,802,370
3532270724,3795503592,1653363389,1653363796,407,702
3308071201,3468963532,1659738393,1659739157,764,43
3665557228,3888764578,1641537475,1641538399,924,452
3555571916,3409978701,1657304890,1657305401,511,2207
3186897818,3539866422,1652313403,1652314032,629,559
3548132533,3909168020,1657653575,1657654180,605,1709
3260036272,3765962960,1668478243,1668479077,834,2333
3012152244,3248096339,1643476005,1643476149,144,2000
3659285822,3637408266,1665552503,1665552761,258,2496
3876696308,3886368625,1666360593,1666361291,698,1724
3757020498,3780182766,1654231967,1654232141,174,2292
3307636200,3393501277,1654226159,1654226682,523,862
3343543154,3759165741,1654329454,1654329775,321,409
3088854267,3637981738,1646305829,1646306106,277,1612
3382777450,3571719140,1648111420,1648112065,645,956
3636528701,3990312725,1648421583,1648422580,997,2125
3518322544,3795269127,1651092229,1651092624,395,799
3692861248,3179280029,1648568329,1648569166,837,434
3433768649,3630744403,1643880074,1643881037,963,263
3762890946,3104719783,1665071093,1665071468,375,2263
3920327961,3604694727,1642157030,1642157318,288,349
3886917024,3758115218,1661470569,1661470800,231,1032
3765023649,3049592624,1661093050,1661093386,336,612
3192367201,3309106486,1659949033,1659949451,418,476
3318577605,3235476099,1667982662,1667982718,56,417
3710318693,3792527009,1645904709,1645904925,216,1230
3949201468,3157765022,1650430275,1650430559,284,39
3799900837,3775766805,1666866488,1666866984,496,2090
3433439185,3883703576,1663022328,1663023122,794,1827
3491398730,3323783108,1645565401,1645565976,575,2083
3032834107,3608071362,1641165460,1641166177,717,2102
3984215552,3099224416,1649889150,1649889180,30,1801
3358242037,3098934820,1644503157,1644503207,50,1774
3816567987,3624294521,1658953150,1658953188,38,1221
3359189419,3314028925,1647110664,1647110946,282,732
3090506589,3126995401,1659867624,1659868199,575,1754
3399503261,3108998670,1658205263,1658205551,288,2012
3504398546,3392469094,1650403935,1650404046,111,2025
3182502852,3816240060,1641178689,1641178777,88,2395
3851982179,3878573707,1659085989,1659086262,273,641
3478959759,3690586350,1668443961,1668444927,966,2408
3563750578,3231701470,1661171231,1661171694,463,965
3959093613,3297123407,1646314115,1646314783,668,875
3520344153,3005773066,1653443807,1653444221,414,1101
3328544337,3249916829,1669381378,1669381508,130,118
3439303987,3859379131,1667274752,1667274955,203,1803
3021968850,3219292166,1641958472,1641959362,890,1452
3246260241,3309219121,1656981573,1656982260,687,1570
3373239702,3169012590,1654646368,1654646496,128,867
3217375075,3637518238,1644697786,1644697917,131,2203
3325944344,3215514672,1664446810,1664447159,349,1747
3051253299,3385246088,1644420524,1644420733,209,1531
3852506516,3894382679,1668273693,1668273734,41,730
3015253917,3803051709,1650344254,1650345124,870,1406
3922385616,3444174394,1642518106,1642518490,384,1509
3809387134,3705996677,1663830383,1663831237,854,1718
3289437738,3771528397,1641506611,1641507105,494,1343
3013681789,3230277243,1644636684,1644637094,410,1277
3998221237,3105054400,1657982213,1657982622,409,2349
3434182192,3398865388,1654323826,1654324509,683,2201
3988674966,3402878567,1657021223,1657021593,370,1929
3156962564,3102672864,1660461630,1660461899,269,894
3999314182,3201213219,1651371744,1651372311,567,245
3118443532,3554753273,1646382017,1646382139,122,472
3511755413,3518583464,1663489127,1663489212,85,956
3550107804,3869505474,1651466353,1651466699,346,52
3731588710,3263239497,1660298445,1660299351,906,1740
3661494924,3438465122,1645278565,1645279520,955,1476
3449915970,3856467502,1642720221,1642721182,961,2149
3460669513,3662409391,1651733902,1651734781,879,226
3641185549,3058290794,1667667085,1667667442,357,702
3165807050,3643615690,1662995516,1662996096,580,705
3969728585,3714538351,1650482156,1650482785,629,2222
3244198823,3818353360,1663865478,1663866111,633,393
3521258004,3293761762,1663085074,1663085192,118,2271
3825971737,3822213532,1648460366,1648461045,679,47
3796784054,3018838603,1657995250,1657995768,518,100
3659701814,3233040662,1645404390,1645405068,678,1653
3992528955,3894115655,1647622031,1647622169,138,1857
3919478201,3260174905,1646916151,1646917085,934,544
3623191811,3463875425,1654879868,1654879991,123,776
3059322626,3541942422,1669125984,1669126464,480,763
3149046961,3581324538,1657298098,1657298220,122,220
3737772457,3637292465,1641464273,1641465123,850,2
3035794185,3267248595,1653916210,1653916517,307,1794
3710189327,3293865251,1654378939,1654379017,78,2301
3816240060,3339856407,1657881469,1657882172,703,1508
3913680174,3142747577,1667997442,1667997453,11,537
3577651077,3152860718,1668244895,1668245775,880,2018
3022453107,3645778086,1642339038,1642339619,581,1576
3219869001,3409779636,1642382910,1642383904,994,1310
3476820014,3712276884,1667010238,1667011198,960,676
3140486428,3489538095,1649724728,1649724901,173,25
3481085072,3339856407,1665771290,1665771814,524,724
3109941959,3272879760,1647676052,1647676483,431,1779
3433237569,3816493730,1668506216,1668506784,568,199
3462825977,3395679954,1656495573,1656495585,12,813
3582076532,3346860393,1658893064,1658893456,392,120
3986631065,3870320323,1641668442,1641669322,880,1513
3886521075,3428026242,1650343520,1650343589,69,1578
3115029581,3574460900,1666878048,1666878746,698,2204
3747621620,3689032543,1661645478,1661646106,628,1557
3537151295,3593967802,1650833970,1650834503,533,2262
3288347905,3043753185,1663519495,1663520445,950,549
3304282571,3083020614,1663289379,1663289718,339,829
3236325866,3537943189,1668437801,1668438388,587,666
3832072924,3178728299,1664669966,1664670392,426,1271
3359896430,3359278409,1655850944,1655851508,564,1793
3751411767,3361051044,1643005944,1643006487,543,1060
3359189419,3403471618,1649126794,1649127099,305,1002
3741024153,3997038651,1660323831,1660324625,794,141
3475686271,3927273567,1641665236,1641665690,454,649
3146481001,3190544941,1658863974,1658864600,626,1509
3621379912,3077683954,1661360644,1661360793,149,1981
3533290388,3802694367,1665757740,1665758581,841,1167
3877090261,3167142908,1667025425,1667026005,580,587
3498466937,3728950700,1647136088,1647136595,507,182
3021727735,3366192341,1645931107,1645931566,459,2175
3188567155,3027870588,1668062438,1668062624,186,90
3628830127,3930205120,1668862325,1668862779,454,1927
3508398331,3274452346,1659792999,1659793080,81,1088
3044390847,3250867562,1654010055,1654010776,721,89
3478219461,3467933841,1641371862,1641372107,245,410
3366321387,3442799166,1649689155,1649689229,74,2244
3673761066,3260306978,1666008091,1666009082,991,719
3103625074,3847237978,1660071793,1660072110,317,2265
3098161767,3869618249,1658479247,1658480221,974,1638
3805888209,3633830454,1661675726,1661676349,623,818
3735855753,3899315309,1661264319,1661264603,284,1266
3447407380,3423028100,1642932038,1642932190,152,298
3658659669,3070237620,1660623282,1660623876,594,204
3823942349,3074795505,1666969559,1666970020,461,982
3377457710,3292172583,1666240435,1666241017,582,1146
3096746005,3660998516,1647069305,1647069323,18,2310
3482826953,3649447383,1668776559,1668777533,974,171
3777568712,3636879699,1669207567,1669208054,487,216
3882414600,3466942824,1645172086,1645172739,653,1182
3165973608,3845334081,1648019648,1648020192,544,596
3565052722,3873218862,1650546951,1650547857,906,202
3517260537,3439510951,1646801199,1646802065,866,1770
3616651934,3184615246,1660045100,1660046055,955,416
3514458890,3410737355,1660550310,1660550980,670,86
3315218003,3044564753,1657205820,1657206669,849,96
3938973292,3025014828,1653967803,1653967827,24,331
3467383586,3821979869,1641934927,1641935693,766,2418
3885084129,3926088173,1651269158,1651270118,960,62
3052789625,3618013844,1661146774,1661147073,299,450
3075563867,3892850406,1661952313,1661952902,589,1876
3534201448,3328471090,1653438821,1653439200,379,1943
3553471050,3840416991,1653398767,1653398885,118,2207
3824353209,3449993526,1655658223,1655658761,538,2420
3035464149,3252790120,1658624613,1658625204,591,1187
3927660473,3821299576,1657799332,1657800141,809,2002
3086084685,3143620816,1668603356,1668603616,260,476
3893018254,3265712439,1667725758,1667726706,948,67
3685715658,3956836647,1667875208,1667875886,678,2040
3572689902,3117732598,1658928150,1658928326,176,222
3830541998,3796990042,1644200286,1644200978,692,257
3993866389,3028311577,1643925048,1643925713,665,1577
3185210514,3307305290,1654630066,1654630106,40,1152
3654344198,3186584232,1669461745,1669462529,784,747
3997177535,3031386210,1655667250,1655667864,614,1174
3797778150,3588579914,1643577975,1643578806,831,631
3954073874,3944398168,1653637139,1653638112,973,2143
3216912897,3690667222,1658294142,1658294968,826,2086
3599007187,3468922263,1649198811,1649199052,241,1673
3215402575,3008760173,1656188281,1656189148,867,2073
3773789419,3037786726,1647457417,1647457707,290,604
3995270744,3784495839,1642470282,1642470891,609,1921
3589366986,3549475344,1647129258,1647129423,165,1224
3554600361,3589366986,1665276150,1665276436,286,2204
3695419353,3708034201,1643536051,1643536466,415,2142
3502947486,3400121632,1657011008,1657011583,575,170
3692498377,3955219063,1647681899,1647682738,839,930
3183435456,3903108572,1663747135,1663747553,418,418
3724157579,3026025743,1650322196,1650323079,883,1794
3841904297,3083494718,1660611398,1660612007,609,1590
3098108231,3256615260,1660927638,1660928622,984,2308
3378162995,3105630699,1652455213,1652456133,920,1783
3721395445,3493138014,1647137717,1647138185,468,1379
3145045320,3231794234,1641679337,1641679933,596,2183
3815236635,3168655636,1643107614,1643107950,336,2076
3576386271,3663038239,1649492445,1649492903,458,1877
3447527130,3090588645,1660468876,1660469852,976,341
3930124385,3060757458,1669135522,1669135821,299,2315
3134337442,3575715668,1648413488,1648414347,859,1207
3481072834,3657305306,1649598338,1649598825,487,1058
3586734200,3861247260,1663969650,1663970249,599,1933
3087394554,3828921434,1647543957,1647544787,830,2195
3640571571,3257375975,1652600154,1652600529,375,534
3024979152,3772910484,1650776255,1650776438,183,618
3098891437,3903709933,1654446730,1654447189,459,2419
3032970317,3896867161,1667048024,1667048431,407,806
3452773006,3585674939,1667097993,1667098211,218,1181
3275027460,3097489594,1662721972,1662722458,486,782
3740274448,3043180716,1649394528,1649394833,305,1565
3912111332,3708032127,1660553892,1660554023,131,2148
3130135928,3961973688,1658461823,1658462379,556,192
3021679982,3005773066,1651887731,1651887887,156,1050
3640605424,3466282430,1661580404,1661581270,866,1747
3407778626,3770641398,1650246411,1650247193,782,736
3142274869,3242622170,1663440225,1663441025,800,1845
3470287808,3835612256,1651010716,1651011593,877,686
3678425549,3912106632,1642084633,1642085356,723,2365
3746979257,3201142543,1642831424,1642831570,146,223
3070588700,3760432849,1649349485,1649349780,295,1538
3834826280,3479087219,1655991615,1655991819,204,1747
3493489568,3686249771,1660289117,1660289216,99,1516
3367457506,3275027460,1653008685,1653008903,218,1908
3595535977,3676634608,1648768735,1648768800,65,1300
3659224437,3055918856,1643916024,1643916095,71,366
3743934334,3475322181,1641801837,1641802608,771,1251
3021621189,3637518238,1666799596,1666800439,843,1554
3112287858,3682279970,1666666830,1666667039,209,1823
3624060457,3639352352,1645497875,1645498077,202,2285
3107541952,3022082086,1661151542,1661152087,545,685
3360040841,3966881800,1659464681,1659465610,929,162
3877090261,3572792752,1660009266,1660009936,670,1931
3622596133,3809773923,1662721389,1662722238,849,2497
3644334498,3777091595,1664737240,1664738083,843,748
3259625938,3291838772,1652928606,1652928674,68,1953
3063744739,3136396999,1641818655,1641818984,329,479
3081641451,3267479523,1651827284,1651827387,103,528
3396154732,3957577990,1668257062,1668257189,127,319
3494971523,3844822083,1647038509,1647038789,280,733
3330623875,3359541123,1659218375,1659219045,670,4
3570906118,3751826055,1663464442,1663465300,858,2306
3262596597,3541920859,1643459667,1643460281,614,1323
3155320608,3342082281,1667331712,1667332366,654,467
3040742963,3628963667,1656311223,1656312132,909,2361
3423073970,3208464348,1645848440,1645849142,702,1858
3466156489,3921816397,1664122670,1664123420,750,1630
3547365303,3092118254,1666980050,1666980274,224,439
3440372055,3259430206,1654939122,1654939669,547,1296
3529946433,3898699023,1641775530,1641776283,753,410
3036046331,3556819852,1661839283,1661839951,668,2246
3173809486,3903709933,1647343790,1647344441,651,2142
3419751912,3195534254,1641577321,1641577984,663,599
3015246686,3375759020,1662484784,1662485434,650,1411
3458252541,3929794333,1643465987,1643466687,700,1639
3397052856,3710043628,1661269332,1661269984,652,988
3217719618,3495420849,1651759374,1651759853,479,673
3647263296,3853258306,1647861661,1647862170,509,688
3072317138,3327427782,1665064668,1665064897,229,70
3884256882,3619660501,1665028194,1665028700,506,1815
3223154180,3835069955,1648946154,1648946396,242,1198
3259071830,3522549719,1654073327,1654073750,423,2
3695237310,3213039478,1656911667,1656911920,253,1611
3536832504,3283922234,1664026519,1664027508,989,2424
3426004964,3305480485,1645404264,1645404858,594,49
3383755219,3967754963,1656262887,1656263817,930,1455
3164836342,3227652803,1655331627,1655332281,654,506
3787298788,3842445140,1647192679,1647193054,375,1333
3862583365,3807323401,1664510281,1664510466,185,339
3369049258,3579486534,1642554740,1642555383,643,1635
3313295291,3668677061,1649249115,1649249907,792,257
3400604704,3548145086,1644721743,1644722245,502,2373
3030286864,3196009998,1657831417,1657831835,418,807
3346254669,3762422234,1642316297,1642317187,890,2323
3247047829,3083182515,1663517704,1663518525,821,2364
3438550737,3127412666,1667283665,1667284623,958,849
3288329354,3246796194,1654704442,1654704811,369,1741
3877464299,3475027844,1668564275,1668564657,382,2035
3154653229,3920482918,1656136418,1656137147,729,1646
3401677898,3610577318,1662266616,1662267535,919,1109
3295850908,3329618048,1648284168,1648284225,57,1920
3686530724,3317318302,1660441809,1660442048,239,733
3355429456,3095221133,1646705899,1646706138,239,2020
3369175849,3647295073,1646899203,1646899643,440,1648
3707892765,3032970317,1645153619,1645153809,190,838
3487756836,3843917747,1668105286,1668106240,954,363
3026244912,3923692475,1650709283,1650709830,547,1291
3242406857,3929497543,1650238918,1650238950,32,2411
3833342718,3385430413,1650922840,1650923588,748,1423
3499091436,3137891271,1641571094,1641571711,617,610
3054828202,3177036721,1657780429,1657780886,457,1570
3049424358,3122288373,1655213398,1655214152,754,2192
3634936481,3685049252,1654638129,1654638192,63,1775
3954255558,3178728299,1648426757,1648427585,828,974
3033438220,3975379893,1643365146,1643365356,210,1520
3210913409,3820585135,1666841558,1666841657,99,104
3796275634,3366155048,1641111983,1641112266,283,590
3948002281,3375290121,1647454540,1647454940,400,1243
3761147252,3416230781,1655963118,1655963672,554,2049
3772762015,3128613298,1656312554,1656312753,199,744
3433768649,3556577780,1668470770,1668470991,221,1290
3615419444,3183672525,1655273181,1655273922,741,336
3631152825,3442477300,1653477381,1653478175,794,31
3611025093,3812239613,1652074048,1652074646,598,954
3064804156,3099934862,1646827962,1646828527,565,1053
3703457098,3393458100,1642805597,1642805780,183,1224
3513925385,3013862518,1666600426,1666601008,582,1094
3691032308,3180062640,1653450903,1653451651,748,1391
3996933937,3403933668,1667150071,1667150693,622,1759
3833345079,3150289965,1652904242,1652904282,40,2038
3992909356,3402878567,1657516508,1657517499,991,1368
3021968850,3682928814,1665645879,1665645970,91,2195
3530491537,3879520142,1662024546,1662024813,267,2035
3985037610,3115367011,1662559382,1662559549,167,1686
3560015501,3830330372,1648623328,1648624091,763,487
3531345844,3929774793,1653350753,1653350961,208,1693
3619045997,3610239794,1647736785,1647736888,103,2178
3388159268,3580531210,1664634307,1664634934,627,2099
3534182480,3172524712,1661780844,1661781277,433,974
3654922401,3614627046,1643428859,1643429088,229,1625
3379076226,3817667121,1644523139,1644523554,415,2129
3582046255,3828531030,1662526482,1662527395,913,306
3059447105,3362812887,1661227829,1661228826,997,1093
3679533416,3450689808,1666643452,1666644261,809,447
3283671920,3407150254,1651829640,1651830033,393,2141
3260085949,3508311968,1665715865,1665716135,270,1163
3876888791,3878005127,1641079418,1641080290,872,1302
3808541027,3273701051,1659644389,1659644893,504,2446
3648593799,3826502515,1646092873,1646093282,409,849
3852673624,3821180393,1669236931,1669237340,409,2498
3040219251,3408460871,1652586165,1652586733,568,2033
3667718430,3821120962,1643364971,1643365451,480,870
3468703620,3120092137,1659606267,1659607082,815,2180
3520107804,3832786192,1654319070,1654319522,452,2011
3106395050,3108288045,1641311150,1641312013,863,30
3672694122,3162836777,1644566512,1644567374,862,876
3620725243,3433576059,1666142198,1666143193,995,2026
3136174856,3031026970,1641913741,1641913973,232,1712
3671296032,3335976452,1661013679,1661014012,333,501
3173969437,3609029368,1665039127,1665039314,187,17
3188567155,3164702890,1648914968,1648915186,218,1820
3329618048,3746050591,1652824870,1652825134,264,1714
3451823359,3417411117,1657220653,1657221632,979,790
3422374987,3126746702,1642513576,1642514399,823,11
3252421501,3890492731,1663995234,1663995943,709,564
3709681519,3303815040,1657059689,1657060429,740,442
3454753343,3852500776,1663179888,1663180149,261,523
3620787716,3782673553,1660719071,1660719626,555,464
3865947139,3026769225,1664114380,1664114407,27,39
3217047921,3029451399,1641264138,1641265053,915,1097
3569761806,3592519306,1661699626,1661699814,188,558
3319037937,3518202698,1665446366,1665446515,149,1063
3445666899,3296556189,1652825349,1652825802,453,34
3483254795,3926200409,1651475604,1651476379,775,2099
3037844343,3375585327,1666230408,1666231110,702,2296
3486541605,3500152600,1665091685,1665092168,483,1135
3084592361,3732840219,1656378694,1656379411,717,1719
3829986472,3797237179,1642857073,1642857805,732,891
3105636655,3159669419,1650063665,1650064272,607,2160
3154309446,3216439052,1641316695,1641316778,83,1809
3201933010,3976335280,1661334406,1661334414,8,1943
3230248695,3269629374,1665363076,1665363416,340,1469
3339048327,3725979769,1660351731,1660352594,863,795
3973050834,3442447509,1647039198,1647039390,192,1227
3063744739,3216171635,1656319839,1656320308,469,218
3921261515,3404043594,1667449644,1667449878,234,1225
3086894794,3493226566,1657398025,1657398325,300,863
3347434027,3950225483,1653473895,1653474154,259,1768
3057837723,3566874478,1651624989,1651625911,922,260
3663814997,3996319604,1662933074,1662933729,655,948
3264281080,3115177011,1651133756,1651134736,980,2232
3334483625,3722380765,1642179391,1642180084,693,668
3560043638,3931294653,1656189343,1656189771,428,2338
3754292816,3995270744,1643304046,1643304761,715,913
3378814600,3483553551,1656001024,1656001970,946,475
3224130773,3192836427,1653811657,1653812270,613,1509
3261685435,3029807207,1663389482,1663390024,542,365
3006507589,3945607460,1642952877,1642953477,600,1495
3732585972,3657044188,1657532229,1657532652,423,1883
3130561868,3039544352,1653281157,1653281922,765,1917
3177879837,3666148943,1647903030,1647903972,942,1679
3730266625,3977317498,1655863686,1655864401,715,1143
3165129580,3600334566,1650905202,1650905269,67,811
3442408044,3885893310,1650492798,1650493021,223,844
3944493334,3447257561,1646087373,1646087702,329,60
3316485303,3662526382,1661367855,1661368722,867,1585
3594795944,3808022912,1647047813,1647048549,736,2093
3575784654,3192505750,1660255620,1660255866,246,2069
3946306778,3821391381,1656957707,1656958574,867,1605
3121932256,3253395374,1658999607,1658999650,43,1334
3277298737,3562004989,1663405923,1663406299,376,2245
3146555014,3117575075,1650996892,1650997219,327,1752
3993653521,3442967650,1667516801,1667517266,465,472
3404317985,3749308364,1649135767,1649136590,823,1420
3089574886,3581302872,1645664646,1645664844,198,2150
3184455727,3167074299,1661922772,1661923082,310,2144
3119036139,3577114014,1661983618,1661983875,257,1424
3292636621,3040889811,1658883778,1658883788,10,627
3149135097,3367279073,1653688479,1653689156,677,1814
3919196366,3870998298,1646159686,1646160437,751,412
3827810459,3026727334,1651824181,1651824712,531,2116
3008417861,3816921514,1647981632,1647981727,95,2105
3321971009,3217250826,1662663143,1662663296,153,584
3529732289,3104164320,1649817721,1649818047,326,1221
3736118442,3834826280,1652595837,1652596755,918,1162
3097031283,3466942824,1663869123,1663869468,345,2273
3879787945,3740090157,1642671920,1642672487,567,1964
3055402951,3663718795,1664704336,1664705207,871,333
3909173527,3680139573,1653787122,1653787672,550,1927
3270325529,3410261725,1647371809,1647371915,106,340
3286476251,3498441448,1663646556,1663646748,192,629
3303561746,3286466102,1641885495,1641886299,804,1514
3011863548,3770388331,1642594506,1642595222,716,1240
3047372637,3679617161,1645026673,1645027328,655,2120
3540251095,3146529279,1653926262,1653926650,388,16
3344472194,3043258601,1652298858,1652299651,793,22
3443490373,3994927164,1643402868,1643403139,271,2150
3715118659,3536903033,1653152560,1653153028,468,1063
3029956642,3758849561,1666924895,1666925317,422,1061
3822143503,3979352608,1668389736,1668389843,107,740
3596951808,3519726741,1641059681,1641060111,430,1531
3622933919,3564839908,1650460826,1650461724,898,1037
3106804099,3563967528,1650468777,1650469295,518,847
3082359035,3181236848,1659872704,1659872948,244,195
3424621981,3763804073,1651007943,1651008278,335,52
3410737355,3527106895,1652136343,1652136434,91,1925
3197660189,3745420516,1644166102,1644166665,563,785
3371818930,3276618988,1653376385,1653376670,285,642
3790402339,3230775095,1650766077,1650766530,453,943
3675429073,3691834770,1665972201,1665972210,9,1455
3454554705,3952425376,1669121716,1669121732,16,2416
3489083203,3250312962,1654145756,1654145782,26,758
3435319506,3589366986,1660888569,1660889110,541,2490
3959783422,3743835099,1651619502,1651619749,247,1255
3857081560,3447527130,1653856831,1653857809,978,491
3021515419,3627886263,1655312875,1655313659,784,1448
3776944992,3131820605,1650959219,1650959827,608,1974
3792143103,3877483900,1650024279,1650025170,891,694
3612720177,3499481051,1661320796,1661321576,780,1588
3350067994,3122624322,1661503964,1661504778,814,2438
3181047536,3049579265,1668470604,1668471285,681,623
3863697907,3098422570,1657016712,1657017031,319,969
3819467184,3131938458,1656990134,1656990797,663,1621
3393032827,3928212115,1667354713,1667355400,687,991
3329253794,3062486954,1664815397,1664816259,862,489
3456285013,3174373725,1653343046,1653343249,203,730
3177433990,3032747459,1658395692,1658396413,721,977
3633544934,3347679085,1649069937,1649070035,98,887
3835976086,3181032246,1667114269,1667115063,794,2425
3066645531,3623782659,1663583470,1663584057,587,2264
3499091436,3311921613,1643762136,1643762790,654,1850
3775645582,3604426149,1650922432,1650923430,998,369
3878695242,3453076338,1661636327,1661636803,476,1636
3913243283,3574740304,1648124475,1648125168,693,1474
3909837555,3597557082,1646793240,1646794150,910,1151
3033692011,3529381895,1656079237,1656080192,955,2152
3371430360,3516399207,1646189541,1646190266,725,64
3485695895,3785883615,1658873736,1658873854,118,2468
3087662482,3673550835,1655679402,1655679505,103,696
3989741708,3935022176,1662819474,1662820320,846,1138
3865529150,3736459302,1665723500,1665724100,600,330
3562243381,3795269127,1659922152,1659922436,284,1365
3719507293,3747363730,1662079817,1662080606,789,1799
3878180077,3615359439,1641744585,1641745063,478,2144
3741983763,3538686599,1652698615,1652698690,75,216
3172018366,3027870588,1647872599,1647873582,983,1471
3904546701,3279370751,1661963964,1661964805,841,1763
3258098890,3066892936,1666836329,1666836658,329,854
3131753608,3468324129,1643404720,1643404993,273,2425
3239162274,3580908290,1649159221,1649159801,580,871
3817252660,3817668840,1659041257,1659042117,860,1507
3130181848,3179354869,1666992078,1666992758,680,1514
3159645889,3095849365,1644912890,1644912953,63,2416
3882978452,3710681792,1646895939,1646895957,18,2499
3698898645,3284628242,1663197690,1663198193,503,1055
3870485916,3165807050,1651199995,1651200378,383,1790
3505270174,3680703930,1659831331,1659831593,262,1634
3224792502,3819405521,1651106899,1651107823,924,344
3227446097,3437983939,1650741342,1650742024,682,1501
3804648275,3911290843,1656636639,1656637165,526,644
3917715509,3908209550,1649394051,1649394315,264,112
3303358502,3812800144,1665022229,1665023151,922,1846
3770118341,3354912831,1646523582,1646523591,9,121
3657464089,3923137418,1644989309,1644989980,671,2399
3185444969,3944398168,1666471403,1666471466,63,1908
3380213005,3555966791,1668449511,1668449538,27,431
3131629372,3350566867,1659977735,1659978258,523,347
3497079704,3842738399,1661944992,1661945644,652,533
3400211665,3669324531,1656534209,1656534646,437,129
3549752945,3975379893,1658007933,1658008564,631,1898
3877902487,3888895982,1654245556,1654245735,179,510
3063478155,3949771162,1659685319,1659686213,894,437
3993332175,3280328195,1647953644,1647953969,325,1941
3598117343,3786480807,1663635336,1663636219,883,1141
3107713394,3587171844,1644271045,1644271130,85,954
3196704660,3405749286,1661694236,1661694897,661,556
3645666563,3447203087,1659223280,1659224192,912,2158
3767409219,3661747291,1654164619,1654165531,912,121
3518817978,3487992433,1663940924,1663941746,822,1134
3250824932,3672070606,1655328141,1655328423,282,2175
3325944344,3190035679,1657080456,1657080536,80,81
3204346356,3653925331,1662378881,1662379692,811,121
3181032246,3601851578,1660840372,1660840895,523,1101
3781446747,3193095337,1666391270,1666391961,691,875
3962773297,3173909495,1660091556,1660091625,69,1659
3444067052,3242857629,1648639484,1648640344,860,417
3806664868,3773434774,1654717808,1654718277,469,1898
3092118254,3168818004,1654789291,1654789457,166,598
3132584801,3514458890,1644600216,1644600895,679,1725
3176432386,3293237543,1664937741,1664938247,506,1255
3759608318,3198240429,1665156417,1665157373,956,1672
3770061469,3997541339,1643145634,1643146189,555,2029
3334298803,3463973561,1659211814,1659212437,623,2098
3967372197,3420137628,1667684069,1667684728,659,4
3713482005,3898229031,1655223634,1655224184,550,804
3612061421,3602340127,1648885278,1648885621,343,1526
3361529884,3739490721,1642431117,1642431798,681,1262
3325944344,3430102174,1645902461,1645903332,871,2173
3320065223,3240588695,1666578962,1666579724,762,622
3517260537,3031026970,1649924722,1649925525,803,2097
3205543673,3672609185,1646163016,1646163971,955,57
3327061038,3280657282,1652979811,1652980157,346,1049
3399552669,3545394112,1666997910,1666998894,984,1032
3947604616,3243883781,1642290267,1642290949,682,2191
3471703914,3052063374,1666141792,1666142130,338,1681
3198520645,3823288349,1665479244,1665479476,232,2457
3807478002,3089590512,1663912502,1663912675,173,2170
3086273441,3488001885,1641540003,1641540301,298,1301
3063674428,3970970054,1649526339,1649526930,591,1007
3997886077,3363902315,1651097796,1651098503,707,1953
3187561832,3707584091,1666985372,1666985618,246,1742
3080287966,3546954605,1658626593,1658627021,428,2312
3587874085,3283947136,1664793003,1664793856,853,886
3369731959,3327504995,1656426080,1656426865,785,224
3197466224,3796936978,1645473374,1645473850,476,1211
3666079547,3183435456,1643252754,1643253184,430,1105
3171307709,3639090741,1655891176,1655892154,978,1432
3903108572,3323797477,1643271714,1643272075,361,1643
3353722089,3969103555,1662105316,1662105379,63,1592
3146653168,3432954312,1649568317,1649568688,371,1502
3905581902,3032465570,1664379370,1664379614,244,157
3104396432,3362249024,1661025166,1661025560,394,1689
3855521057,3872493238,1662469019,1662469457,438,1729
3139551539,3578655079,1665495310,1665495672,362,1202
3628554134,3331904172,1649169216,1649170010,794,1091
3150730013,3114605564,1665503373,1665503486,113,1659
3016992122,3558733181,1649933048,1649933638,590,1064
3907705988,3844966905,1649284171,1649284561,390,1244
3103497887,3002876565,1653596726,1653597270,544,85
3922927380,3946015739,1652149327,1652149363,36,2007
3797294746,3556729365,1646505950,1646506071,121,2439
3432059238,3084855451,1643000442,1643001241,799,1299
3392156471,3337684100,1646114798,1646114911,113,131
3327427782,3216912897,1655588445,1655589025,580,2138
3668456327,3801038758,1652319201,1652319972,771,1635
3637408266,3478959759,1664979869,1664979892,23,2021
3971722824,3712581685,1655389716,1655390041,325,181
3879325408,3732796331,1646823729,1646824037,308,230
3930124385,3175929512,1656829710,1656830255,545,1905
3111514903,3911891369,1660465278,1660465380,102,1224
3289615980,3645341350,1655628635,1655628874,239,216
3661507330,3432321849,1649987909,1649987965,56,601
3103158328,3570747542,1664872496,1664873229,733,1275
3870349696,3515460273,1664584285,1664585095,810,1445
3747929255,3226234284,1658027313,1658027433,120,1116
3344205602,3846298815,1664797650,1664797757,107,837
3840533238,3319546209,1668839804,1668840617,813,1956
3906236028,3967439884,1663084000,1663084403,403,1369
3569200063,3070404759,1661248219,1661249102,883,676
3105299236,3063791472,1642511239,1642511826,587,1197
3385264040,3264673951,1665308468,1665309356,888,869
3346778916,3325944344,1642752477,1642752694,217,1344
3823419231,3451131159,1658290043,1658290538,495,2371
3992528955,3065482463,1660398579,1660399381,802,1207
3015956370,3146634302,1645415487,1645415599,112,147
3079219552,3365663032,1658916496,1658916845,349,1080
3187807330,3116684420,1669524001,1669524053,52,950
3895861447,3391857064,1643126557,1643126978,421,897
3735286926,3867868879,1642782844,1642783250,406,1084
3953655387,3433439185,1662229978,1662230627,649,2028
3442244098,3293237543,1642895402,1642896327,925,1604
3697650296,3623769570,1663168073,1663168741,668,1642
3067641822,3498740809,1643266068,1643266761,693,102
3518079213,3132210207,1669163848,1669164457,609,391
3153335208,3072911780,1652074096,1652075070,974,2367
3154823834,3754631129,1669452544,1669453499,955,969
3896281957,3215514672,1642740539,1642740827,288,1235
3901459563,3351216955,1646002497,1646002543,46,1406
3094418033,3516838480,1659155412,1659155762,350,2053
3845511281,3052499026,1655392183,1655392789,606,1762
3060674509,3738981251,1643848652,1643849204,552,2198
3319946083,3400211665,1644863927,1644864686,759,1864
3494746675,3828485006,1645335728,1645336233,505,585
3629942160,3072276713,1650058812,1650059690,878,1900
3841314189,3973959874,1665400875,1665401704,829,1863
3122288373,3279773317,1667679749,1667680569,820,1005
3392469094,3555912894,1669247970,1669248791,821,1483
3268570857,3084783158,1660723940,1660724609,669,2328
3582859001,3148259657,1659753129,1659753554,425,1252
3562021711,3938615588,1645641596,1645642477,881,746
3961973688,3625393284,1652432021,1652432791,770,2493
3545544203,3293416862,1650432868,1650433666,798,2374
3064323869,3954255558,1661410069,1661410763,694,368
3194617168,3893829650,1651498951,1651499187,236,114
3813632607,3060757458,1659985656,1659986375,719,1498
3718731864,3007087811,1648897533,1648897966,433,916
3893601176,3323198594,1656337007,1656337693,686,1510
3321391869,3976757440,1658471991,1658472021,30,39
3702671465,3206512870,1669338134,1669338830,696,1345
3633382140,3541157955,1660106092,1660106709,617,4
3087709771,3197661010,1657483735,1657484242,507,1997
3640587334,3473399101,1661062449,1661062959,510,731
3453076338,3788018778,1646136705,1646137261,556,2328
3133601374,3278703976,1649436466,1649437408,942,1097
3830850007,3706560099,1650149116,1650149270,154,795
3766205598,3095728444,1663348230,1663349032,802,691
3803051709,3289799796,1659189991,1659190068,77,1642
3639618179,3834152797,1665339822,1665339954,132,1563
3886344418,3062789212,1665303017,1665303864,847,374
3458971289,3274588728,1648038900,1648039515,615,672
3220424979,3132258390,1665350965,1665351681,716,1363
3645585393,3149313426,1643028298,1643029016,718,296
3138801114,3229975544,1647816909,1647817119,210,2289
3401582775,3272912522,1647138399,1647138821,422,209
3987510303,3175478710,1653057386,1653057929,543,237
3957115705,3997177535,1645117002,1645117117,115,66
3807922855,3412927884,1664336642,1664336838,196,302
3278397100,3656092578,1662657873,1662658850,977,1594
3852685738,3606368289,1643779998,1643780328,330,933
3896866052,3435036750,1647212932,1647213661,729,108
3958449916,3712332461,1656833645,1656834338,693,2299
3208464348,3191460519,1652875725,1652876545,820,2261
3934383056,3830388213,1665447612,1665447968,356,1430
3093024844,3574985668,1663766941,1663767374,433,564
3608893234,3897030063,1659866513,1659866814,301,2480
3770393539,3356154602,1642439031,1642439134,103,1120
3897412947,3554741157,1651467074,1651467945,871,2413
3149336644,3007480776,1668122660,1668123016,356,865
3882903150,3923647484,1654206425,1654206648,223,1629
3103728720,3891518316,1652046426,1652046924,498,11
3553725082,3831699015,1657550705,1657551333,628,1355
3149896107,3897756969,1660148212,1660148829,617,2106
3727859047,3097395182,1662511604,1662511684,80,2438
3619126886,3630750697,1663384528,1663384855,327,2435
3266991557,3447812768,1656570571,1656570644,73,2494
3072834944,3701979416,1650067204,1650067645,441,1650
3581302872,3749161560,1643351341,1643351781,440,508
3127419046,3590384867,1646121728,1646121810,82,876
3077145114,3931854815,1642051160,1642052081,921,808
3815507952,3582859001,1650467719,1650468440,721,666
3749593178,3401677898,1648877605,1648877653,48,799
3319605191,3058951367,1653194053,1653194167,114,690
3759008568,3048781539,1649072415,1649072483,68,1181
3597904540,3969355995,1666203508,1666203767,259,79
3191398794,3549209951,1667908161,1667909119,958,1063
3183299670,3355135607,1657730857,1657731515,658,1981
3447926518,3542688397,1649097761,1649098588,827,2029
3987979637,3487740667,1646806349,1646807336,987,1807
3870485916,3797237179,1655486091,1655487081,990,145
3930591160,3043064916,1652004159,1652004667,508,1504
3516676045,3156331863,1652773152,1652773378,226,701
3437665905,3551810435,1652179412,1652179849,437,2308
3959261742,3100027110,1653694821,1653695442,621,891
3149313426,3630750697,1650126739,1650127004,265,997
3115236500,3119869652,1661538645,1661539109,464,812
3605316405,3388726341,1664617695,1664617877,182,608
3987813210,3021289375,1660528838,1660529588,750,870
3641455530,3792834070,1648173249,1648173896,647,1506
3838851134,3991299369,1658064708,1658065633,925,1877
3112602434,3079516653,1644310730,1644311128,398,2468
3897222406,3090057747,1665323962,1665324801,839,1981
3898188404,3811318665,1645588360,1645589239,879,632
3852704822,3587324906,1664227571,1664227717,146,121
3433576059,3561037966,1662663245,1662663536,291,152
3314495556,3614179985,1668118575,1668119505,930,2498
3809312897,3335915365,1665846342,1665846870,528,2012
3247590827,3351691261,1669209373,1669209774,401,1944
3898012654,3247590827,1667065577,1667065993,416,549
3133030435,3300479839,1653641860,1653642247,387,1202
3132210207,3755269138,1647373100,1647373890,790,1087
3743860568,3524545245,1657543306,1657543681,375,2423
3961903747,3012032774,1665115827,1665116207,380,698
3255149739,3037042091,1650090667,1650090839,172,1374
3878180077,3512935575,1655587456,1655587708,252,178
3867126446,3329154834,1647486342,1647486863,521,2256
3177370273,3923907099,1644406999,1644407052,53,2338
3048788442,3204114911,1652367512,1652368107,595,706
3652480299,3593704176,1650614671,1650614950,279,110
3852506516,3662788693,1645365350,1645365566,216,2159
3568289450,3476405785,1652155221,1652155769,548,397
3892535771,3944476586,1668558962,1668559934,972,2091
3044967578,3932161358,1651518897,1651519307,410,1636
3555903175,3362091170,1666202118,1666202622,504,959
3048296949,3431595099,1654850502,1654851458,956,657
3983490056,3796198742,1654807857,1654808313,456,1313
3345413125,3548128446,1660294502,1660295094,592,246
3960450011,3885583347,1649321483,1649321668,185,808
3129500635,3915315003,1657248319,1657248826,507,2194
3204359619,3814620482,1642552152,1642553136,984,2448
3970444667,3062261092,1669301715,1669302246,531,841
3445023517,3990870728,1655050446,1655051210,764,1690
3474402148,3225741855,1658528932,1658528964,32,1041
3898959510,3188567155,1654710019,1654710889,870,1
3118554894,3562859716,1655016822,1655017204,382,508
3864133914,3653030573,1642712389,1642712843,454,1076
3446481380,3139551539,1661942680,1661943481,801,1962
3719146348,3407778626,1665327574,1665328145,571,1828
3740274448,3980781580,1649276690,1649277387,697,1247
3488484971,3090588645,1658712696,1658713165,469,886
3133694612,3801579775,1650975617,1650976353,736,743
3268446099,3439827305,1646611590,1646611781,191,360
3540737045,3474723005,1663902717,1663903443,726,1372
3587727278,3733440098,1653322327,1653322879,552,228
3935383578,3649154395,1645761269,1645761811,542,635
3429074631,3896091695,1648008156,1648008331,175,62
3307949630,3332721407,1669054980,1669055230,250,1021
3413898378,3289332257,1659424386,1659424885,499,648
3761307187,3113423573,1669378954,1669379876,922,2424
3452773006,3811337280,1666397732,1666397839,107,588
3887108152,3580901513,1650870826,1650870966,140,27
3553096192,3986825518,1666159718,1666160193,475,1426
3980971387,3113516667,1657632201,1657632611,410,1648
3492657889,3740728884,1662005432,1662005973,541,404
3167142908,3132611388,1648608741,1648609137,396,762
3728240849,3633498077,1650853016,1650853031,15,216
3054160201,3440372055,1659967738,1659968728,990,2182
3800014504,3493489568,1654212517,1654212798,281,2425
3257947713,3742159503,1645628516,1645628803,287,1399
3220903356,3618941109,1650082783,1650082857,74,184
3884750087,3844939526,1661988708,1661989550,842,965
3744734019,3188643066,1656750641,1656750906,265,1975
3240340462,3900571767,1667721552,1667722138,586,658
3578068647,3606643671,1641026364,1641027238,874,1339
3271039091,3876687977,1644943297,1644943326,29,57
3134337442,3142106289,1642741914,1642742314,400,919
3381060534,3864133914,1663492029,1663492629,600,1278
3299840986,3083494718,1655026593,1655026593,0,1295
3549768940,3224491185,1658532714,1658533708,994,2010
3377901268,3204081712,1650170914,1650171710,796,2262
3907299052,3076285457,1666755056,1666755126,70,1006
3752442248,3223412894,1665873927,1665874487,560,1465
3915494041,3039255124,1652314410,1652315017,607,1211
3865847882,3250023388,1654219443,1654219712,269,293
3289330422,3993332175,1647882564,1647883299,735,147
3103421893,3809332572,1654005605,1654005668,63,2114
3170325894,3116584028,1668080053,1668080492,439,1153
3040416131,3713520914,1643550547,1643551008,461,98
3112259657,3009835115,1667204010,1667204157,147,2262
3031816406,3536931244,1647006857,1647007483,626,1844
3515332061,3880835949,1660466334,1660467171,837,1652
3066892936,3634282428,1656671041,1656671843,802,333
3814620482,3692512390,1655016322,1655017197,875,2260
3823942349,3795508879,1669607813,1669608463,650,532
3429004715,3347854994,1645635190,1645635794,604,319
3807538433,3892023630,1661531021,1661531890,869,817
3704437148,3044450059,1652600720,1652600992,272,93
3246024635,3822458181,1669232170,1669232698,528,878
3118807144,3202063550,1654074247,1654074754,507,328
3147336288,3542204344,1655222156,1655222903,747,1218
3430165544,3413111275,1642256449,1642256780,331,2107
3898403925,3928810650,1654810748,1654811352,604,94
3987606604,3601562567,1646078824,1646079116,292,288
3631340178,3883846613,1646573331,1646573805,474,1718
3061619114,3255248380,1657210545,1657211206,661,538
3124063685,3385246088,1661138163,1661138960,797,380
3888895982,3514354263,1658391694,1658392368,674,740
3409050239,3983162503,1647669142,1647669890,748,752
3140682569,3045925816,1643042287,1643042859,572,663
3028910693,3044483301,1646597849,1646598039,190,1797
3413948595,3687243333,1659595341,1659595382,41,2440
3493752989,3059151355,1656565623,1656565751,128,41
3501972053,3333872407,1647233024,1647233773,749,181
3393528919,3003872692,1667083494,1667084114,620,1379
3938505582,3675359399,1647372027,1647372529,502,1331
3566834497,3521160717,1652625270,1652625690,420,2042
3388628484,3689231617,1648726151,1648726377,226,2028
3448866192,3927886349,1659603518,1659603701,183,1783
3243018622,3472983363,1662863187,1662863935,748,520
3386868280,3795792181,1650563336,1650563573,237,1496
3599104606,3669299007,1645107527,1645108426,899,472
3289332257,3933450798,1644809898,1644810415,517,2020
3418276734,3058855369,1645460025,1645460274,249,1978
3492103801,3468516508,1641932353,1641933008,655,162
3001302955,3800451074,1669343184,1669343637,453,2316
3128287586,3335573495,1658000343,1658000541,198,411
3705809622,3996587507,1651994366,1651995148,782,1243
3035287101,3724116295,1653299172,1653299227,55,1289
3152518339,3197371652,1663854266,1663854609,343,1452
3127467065,3927864902,1646210194,1646210980,786,193
3223694966,3835355277,1657667430,1657667446,16,813
3354330082,3235049473,1646105884,1646106820,936,1688
3514335388,3917373940,1653508389,1653509039,650,1324
3225500469,3759165741,1642961110,1642962107,997,408
3046707177,3860879385,1661786018,1661786605,587,1509
3087612913,3449395269,1658266433,1658266473,40,1315
3524315738,3066439887,1662093896,1662094647,751,1441
3773658133,3913366963,1657248587,1657249543,956,124
3565700391,3473037406,1660460576,1660460635,59,1783
3390431277,3280717680,1669326355,1669327128,773,1192
3292812509,3822187489,1657889274,1657889693,419,2390
3502815865,3431117217,1648878101,1648878373,272,1134
3278297907,3222870125,1662910334,1662910541,207,419
3415892236,3497911447,1645149045,1645149088,43,666
3100239217,3867026366,1649680981,1649681704,723,401
3295806447,3566257032,1663957799,1663958184,385,1256
3546859493,3086653619,1646606931,1646607115,184,2158
3391622565,3104472516,1650934577,1650935470,893,240
3003243547,3558539337,1647144277,1647145211,934,390
3660575608,3732472752,1655979063,1655979936,873,1358
3679141266,3353422891,1642105354,1642106245,891,234
3794408677,3348102929,1666897979,1666898825,846,1909
3215453691,3313687025,1654363357,1654363361,4,2174
3033029762,3184539687,1665858414,1665858695,281,2177
3254866960,3130135928,1648757509,1648758402,893,2456
3444174394,3384307655,1650635040,1650635588,548,1744
3701370209,3188726102,1652301149,1652301197,48,1557
3789314517,3965960711,1656833544,1656834318,774,2203
3113423573,3415892236,1667408599,1667408951,352,189
3993513856,3396146110,1647853710,1647853732,22,1156
3174676733,3710681792,1660811766,1660812309,543,1232
3397987502,3024651290,1665141659,1665142170,511,1121
3478362234,3040715509,1649989073,1649989781,708,1235
3250248786,3439462043,1665225858,1665226275,417,1197
3622596133,3367865740,1663050289,1663050547,258,986
3080829502,3039081980,1650637370,1650638017,647,1938
3437603547,3069318012,1642539605,1642540426,821,1976
3887791096,3959497834,1649841636,1649841891,255,2418
3868474839,3804329236,1641764135,1641764531,396,735
3606643671,3474259908,1666993322,1666993970,648,1759
3052875832,3722945080,1650321258,1650321753,495,1860
3642339062,3839200168,1645904888,1645904925,37,1003
3859976372,3806520351,1664849593,1664849911,318,138
3197323395,3536080615,1651249882,1651250022,140,1250
3552091513,3687617825,1664436503,1664437429,926,1582
3948969420,3889288487,1647824325,1647824888,563,1277
3110649041,3165536332,1648195334,1648196025,691,1058
3299191225,3894030912,1645204034,1645204956,922,567
3397376963,3428026242,1647193978,1647194010,32,324
3685715658,3815507952,1641716001,1641716983,982,2330
3066426534,3452391459,1659667456,1659667981,525,727
3570152654,3255149739,1668772055,1668772746,691,208
3717137928,3423298470,1654294528,1654294792,264,1158
3202453519,3932077086,1643128718,1643129085,367,1427
3205543673,3188936143,1667920477,1667920785,308,222
3212707122,3133805973,1668060133,1668060729,596,1804
3129500635,3291780380,1652243376,1652244304,928,2285
3299472791,3496921526,1649566502,1649566611,109,685
3439462043,3727995134,1666678530,1666678701,171,1205
3807440065,3984818292,1666830778,1666831106,328,1982
3951216492,3767409219,1645602430,1645603338,908,2226
3102992210,3823650698,1667803321,1667804138,817,8
3891477592,3506045470,1651469857,1651470296,439,2139
3150027454,3516107946,1643789355,1643789890,535,1801
3161586578,3253436330,1654144311,1654144766,455,310
3409034003,3370350588,1665736474,1665737066,592,1786
3266867093,3894593426,1665894763,1665895058,295,271
3121336226,3659771853,1650938436,1650939367,931,1147
3994014690,3380822514,1644754290,1644754530,240,74
3724523438,3914166761,1664926746,1664927156,410,709
3456603950,3083235668,1655109161,1655109588,427,665
3579642249,3395236647,1661094901,1661095746,845,1919
3292812509,3778402105,1666130013,1666130669,656,2114
3595270507,3343232841,1658598971,1658599787,816,62
3118188990,3258417294,1647493869,1647493881,12,2031
3955750752,3112287858,1657635040,1657635092,52,1541
3814899146,3180101007,1645603912,1645603925,13,2464
3520392773,3415917688,1669552840,1669552897,57,433
3191414403,3156942626,1646099129,1646099877,748,2492
3553241769,3425002636,1657057790,1657058187,397,381
3849701361,3052396813,1649501760,1649501909,149,1154
3986003303,3796275634,1657672032,1657672065,33,97
3995868243,3358968691,1654874573,1654875360,787,477
3141997314,3527067891,1656620938,1656621304,366,1712
3768211591,3315402916,1658130232,1658130465,233,1315
3880580622,3124927662,1652069031,1652069496,465,516
3350783192,3421600026,1643805677,1643805977,300,2028
3888438556,3787230225,1662994974,1662995604,630,1339
3523631626,3336525489,1645250236,1645251075,839,1670
3997162156,3635502276,1658266431,1658266591,160,1518
3104459009,3734035973,1658498678,1658499209,531,120
3672751607,3516865615,1664814257,1664814807,550,1560
3149668198,3019669727,1663725913,1663726481,568,1416
3338082003,3520385284,1662505579,1662506198,619,1766
3666268915,3145961063,1661466278,1661466604,326,76
3797259426,3323936820,1659335548,1659335665,117,551
3461505923,3991046503,1649201791,1649201849,58,1758
3658260972,3550874434,1659021455,1659022405,950,1249
3572224210,3712211736,1648139690,1648139910,220,925
3312580754,3894359262,1656387132,1656388103,971,989
3707604534,3726883867,1650954720,1650955644,924,1543
3559696066,3641752896,1659315197,1659315381,184,463
3566534974,3125008218,1650619085,1650619971,886,175
3452275962,3141196312,1643118197,1643118628,431,139
3097033729,3638847705,1666793650,1666794305,655,152
3014185506,3894115655,1664459423,1664460351,928,1245
3265725715,3561562385,1649554531,1649554715,184,1697
3405168756,3683198772,1648370863,1648370963,100,252
3934914335,3744645350,1656404171,1656404555,384,1876
3431892611,3097395182,1642837092,1642837536,444,515
3805665502,3895542691,1666777293,1666778027,734,724
3239377872,3629999604,1669570213,1669570819,606,129
3774437189,3536768410,1663010286,1663010726,440,1419
3607717009,3577651077,1658345062,1658345440,378,1975
3290681709,3190454065,1646602453,1646602675,222,2031
3242622170,3482576542,1667920559,1667920631,72,2100
3154680228,3808541027,1643898446,1643899362,916,1749
3317318302,3411993487,1664114500,1664114746,246,1430
3011015055,3239158180,1666569235,1666569348,113,2164
3523305140,3388971461,1647530912,1647531415,503,1614
3112419355,3867101565,1661698399,1661698730,331,1777
3233932115,3401382792,1654660060,1654660728,668,1447
3192005711,3586950573,1665794854,1665795032,178,1319
3246900158,3982916950,1648232123,1648232674,551,46
3008470758,3036801405,1643338200,1643338617,417,1242
3658271419,3692498377,1662686409,1662687321,912,2170
3172429422,3999551936,1650215298,1650215412,114,273
3678152024,3665148560,1646055921,1646056855,934,1231
3196822601,3592906293,1659398942,1659399745,803,1791
3961721758,3021287506,1660977611,1660978117,506,1057
3188588023,3946409673,1657385254,1657385711,457,810
3688758916,3399552669,1649602530,1649603069,539,1543
3918581818,3306515955,1655545626,1655546021,395,363
3089126812,3720223108,1649515146,1649515273,127,719
3551792540,3451263201,1666296238,1666296820,582,528
3567368088,3289799796,1668921813,1668922465,652,1214
3973264936,3228737899,1647952597,1647952615,18,796
3736085476,3104944123,1654116491,1654117019,528,2413
3564089463,3385196866,1663899590,1663899683,93,1906
3903588940,3118425000,1643224693,1643225566,873,1691
3237841242,3686826205,1657764729,1657764840,111,1142
3802749978,3724455974,1652389055,1652389368,313,1081
3369792484,3007339106,1650251635,1650251979,344,263
3962746969,3151346211,1664366835,1664367035,200,1694
3640587334,3439280560,1642303055,1642303223,168,583
3592519306,3025014828,1664023039,1664024002,963,832
3027110508,3936821313,1641694815,1641695179,364,58
3810861883,3581011004,1659638816,1659639489,673,1898
3792012199,3578219289,1644320843,1644321748,905,217
3716757245,3119345546,1655189366,1655190295,929,1190
3416230781,3543872563,1645321163,1645321242,79,280
3548799053,3158834421,1649589604,1649589651,47,618
3037090215,3019601621,1649026584,1649026928,344,830
3850214790,3085412399,1655415251,1655415586,335,1036
3894454988,3439660528,1644565169,1644565491,322,1402
3065246027,3364600039,1660325848,1660326420,572,209
3170036337,3629225227,1668954395,1668955245,850,896
3015593061,3309286736,1663733043,1663733767,724,943
3745712275,3222563704,1645960413,1645960832,419,825
3005771350,3563103144,1659079149,1659079860,711,100
3177628377,3184669033,1655370063,1655370768,705,1372
3241847877,3713455058,1660905082,1660905642,560,265
3811318665,3790751649,1652816706,1652817568,862,1297
3840449491,3744726408,1666094218,1666094550,332,1719
3400730635,3555272427,1655175414,1655176371,957,1774
3338749992,3757507821,1659373746,1659374153,407,1015
3973713516,3339856407,1658919941,1658920744,803,791
3671054235,3752797217,1666321230,1666321782,552,2319
3916244157,3569006301,1649873089,1649873713,624,2437
3931789231,3734621671,1647666956,1647667354,398,627
3734621671,3825930964,1641625157,1641625638,481,1544
3976453338,3032018734,1659776234,1659776984,750,1463
3168329235,3421671936,1655199095,1655199637,542,1338
3248395971,3279351560,1653902650,1653903019,369,1423
3527221438,3896960517,1647619724,1647620027,303,1298
3012892515,3958539607,1650398934,1650399709,775,2151
3616901816,3128009914,1644282965,1644283320,355,2025
3900911220,3438084709,1666794461,1666794955,494,2143
3050434345,3822126164,1657136724,1657137519,795,93
3568756567,3541579882,1655786592,1655787551,959,1123
3951354982,3675418278,1648760852,1648760869,17,873
3947788644,3850178015,1655194833,1655195245,412,1401
3876696308,3468654589,1660200897,1660201056,159,396
3188126815,3908727190,1662597184,1662598068,884,992
3963841091,3144993263,1655180576,1655180936,360,2495
3415522797,3918552618,1655359060,1655359828,768,1304
3741024153,3048721189,1661498093,1661498779,686,1953
3671054235,3974630210,1664585134,1664585713,579,1612
3924879744,3386724007,1657894842,1657895595,753,1013
3137967669,3467686942,1669566427,1669567329,902,1560
3506090868,3844666457,1656684250,1656684426,176,2096
3223694966,3630750697,1649476051,1649476059,8,1579
3750160040,3015956370,1655237048,1655237068,20,2221
3345186165,3180062640,1652120325,1652120525,200,1764
3193890426,3469783180,1659466604,1659466983,379,1588
3174499556,3592906293,1662817609,1662817613,4,564
3434224349,3505417530,1658196908,1658197142,234,1688
3894508827,3024979152,1659941072,1659942064,992,2029
3679617161,3443360830,1658092102,1658093042,940,191
3527106895,3052499026,1648801445,1648801783,338,2254
3079029428,3804064265,1653235244,1653235629,385,1611
3310294122,3392569339,1658687536,1658688202,666,50
3564592902,3256807270,1645323144,1645323347,203,1611
3888505889,3112622637,1646206191,1646206366,175,850
3224617784,3114744245,1652504351,1652504999,648,160
3848740333,3741978230,1665288002,1665288433,431,579
3670550887,3625651694,1659660830,1659661513,683,512
3300015174,3105243389,1662900323,1662900439,116,947
3699533383,3770771031,1652363499,1652364451,952,1289
3957689713,3843331100,1642269012,1642269480,468,2228
3436916222,3364456908,1643213123,1643213172,49,2330
3914796719,3971648409,1664271147,1664272115,968,1883
3048896097,3960494982,1661366699,1661366908,209,1863
3875434702,3886368625,1645367553,1645368219,666,1012
3435915872,3478097925,1667259650,1667260428,778,1400
3086084685,3150893774,1665256724,1665257207,483,2000
3414488975,3016992122,1663803853,1663804437,584,1902
3680453323,3125911793,1655106057,1655106632,575,522
3407409307,3951692395,1647585373,1647586240,867,794
3897491493,3365381632,1659170596,1659170813,217,824
3708777992,3952425376,1643597050,1643597747,697,1356
3393199571,3205423909,1644086997,1644087649,652,2096
3361422449,3625034951,1657099062,1657100056,994,2262
3098667748,3415535285,1656579308,1656579749,441,1700
3093178960,3124574350,1660975957,1660976681,724,371
3888757366,3291175188,1666545436,1666545604,168,163
3727706350,3207801201,1649447823,1649447878,55,2194
3415041326,3798509385,1649157143,1649157825,682,2331
3018756378,3678425549,1644468204,1644468736,532,2164
3576422890,3914348680,1644681663,1644682581,918,2053
3381821132,3277978979,1668515679,1668516159,480,1821
3320488617,3887054161,1643469554,1643469994,440,2474
3642946322,3763912599,1668302757,1668302881,124,2460
3465796988,3772337054,1643134765,1643135307,542,899
3530495336,3175706913,1658838606,1658839570,964,965
3607717009,3854390772,1648582549,1648583174,625,1395
3696096099,3243086924,1646403539,1646404399,860,2125
3541157955,3686247296,1650949523,1650949603,80,803
3939480099,3895861447,1665899738,1665899950,212,1707
3458493864,3693652924,1659662666,1659662909,243,525
3769269484,3078830914,1651389449,1651389883,434,303
3630963449,3059447105,1658701355,1658702027,672,1738
3947879014,3301119536,1651839619,1651839726,107,692
3704980935,3782182063,1666488988,1666489976,988,1782
3542293606,3898959510,1641374840,1641374879,39,1443
3211015636,3890335277,1655254880,1655255088,208,2489
3286129059,3173667762,1643288540,1643288672,132,2051
3319365305,3953224601,1669312635,1669312793,158,47
3383686911,3884551317,1657802091,1657803088,997,1312
3642318884,3516410980,1667481383,1667481543,160,198
3599795440,3927660473,1652111594,1652112430,836,671
3755243698,3544965463,1667671823,1667671975,152,1153
3061594355,3398840886,1653494402,1653494740,338,2295
3458209928,3664381582,1645506062,1645506209,147,2095
3581302872,3464983756,1669130664,1669131298,634,488
3287175350,3571972204,1644153744,1644154036,292,2493
3082026010,3600501749,1667574722,1667574948,226,1073
3998728915,3951845301,1656847855,1656848390,535,1450
3437707461,3104870555,1648213399,1648213492,93,2473
3640508439,3048504189,1660259126,1660259479,353,350
3924583665,3149534519,1641651554,1641651778,224,2227
3071850041,3201446016,1661866968,1661867782,814,2139
3569738818,3881143383,1644348224,1644348523,299,79
3392121294,3790783685,1658661035,1658661374,339,943
3952283751,3973440480,1655574153,1655574201,48,1136
3622478840,3860430252,1642581374,1642581955,581,1614
3096386556,3995365519,1668337491,1668337556,65,772
3440778681,3861263764,1657011504,1657012370,866,159
3389560959,3866158221,1645973722,1645973906,184,1053
3404432145,3762422234,1644378583,1644379233,650,1239
3194342775,3679533416,1643892579,1643893243,664,144
3272879760,3962518574,1649089947,1649090523,576,1290
3574240169,3385413048,1658376937,1658377436,499,1394
3364945349,3729389785,1657037265,1657038129,864,939
3001912243,3739865914,1649338304,1649338486,182,813
3734779425,3834011879,1661555680,1661556001,321,585
3300380060,3185373368,1642231979,1642232406,427,1606
3356728242,3458815526,1650043843,1650044002,159,1532
3132863382,3651058536,1663036902,1663037096,194,1016
3637408266,3970886019,1644540330,1644541306,976,1489
3637269987,3455537522,1647560861,1647560957,96,733
3364199338,3637993177,1647835496,1647836422,926,902
3995654203,3764298989,1642391233,1642392096,863,2441
3787714854,3439120258,1647648468,1647648571,103,1701
3130973015,3270273033,1651084703,1651084935,232,2174
3896982954,3039198774,1651226600,1651227197,597,3
3567126985,3540730645,1652237465,1652237680,215,291
3850214790,3625684557,1652703401,1652703570,169,844
3254930364,3640765121,1660315681,1660315911,230,653
3802545642,3156210736,1659495674,1659496154,480,922
3806015172,3132349279,1663027114,1663028044,930,1464
3491306285,3912183552,1665084352,1665084464,112,1961
3313431689,3034601276,1646564012,1646564785,773,966
3332721407,3911671645,1657106871,1657107844,973,838
3472375572,3357029840,1642319526,1642319897,371,1065
3142765587,3567637602,1648904006,1648904496,490,1946
3657333207,3232835207,1643342200,1643342204,4,2128
3097161771,3088553332,1663232068,1663232851,783,74
3787230225,3868873330,1646381040,1646381100,60,1132
3957824946,3007308564,1664961301,1664961985,684,722
3702932977,3297123407,1663501558,1663501974,416,1594
3011225738,3686641761,1661320898,1661321596,698,599
3802040767,3079219552,1666852215,1666852413,198,1533
3501520918,3899301205,1647761403,1647761594,191,1959
3046380642,3099224416,1650916822,1650917304,482,1244
3353422891,3613730980,1659270398,1659270752,354,2179
3750277600,3611100286,1644528709,1644528979,270,1137
3777929700,3891518316,1653016213,1653016983,770,459
3061366261,3231701470,1648282529,1648282616,87,1091
3048045312,3736911154,1664705297,1664705787,490,143
3698706740,3084982671,1641331730,1641332542,812,83
3729600228,3982210988,1667887680,1667888519,839,2085
3152537793,3760975208,1644821168,1644821186,18,1948
3286476251,3623769570,1644891481,1644892257,776,1721
3585495750,3074477991,1664176128,1664176248,120,2287
3154435614,3194618871,1651635580,1651636211,631,1228
3865422787,3660575608,1646748835,1646749273,438,2315
3947369111,3930118877,1661313111,1661314011,900,1474
3102672864,3096541903,1657377976,1657378864,888,878
3124941982,3626020948,1650198312,1650198863,551,2112
3643372353,3693797946,1642328024,1642328542,518,540
3552958954,3516585405,1654236250,1654236388,138,1978
3333872407,3444067052,1657913155,1657913986,831,179
3011567148,3263328793,1669125542,1669126003,461,2308
3993066194,3355942761,1657266519,1657266998,479,1368
3273379502,3000986440,1643044246,1643045183,937,871
3877902487,3583985803,1667111729,1667112164,435,7
3092365114,3057922933,1645779406,1645780140,734,1758
3561529281,3386628594,1663690104,1663690302,198,2170
3336991621,3518246885,1665618069,1665619003,934,1383
3856882586,3146555014,1646478635,1646479255,620,490
3319334426,3726117061,1658324957,1658325325,368,2491
3876377964,3042836639,1647465184,1647465958,774,1646
3282166903,3806737055,1663474212,1663474294,82,1172
3699258770,3600692380,1669040317,1669040686,369,373
3682279970,3868427833,1653988667,1653989051,384,194
3686407290,3910712536,1647730663,1647731549,886,697
3888438556,3592906293,1646880154,1646880520,366,751
3622978712,3711701083,1644163245,1644163982,737,247
3098316380,3648305208,1669137369,1669138307,938,178
3266751679,3447743170,1642063248,1642063669,421,1887
3225989431,3825930964,1643033872,1643034457,585,228
3634282428,3985620157,1646944342,1646944657,315,1511
3156483651,3786478382,1646726675,1646727578,903,1910
3334792271,3024447668,1666398309,1666398637,328,931
3463003824,3310953839,1655119806,1655119832,26,23
3540735539,3115777637,1655829470,1655829900,430,70
3744759130,3905922866,1649149415,1649149771,356,1938
3117234289,3367457506,1657123298,1657123487,189,928
3613021322,3995850572,1664241887,1664242562,675,1535
3900401259,3601499230,1667177362,1667178208,846,41
3038211411,3130899709,1659927079,1659927142,63,849
3025133604,3153518026,1669001193,1669001847,654,2231
3339312980,3140407144,1666143628,1666143867,239,1116
3280328195,3185250646,1655377642,1655377883,241,2189
3474558723,3612269633,1658046400,1658047059,659,436
3909558934,3788717673,1646857788,1646858660,872,178
3092941538,3675429073,1654929081,1654929514,433,1742
3934489625,3297290662,1663432376,1663432961,585,2417
3183340735,3515941468,1668269844,1668270069,225,1490
3361422449,3413300274,1663541936,1663542079,143,1866
3341897848,3447257561,1650537577,1650537870,293,1317
3485995293,3298993308,1664037150,1664037804,654,1316
3307033178,3041386590,1641502306,1641502970,664,2170
3308028752,3307933176,1661940576,1661941020,444,2386
3977872515,3179280029,1669030866,1669031324,458,1530
3554275173,3683507812,1668255178,1668256004,826,1511
3634041831,3419117613,1651826896,1651827392,496,499
3773770885,3612556887,1649441320,1649441871,551,2069
3060727793,3645868952,1641958523,1641959412,889,1544
3876097800,3771028638,1663288684,1663289404,720,1512
3625606853,3067179904,1663146631,1663147579,948,57
3691367177,3104306511,1666309415,1666310241,826,1721
3951216492,3980108258,1665846785,1665847169,384,643
3677001111,3556648442,1657627388,1657627665,277,1169
3884704204,3651753987,1644371556,1644371568,12,2341
3451167153,3353388722,1660164455,1660165088,633,1313
3662455665,3374007172,1655443555,1655444442,887,2297
3973440480,3518932161,1668236591,1668237493,902,2272
3377473764,3279239799,1660285506,1660286350,844,1998
3065298582,3490430582,1669459794,1669460444,650,867
3710943716,3646797040,1667278918,1667279561,643,2025
3546954605,3643412582,1661578549,1661579165,616,2226
3534192041,3268349855,1649039311,1649040232,921,1309
3894508827,3821120962,1642633244,1642633302,58,1188
3749327438,3470102638,1642553020,1642553387,367,1162
3437309077,3872626198,1661140387,1661140976,589,2473
3861173090,3925754107,1642764887,1642765159,272,686
3135119423,3229881750,1667922251,1667922744,493,467
3264993323,3125459736,1642371056,1642371740,684,2242
3420520626,3855218155,1661058677,1661059045,368,1976
3672350582,3477243904,1661400800,1661401367,567,1289
3337738889,3647994845,1641259465,1641260068,603,344
3188936143,3068982966,1649167197,1649168071,874,1752
3955776304,3225328547,1641722859,1641722931,72,38
3756806050,3362148197,1665717542,1665718266,724,124
3184539687,3685715658,1642283327,1642283927,600,1880
3185611253,3816690173,1663219801,1663220513,712,947
3597794683,3606331231,1653818292,1653818439,147,986
3607978764,3439700326,1661034864,1661035250,386,1824
3571173934,3371970996,1666266973,1666267531,558,2298
3188936143,3447440058,1656520576,1656521077,501,2272
3982058383,3426585956,1648865898,1648866731,833,1690
3345138946,3414502284,1656470577,1656470972,395,2391
3220750989,3590228003,1662355985,1662356801,816,2363
3399180008,3091418450,1644186344,1644186722,378,2266
3529381895,3848272906,1647402687,1647403523,836,2034
3823942349,3168329235,1665009054,1665009092,38,1515
3806875541,3224095644,1647105431,1647105621,190,2383
3106436957,3840694563,1666000773,1666001105,332,1940
3608775321,3367279073,1669541505,1669542131,626,1819
3298770258,3289108426,1649084257,1649084707,450,1575
3310496626,3190906256,1664386562,1664387206,644,2402
3341248102,3648593799,1660607343,1660607418,75,693
3332721407,3090588645,1657083554,1657083662,108,1202
3854357910,3038035861,1663506339,1663506823,484,652
3803799575,3599551667,1669530209,1669530381,172,593
3624911947,3339349217,1655289617,1655290033,416,1976
3128009914,3150582711,1659867978,1659868157,179,40
3852344377,3505600550,1650497721,1650498052,331,734
3827937024,3293761762,1657689314,1657690008,694,1899
3795934256,3611967437,1667318766,1667319567,801,2458
3016616906,3772035177,1662244334,1662244994,660,921
3264018414,3171413650,1645046391,1645046519,128,2212
3412715210,3175295329,1655072872,1655073759,887,2136
3881206954,3351441481,1660945781,1660946183,402,2332
3135116989,3815605229,1664904361,1664904677,316,1466
3251854206,3975075818,1658860067,1658860743,676,160
3891477592,3634885711,1651222997,1651223929,932,121
3056030317,3466459383,1667157470,1667157730,260,1407
3612720177,3404200815,1656843968,1656844228,260,857
3243059921,3883976824,1662949512,1662949873,361,689
3643412582,3363733362,1667509047,1667509911,864,1617
3284269721,3252157235,1647412581,1647412779,198,841
3938949913,3777872237,1667367813,1667368654,841,2026
3775146250,3201446016,1669095415,1669095700,285,1403
3980841914,3832370690,1665059524,1665059915,391,713
3957973658,3719445490,1646560393,1646560965,572,408
3671147965,3364842162,1646204515,1646205408,893,1183
3568965374,3666072303,1646541742,1646542114,372,2304
3297626110,3634885711,1661014840,1661015556,716,1027
3839200168,3914888679,1659739627,1659739907,280,2210
3784948704,3904625406,1641444500,1641444906,406,1678
3133030435,3677300151,1651763324,1651763953,629,2219
3879001343,3810891199,1667719700,1667720521,821,1892
3687617825,3068723030,1655525188,1655525572,384,500
3009141852,3902739418,1664566354,1664567199,845,1140
3002029298,3769198196,1651507133,1651507887,754,2048
3820070209,3468703620,1657197692,1657198257,565,603
3034827961,3354055639,1653658243,1653658521,278,1912
3257865090,3260783577,1653102900,1653103273,373,1302
3460428731,3710189327,1647649086,1647649388,302,2277
3477770827,3241007838,1658307645,1658308531,886,947
3313295291,3081396297,1643418183,1643419039,856,1723
3192375486,3949620827,1660130163,1660130223,60,223
3900101700,3772788087,1641108721,1641108989,268,299
3270395343,3994007098,1652636016,1652636459,443,422
3132863382,3968143962,1646259976,1646260488,512,1832
3878180077,3331336589,1651412405,1651413291,886,2210
3778575442,3869293895,1669554239,1669554688,449,2229
3630982131,3564839908,1654966749,1654967368,619,591
3185360566,3112859411,1662933210,1662933566,356,1868
3146072606,3282166903,1652022636,1652022718,82,470
3415768719,3432462167,1659477236,1659477908,672,271
3580280923,3610056283,1662435326,1662436008,682,1286
3905581902,3946833004,1648777536,1648778054,518,820
3370771897,3970444667,1655985607,1655986376,769,1311
3607959490,3520758396,1648847143,1648847777,634,54
3859634422,3766193314,1644032951,1644033476,525,1753
3753483202,3154991935,1669050166,1669050853,687,2022
3462412055,3109980927,1657421070,1657421773,703,1254
3027287663,3604456101,1660736629,1660737156,527,1255
3421178618,3886158471,1656929310,1656929357,47,96
3395525819,3097033729,1645210695,1645210985,290,2287
3607354151,3473394094,1656720670,1656720945,275,1545
3544365476,3795250558,1645277977,1645278911,934,1511
3927388172,3976970303,1651456384,1651457267,883,1098
3536768410,3009835115,1662867951,1662868382,431,2183
3965863452,3427225872,1653721478,1653722355,877,2186
3142463511,3247047829,1655397168,1655397490,322,1473
3595284541,3126995401,1656073071,1656073886,815,1590
3099546139,3065246027,1654853392,1654854279,887,293
3156483651,3722817789,1654234668,1654235531,863,1950
3372334548,3374688375,1662951281,1662951469,188,2164
3051253299,3757507821,1646732060,1646732975,915,302
3032498591,3935740815,1663437944,1663438808,864,656
3014646091,3260157601,1659273915,1659274000,85,1973
3666782310,3292739128,1656882453,1656882647,194,1064
3257690557,3813666053,1662317406,1662317892,486,187
3691474413,3606545393,1668438445,1668439199,754,2078
3004160380,3012032774,1644953981,1644954852,871,1461
3103404280,3872626198,1655687743,1655688716,973,1200
3156189187,3722972444,1659784228,1659784326,98,1072
3002727939,3000275416,1667543512,1667543553,41,468
3039081980,3718176139,1652800257,1652801052,795,2061
3804458349,3145220460,1653624764,1653624977,213,1113
3617349707,3398257086,1659515290,1659515466,176,2493
3389472671,3870032753,1652530174,1652530686,512,2235
3822404633,3260867614,1661042777,1661042843,66,184
3698358344,3641493201,1666621372,1666621760,388,1305
3510247235,3997051818,1659890671,1659891132,461,1567
3252157235,3022401876,1645044824,1645045053,229,532
3238443990,3548133562,1669439642,1669439961,319,1432
3422046745,3782673553,1648704884,1648705300,416,1147
3260861147,3258057377,1653904090,1653904329,239,1212
3510634049,3209544947,1646430483,1646431478,995,331
3995358434,3113427537,1654117656,1654118616,960,2315
3704604706,3239162274,1653483076,1653483364,288,829
3002415281,3584402021,1642139686,1642139993,307,673
3437593879,3572164547,1652335950,1652336863,913,1213
3103404280,3472112661,1650755575,1650756441,866,1026
3020729502,3062423981,1664825159,1664825624,465,1429
3168655636,3037846389,1651923908,1651924214,306,78
3798728420,3816194055,1653504112,1653504467,355,1520
3843157491,3115343467,1644462206,1644462368,162,1172
3136396999,3611967437,1653976322,1653976684,362,1467
3510528970,3491718080,1664738999,1664739220,221,1042
3085429140,3013484024,1651117396,1651117914,518,663
3663474230,3316496524,1657366968,1657366996,28,83
3270923168,3287714636,1649649971,1649650001,30,268
3466494394,3981173642,1652186481,1652186831,350,1318
3120737114,3622478840,1642101561,1642102446,885,2147
3129641154,3640587334,1643712096,1643712891,795,1256
3901360663,3442799166,1646782838,1646782878,40,1302
3854535872,3289108426,1654491364,1654492333,969,1652
3757044916,3499026312,1667195648,1667195738,90,25
3787071341,3864485247,1659361205,1659361241,36,546
3106788261,3424476490,1665646908,1665647153,245,117
3248324593,3366192341,1658756672,1658757580,908,1147
3989991456,3569401888,1644680686,1644680754,68,2188
3975864053,3942273552,1664259348,1664260047,699,484
3294319716,3319965397,1645144563,1645144896,333,1708
3211047702,3734534401,1644551169,1644551722,553,709
3852704822,3885893310,1661695953,1661696868,915,1767
3585674939,3823206701,1653631705,1653632217,512,48
3493447321,3048328762,1641509346,1641509701,355,690
3815462032,3286424440,1642112401,1642113274,873,2160
3258050916,3576661425,1644520430,1644520502,72,606
3324069408,3329751201,1650256832,1650257496,664,906
3808415962,3795342940,1658259942,1658260165,223,2197
3834174227,3947604616,1649526241,1649526864,623,996
3976156173,3549604297,1641872218,1641872483,265,1439
3441383531,3270923168,1658376805,1658377393,588,634
3541413511,3339649448,1644024676,1644025404,728,2337
3420205343,3797653596,1664108988,1664109878,890,185
3819172879,3284892894,1660705567,1660705601,34,1458
3273219526,3728950700,1659604469,1659605299,830,1399
3493138014,3456660113,1666098323,1666099030,707,1794
3563428558,3759421049,1650818254,1650818365,111,692
3130134092,3060121211,1645684539,1645685462,923,1800
3970288014,3104793032,1652944299,1652945110,811,2106
3103681676,3739233756,1658121835,1658122343,508,1672
3400233871,3094906195,1652735996,1652736987,991,219
3464734783,3797653596,1659045675,1659046653,978,1478
3993994586,3353527086,1653601532,1653602058,526,1414
3243873593,3413334821,1663578817,1663579223,406,1598
3776128581,3911849911,1659587237,1659587800,563,1796
3935022176,3563343479,1668626009,1668626743,734,1002
3614399988,3491306285,1660125302,1660125493,191,2010
3047643464,3835922991,1652066168,1652066733,565,886
3052889118,3413898378,1666353728,1666354653,925,2326
3222282745,3009366895,1668479096,1668479637,541,828
3297826818,3037048394,1660323795,1660324575,780,2090
3400604704,3295402408,1649043848,1649044804,956,1182
3215819425,3738887934,1641791323,1641791396,73,76
3462410204,3671437138,1660657193,1660658129,936,1857
3181237998,3084334078,1667421707,1667421889,182,1558
3738591594,3964664117,1641356061,1641356410,349,649
3637092038,3780654306,1643703751,1643704302,551,584
3912803496,3786322776,1649345700,1649346662,962,67
3157765022,3910427189,1663340366,1663341069,703,2484
3090057747,3290710394,1665857640,1665858078,438,1883
3364199338,3029956642,1668281584,1668282562,978,88
3344957789,3063714742,1641750069,1641750173,104,1150
3883846613,3645314586,1644084060,1644084756,696,2020
3639090741,3149181988,1653197586,1653198212,626,953
3546799061,3586489382,1642720606,1642721335,729,2001
3421728246,3282449988,1647270955,1647271298,343,714
3106732056,3953655387,1662761876,1662762661,785,1284
3043258601,3184720975,1663661269,1663661894,625,302
3787590278,3258057377,1657561712,1657561983,271,1789
3301620813,3934125569,1664868944,1664869400,456,2004
3702541874,3580531210,1651762277,1651762551,274,211
3966525848,3622062401,1660126326,1660127179,853,75
3292010262,3276482511,1643802234,1643802396,162,1319
3036046331,3069989068,1663238756,1663239093,337,1848
3297290662,3793032912,1669639980,1669640357,377,868
3696184358,3548128446,1651367160,1651367683,523,1748
3925344243,3959872101,1654741309,1654741756,447,1200
3040563913,3967754963,1669067648,1669068316,668,2435
3029149493,3323109920,1647904253,1647904941,688,1424
3017740025,3607622692,1645338850,1645339092,242,2411
3427937915,3733486808,1668253658,1668254418,760,377
3291267409,3534201448,1666576753,1666577223,470,2111
3258854274,3842677051,1642170526,1642170568,42,1810
3598576303,3597459911,1658645789,1658646511,722,1554
3341573446,3515837186,1666112914,1666113684,770,3
3766274699,3189002771,1659283602,1659284095,493,2073
3911439857,3189002771,1660400053,1660400891,838,114
3881002245,3187644022,1658082948,1658083018,70,1573
3964664117,3515480973,1667775469,1667776432,963,660
3346530861,3407746149,1656533717,1656534281,564,604
3345875910,3478362234,1646831633,1646832139,506,71
3014363081,3420676198,1662150363,1662150808,445,2413
3157190919,3098290557,1651332676,1651333376,700,433
3771028638,3830053941,1655713794,1655714508,714,1414
3074619364,3756806050,1650349499,1650349696,197,1024
3955307397,3190417421,1650187883,1650188802,919,1309
3013681789,3979696807,1652881701,1652882129,428,48
3956054666,3165845148,1647940670,1647941559,889,741
3693000511,3728974462,1645654500,1645654699,199,1659
3526793212,3272535116,1648343189,1648343424,235,1588
3590621650,3342189600,1654204021,1654204543,522,1437
3809059026,3438550737,1655572653,1655573188,535,825
3470286872,3921189235,1666480738,1666481475,737,1082
3757139792,3187257156,1654432645,1654432924,279,1499
3441383531,3410972917,1644575009,1644575725,716,2291
3891850013,3492749874,1648105803,1648106276,473,2158
3503453854,3688405055,1658655127,1658655612,485,1780
3000600578,3993866389,1659244341,1659245108,767,402
3025014828,3152537793,1642522212,1642522666,454,972
3474723005,3261265769,1665867163,1665867388,225,510
3043354217,3699152541,1666914590,1666915282,692,2293
3152036409,3048409719,1656102624,1656102956,332,74
3431117217,3605412707,1641972796,1641973448,652,1914
3106584115,3206061644,1650504373,1650504666,293,659
3148400970,3241007838,1651531017,1651531350,333,1680
3777022057,3546943801,1669285952,1669286763,811,1835
3479778946,3850474820,1643662587,1643663484,897,12
3188717499,3400000869,1669537475,1669538338,863,2079
3769391036,3197661010,1648696650,1648697486,836,1489
3136707992,3943947223,1658111897,1658112311,414,1125
3398278082,3242180365,1643336183,1643336800,617,1479
3656092578,3273827707,1654042459,1654043395,936,1350
3170325894,3100716894,1642700679,1642700874,195,516
3762525964,3734576015,1654626852,1654627568,716,789
3634089207,3819547274,1659859814,1659860255,441,1978
3369792484,3106395050,1668896201,1668896254,53,739
3081028310,3881956491,1645754975,1645755132,157,639
3762890946,3093589416,1646349624,1646350261,637,2094
3991046503,3734621671,1657073663,1657073825,162,929
3674037967,3048077825,1652986649,1652987334,685,851
3474808421,3890492731,1654308782,1654309468,686,1079
3456364565,3070117232,1653482351,1653483194,843,1751
3478097925,3833692711,1656105762,1656106177,415,1008
3105636655,3800337461,1654578863,1654578930,67,2372
3814572709,3930994715,1653315533,1653316365,832,1468
3167985603,3992927391,1667427984,1667428616,632,499
3704871253,3113608489,1657192085,1657192857,772,2050
3360051725,3052889118,1669637381,1669637411,30,178
3219637680,3814608487,1658518496,1658519246,750,1551
3660129917,3809387134,1652869337,1652870100,763,263
3780014272,3393552322,1664340443,1664340443,0,672
3288261603,3778405053,1661217920,1661218709,789,2258
3208831400,3949480596,1655263145,1655263482,337,1202
3102669962,3290359932,1668380262,1668381239,977,1586
3775501779,3118526217,1667030044,1667031037,993,1258
3711589639,3445469609,1650782327,1650782377,50,1046
3524942512,3808415962,1655970762,1655970988,226,2205
3021968850,3161999632,1650875904,1650876450,546,182
3049592624,3617746688,1642449742,1642450665,923,1788
3519233850,3057090135,1656065113,1656065123,10,1138
3272187328,3711016575,1651779007,1651779447,440,189
3217029107,3903108572,1654191051,1654191272,221,1998
3982715838,3212707122,1643228113,1643228485,372,1371
3252421501,3346832945,1641841193,1641842140,947,1394
3661462228,3692512390,1657421247,1657421778,531,1916
3340427847,3960036547,1646221632,1646222073,441,986
3790783685,3645310975,1651908581,1651909555,974,2262
3952389962,3832995595,1657392627,1657392775,148,815
3743569811,3409779636,1645106293,1645106532,239,309
3327933393,3938973292,1647558104,1647558623,519,907
3806629780,3408108471,1665794596,1665795485,889,839
3119869652,3645768666,1663973945,1663974542,597,654
3526365568,3333872407,1668342010,1668342908,898,69
3746969288,3948193261,1652441905,1652442682,777,1589
3917526154,3108342285,1648467980,1648468239,259,296
3887054161,3251744109,1656803887,1656804415,528,1013
3727801252,3875945215,1650756680,1650757463,783,912
3885926991,3582060994,1642604206,1642604972,766,2133
3847104925,3767868249,1648972654,1648973653,999,519
3242948145,3900309643,1649710533,1649711489,956,960
3517149250,3939755962,1648942076,1648942525,449,1304
3735098036,3902705203,1651802946,1651803263,317,200
3487104766,3152200344,1665483391,1665483427,36,760
3255115511,3728924033,1644394579,1644395221,642,2459
3148549210,3887054161,1661643243,1661643532,289,1527
3549752945,3882603510,1654590420,1654590571,151,503
3650342769,3039932020,1669723993,1669724020,27,1548
3927886349,3659326501,1656339598,1656339905,307,2392
3780808964,3165492854,1660394984,1660395340,356,2150
3438961567,3404330776,1642911404,1642912168,764,1872
3878512967,3889967886,1652746325,1652746611,286,607
3567656858,3538972815,1659718484,1659718687,203,794
3568162481,3173535458,1656895379,1656895504,125,1521
3933045461,3934453508,1653419787,1653420458,671,134
3381900638,3121932256,1663455924,1663456225,301,2024
3761147252,3066546417,1660708346,1660709086,740,1550
3778402105,3372334548,1667933809,1667934483,674,1745
3587568478,3966130885,1662694495,1662694738,243,1918
3058725687,3307033178,1664922424,1664922441,17,1851
3208464348,3126417218,1657716256,1657717101,845,1273
3448409263,3199892178,1644594530,1644595457,927,2335
3474975781,3687691090,1666710228,1666711188,960,267
3739048247,3668174777,1651912923,1651913759,836,2298
3620006027,3568614629,1656879080,1656879479,399,1805
3778575442,3139268488,1668188712,1668189286,574,1459
3441581446,3204114911,1664975825,1664975850,25,29
3658017612,3450811740,1643914090,1643914931,841,32
3411921561,3370217481,1644178984,1644179600,616,1333
3292010262,3930852270,1663327996,1663328351,355,1510
3819380768,3899890592,1647721755,1647721779,24,129
3069989068,3095594016,1660232324,1660232525,201,1776
3875945215,3068913990,1666321924,1666322396,472,1145
3523236646,3909002163,1654499497,1654499880,383,1377
3764724451,3028886204,1649732294,1649733005,711,2206
3649724545,3034985161,1641142665,1641142729,64,2054
3740102481,3501729913,1663314750,1663315192,442,918
3407770585,3049141347,1646875105,1646875477,372,2173
3909859344,3987860424,1646623945,1646624853,908,1614
3170844702,3339027368,1654708711,1654709175,464,1618
3567906153,3565781990,1661794882,1661795095,213,2257
3893475632,3057159511,1654693017,1654693068,51,2071
3461108375,3689231617,1669203079,1669203518,439,400
3809623566,3207875764,1659966557,1659966870,313,447
3762533949,3171734482,1666778852,1666779712,860,1443
3906024837,3940115951,1652796170,1652796704,534,1470
3996381336,3698898645,1665577514,1665578413,899,701
3675366639,3877299439,1658468728,1658468876,148,363
3917956140,3961420550,1658524988,1658525323,335,539
3435578430,3470102638,1655979155,1655980040,885,28
3176818286,3581026789,1669754090,1669754234,144,125
3784808734,3018946311,1665222266,1665222351,85,2301
3449125023,3728240849,1662001183,1662001569,386,407
3670154961,3057574793,1662010844,1662010922,78,2204
3211047702,3770948247,1661235659,1661236146,487,1765
3041223311,3516410980,1650527328,1650528054,726,2485
3969728585,3304958701,1651251846,1651252317,471,1609
3022082086,3641542734,1654411392,1654411908,516,1747
3918491301,3109980927,1644346998,1644347306,308,2264
3957051129,3288496623,1642274876,1642275151,275,591
3489695411,3763455710,1655042336,1655042445,109,116
3408240731,3038823274,1651351867,1651351948,81,386
3583859826,3134422689,1647522956,1647523080,124,640
3089471552,3600955732,1658941290,1658941994,704,1360
3286463125,3980050310,1649597349,1649597849,500,1669
3712276884,3084882941,1656601485,1656601801,316,1040
3740854424,3143293050,1649147482,1649148059,577,65
3928852706,3310169810,1644690979,1644691033,54,512
3433768649,3159873313,1666745402,1666745544,142,967
3268670465,3757499622,1641465265,1641466036,771,838
3780991625,3070810251,1648648106,1648648380,274,2250
3286555687,3397397223,1668154861,1668155742,881,806
3978691513,3316978783,1661577061,1661577487,426,2227
3995299995,3863080370,1668295221,1668295605,384,543
3060757458,3400786498,1664183198,1664183321,123,89
3112217806,3510805998,1641121453,1641121510,57,2017
3097982496,3996933937,1641839234,1641839863,629,1468
3986825518,3852253700,1642954616,1642955248,632,1220
3504641910,3488151008,1662968026,1662968362,336,286
3815718297,3554600361,1663407491,1663407906,415,2293
3832463052,3179891006,1642500947,1642501109,162,1451
3875483766,3362647814,1663834353,1663834690,337,821
3180973124,3500595056,1648167362,1648168006,644,794
3738761840,3368420871,1646636002,1646636113,111,2225
3458243810,3295020761,1645930968,1645931496,528,1701
3412675211,3257375975,1641947369,1641948306,937,1308
3640915578,3287399418,1655696432,1655696732,300,291
3814278185,3938417195,1666665654,1666665722,68,1762
3795494127,3730533080,1657502457,1657502477,20,1031
3093534312,3129993467,1663369204,1663369309,105,910
3166754795,3484264209,1662427980,1662428530,550,2385
3486810833,3169688960,1644721158,1644722116,958,2225
3456080836,3483666747,1648274494,1648274721,227,2010
3857081560,3886720244,1669546803,1669547019,216,193
3548670552,3618095446,1644143679,1644144540,861,1902
3467211844,3716137932,1664962145,1664962736,591,1039
3184955498,3185785923,1669496352,1669496832,480,1885
3938615588,3925344243,1645853924,1645854186,262,502
3891235779,3289330422,1654707994,1654708784,790,328
3199117399,3914926954,1642185587,1642186213,626,283
3385264040,3626156541,1647316061,1647316065,4,1540
3095559156,3458116043,1648083774,1648084639,865,168
3087278716,3242785599,1642949393,1642949912,519,1479
3124363805,3265324040,1645472039,1645472960,921,527
3628034615,3417411117,1641720170,1641720820,650,605
3506585658,3313615371,1655314309,1655314341,32,1069
3042446262,3927864902,1666585639,1666585781,142,834
3829149174,3091579646,1666155465,1666155993,528,1124
3507871733,3642377610,1646524898,1646525612,714,1563
3671699977,3054573274,1661575503,1661575884,381,874
3449395269,3616794499,1644563218,1644563948,730,1806
3582138072,3472706088,1663352039,1663353028,989,776
3134380066,3481466662,1648682187,1648682800,613,1632
3773505782,3792253761,1650725180,1650725921,741,1081
3479385096,3034827961,1665291838,1665292084,246,1547
3965926652,3461508348,1649347128,1649347961,833,794
3553950534,3987813210,1647026132,1647026451,319,505
3250312962,3761307187,1653657599,1653657675,76,2122
3962536480,3748988849,1658889845,1658889954,109,1767
3417298701,3338882756,1667509178,1667509352,174,1696
3131629372,3402511144,1665613875,1665614308,433,501
3303698845,3445530012,1668085393,1668086029,636,678
3068161140,3608297293,1661142145,1661142935,790,2019
3287600901,3687293094,1661571971,1661572740,769,153
3413300274,3986955632,1655373809,1655374025,216,2277
3023880168,3118443532,1657343792,1657344134,342,1986
3482235012,3039035602,1642112568,1642112988,420,1408
3415761431,3653925331,1656575072,1656575454,382,2013
3713693431,3751022139,1650512760,1650513735,975,405
3357699960,3956491451,1657981658,1657981861,203,1012
3791633858,3006507589,1655010083,1655010193,110,1853
3515480973,3039176873,1652222838,1652223483,645,1745
3171731237,3661243199,1644657268,1644657803,535,1816
3921189235,3449125023,1657271238,1657272162,924,947
3574285791,3377743288,1657733715,1657734630,915,550
3471221302,3534133715,1663932836,1663933049,213,1051
3137529896,3391324219,1643158107,1643158719,612,1806
3343543154,3729553337,1657132239,1657133230,991,1447
3246759301,3528271389,1657696357,1657696870,513,747
3350812449,3835708711,1666199724,1666200015,291,39
3561573044,3687243333,1653529464,1653530463,999,1973
3878573707,3759409777,1660545390,1660545773,383,1473
3625606853,3090304189,1644130425,1644130746,321,1572
3451263201,3485815053,1662425452,1662425616,164,2045
3828516865,3481672220,1669593539,1669594411,872,1898
3987860424,3124574350,1646305412,1646306228,816,2367
3362249024,3811930283,1661109553,1661110415,862,1726
3809458973,3550299952,1653345096,1653345199,103,1063
3506273643,3023772977,1655313652,1655314421,769,175
3104472516,3950146840,1667651830,1667652720,890,671
3058141936,3127549843,1657979191,1657979917,726,844
3549475344,3482509515,1641111907,1641112118,211,1707
3772034355,3008576449,1656680832,1656681693,861,266
3417248496,3349030618,1662461844,1662462841,997,284
3082708890,3764318951,1669115690,1669116146,456,2282
3816011687,3125436993,1659133353,1659134136,783,1071
3777568712,3104902156,1645165662,1645165902,240,2488
3682419396,3419809319,1648409356,1648410103,747,2268
3951592432,3942140107,1649983129,1649983661,532,1825
3382133724,3898391169,1653244677,1653245370,693,918
3864436164,3931677547,1649613762,1649614284,522,568
3726883867,3619660501,1660142371,1660142747,376,134
3843157491,3413592003,1641818541,1641819433,892,2189
3154435614,3787333178,1662507657,1662507821,164,2030
3776862606,3022283384,1644494007,1644494984,977,1917
3095594016,3338020076,1658148894,1658148916,22,2234
3132210207,3671971306,1657129896,1657130643,747,359
3375290121,3933845116,1657961348,1657962048,700,644
3933940005,3364911803,1648140720,1648140939,219,658
3466156489,3080007856,1648273602,1648273709,107,984
3339911597,3649649514,1654713581,1654713824,243,512
3532756620,3337967165,1660351032,1660351658,626,2202
3064522150,3095849365,1657141431,1657142243,812,1365
3555571916,3389546736,1651984936,1651985819,883,2051
3135134317,3885493402,1658726345,1658726464,119,786
3362647814,3149046961,1669345425,1669345688,263,22
3566693010,3159525512,1659167833,1659168262,429,153
3014185506,3251372174,1655861279,1655862230,951,2491
3913366963,3576961863,1651837900,1651838273,373,979
3759230876,3011158212,1668327598,1668328035,437,925
3402354750,3278190233,1662160937,1662161715,778,517
3456948150,3281907019,1643686015,1643686355,340,2420
3735167946,3489273340,1643277813,1643278542,729,2059
3994721189,3716137932,1642562480,1642562698,218,2246
3881206954,3210337290,1664861996,1664862381,385,1726
3347397074,3639059199,1647368762,1647368913,151,499
3653577731,3150067482,1659799830,1659800025,195,1737
3707676798,3565287194,1657014686,1657015544,858,1677
3049307137,3120762596,1669556729,1669556820,91,2336
3735167946,3865503383,1650143532,1650143533,1,1515
3114097031,3638595264,1645922507,1645923173,666,287
3508311968,3822126164,1654456225,1654456864,639,2431
3643185661,3702755503,1654567922,1654568104,182,39
3015246686,3875008839,1649352529,1649353424,895,2340
3269653223,3093599187,1652416643,1652417451,808,1803
3137942933,3043180716,1643685043,1643685626,583,1521
3463009951,3936914064,1656735911,1656736588,677,819
3351786927,3031816428,1642879605,1642879847,242,2443
3855754332,3863676573,1661052107,1661053103,996,1001
3112622637,3923647484,1655246735,1655246849,114,7
3816194055,3862138776,1669199021,1669200021,1000,243
3358745496,3831770571,1656642683,1656643624,941,1568
3787550831,3852344377,1648651899,1648652598,699,246
3674059710,3421294150,1653761117,1653761737,620,722
3249145163,3343177837,1659888995,1659889018,23,702
3035992910,3081028310,1651831577,1651832480,903,1060
3333095694,3311252249,1646843793,1646843863,70,1481
3095503795,3832640445,1644366299,1644366321,22,2428
3515550503,3265895976,1662147162,1662147542,380,830
3726883867,3774806676,1646111220,1646111632,412,2055
3252760026,3112859411,1646977097,1646977567,470,2430
3729340640,3228574805,1658106576,1658106643,67,1285
3611763388,3555108136,1644017524,1644017873,349,531
3903550568,3098546487,1659388686,1659388978,292,1211
3271409183,3921560605,1642227937,1642228173,236,1511
3827195774,3887290680,1649652800,1649653038,238,2447
3855777399,3434324683,1667990221,1667990457,236,1870
3325360523,3733072964,1659500002,1659500328,326,445
3434650074,3867640062,1659399008,1659399301,293,1078
3852810875,3820855275,1641723702,1641724650,948,1812
3037042091,3389114774,1661626559,1661627145,586,369
3154250720,3678778706,1645203827,1645203827,0,901
3823942349,3424897066,1641039815,1641040031,216,2258
3957824946,3348102929,1661636063,1661636233,170,2272
3357966828,3772792062,1668085790,1668086453,663,72
3138539283,3662763316,1664720891,1664721657,766,2088
3880196075,3882254802,1661134676,1661135460,784,2069
3893829650,3234141140,1660596929,1660597408,479,1298
3091709202,3319224567,1667796955,1667797789,834,792
3640523860,3597661669,1669732607,1669732794,187,964
3077238667,3704980935,1662628427,1662628588,161,702
3770948247,3442927979,1653475142,1653475426,284,1434
3760972512,3442725932,1668810008,1668810292,284,360
3738591594,3772340083,1642300555,1642300915,360,1987
3483827042,3801579775,1660566554,1660567027,473,264
3063566522,3976156173,1652639855,1652639979,124,1611
3987318292,3705306826,1661542096,1661542737,641,2058
3956194935,3197176680,1661585484,1661585930,446,842
3841318125,3575457804,1645032458,1645033305,847,2088
3534752391,3362388538,1649808997,1649809341,344,370
3027478849,3920875021,1659034874,1659035804,930,1975
3474115926,3629207282,1645359784,1645359852,68,1059
3943892886,3412307376,1660936535,1660937179,644,2003
3417049317,3320179826,1661212655,1661212775,120,1539
3161234904,3749282990,1643547583,1643547633,50,1411
3609804397,3994913668,1654718854,1654719698,844,1769
3249071020,3002631535,1649285521,1649285996,475,2226
3611777140,3632101943,1662478718,1662479589,871,176
3812034379,3220736075,1658533626,1658534421,795,736
3638822670,3289630313,1649039102,1649039103,1,154
3042052031,3879001343,1653361790,1653362174,384,1588
3175505409,3539866422,1643583647,1643584423,776,2030
3316625530,3210331889,1645946617,1645947284,667,989
3045925816,3609880975,1664564298,1664564939,641,2494
3634089207,3256374123,1647988585,1647989039,454,864
3414328029,3851327758,1668866170,1668867056,886,996
3704305860,3835036552,1667183618,1667184410,792,2277
3112615469,3272879760,1643231080,1643231154,74,2308
3924960579,3817668840,1655120844,1655121189,345,563
3962798581,3254367735,1647586666,1647587166,500,1222
3142899759,3796936978,1644232769,1644233677,908,72
3568289450,3993438914,1659943806,1659944362,556,2259
3990949387,3795494127,1648981315,1648981454,139,2441
3126499590,3241033604,1669565445,1669566117,672,213
3842738399,3237339326,1648897678,1648897812,134,1543
3840026910,3072599295,1644226285,1644227196,911,2054
3963257683,3959228076,1667875927,1667876458,531,1074
3332592315,3873002836,1659266157,1659266222,65,1570
3248324593,3662763316,1663508875,1663509645,770,2095
3286696325,3048896097,1654645170,1654645395,225,1385
3866993832,3169688960,1657885991,1657886742,751,970
3856658213,3037786726,1650588447,1650588940,493,1817
3087662482,3503453854,1658458309,1658459236,927,1573
3164942448,3495691991,1654871756,1654872464,708,1994
3166518187,3023530031,1650816384,1650817192,808,708
3870032753,3241584825,1654087823,1654088337,514,1530
3264673951,3163551629,1648424172,1648424644,472,98
3599795440,3413898378,1655542481,1655542803,322,1746
3172310061,3884551317,1655299266,1655299720,454,2280
3336494171,3137195290,1663704275,1663704706,431,1759
3286129059,3917500425,1653663441,1653664390,949,90
3704305860,3880638655,1667523027,1667523643,616,370
3033029762,3013484024,1648897355,1648897598,243,519
3527349190,3514458890,1656831072,1656831441,369,422
3546954605,3715200176,1652506747,1652507246,499,826
3155294057,3611763388,1667182806,1667182828,22,1036
3994967281,3340511048,1667764918,1667765167,249,1594
3790883274,3607717009,1652089088,1652089103,15,574
3973264936,3237674968,1648513431,1648513605,174,2205
3139455252,3488757134,1659349997,1659350597,600,2179
3868397809,3185977048,1643535791,1643536337,546,429
3926612159,3889967886,1656264778,1656264881,103,1549
3767249449,3938773149,1668021419,1668021462,43,555
3059848821,3626505512,1659137966,1659138048,82,806
3307636200,3534726913,1651489408,1651490041,633,2072
3083791573,3750160040,1666680592,1666681343,751,153
3410865372,3273701051,1646794771,1646795527,756,535
3135211724,3319224567,1660997942,1660998921,979,1875
3823419231,3725611236,1645134948,1645135880,932,210
3239620599,3911960681,1645379692,1645380285,593,1627
3107982351,3453884967,1645886233,1645886920,687,2024
3397397223,3497288872,1646909036,1646909586,550,2146
3662507847,3462744404,1644784711,1644785331,620,829
3814641263,3492909923,1641303457,1641303714,257,498
3373239702,3308001923,1655870872,1655871613,741,2225
3033438220,3189300345,1651912140,1651912845,705,164
3790407401,3347990376,1654185131,1654185435,304,68
3351145248,3475897333,1660713577,1660713660,83,678
3699263886,3626156541,1647714502,1647715375,873,2023
3193403424,3272912522,1659649534,1659650036,502,1018
3089699104,3156331863,1646698861,1646699556,695,1339
3472458500,3658562439,1660543552,1660543813,261,1023
3342708435,3141503682,1661461051,1661461552,501,1356
3128449335,3825995272,1641387542,1641387746,204,1803
3974481828,3918602291,1651150600,1651151183,583,1618
3284832227,3249627758,1667087085,1667087257,172,1440
3790635482,3463405011,1650651777,1650651945,168,504
3391324219,3572746096,1668968945,1668969711,766,1727
3941548978,3423593448,1663637927,1663638835,908,79
3108123256,3152933136,1668347658,1668348238,580,142
3793967785,3752858965,1665736411,1665737071,660,151
3009177873,3599915754,1668948895,1668949411,516,1576
3760042128,3033373685,1658124061,1658124106,45,35
3171413650,3060757458,1657478468,1657478851,383,193
3368654717,3469437983,1653598740,1653599139,399,31
3520825972,3755269138,1658016553,1658017362,809,2087
3983162503,3981049957,1657491607,1657492166,559,715
3414930462,3242948145,1667379110,1667379150,40,63
3016068435,3162284444,1650783580,1650783695,115,1680
3266620552,3117821060,1653587888,1653588320,432,1069
3506143492,3398583773,1645527687,1645527955,268,1399
3989741708,3106395050,1643549211,1643549421,210,708
3476903669,3379296882,1647257864,1647258367,503,18
3773488272,3134422689,1653412064,1653412500,436,67
3118526217,3960036547,1665607090,1665607685,595,497
3342190885,3981191978,1668817054,1668817530,476,2244
3927329503,3749529134,1653007542,1653008048,506,327
3857215319,3197466224,1645242826,1645243749,923,1094
3948964302,3384452997,1642421746,1642422669,923,1927
3991299369,3471707938,1659819623,1659820525,902,1015
3146634302,3796990042,1650252989,1650253646,657,2231
3729914869,3962440297,1653621012,1653621713,701,877
3971926686,3935656272,1660703709,1660704503,794,303
3682608460,3961721758,1649415630,1649415796,166,1454
3708134798,3786811867,1656953639,1656953955,316,123
3237245622,3038035861,1642850119,1642850568,449,757
3362091170,3234064286,1648264710,1648265667,957,2268
3924799278,3086273441,1661819247,1661820208,961,836
3102669962,3400121632,1657476824,1657477277,453,732
3898229065,3564592902,1663327044,1663327745,701,1925
3661705197,3075001202,1652822326,1652822885,559,440
3117234289,3787880772,1646720154,1646721132,978,91
3636960130,3811930283,1658756586,1658757231,645,2312
3854995649,3177370273,1642136637,1642137452,815,183
3253827804,3304523843,1658261186,1658261434,248,260
3641682706,3010488834,1655966242,1655966497,255,404
3555105048,3316951862,1666618653,1666619244,591,863
3781268781,3523465225,1655630007,1655630950,943,177
3705809622,3893709526,1663718811,1663719364,553,1268
3320792244,3300983140,1641281273,1641281907,634,540
3925523737,3332592315,1658672282,1658672940,658,51
3366896849,3606994517,1657094456,1657095291,835,2443
3532450192,3693102953,1650230715,1650231633,918,1669
3757044916,3061924533,1653535800,1653536305,505,2430
3797930164,3364059276,1653887831,1653888246,415,1753
3476820014,3811827366,1659142749,1659143315,566,439
3448135160,3510166785,1646369339,1646370114,775,926
3759737476,3075519908,1661755135,1661755992,857,2135
3918397944,3994383813,1660194445,1660195374,929,1194
3042739113,3784105182,1655814698,1655815224,526,492
3289615980,3429684538,1651628412,1651629252,840,1603
3782730026,3479385096,1647534431,1647534886,455,1292
3379726555,3385196866,1661691198,1661691898,700,636
3068129646,3948946969,1666542619,1666543064,445,1619
3021289375,3043354217,1666970484,1666971470,986,1961
3246900158,3867543887,1665336857,1665337218,361,2424
3478097925,3395525819,1667711870,1667711908,38,362
3515933745,3075313832,1648224575,1648225246,671,457
3819547274,3614179985,1649907460,1649908106,646,1392
3619490574,3560020610,1662178302,1662178617,315,2395
3381769309,3392105056,1650633601,1650634598,997,705
3349879521,3378162995,1644636874,1644636901,27,939
3673950693,3262845808,1667513891,1667514771,880,650
3062789212,3342820244,1656254985,1656255301,316,2118
3127549843,3550874434,1653810548,1653810556,8,1561
3149191705,3393724727,1660597046,1660597184,138,2296
3007308564,3816194055,1654132617,1654132899,282,1751
3957577990,3465064732,1646437995,1646438796,801,1773
3464235741,3004160380,1665108703,1665108986,283,1633
3064522150,3747621620,1642712574,1642713272,698,1066
3881578299,3406357109,1661619379,1661620018,639,2069
3403337910,3196704660,1656602218,1656603063,845,858
3802790977,3573450428,1641597623,1641598087,464,664
3554832209,3008372630,1644647999,1644648646,647,2255
3397972687,3594682644,1642026059,1642026611,552,1669
3871851890,3331439996,1648811009,1648811037,28,407
3901579796,3509999399,1641973353,1641974109,756,1860
3571972204,3666268915,1650135867,1650136307,440,539
3309799085,3375279811,1645236665,1645237492,827,2233
3788819111,3139935588,1669168615,1669169552,937,1091
3840558415,3315402916,1643161276,1643162224,948,574
3659732080,3658461707,1656558926,1656559162,236,104
3643185661,3812231046,1644423776,1644424139,363,314
3175298013,3595144575,1662380637,1662380892,255,2144
3865964859,3369356299,1650727167,1650727811,644,1058
3835112188,3264081641,1653270766,1653271468,702,373
3162641272,3784959270,1646813404,1646814318,914,1488
3255460937,3677064508,1647018921,1647019564,643,779
3892336923,3994007098,1661013001,1661013209,208,2303
3328589697,3003861871,1652255073,1652255118,45,2366
3988913212,3762690279,1664538500,1664539192,692,2419
3755962729,3596841713,1664966609,1664966806,197,266
3952252601,3240347468,1657576680,1657577308,628,1881
3894454988,3265364405,1651049910,1651050249,339,858
3276482511,3469437983,1650423085,1650423635,550,2377
3635616513,3628789282,1661161656,1661162097,441,381
3346948485,3489909547,1652372148,1652373033,885,1048
3508311968,3200875282,1657339408,1657340083,675,1169
3502432342,3467401235,1667118686,1667119020,334,181
3526315797,3045925838,1654583188,1654584107,919,1448
3654344198,3954434825,1666370774,1666370968,194,2153
3456603950,3131735006,1660750253,1660750327,74,1796
3225328547,3323797477,1654969839,1654969839,0,2068
3171734482,3835976086,1661118440,1661118711,271,521
3904517073,3254083367,1667691163,1667691951,788,474
3404020970,3207258694,1664190267,1664191136,869,983
3185558387,3903978752,1654008956,1654009455,499,1186
3401957566,3047400344,1653690098,1653690416,318,1999
3282561101,3797294746,1657323667,1657324137,470,2232
3292111100,3415020400,1664514958,1664515617,659,361
3166517941,3569563212,1654550308,1654550464,156,93
3056053831,3941512307,1659883515,1659884393,878,1784
3724861653,3411023911,1668553571,1668553956,385,1339
3532307372,3079809630,1654626551,1654626654,103,1613
3618397647,3619399873,1645181800,1645182440,640,740
3031816428,3524545245,1648530809,1648531085,276,102
3346164838,3845980646,1669000746,1669001602,856,1226
3228574805,3099934862,1652228694,1652229037,343,1948
3820466728,3813666053,1659701076,1659701381,305,1701
3165845148,3045016501,1667440380,1667440616,236,510
3927646653,3192194263,1667036056,1667036837,781,2413
3434575449,3494372287,1653175626,1653176212,586,109
3894508827,3335455607,1663253617,1663254533,916,52
3688758916,3054171550,1644871277,1644872274,997,33
3168329235,3507960689,1651118613,1651119603,990,557
3017484229,3595726436,1648452481,1648453083,602,691
3287116319,3741273371,1652132700,1652132830,130,676
3456239535,3522814184,1657064905,1657064972,67,185
3085676024,3804064265,1658726845,1658727560,715,1671
3868902207,3713693431,1645565476,1645566261,785,1593
3895542691,3813690540,1651550661,1651550706,45,706
3224364206,3133030435,1641904040,1641904481,441,135
3732585972,3499481051,1668942318,1668942951,633,2233
3970654045,3100440036,1653548424,1653548617,193,1480
3822935707,3003145369,1645512756,1645513690,934,2360
3780885377,3851879278,1657954896,1657955187,291,959
3379259059,3258352640,1658415727,1658416104,377,2432
3948074176,3029263333,1659183185,1659184063,878,2307
3232160942,3806520351,1664832672,1664833000,328,1604
3987005983,3804657904,1652335622,1652336122,500,2123
3217029107,3270914746,1644387146,1644387261,115,1383
3004708023,3947788644,1656464901,1656465863,962,406
3293615945,3464595898,1645621735,1645621967,232,303
3320272612,3985734621,1654797488,1654798086,598,2093
3760142759,3269966376,1657239580,1657239951,371,84
3562547940,3646544919,1643255120,1643256040,920,1891
3685158343,3010161936,1668665288,1668665820,532,1432
3430638959,3991299369,1660035817,1660036573,756,2471
3429660049,3405319002,1647625059,1647625986,927,1423
3865529150,3120186347,1663702227,1663702695,468,1750
3139882519,3048409719,1662623369,1662624030,661,1341
3014363081,3020429639,1659549934,1659550069,135,1947
3796587240,3200059644,1655480776,1655481102,326,1452
3264401846,3647255060,1647762125,1647762691,566,1720
3779459643,3141963631,1644546220,1644546335,115,1551
3417049317,3765617850,1667665012,1667665527,515,2323
3051404798,3555903175,1652598975,1652599661,686,30
3374603408,3792143103,1652219124,1652219696,572,277
3852184769,3474081200,1651201944,1651202077,133,774
3231938844,3468455079,1663566388,1663567044,656,1552
3246759301,3032800454,1653423310,1653423752,442,2164
3815507952,3780014272,1645137753,1645138142,389,1594
3729321195,3447257561,1644062424,1644063290,866,1260
3291267409,3128133737,1667175610,1667176555,945,506
3416196153,3323198594,1663240485,1663241478,993,864
3373239702,3485526833,1641298994,1641299898,904,1906
3676100322,3942656665,1648663236,1648664182,946,2188
3683246538,3722859316,1654270591,1654270943,352,1145
3801038758,3775968124,1647928041,1647928842,801,100
3680841490,3427860415,1654557654,1654557860,206,386
3776063818,3507431231,1654815886,1654816665,779,362
3500595056,3404330776,1655973567,1655974273,706,1060
3725283025,3377774902,1661164527,1661164858,331,2082
3627730665,3573975780,1645398467,1645398952,485,2444
3513576000,3526315797,1647925487,1647926345,858,943
3914348680,3918121469,1660929965,1660930381,416,1927
3023772977,3336991621,1646696883,1646696899,16,1932
3945611603,3232737784,1668165963,1668166516,553,2021
3336551797,3395753607,1662515996,1662516151,155,642
3379076226,3296919195,1646797157,1646797796,639,1925
3151896132,3252981510,1656894140,1656894184,44,1186
3924865492,3768253081,1664041946,1664042822,876,1290
3888757366,3187561832,1666051654,1666052236,582,2280
3487992433,3809965750,1646247742,1646247900,158,832
3404959548,3247758952,1658053563,1658054489,926,597
3252421501,3955663201,1652141654,1652141688,34,1860
3411495833,3024554792,1666917758,1666918353,595,651
3565392717,3771460646,1664349754,1664350482,728,1819
3080930599,3907213401,1668299209,1668299537,328,2481
3984467207,3345186165,1652433444,1652434112,668,2350
3959093613,3287901684,1642225373,1642226036,663,1432
3260695363,3882038749,1654742810,1654743522,712,638
3339962549,3295905536,1655388543,1655388744,201,904
3298635617,3924607271,1655613157,1655613168,11,837
3872493238,3109108614,1662814967,1662815481,514,1945
3653757569,3366558556,1650482984,1650483111,127,528
3710189327,3243873593,1650289622,1650290286,664,58
3283947136,3968636198,1646056415,1646057155,740,2238
3301148308,3141480547,1669237599,1669238308,709,2004
3042836639,3571991159,1662372864,1662373354,490,1819
3922066704,3218686367,1652689391,1652689942,551,2156
3344337283,3092360885,1643539163,1643539248,85,765
3256566881,3854995649,1652096932,1652096968,36,916
3017005264,3762744269,1658558208,1658558982,774,610
3870320323,3964987979,1642940072,1642940261,189,442
3995358434,3506458720,1645236321,1645236692,371,542
3962798581,3930205120,1665255225,1665255478,253,2154
3160135389,3790180006,1668612520,1668613409,889,2390
3294478149,3538039823,1648590464,1648591017,553,341
3278612503,3818467247,1655974945,1655975077,132,156
3442194248,3687215472,1665327405,1665328315,910,2170
3693797946,3627902900,1669368301,1669369242,941,1134
3808397193,3538692457,1659188338,1659188671,333,1022
3624872846,3894030912,1660296545,1660296995,450,305
3781368357,3414700083,1664199532,1664199783,251,978
3230843282,3035287101,1654575237,1654575655,418,1548
3057721767,3775753518,1667588264,1667588296,32,2310
3881861537,3189002771,1662605627,1662606462,835,811
3599795440,3678541527,1644915628,1644916238,610,1204
3862456223,3532634291,1644396054,1644396350,296,1828
3728160519,3299840986,1652530078,1652530630,552,1087
3011993360,3051404798,1644359089,1644359567,478,1959
3753596469,3775766805,1659678051,1659678572,521,1233
3145669202,3013681789,1654396501,1654396834,333,613
3777022057,3438756008,1649097775,1649098470,695,48
3598572594,3065810858,1649053221,1649053603,382,2076
3371536214,3883057669,1652768410,1652768939,529,560
3307033178,3270395343,1662365809,1662366351,542,475
3352005808,3324473595,1656062835,1656063485,650,1232
3016299339,3981065835,1659453703,1659454271,568,1064
3686967459,3736118442,1659731432,1659732004,572,2405
3310169810,3805665502,1641969741,1641970592,851,2011
3216912897,3102027139,1644143125,1644143989,864,1758
3416945471,3462026511,1662771667,1662771969,302,673
3735286926,3556577780,1648075442,1648076017,575,2279
3378221943,3189211545,1643589697,1643590549,852,2034
3059151355,3730845439,1661439208,1661439334,126,1100
3822458181,3397397223,1648690810,1648691643,833,470
3254367735,3307305290,1645531778,1645531806,28,23
3154833958,3309799085,1661477540,1661477698,158,803
3329496705,3347990376,1644140338,1644140969,631,568
3952874218,3653030573,1655960227,1655960973,746,1394
3180534430,3034088160,1654906809,1654907114,305,2428
3879322451,3943622737,1652996928,1652997572,644,591
3442753076,3942399353,1652202885,1652203678,793,682
3801736024,3695935038,1646791757,1646791975,218,536
3508143883,3252593307,1666842750,1666842914,164,801
3391324219,3007911826,1656908809,1656909062,253,1027
3610056283,3866541862,1652424902,1652425624,722,810
3330548469,3324618357,1652199590,1652200029,439,1898
3156980878,3690015481,1659789458,1659790030,572,1325
3358242037,3136448234,1665823130,1665823381,251,920
3328024680,3514680311,1666562508,1666562591,83,227
3486810833,3428299424,1667019769,1667020410,641,1110
3337601088,3532063469,1666550979,1666551196,217,953
3784414098,3331426472,1645429460,1645430431,971,2482
3261255394,3734367959,1645779489,1645779946,457,1284
3187257156,3146634302,1668811899,1668812132,233,122
3047628685,3487475790,1657408365,1657409199,834,697
3880599649,3569390971,1659706000,1659706601,601,2122
3600725106,3222871111,1667712813,1667713142,329,954
3648257100,3480308437,1653086989,1653087700,711,87
3960727778,3571719140,1649684014,1649684835,821,673
3270273033,3733051386,1665015184,1665015924,740,1133
3128514837,3529898997,1643843389,1643844124,735,2366
3884949094,3314823389,1664093777,1664094385,608,2055
3890781778,3663100834,1655353289,1655353724,435,1886
3168984273,3203904444,1666074908,1666075598,690,2274
3035464149,3089844622,1653887179,1653887293,114,336
3988935369,3293615945,1657366081,1657366662,581,502
3066067288,3375177760,1650647943,1650648911,968,722
3090910630,3985620157,1661410196,1661410815,619,2110
3429445014,3447447895,1647742967,1647743891,924,1504
3939948508,3997038651,1669073506,1669073966,460,425
3759393612,3327427782,1659724419,1659725203,784,1164
3267319115,3660577882,1644311570,1644311877,307,1632
3016482005,3042943074,1654026051,1654026638,587,795
3093024844,3515460273,1662003269,1662003367,98,165
3282079727,3749327438,1663801069,1663801994,925,2467
3541200701,3761269014,1648471886,1648472479,593,1054
3571173934,3793032912,1650994061,1650994889,828,1471
3800201060,3264879958,1665769942,1665770272,330,1352
3584037261,3216092524,1659058839,1659058890,51,133
3056726479,3749379449,1647613980,1647614268,288,1604
3002876565,3899932297,1654870756,1654871146,390,772
3127783768,3573939226,1665069896,1665070034,138,754
3733619028,3578655079,1659440766,1659441022,256,1486
3079031370,3184539687,1668275208,1668275619,411,1539
3639352352,3432522125,1657680168,1657680933,765,1179
3563103144,3066439887,1653567371,1653567455,84,1709
3315283904,3125008218,1658064054,1658064441,387,2123
3686320266,3800239896,1663385431,1663385570,139,2425
3927864902,3094147044,1641498603,1641499576,973,2108
3141392063,3874626130,1652121387,1652121426,39,347
3250528764,3874626130,1668178330,1668179020,690,52
3944476586,3197323395,1645416252,1645416763,511,2337
3005809519,3823206701,1669321129,1669321559,430,1695
3531345844,3526687041,1654652704,1654653494,790,1603
3705306826,3012339110,1663181445,1663182059,614,228
3044161404,3424562136,1656651332,1656652251,919,1031
3333339972,3413319616,1657993439,1657993974,535,736
3945299482,3940222685,1667651819,1667652542,723,44
3186371475,3537862606,1669287272,1669287672,400,748
3174499556,3103404280,1651717891,1651718514,623,1332
3021621189,3260174905,1656573628,1656574473,845,862
3877049401,3163030169,1655164622,1655165592,970,1702
3453511353,3404934353,1661571623,1661571857,234,1908
3109959336,3076307729,1651288936,1651289933,997,1766
3823761286,3505322684,1651817866,1651818843,977,2183
3890821469,3333095694,1653002403,1653002919,516,1077
3097161771,3398443861,1658760688,1658761492,804,2472
3693453006,3505272067,1649699772,1649700059,287,2087
3808191596,3244969283,1655274586,1655274592,6,1074
3857460953,3993623323,1654736029,1654736889,860,2455
3818028118,3537862606,1661037504,1661037983,479,2116
3720381616,3829377486,1658583074,1658583608,534,1295
3683793217,3619126886,1662063468,1662064305,837,665
3664381582,3036801405,1663840506,1663841398,892,316
3784168038,3278397100,1654459780,1654460328,548,1635
3813287023,3183640403,1645958410,1645959150,740,2064
3634735892,3116751960,1656596830,1656597255,425,1617
3870320323,3086324092,1641369134,1641369139,5,1323
3123166182,3893872926,1651740000,1651740514,514,2029
3189111071,3189673990,1656646512,1656647415,903,1468
3450294094,3945607460,1651330851,1651331544,693,63
3744234480,3626015702,1668569061,1668569280,219,2166
3294094629,3767912489,1658064359,1658064965,606,1409
3333336166,3736681866,1658359654,1658360504,850,364
3204508195,3467215587,1666926201,1666926869,668,544
3506143492,3817073865,1644293686,1644294365,679,191
3480314503,3690667222,1665660775,1665660952,177,174
3064461314,3278819973,1654085861,1654086492,631,2036
3464595898,3505272067,1654929430,1654930099,669,633
3928989640,3312805786,1663509508,1663509723,215,405
3436578278,3232141615,1651278655,1651279394,739,808
3308891574,3515332061,1662393124,1662393460,336,961
3937197371,3895991710,1642731193,1642731358,165,1990
3808952164,3847638658,1646585272,1646586122,850,1811
3086534991,3345413125,1656080805,1656081615,810,410
3793518113,3164391025,1649714868,1649715316,448,574
3269699819,3693862073,1654492393,1654493328,935,494
3097031283,3666179764,1653797916,1653798208,292,2254
3573975424,3289061595,1663647414,1663647759,345,606
3451370887,3325334543,1668173641,1668173790,149,1436
3510761729,3104944123,1663006132,1663006432,300,2157
3563488722,3573450428,1655034490,1655034566,76,2045
3379259059,3382110972,1641394663,1641395561,898,316
3329987086,3913905115,1665021882,1665022442,560,2228
3595500034,3043064916,1664251010,1664251824,814,2361
3544772636,3521217476,1659486521,1659486556,35,2152
3316978783,3067641822,1660698542,1660699200,658,2083
3683440211,3045691620,1666622825,1666623038,213,1604
3166518187,3604852600,1643255309,1643255971,662,1849
3167494570,3549145976,1659761398,1659762372,974,46
3934386586,3132210207,1659982738,1659983254,516,1049
3327253070,3790329301,1643166975,1643167966,991,1945
3156962564,3451307942,1641933787,1641934283,496,818
3752522830,3210422873,1644421276,1644421323,47,1056
3173642675,3544020942,1650989774,1650990178,404,593
3112314644,3386490201,1643143754,1643144189,435,15
3686967459,3887586447,1654993663,1654994038,375,2115
3544020942,3821275122,1653633511,1653633581,70,2177
3853912096,3895976556,1651188267,1651189063,796,2012
3844560489,3520392773,1641671690,1641671721,31,27
3986016860,3054573274,1641285906,1641286120,214,431
3820254686,3397376963,1659538466,1659539006,540,1956
3177851224,3621456276,1647427560,1647427943,383,1960
3327311623,3791486887,1665631491,1665631571,80,36
3870320323,3742746848,1644035524,1644036101,577,515
3899858422,3140682569,1665986361,1665986620,259,1529
3390976131,3718026583,1658780131,1658781029,898,96
3562875112,3422374987,1659004677,1659004930,253,1219
3031649001,3125350196,1647442921,1647443278,357,918
3173909495,3601851578,1658184989,1658185529,540,112
3974917779,3125730442,1665738882,1665738926,44,269
3824168840,3554261399,1645626163,1645626334,171,722
3825484587,3656000543,1656740136,1656740465,329,2352
3406042920,3496921526,1656449716,1656449837,121,1927
3998329857,3784808734,1643387393,1643388325,932,2490
3338154846,3015715378,1641207758,1641208558,800,2126
3870877628,3099424302,1662755222,1662755719,497,795
3930909418,3940520472,1663931906,1663931922,16,97
3267411650,3185210514,1665839681,1665840266,585,1018
3683326795,3255751346,1649381577,1649381966,389,87
3848995096,3817000379,1644005684,1644006187,503,589
3357966828,3449693686,1662586865,1662587247,382,1982
3035135381,3815507952,1658116452,1658117259,807,1094
3816194055,3887002610,1643325609,1643326206,597,1327
3257821708,3452067391,1666030456,1666030914,458,883
3621726953,3086084685,1654831607,1654831939,332,351
3173369021,3023530031,1669437107,1669437264,157,1340
3017758671,3317961564,1659073111,1659073443,332,277
3356728242,3815692931,1661991340,1661991730,390,2001
3967147343,3154653229,1661104653,1661105154,501,1296
3895886228,3571576669,1641002072,1641002299,227,171
3562110382,3765617850,1661711138,1661711385,247,672
3451227417,3913905115,1644783671,1644783858,187,544
3500216283,3415686543,1665314960,1665315520,560,1081
3215819425,3066714195,1664465395,1664465894,499,549
3357699960,3945607460,1665217813,1665218583,770,348
3153391276,3820225206,1663718768,1663719577,809,1768
3980824960,3941642636,1642231150,1642231947,797,896
3179651539,3915986965,1661278228,1661278762,534,602
3549752945,3570429285,1642048562,1642049090,528,1037
3569200063,3869293895,1659953503,1659953914,411,453
3150503842,3986631065,1659990098,1659990474,376,23
3013073909,3733821292,1662132093,1662132219,126,365
3645868952,3969355995,1657069617,1657069659,42,797
3751346675,3087333030,1657713066,1657713858,792,1291
3325334366,3846007471,1653157347,1653157467,120,2393
3921229994,3526439962,1667136649,1667136857,208,2459
3344205602,3312805786,1645843685,1645843926,241,1084
3196822601,3715766296,1645274126,1645274959,833,116
3022707615,3361167735,1642159950,1642160680,730,1219
3339649448,3756806050,1646962235,1646962768,533,1457
3909558934,3408944120,1665729748,1665730660,912,1646
3672482112,3526315797,1644107488,1644108415,927,381
3228737899,3672371563,1650015496,1650015789,293,610
3614179985,3664381582,1646688046,1646688741,695,1188
3410719383,3427225872,1654948421,1654948899,478,344
3286424440,3746351822,1649828213,1649828558,345,2425
3840807781,3757305418,1669712830,1669713595,765,721
3921754282,3974318707,1663831981,1663832764,783,872
3676100322,3540717336,1659300509,1659300783,274,1643
3831951487,3636237325,1664071053,1664071136,83,1885
3728974462,3142230569,1659941213,1659942176,963,1610
3632284739,3848860153,1643079076,1643079299,223,43
3961721758,3329887381,1658020877,1658020909,32,2330
3604769442,3841106350,1653951960,1653952398,438,658
3699625300,3291838772,1664139990,1664140751,761,429
3331295538,3204735172,1655183915,1655184612,697,225
3657758228,3278190233,1646392909,1646393234,325,2178
3278077270,3875343154,1651059014,1651059695,681,25
3297681098,3470287808,1651525610,1651525919,309,2446
3677379196,3575766470,1658906963,1658907109,146,1961
3768087701,3741024153,1661715556,1661716541,985,2455
3138411685,3485046222,1657123790,1657123967,177,38
3966056341,3640010781,1650117404,1650117961,557,1567
3164462099,3646159351,1643072195,1643072527,332,153
3536931244,3499481975,1654459340,1654460265,925,720
3701726268,3520943619,1667712822,1667713674,852,2327
3816240060,3123815439,1662283891,1662284521,630,607
3831380073,3217060058,1651044816,1651045543,727,2173
3505761464,3586405616,1664742102,1664742388,286,2495
3439325479,3191811632,1648978762,1648978823,61,1134
3518717396,3678505160,1657645371,1657645613,242,1180
3401156180,3098342545,1653409286,1653409868,582,2335
3120208739,3792004796,1663441475,1663442237,762,941
3005809519,3761576790,1665553077,1665553707,630,2319
3725439899,3714698686,1669368341,1669368464,123,1697
3160349110,3066053770,1644795832,1644796522,690,332
3478097925,3852633699,1647316393,1647316889,496,2234
3476882609,3515550503,1667333369,1667334250,881,1332
3615666134,3080454518,1650349441,1650350272,831,2499
3097489594,3770948247,1646518927,1646519520,593,964
3525442421,3203153576,1666890060,1666890884,824,581
3401677898,3193991721,1660322897,1660323027,130,1667
3706209487,3828342380,1663091928,1663092376,448,2332
3570050230,3260085949,1652667434,1652668058,624,688
3314953470,3283155844,1647033850,1647034022,172,1013
3856882586,3981049957,1666389446,1666389712,266,892
3495691991,3177943874,1645930441,1645930598,157,1921
3208220195,3657251975,1647494702,1647494839,137,397
3748360490,3800392649,1641352698,1641353220,522,960
3417176290,3884878006,1648537236,1648537440,204,2476
3819547274,3962617141,1643248720,1643248755,35,1464
3542832965,3712332461,1646676690,1646677008,318,2057
3296957627,3231727990,1647800531,1647800931,400,1561
3104050460,3310294122,1668259629,1668260204,575,750
3921877328,3990949387,1645967788,1645967938,150,518
3114605564,3604514331,1667462886,1667463722,836,767
3980867331,3436199937,1648600622,1648601280,658,2442
3163470555,3578655079,1642461989,1642462111,122,799
3795264165,3481308282,1667991705,1667992328,623,250
3415888174,3592453741,1668455909,1668456884,975,126
3079013365,3124321462,1667321300,1667322053,753,654
3356154602,3908007955,1644856862,1644857249,387,1861
3865239822,3991542844,1669077292,1669077381,89,1091
3174658362,3568141696,1659680815,1659680988,173,346
3985326073,3688405055,1647232316,1647232786,470,289
3822307865,3527995096,1645992697,1645993417,720,535
3875570780,3964524277,1662006885,1662007271,386,929
3839454838,3138755786,1644127139,1644127908,769,219
3434351368,3888895982,1650387108,1650387748,640,2087
3690349378,3722859316,1668559443,1668559869,426,1367
3430090428,3787230225,1665355043,1665355591,548,2162
3886368625,3345458354,1654155115,1654155545,430,1668
3937698731,3941986034,1648713145,1648713741,596,741
3890335277,3658656847,1643297313,1643297779,466,187
3263842575,3839566998,1659426657,1659426724,67,588
3414026708,3895274115,1652131100,1652131546,446,1808
3850546468,3541597384,1665368631,1665369383,752,2340
3034750166,3090304189,1653794580,1653795065,485,1516
3223174482,3641372344,1669400494,1669401471,977,325
3308015697,3561543601,1641389547,1641390333,786,1378
3601499230,3038823274,1661693098,1661693320,222,1898
3682803273,3008968100,1667719920,1667720036,116,672
3881378306,3603096793,1654891954,1654892143,189,2384
3984050382,3959081575,1658131864,1658132565,701,1711
3136172164,3660046291,1645488289,1645489052,763,2411
3168983812,3073540574,1648773590,1648774590,1000,2241
3084430345,3367977353,1655472465,1655472687,222,1727
3250484759,3760817382,1659657907,1659658370,463,1136
3489915638,3373512814,1649839655,1649840087,432,1333
3796936978,3721977473,1652145133,1652145624,491,1207
3089034472,3627730665,1663643254,1663643320,66,842
3811164522,3841459327,1653386302,1653386334,32,460
3226559906,3739490721,1641881016,1641881611,595,701
3322337553,3840416991,1650739570,1650739866,296,2497
3678541527,3264401846,1657655370,1657655417,47,1134
3271314900,3572896327,1657412576,1657413529,953,2427
3423043196,3460842972,1667443261,1667444008,747,2210
3462026511,3378814600,1641040328,1641040798,470,136
3241021396,3174712961,1668165154,1668165562,408,1995
3792012199,3470404771,1651380220,1651380792,572,1701
3498707377,3278346826,1663756944,1663757220,276,1311
3205601088,3218117875,1658684177,1658685110,933,2430
3010546611,3066546417,1642126976,1642127125,149,2027
3157600969,3362298218,1661164535,1661164794,259,337
3000650426,3983711613,1648412665,1648413368,703,2463
3075563867,3726367604,1647645067,1647645559,492,2106
3776939860,3248324593,1646744964,1646745783,819,36
3661642309,3319037937,1656318581,1656319140,559,2273
3258098890,3685665978,1643331016,1643331943,927,947
3562875112,3072276713,1654461230,1654461974,744,442
3660939542,3029460549,1645672607,1645673565,958,1262
3936135558,3975380491,1647508607,1647509490,883,2374
3567328601,3776939860,1665572770,1665572999,229,221
3374603408,3692954946,1665345809,1665346750,941,620
3210536820,3465842758,1654549203,1654549957,754,2147
3526088150,3551792540,1663854855,1663854872,17,87
3483354291,3152988371,1642914802,1642914893,91,1871
3830388213,3577718759,1655455685,1655455882,197,1051
3416719967,3662289637,1660340661,1660341428,767,873
3327427782,3985901910,1648123668,1648123833,165,188
3087123320,3910846571,1655810839,1655811729,890,2164
3541881881,3803051709,1642744701,1642745298,597,1909
3256566881,3560977513,1651864163,1651864704,541,2090
3309396992,3739719526,1642377025,1642377680,655,1536
3984977278,3861247260,1643540313,1643540532,219,2455
3762208346,3992927391,1659239438,1659240383,945,803
3293924278,3481548873,1657464690,1657465370,680,1805
3097596187,3653335612,1662794241,1662794707,466,733
3887002610,3363733362,1658802135,1658802646,511,924
3835069955,3139928298,1644497219,1644497665,446,1772
3487406679,3510634049,1654343633,1654344281,648,676
3404908537,3103417672,1646704319,1646705047,728,1673
3916290714,3657380279,1655086499,1655087262,763,1612
3912014286,3260571568,1645346947,1645347766,819,2499
3708809295,3406357109,1666907644,1666908568,924,886
3504893701,3222119601,1648990567,1648990599,32,1438
3942862085,3210331889,1661815649,1661816581,932,2040
3266991557,3028780744,1665305176,1665306081,905,514
3998987664,3965137487,1663315066,1663315129,63,2262
3715200176,3270325529,1668459598,1668460403,805,1176
3009169806,3968076690,1642922802,1642923008,206,59
3939722468,3213995449,1669646394,1669646926,532,309
3045427279,3853912096,1650585746,1650586007,261,2164
3356034290,3504446959,1662492350,1662493030,680,1786
3836565798,3428287409,1648139211,1648139419,208,162
3628556060,3681489851,1665507447,1665508194,747,2110
3528146911,3491398730,1656084507,1656085022,515,1295
3740090157,3346978275,1649803148,1649804071,923,1921
3639352799,3129683689,1668169799,1668170556,757,1281
3687689210,3583985803,1651320225,1651320758,533,2261
3878925459,3353722089,1649281724,1649282326,602,1876
3905581902,3964830238,1646634316,1646634723,407,1154
3522623156,3082434177,1661056800,1661057367,567,1621
3634999231,3143909362,1666676051,1666676510,459,2380
3331904172,3707362025,1661786412,1661786990,578,1821
3614952111,3065246027,1667367453,1667367685,232,1974
3214711870,3208831400,1666769647,1666769886,239,1035
3112960048,3893872926,1646947794,1646948144,350,639
3221885729,3513847916,1644978519,1644979045,526,378
3508143883,3350566867,1653153637,1653153724,87,1915
3723784545,3113321914,1655770942,1655771552,610,576
3579093901,3782266220,1647850050,1647850312,262,651
3791389559,3139268488,1655319585,1655320061,476,1081
3948743692,3491468798,1642146272,1642146712,440,25
3258417294,3913680174,1661177631,1661178137,506,1387
3058846696,3232141615,1652772318,1652772659,341,2097
3185977048,3700412611,1641959063,1641959629,566,1476
3009801123,3061362091,1654435324,1654435330,6,1685
3512935575,3607959490,1655748940,1655749713,773,2031
3414930462,3420180743,1666973587,1666973973,386,323
3990870728,3181047536,1667499890,1667500123,233,618
3241444105,3765617850,1661195175,1661195429,254,517
3960215733,3147245859,1657159305,1657159724,419,2067
3549038219,3508340066,1663175339,1663175528,189,727
3656448203,3510281371,1665163916,1665164272,356,1928
3188162412,3521258004,1653587658,1653588399,741,2000
3518179871,3421875747,1667105593,1667106466,873,28
3092941538,3763385597,1665535670,1665536505,835,1289
3276526689,3424584896,1656480261,1656480881,620,1318
3458815526,3962034507,1642133139,1642134124,985,2405
3796936978,3895334140,1664794616,1664795485,869,2452
3479738009,3316318605,1647943217,1647943884,667,569
3235672444,3772337054,1641820326,1641820846,520,1241
3808191596,3018838603,1665572606,1665573362,756,599
3268349855,3112259657,1655883825,1655883854,29,2072
3335462055,3236819846,1662364215,1662364405,190,485
3264831577,3556061704,1642412239,1642412897,658,1073
3142454040,3711048943,1655104860,1655105227,367,1165
3118526217,3299191225,1652468244,1652469187,943,288
3316448833,3816538946,1667519416,1667519989,573,1937
3826827617,3016992122,1641865661,1641866202,541,797
3969650128,3849701361,1651832852,1651833304,452,1716
3977139394,3424994271,1660087942,1660088430,488,162
3034807560,3693453006,1654471558,1654472116,558,1654
3568965374,3262711330,1665071389,1665072099,710,2231
3486442976,3247948931,1648366726,1648366976,250,2116
3150503842,3425548171,1651501891,1651502472,581,293
3235825340,3450672463,1656013104,1656013202,98,1628
3475686271,3456603950,1665475168,1665475370,202,2111
3404200137,3291324812,1642030602,1642031517,915,460
3192612662,3901026791,1667375419,1667375946,527,535
3109980927,3249554278,1662946500,1662946731,231,45
3295352365,3081725518,1645361009,1645361307,298,1353
3558492617,3625611440,1666055399,1666056250,851,1067
3700287335,3468455079,1648341403,1648341696,293,454
3417798594,3936360658,1654311515,1654311846,331,2484
3622596133,3474572698,1645667737,1645668517,780,263
3657753711,3284958290,1648242344,1648242582,238,802
3387840253,3393552322,1647574263,1647574764,501,613
3980934555,3911849911,1645860954,1645861320,366,1464
3475027844,3197371652,1642158147,1642158314,167,1991
3046006152,3511569871,1649192390,1649192898,508,869
3669299007,3005101248,1667201413,1667201688,275,1485
3549549632,3514498367,1669275664,1669276296,632,577
3091112554,3124941982,1665831658,1665831886,228,768
3983166385,3338812942,1660395008,1660395160,152,2240
3132486699,3309286736,1648366712,1648367660,948,2413
3106490071,3899788381,1649649570,1649650550,980,487
3098276544,3674049704,1653511152,1653511681,529,964
3045016501,3015956370,1651423450,1651424014,564,2107
3433374325,3638297718,1652684030,1652684189,159,1460
3940391939,3796065026,1642164608,1642165110,502,762
3936122118,3789380087,1646459064,1646459757,693,1597
3894382679,3876829785,1656547438,1656548374,936,1928
3935936621,3680100111,1644908458,1644908707,249,386
3340366291,3296151097,1642798909,1642798959,50,2442
3202625372,3382526428,1658343757,1658344708,951,2455
3866268396,3360040841,1651397502,1651398216,714,220
3849379963,3706605056,1642906615,1642907067,452,1352
3218136112,3011225738,1657979841,1657980729,888,1518
3401962895,3269573550,1663945356,1663946011,655,1707
3017504746,3232209052,1662501663,1662501978,315,2032
3300994471,3425006843,1657593046,1657593829,783,229
3569600936,3554741157,1645080813,1645081310,497,398
3585100772,3224952698,1644564460,1644564848,388,66
3833683293,3799900837,1649112504,1649112672,168,1290
3670063835,3336535934,1655044415,1655044903,488,528
3357048496,3929925771,1655092357,1655092446,89,337
3986016860,3590672346,1649340506,1649341384,878,1250
3997177535,3053005521,1665022268,1665022478,210,133
3604593541,3149896107,1648275634,1648276549,915,2414
3228565452,3819235768,1658973757,1658974169,412,928
3409978701,3713126710,1669117813,1669118432,619,1087
3913994422,3214711870,1650735542,1650735795,253,2339
3167494570,3960908616,1669159938,1669160767,829,1252
3395525819,3280372392,1652133265,1652133348,83,2197
3603071341,3997886077,1649499486,1649499903,417,974
3277875103,3759472039,1641346590,1641347470,880,1269
3292812509,3695558824,1650778239,1650778797,558,1344
3405373154,3012034151,1654671015,1654671118,103,2342
3413918139,3930909418,1660050437,1660050875,438,424
3249305465,3060450258,1666260493,1666261341,848,259
3299840986,3448409263,1662857788,1662858157,369,1997
3096076350,3091008161,1651763525,1651763916,391,1107
3832370690,3093599187,1668956150,1668956634,484,600
3938417195,3806875541,1657918875,1657919717,842,930
3365676412,3852741277,1657729807,1657729907,100,2441
3208464777,3740728884,1658469140,1658470042,902,1290
3762533949,3720307988,1669176128,1669176274,146,1690
3496369924,3353878603,1649951801,1649952567,766,870
3570335491,3688910009,1661647269,1661647733,464,366
3160515169,3515845767,1641658776,1641659261,485,769
3710708040,3769647112,1654308853,1654309720,867,2420
3761775611,3565052722,1641292242,1641292539,297,2253
3676592387,3673850585,1641861697,1641862334,637,1246
3232436630,3791510494,1666895965,1666896675,710,111
3690171214,3813318946,1662439470,1662439865,395,1735
3777597419,3182703869,1663477747,1663478259,512,421
3505026131,3437109709,1650559273,1650560197,924,1303
3298436959,3590735151,1650835319,1650835897,578,1002
3923907099,3226298244,1664805400,1664805467,67,793
3123166182,3366583139,1661400615,1661400851,236,724
3138801114,3315544584,1643010909,1643011108,199,1215
3880196075,3408529019,1666187572,1666188170,598,2313
3862685266,3264081641,1658122821,1658123509,688,747
3533497399,3162284444,1667871372,1667872253,881,281
3005125326,3321971009,1667966001,1667966273,272,1505
3216439052,3042046828,1652128869,1652129124,255,1583
3985901910,3310542239,1660591588,1660591725,137,2322
3259071830,3141963631,1664590753,1664591441,688,901
3468633309,3200897172,1650663140,1650663294,154,488
3846866111,3942399353,1657092422,1657093288,866,584
3362388538,3783723078,1650510617,1650510988,371,192
3126499590,3645666563,1664272484,1664272635,151,1753
3480100868,3048045312,1644063609,1644063903,294,35
3534224607,3149545838,1642002393,1642002915,522,794
3869495480,3321835417,1644303365,1644304315,950,662
3975380491,3329463543,1656888682,1656888840,158,864
3877090261,3889112055,1649203961,1649204226,265,2048
3766160943,3983727854,1650414946,1650415831,885,121
3648447244,3808191596,1645608131,1645608516,385,1936
3461674303,3219656369,1656423288,1656423733,445,104
3461017113,3224715818,1657781265,1657782054,789,1502
3553721378,3003872692,1643467554,1643468458,904,1116
3170167097,3655566080,1661471504,1661471594,90,1588
3252843201,3485926280,1644193196,1644193774,578,486
3691032308,3577817989,1651517388,1651517607,219,2027
3947704522,3689464410,1641986370,1641986598,228,2016
3037090215,3622062401,1645518760,1645519747,987,2031
3990037235,3481689842,1650052385,1650052472,87,322
3370267721,3855548589,1656161285,1656161438,153,411
3538972815,3739595528,1668041425,1668042267,842,293
3901468403,3300380060,1645597011,1645597295,284,971
3833553454,3085851145,1650177989,1650178665,676,2226
3546284533,3888670009,1649307482,1649308377,895,1123
3045016501,3030630339,1650383058,1650383483,425,453
3217375075,3784594026,1662354781,1662355135,354,2274
3926612159,3403471618,1663375331,1663375623,292,1732
3282587673,3353722089,1669291116,1669291644,528,1394
3255182489,3828485006,1669547557,1669548106,549,741
3771931468,3141963631,1651018074,1651018865,791,1433
3839369127,3527869582,1652735424,1652736101,677,2217
3084030782,3864133914,1664759418,1664759506,88,2288
3099976032,3823951765,1669219933,1669220676,743,152
3321818923,3900241568,1652186728,1652187298,570,1651
3276341369,3219575313,1642312241,1642312434,193,177
3159900056,3364247623,1664174737,1664174744,7,1200
3177651100,3653757569,1667366519,1667367260,741,2299
3218136112,3563428558,1656662098,1656662879,781,1957
3177951035,3828196026,1665343430,1665343512,82,369
3309286736,3647539125,1666694713,1666694842,129,1499
3691925367,3254592040,1657172981,1657173417,436,849
3768099353,3693041370,1642195128,1642195229,101,1572
3128009914,3863652254,1666809535,1666810050,515,785
3841108033,3043064916,1649570723,1649571283,560,1824
3957586219,3950146840,1642224442,1642224968,526,2467
3739048247,3861652282,1648820325,1648820699,374,1706
3636572173,3639059199,1653264093,1653264305,212,1841
3616094004,3025135840,1657777614,1657778334,720,2276
3139931020,3991390314,1649788000,1649788323,323,101
3938025728,3586405616,1664596420,1664596691,271,257
3885555985,3985734621,1645325781,1645326508,727,1145
3468516508,3569552798,1646207763,1646208356,593,2003
3501729913,3294526671,1644099070,1644099905,835,349
3122818832,3146072606,1653797534,1653798074,540,263
3018262582,3528069102,1641087062,1641087360,298,1633
3506750759,3982210988,1662390438,1662390643,205,1689
3063955055,3040897601,1653552008,1653552606,598,1124
3705217157,3351843519,1650518681,1650519051,370,398
3870035420,3306290309,1645079404,1645079454,50,275
3391118279,3336302831,1656028635,1656029374,739,1678
3802410450,3449693686,1663699852,1663700292,440,196
3140486428,3922728266,1646974728,1646974761,33,1598
3008968100,3841174974,1645078025,1645078831,806,1425
3696437293,3744734019,1665010506,1665010893,387,1090
3766966794,3666931632,1658508507,1658509253,746,774
3907764491,3583307819,1650032955,1650033803,848,1503
3186207758,3561113748,1669323852,1669324716,864,1276
3236975783,3648924087,1656149631,1656150181,550,730
3034815361,3453511353,1645795905,1645796250,345,241
3461292351,3675418278,1657376351,1657376439,88,1579
3749529134,3085136451,1658187936,1658188506,570,1417
3850546468,3748812993,1666112301,1666113267,966,1232
3860883669,3069841199,1646594395,1646594438,43,186
3551884757,3925754107,1647247379,1647247428,49,526
3013681789,3175498635,1652349392,1652349882,490,2398
3762538736,3728498046,1655174233,1655174814,581,1124
3123441689,3485801867,1657838247,1657838483,236,1465
3086444841,3834152797,1664656383,1664656701,318,1111
3276840933,3133153956,1649245917,1649246081,164,1308
3780885377,3959228076,1655726259,1655726987,728,324
3018651462,3674349184,1662165448,1662166034,586,1170
3310582583,3933450798,1662875952,1662876069,117,687
3994721189,3977495302,1648967683,1648968319,636,2102
3428889808,3126746702,1653674914,1653675378,464,2447
3948515015,3966056341,1654084839,1654085502,663,778
3816026938,3480308437,1651765440,1651765989,549,285
3759867623,3670835955,1666898225,1666898476,251,214
3798447157,3696512728,1657901675,1657901847,172,364
3080679691,3828531030,1669577455,1669578078,623,1800
3085136451,3220800349,1661771979,1661772926,947,1729
3646544919,3622656083,1668732507,1668733219,712,1156
3645768666,3825023321,1657645307,1657645909,602,1554
3035992910,3707767360,1668710680,1668711189,509,2190
3140971443,3840155084,1641648590,1641649171,581,2389
3507644528,3388814364,1642347971,1642348539,568,1403
3640949933,3757518149,1651521839,1651521871,32,55
3947921257,3269914132,1652368452,1652368877,425,2354
3199563620,3323684905,1645566195,1645567176,981,1870
3124723265,3116584028,1643814264,1643815052,788,654
3013457125,3789999187,1658413892,1658414625,733,2341
3225989431,3024431618,1641932521,1641933180,659,582
3603092087,3918552618,1649889050,1649889883,833,2032
3740404190,3571477883,1646102316,1646102726,410,274
3287116319,3018760022,1662938633,1662939261,628,1869
3152554117,3911316683,1665948143,1665948917,774,1261
3625684557,3378814600,1667333318,1667333406,88,701
3442209140,3766914780,1658746878,1658746894,16,57
3694006679,3145389444,1647561361,1647561480,119,1569
3294278402,3300983140,1655886067,1655887054,987,1815
3828722911,3414370730,1658203405,1658203556,151,512
3287988080,3071929787,1658412250,1658412510,260,1243
3257865090,3099785418,1660904760,1660905644,884,2164
3058855369,3499739176,1655530795,1655531452,657,94
3766914780,3284840023,1643969505,1643970504,999,1003
3631152825,3779590261,1662151720,1662152567,847,796
3199797181,3042739113,1651837583,1651838344,761,183
3126940487,3499541432,1660426163,1660427018,855,1054
3097834756,3304497399,1664902682,1664903506,824,1983
3646079529,3165208023,1645439095,1645439731,636,1023
3209064637,3085001659,1642804037,1642804447,410,223
3190417421,3273258651,1644700435,1644700663,228,1987
3820585135,3528288695,1648546151,1648546379,228,883
3282079727,3783119155,1669076650,1669076869,219,1652
3889730114,3552091513,1650726905,1650727292,387,297
3884949094,3363902315,1654809891,1654810416,525,2039
3103421893,3527269010,1662287440,1662288372,932,1203
3242088486,3108342285,1647878158,1647878786,628,1455
3002013720,3553939893,1643262340,1643263153,813,203
3287784262,3725480364,1669491976,1669492272,296,2330
3714026701,3428557602,1663801678,1663801732,54,463
3248724095,3865503383,1646592225,1646592866,641,1229
3651812819,3395782360,1666524175,1666524658,483,392
3409034003,3752653418,1654643896,1654644777,881,635
3963385029,3435518470,1663204915,1663205555,640,2091
3586408447,3840449491,1658655803,1658656711,908,2248
3496318579,3314932010,1658651051,1658651194,143,491
3782266220,3820374377,1654350422,1654350675,253,2097
3657758228,3069881077,1646758592,1646759033,441,351
3826737259,3404873411,1664363018,1664363305,287,1507
3716757245,3430464852,1649622959,1649623773,814,569
3653577731,3534450842,1662463397,1662463520,123,1382
3711016575,3328373210,1661713617,1661714614,997,240
3855476133,3400000869,1660534836,1660535482,646,2090
3653850140,3816309635,1663574676,1663574801,125,630
3818319301,3829606187,1660338709,1660339644,935,580
3663342046,3338329823,1667111737,1667112388,651,1376
3315593278,3040889811,1641504039,1641504175,136,964
3507952797,3058834310,1646086051,1646086894,843,436
3865422787,3814355412,1667540055,1667540217,162,2147
3890159677,3852344377,1656051925,1656052470,545,1833
3796784054,3147336288,1667561155,1667561491,336,2275
3005809519,3680453323,1641163012,1641163754,742,1657
3522444883,3704120553,1668442274,1668442359,85,2384
3469740343,3899585675,1641647154,1641647472,318,852
3032779815,3356302136,1667970260,1667970536,276,1525
3895277580,3605308632,1644646286,1644646810,524,1264
3284443787,3361670451,1668776788,1668777266,478,707
3219292166,3968635893,1658049933,1658050586,653,2259
3822736402,3693000511,1652038090,1652038277,187,1257
3572689902,3794408677,1668314296,1668314571,275,19
3686968293,3104306511,1668176140,1668176305,165,1068
3575277293,3445226012,1646117377,1646117856,479,603
3990849115,3152933136,1643692434,1643692754,320,1703
3081213963,3373512814,1666725569,1666726091,522,669
3258057377,3826433692,1645380705,1645381701,996,1081
3692691710,3016508907,1641814262,1641814389,127,2291
3934988354,3677674125,1642897496,1642898299,803,724
3527269010,3093364150,1659662970,1659663164,194,2428
3741692259,3001509229,1650601775,1650602409,634,1393
3437215040,3017407853,1669191702,1669192424,722,1217
3062435759,3276458676,1656969886,1656970774,888,424
3963351842,3424562136,1669379932,1669380241,309,2040
3942399353,3962138330,1665598517,1665599252,735,635
3795990774,3558912751,1663373054,1663373254,200,1652
3133030655,3496617169,1657069277,1657069297,20,1125
3200875282,3350891476,1662499135,1662499334,199,2140
3884798812,3016995357,1651408685,1651408774,89,355
3361694981,3574486853,1661712004,1661712648,644,2319
3189300345,3842413213,1654897341,1654897553,212,389
3633730527,3953118937,1664763851,1664764563,712,2312
3331539245,3669299007,1664212977,1664213256,279,1934
3580774207,3249759052,1654381079,1654382075,996,749
3011459628,3810798932,1651343057,1651344028,971,2013
3252961062,3654344198,1667663127,1667663298,171,1213
3264081641,3807473345,1647592137,1647592358,221,1013
3879898101,3985854594,1669330123,1669331007,884,598
3910029798,3751975877,1665965266,1665966060,794,2042
3833230225,3951845301,1643883024,1643883815,791,832
3621969167,3657251975,1662947909,1662948072,163,108
3636960130,3448734872,1664704329,1664704417,88,1338
3523829341,3680703930,1666061370,1666061922,552,515
3004870031,3557409187,1652582970,1652583060,90,358
3799624292,3890335277,1645519654,1645519971,317,41
3643132014,3184000585,1661063430,1661064189,759,727
3214282155,3026769225,1668728391,1668728491,100,2433
3901086549,3250627439,1655287514,1655287751,237,2167
3898118371,3447470600,1650265153,1650265288,135,873
3184270447,3034255613,1655345915,1655346267,352,162
3790157838,3137441705,1641619831,1641620163,332,381
3096541903,3569329621,1653502139,1653502236,97,425
3699152541,3416196153,1663938488,1663939395,907,2124
3024551635,3744293001,1661055596,1661055794,198,819
3990233750,3866260144,1666049394,1666049750,356,114
3108998670,3282449988,1656473555,1656473823,268,1748
3701103798,3887002610,1666781050,1666781641,591,1872
3855769157,3253568318,1668580216,1668580571,355,700
3716137932,3721340009,1642881475,1642881918,443,1623
3961601633,3216171635,1654577593,1654578053,460,2476
3311921613,3364893066,1660250863,1660251321,458,1844
3960772879,3002415281,1658795827,1658796638,811,2332
3710756423,3288937566,1663451974,1663452120,146,1684
3268916307,3836823852,1646890775,1646891591,816,2301
3195214383,3388971461,1656388833,1656389416,583,2435
3861652282,3904517073,1665612513,1665612982,469,1822
3462543040,3413948595,1650822365,1650823026,661,1534
3352751731,3993653521,1647156023,1647156403,380,1847
3986353377,3067539427,1647932057,1647932328,271,1237
3127549843,3586128295,1642091551,1642091573,22,335
3141391673,3438130685,1667751589,1667752489,900,2037
3670063835,3815774397,1645962084,1645962173,89,177
3657587705,3642377610,1669730092,1669730627,535,478
3077552507,3149336644,1642029572,1642030083,511,1907
3564667780,3316237227,1642471853,1642472460,607,672
3620817271,3695419353,1662524576,1662525094,518,1132
3610239794,3080703553,1647123421,1647123531,110,1493
3131025611,3840449491,1644870522,1644871123,601,690
3838160976,3294357161,1642149974,1642150630,656,1297
3612878721,3442799166,1655427736,1655428037,301,1408
3959093613,3727020814,1645367826,1645367975,149,2096
3186787984,3831660488,1664498922,1664499044,122,2055
3156331863,3491333253,1657400758,1657400786,28,398
3130181848,3866993832,1667413193,1667413278,85,211
3506345760,3702965571,1641101638,1641102156,518,1759
3750756562,3878005127,1655478809,1655479086,277,16
3382777450,3098820434,1664480509,1664480910,401,44
3608485872,3430916751,1666652837,1666653540,703,2105
3320272612,3760142759,1662938555,1662939393,838,1451
3357692565,3124927662,1654441203,1654441543,340,2386
3958920817,3732456028,1662557320,1662557689,369,455
3571173934,3823206701,1658421908,1658422471,563,1655
3057574793,3882619512,1658061004,1658061759,755,2195
3289330422,3371818930,1655072847,1655073019,172,833
3698521503,3822736402,1669205652,1669206433,781,937
3342685325,3347832946,1666941721,1666941737,16,2258
3061462743,3763723423,1648664253,1648665220,967,920
3863080370,3318577605,1644839311,1644839520,209,263
3329154834,3099934862,1658708126,1658708444,318,310
3085093321,3204346356,1645963284,1645963797,513,1900
3940067834,3890161181,1662289510,1662289960,450,2447
3641983006,3714259747,1649189052,1649189082,30,403
3641682706,3307949630,1664466158,1664466653,495,494
3343729897,3647295073,1644975481,1644975892,411,203
3913994422,3790829012,1646981310,1646981997,687,868
3070984953,3092365114,1648110595,1648111470,875,1460
3103497887,3199563620,1664461626,1664462560,934,1444
3752652141,3556061704,1648349695,1648349778,83,503
3276576100,3567368088,1669186036,1669186833,797,666
3603096793,3090354216,1666048709,1666048920,211,185
3775501779,3540735539,1654217964,1654218757,793,119
3891258957,3565805050,1647279887,1647279949,62,1947
3670267009,3318227153,1668675939,1668676155,216,79
3776685300,3298505096,1656010632,1656011559,927,622
3147896698,3146645864,1650252375,1650253186,811,721
3963351842,3459599732,1644552446,1644553092,646,1526
3784168038,3667414511,1666912432,1666912951,519,1298
3563750578,3333543321,1652627293,1652628278,985,2471
3456285013,3141134453,1646998227,1646998468,241,1149
3437221963,3591290407,1652038301,1652038644,343,1457
3389472671,3115343467,1644838143,1644838187,44,877
3954297181,3850546468,1666656404,1666657025,621,2030
3064644311,3019204329,1654108216,1654109138,922,1025
3651286291,3118358674,1667115022,1667115674,652,1050
3903779058,3327873529,1642202415,1642203403,988,1236
3318663320,3954073874,1663326604,1663326927,323,1945
3412715210,3352444293,1658505343,1658506115,772,699
3822935707,3651847351,1642084616,1642084661,45,2408
3827551944,3829597039,1648095658,1648096311,653,194
3861717658,3972424804,1658159414,1658160119,705,1275
3242948145,3990109853,1648717697,1648718101,404,229
3435253366,3475352970,1669378425,1669378665,240,2427
3434650074,3080007856,1668798160,1668798585,425,995
3252760026,3119802700,1664106615,1664106659,44,256
3741692259,3476882609,1647201721,1647201769,48,616
3082708890,3176753600,1662490853,1662491448,595,813
3855537172,3472983363,1648020467,1648020708,241,645
3807924634,3088132769,1665989479,1665989752,273,414
3035895563,3086871623,1649853573,1649854185,612,1882
3928290954,3231988469,1642127935,1642128056,121,334
3294984880,3701537998,1660951534,1660952007,473,1395
3026769225,3590259850,1645277688,1645278572,884,521
3710043628,3698358344,1659264256,1659265124,868,2228
3765023649,3103004217,1659417613,1659418527,914,430
3272879760,3995868243,1666835591,1666835779,188,131
3107366519,3612878721,1641390425,1641390668,243,1311
3409332035,3062423981,1643640891,1643641185,294,733
3951158399,3656467120,1652947158,1652947316,158,604
3021492589,3569390971,1663318750,1663319260,510,1515
3836762535,3867205407,1643353961,1643354415,454,1757
3909278547,3045691620,1659563592,1659564453,861,421
3410719383,3781537659,1652075513,1652076056,543,214
3060121211,3356499294,1661017873,1661018235,362,304
3162947685,3201068600,1643852279,1643852313,34,1028
3129176226,3289153734,1646959636,1646959639,3,2071
3524508110,3825971737,1657340999,1657341635,636,2335
3332592315,3571576669,1657383668,1657384444,776,1922
3964987979,3479608671,1642797863,1642798714,851,1488
3569578952,3897212070,1668588666,1668588970,304,1263
3974630210,3330749303,1662256456,1662257132,676,1502
3380303288,3202225412,1649932871,1649933413,542,73
3635988688,3829593597,1660234570,1660234682,112,752
3930474522,3271648296,1668292089,1668292677,588,2089
3878573707,3635854686,1663043162,1663043605,443,1238
3882438892,3138662322,1654108118,1654108657,539,2069
3600015858,3650172161,1653126797,1653127796,999,403
3247047829,3549703546,1645768298,1645769212,914,1291
3985734621,3917373940,1666180798,1666181091,293,1257
3332144974,3743835099,1647746120,1647746764,644,457
3254952204,3689741006,1667253243,1667253862,619,1347
3735801716,3957430800,1660259410,1660259570,160,189
3442244098,3856160688,1649821209,1649821951,742,1416
3102119693,3372271387,1657894171,1657894370,199,2029
3479401102,3501568597,1649759413,1649759809,396,2451
3945905688,3740090157,1661923507,1661924408,901,550
3072911780,3309219121,1665815319,1665815530,211,1544
3562547940,3610480358,1660771617,1660771967,350,2294
3220577762,3071929787,1664562361,1664563147,786,1881
3066645531,3177915558,1649117089,1649117262,173,2435
3021727735,3043180716,1655379170,1655379687,517,2080
3827867076,3108818977,1642325897,1642326812,915,995
3028780744,3329987086,1662290891,1662291685,794,1870
3527106895,3568141696,1665412505,1665412774,269,1466
3828219822,3158988425,1654196309,1654196683,374,964
3592561930,3718909055,1642725179,1642725713,534,2437
3885162740,3881216721,1658287154,1658287987,833,58
3624748073,3022082086,1666069178,1666069970,792,2479
3536768410,3885849262,1659533964,1659534456,492,959
3046085814,3278297907,1654504715,1654505451,736,1856
3197362399,3084555769,1662748536,1662749016,480,475
3245723038,3294569676,1659943459,1659943772,313,885
3905067771,3040715509,1647432241,1647432734,493,1098
3399631396,3929887239,1664081600,1664082559,959,522
3428026242,3122002940,1653231465,1653232215,750,2307
3528467648,3782182063,1649585725,1649585929,204,1380
3300159475,3640605424,1645395206,1645395507,301,1160
3734035375,3906309759,1668058303,1668058942,639,76
3781789585,3037577001,1647426565,1647426965,400,296
3054606477,3634010080,1664109348,1664110228,880,250
3784414098,3644128961,1660972843,1660973183,340,1398
3811785839,3440598942,1654602912,1654603662,750,289
3220405755,3785584501,1666629050,1666629921,871,462
3354579861,3087333030,1645931734,1645932409,675,1151
3629090721,3316448833,1668909244,1668910050,806,1013
3648924087,3574205549,1648935183,1648936143,960,1393
3904183865,3515044837,1643637288,1643637581,293,1503
3078216798,3040136606,1644633056,1644633471,415,465
3060310842,3524545245,1651285298,1651285755,457,1242
3431883681,3500735220,1644306865,1644307299,434,1708
3729553337,3595336393,1642637784,1642638727,943,667
3355195985,3413898378,1647002174,1647002874,700,2004
3697231480,3402690548,1662031327,1662032149,822,676
3346012606,3831039944,1644322152,1644322229,77,428
3325735696,3039081980,1661606177,1661606686,509,331
3194871172,3541579882,1643207408,1643207561,153,0
3063791472,3868827867,1648493170,1648493675,505,1863
3354395496,3157546931,1654856433,1654857390,957,1187
3570872297,3727618645,1661655719,1661655925,206,954
3000254515,3818319301,1668022593,1668023354,761,909
3869930031,3025581381,1645615933,1645616763,830,331
3112615469,3721226798,1667323443,1667324215,772,1800
3228737899,3093364150,1659717609,1659718179,570,1520
3793840002,3272663489,1669446887,1669446940,53,1294
3242752835,3501972053,1666987062,1666987222,160,602
3128133737,3056982737,1665635786,1665636614,828,1352
3236819846,3766966794,1646136934,1646137432,498,1587
3897030063,3965867792,1658914885,1658914959,74,136
3142106289,3199395221,1642096504,1642097080,576,478
3916226073,3797294746,1642217966,1642218430,464,2117
3608597242,3591101388,1663761633,1663761906,273,433
3778675824,3653285237,1660668467,1660669334,867,759
3845363108,3780014272,1663981311,1663982116,805,387
3660548799,3744829701,1648106856,1648107426,570,1366
3981846169,3564296836,1667782865,1667782949,84,1749
3596454426,3530806404,1669268970,1669269417,447,1198
3990312725,3191133743,1654287223,1654287598,375,2448
3165884724,3275827194,1647611419,1647611938,519,1658
3913288832,3540550798,1643419411,1643419610,199,1733
3951751770,3828503026,1665371219,1665371473,254,236
3715200176,3822143503,1647996820,1647997238,418,2207
3235155985,3199635800,1656431578,1656432253,675,894
3956500972,3273701051,1650832789,1650833439,650,590
3797617787,3091530738,1669740253,1669740826,573,382
3516838480,3881000980,1651723806,1651724787,981,2454
3222446672,3891258957,1648296994,1648297610,616,752
3528146911,3707476548,1664712370,1664713351,981,1829
3054865222,3223094732,1661321539,1661322318,779,1823
3237841242,3190544941,1654787556,1654788205,649,788
3643939596,3655924018,1654878990,1654879548,558,1813
3508311968,3951592432,1659478536,1659479206,670,477
3884256882,3014552263,1664183643,1664184562,919,822
3691834770,3335040022,1659288526,1659289316,790,1714
3828722911,3771616536,1666507356,1666508137,781,1858
3551371020,3978330638,1651287095,1651287564,469,2145
3102332016,3725903222,1668424205,1668424478,273,734
3185373368,3733102461,1662847185,1662847397,212,2059
3734035973,3307933176,1662418747,1662419440,693,533
3637269987,3143452523,1669214672,1669214726,54,253
3104870555,3137195290,1645808450,1645809295,845,211
3229881750,3402349073,1659279228,1659279663,435,1443
3120505983,3863190883,1651292818,1651292839,21,1311
3470049551,3175418311,1655504984,1655505606,622,2003
3061299464,3595270507,1666451058,1666451595,537,1731
3272879760,3458493864,1656000521,1656001445,924,309
3365939940,3815462032,1658713412,1658714050,638,931
3066007042,3038529026,1658822188,1658822346,158,404
3718652649,3523045898,1668272567,1668272585,18,2335
3707867178,3498740809,1648606369,1648606853,484,2427
3578002057,3131938458,1652274568,1652274756,188,2468
3094147044,3336300808,1641286939,1641287096,157,863
3813666053,3272506285,1653045175,1653046058,883,1164
3546486600,3746971515,1660062291,1660063202,911,1886
3213039478,3550820934,1652296615,1652297059,444,1788
3633382140,3965585706,1662544056,1662544770,714,46
3924960579,3949947697,1656253628,1656254303,675,275
3191133743,3115177011,1665267705,1665267830,125,2058
3509999399,3037984793,1642744495,1642745031,536,592
3184178717,3895542691,1660347983,1660348036,53,1954
3495147813,3105357126,1644836846,1644836855,9,1348
3571991159,3023980378,1668000853,1668000854,1,1115
3402019498,3551810435,1658680625,1658681280,655,1709
3834268660,3711589639,1646630263,1646631227,964,669
3262864867,3946068928,1666746596,1666747241,645,2012
3093599187,3042034210,1667805847,1667806684,837,1806
3816561204,3166805288,1667880505,1667881245,740,2386
3556549065,3723957807,1654622313,1654622745,432,992
3561336684,3264339209,1654508418,1654508580,162,2158
3585495750,3898188404,1652594143,1652594971,828,1336
3384255827,3541200701,1647628686,1647629595,909,2286
3211965606,3655923753,1665192525,1665192582,57,465
3065246027,3786724835,1643328480,1643329360,880,2373
3000275416,3209544947,1669379700,1669379946,246,2474
3559208316,3626457002,1662826627,1662826685,58,2098
3611657912,3059151355,1663614354,1663614654,300,722
3247047829,3222082052,1659736577,1659737463,886,2460
3797259426,3955307397,1668646465,1668647141,676,1856
3909837555,3075563867,1667916446,1667916449,3,414
3698521503,3106371588,1656734880,1656734905,25,613
3942325631,3922697372,1659451825,1659452111,286,864
3505789435,3147512839,1653808845,1653809201,356,1345
3737086539,3390445291,1664095268,1664095499,231,1287
3436582780,3490381305,1657636850,1657637737,887,48
3558517913,3073924620,1649068786,1649069537,751,1427
3412307376,3347679085,1663085677,1663085980,303,77
3653031568,3925481419,1656651115,1656651664,549,215
3292667822,3031299470,1645200025,1645200481,456,36
3265434991,3400899022,1658174312,1658174564,252,80
3345186165,3654899608,1650928597,1650929302,705,718
3536156667,3800451074,1660386418,1660387262,844,1205
3157600969,3141198072,1641805270,1641805396,126,2102
3680677416,3472052544,1656519586,1656520203,617,523
3914926954,3368734939,1661667022,1661667668,646,791
3184680353,3858519840,1645221340,1645221938,598,1866
3722551682,3933045461,1667328461,1667329331,870,765
3236325866,3568141696,1656518297,1656519160,863,936
3097469330,3057574793,1650939113,1650939647,534,1812
3293924278,3510936211,1659390748,1659391015,267,976
3066892936,3407746149,1642674966,1642675186,220,1436
3970288014,3170985187,1646810104,1646810480,376,2061
3841174974,3161234904,1667554915,1667555535,620,1293
3312656348,3246028948,1656836949,1656837379,430,431
3483553551,3209462413,1661612149,1661612616,467,1901
3916244157,3774725066,1655036392,1655036576,184,279
3923635120,3124723265,1666540827,1666541257,430,293
3808952164,3303358502,1666084949,1666085738,789,2455
3542615732,3794408677,1667896443,1667896725,282,524
3947704522,3517556603,1656249368,1656249436,68,305
3511593307,3046006152,1665823511,1665823572,61,170
3886344418,3328854884,1643954143,1643955130,987,288
3745420516,3845334081,1642042246,1642043047,801,1376
3870320323,3119802700,1659246863,1659247444,581,704
3782457642,3687689210,1657403223,1657403724,501,2033
3791107997,3414857456,1641454471,1641454680,209,2285
3092800496,3385413048,1667132053,1667132708,655,117
3228574805,3204333859,1650859622,1650860194,572,1032
3986557042,3274985034,1664568109,1664568448,339,1074
3164702890,3005771350,1643553233,1643553850,617,1440
3938973292,3932002704,1647622042,1647622930,888,376
3851864688,3113760926,1647463698,1647464373,675,1430
3246701704,3852555743,1644942729,1644943125,396,1428
3538692457,3624139591,1649144142,1649144800,658,2074
3700737923,3903112291,1647174513,1647174994,481,379
3833722302,3937429867,1646608353,1646608398,45,820
3752297066,3006738164,1647651354,1647651779,425,113
3883812439,3156483651,1649607471,1649607696,225,938
3890875667,3713129998,1661666224,1661666700,476,2117
3854859043,3080930599,1654635370,1654635681,311,729
3817668840,3172825605,1662899721,1662900031,310,1311
3149804005,3437254567,1647950245,1647950286,41,1594
3155835978,3486442976,1653832561,1653832883,322,890
3166206557,3075293628,1661074745,1661074898,153,1609
3295146156,3033079935,1661989753,1661990003,250,1568
3577651077,3146653168,1651229047,1651229898,851,912
3686594925,3518717396,1655028569,1655028653,84,198
3880638655,3252157235,1641001576,1641002273,697,1822
3277284318,3128805218,1662485541,1662485740,199,539
3686249771,3551243497,1647180399,1647180899,500,1376
3734621671,3719445490,1661101083,1661101570,487,2130
3680255689,3790751649,1660296788,1660296913,125,70
3526968501,3380928920,1667950300,1667951288,988,1633
3949002357,3163030169,1651432853,1651433276,423,392
3796275634,3310294122,1654138438,1654138827,389,1074
3596841713,3835621921,1653331319,1653332108,789,1367
3022403169,3272879760,1658167361,1658167691,330,2374
3876867156,3521160717,1665931759,1665932499,740,157
3074051284,3123458167,1649498740,1649498925,185,1420
3311280180,3725963743,1662371952,1662372174,222,974
3921962724,3260157601,1663955731,1663956078,347,80
3249261763,3469437983,1640992685,1640992707,22,2031
3056267922,3827954829,1669669813,1669669977,164,518
3738591594,3362298218,1647953129,1647954028,899,1599
3142454040,3793344397,1649606628,1649606870,242,354
3686240080,3664267954,1660561761,1660561800,39,461
3799036179,3536118453,1665267704,1665268017,313,489
3671539226,3003705867,1650795784,1650796199,415,1803
3202424407,3829201459,1647258596,1647259078,482,751
3523305140,3097395182,1667952646,1667952875,229,186
3163552496,3604769442,1644995836,1644995862,26,2337
3595144575,3270914746,1647209784,1647210077,293,2000
3189111071,3261174036,1648701619,1648702029,410,635
3518583464,3521271030,1645204187,1645204893,706,755
3139931020,3474543664,1663882931,1663883280,349,2156
3730266625,3526793212,1658639399,1658640168,769,2063
3369330833,3747046698,1663482036,1663482818,782,60
3061461510,3032970317,1651077338,1651077705,367,1200
3431909978,3534910343,1652298020,1652298090,70,1047
3087123320,3623620611,1651859410,1651860191,781,617
3910502945,3622478840,1641760221,1641761096,875,126
3107713394,3167034499,1652317888,1652318242,354,1242
3894193367,3834011879,1663755653,1663756304,651,19
3369040211,3515837186,1656724435,1656724828,393,1130
3559301819,3756028002,1661911192,1661911892,700,2259
3402426323,3701370209,1650733202,1650733423,221,512
3285516363,3896982954,1657488096,1657489070,974,2309
3752817676,3860432776,1652403292,1652403816,524,471
3921261515,3224952698,1642581667,1642582651,984,1420
3994844749,3019761756,1665115392,1665116088,696,904
3225466850,3271689881,1645546229,1645546319,90,1657
3856386170,3807924634,1663150458,1663150619,161,1258
3058750967,3637518238,1666270204,1666270634,430,1830
3945370501,3097563397,1669676812,1669677712,900,620
3991727598,3037984793,1654309716,1654310122,406,696
3452683650,3133153956,1662355191,1662355222,31,1895
3093254727,3109127825,1669658329,1669658376,47,721
3546034581,3583585259,1657317299,1657317398,99,1097
3968337751,3292572977,1654137529,1654138056,527,1384
3357034260,3787937000,1642963451,1642963591,140,258
3346631744,3959872101,1665508405,1665508758,353,1381
3182396653,3311113773,1646416180,1646416822,642,2159
3804329236,3058855369,1664936667,1664937666,999,2026
3123522446,3009169806,1650961782,1650961947,165,267
3710782213,3827195774,1661166754,1661166892,138,122
3017484255,3050341848,1644751275,1644751527,252,2465
3019572992,3978667945,1644816812,1644816844,32,2274
3887397856,3377473764,1659549833,1659550504,671,2251
3520758396,3353388722,1668991334,1668991612,278,310
3767409219,3742159503,1654334817,1654335351,534,2085
3748950684,3937077335,1645176196,1645176861,665,1023
3293007803,3455198360,1643117147,1643117484,337,2220
3914946558,3804458349,1668202414,1668202577,163,872
3473102313,3163552496,1659085587,1659085766,179,2187
3500152600,3027812492,1658154067,1658154949,882,183
3747621620,3392534730,1645960281,1645961279,998,999
3802823421,3738835445,1667480364,1667480680,316,692
3564417343,3097031283,1668605334,1668606276,942,1536
3514354263,3745420516,1652074116,1652074348,232,2210
3526815452,3582859001,1668863885,1668864038,153,2171
3994383813,3257732454,1664593554,1664593645,91,2448
3106436957,3332592315,1655075376,1655075439,63,1793
3184955498,3672699331,1667925653,1667925944,291,2175
3336336934,3709736172,1653108290,1653108770,480,941
3752176146,3578655079,1655349276,1655349333,57,931
3561543601,3954988798,1657274765,1657275543,778,1230
3635854686,3741134467,1647178970,1647179468,498,2285
3253827804,3673549679,1662353033,1662353507,474,2363
3513925385,3007357837,1664500079,1664501034,955,13
3571348230,3877811036,1642157480,1642157708,228,21
3398876044,3969728585,1658436662,1658437027,365,1140
3649442188,3250528764,1644470884,1644471288,404,2286
3056501932,3149668198,1651759432,1651759635,203,2088
3103681676,3377847710,1649906760,1649907047,287,500
3849816711,3844666457,1661481720,1661482237,517,427
3112259657,3153541916,1643940383,1643940972,589,2349
3740090157,3932077086,1662330373,1662331240,867,1663
3705306826,3473314396,1659227061,1659227751,690,11
3642691052,3725903222,1655332830,1655333105,275,893
3771841105,3500320805,1652357477,1652358111,634,504
3570906118,3877205464,1663480862,1663481493,631,942
3697650296,3108342285,1664478581,1664478960,379,291
3301708925,3024447668,1646935832,1646936111,279,593
3435540149,3285516363,1665295663,1665295877,214,1728
3564444579,3799014776,1646700746,1646700821,75,2100
3478166190,3756028002,1642787428,1642787499,71,1004
3392271707,3341694529,1666613625,1666613795,170,1694
3985243519,3991046503,1645971466,1645971470,4,750
3516488694,3689375835,1655099740,1655100119,379,1238
3852017463,3794462820,1658000177,1658001104,927,1549
3952346496,3504457520,1660382549,1660383075,526,1387
3425804563,3660468597,1664225813,1664225985,172,954
3669386720,3781307416,1641254417,1641254427,10,1813
3410150990,3090179745,1652257658,1652258189,531,1868
3100027110,3319446954,1647526671,1647526921,250,1972
3670267009,3051253299,1653799301,1653800167,866,2127
3395782360,3940735440,1645456080,1645456553,473,210
3397972687,3401611149,1663797412,1663798062,650,332
3919478201,3601499230,1648776349,1648777115,766,1712
3539510682,3670266153,1657444448,1657444504,56,1577
3685678285,3645310975,1656101235,1656101948,713,2422
3935809720,3359296227,1662493433,1662494268,835,1091
3070199722,3772762015,1660046578,1660047146,568,1849
3783723078,3055603453,1667269285,1667269592,307,657
3686249771,3298505096,1658273674,1658273791,117,963
3084531614,3971648409,1658579934,1658580560,626,776
3285757325,3946306714,1649760673,1649760845,172,834
3430387951,3325981847,1643299965,1643300412,447,1511
3738761840,3313295291,1652444698,1652445153,455,2320
3616441586,3057308926,1649377321,1649377867,546,1565
3596841713,3645523523,1651848676,1651848945,269,1657
3912858275,3265725715,1642188553,1642189065,512,996
3793901427,3687151281,1652254171,1652254693,522,2333
3592471391,3712443558,1662667784,1662668144,360,1585
3319782337,3343279177,1661671576,1661671845,269,337
3896594746,3105460297,1665134495,1665135001,506,1223
3291394293,3677893619,1658660171,1658660619,448,1081
3223204355,3739453348,1662062129,1662062901,772,1714
3805826972,3970286228,1657459393,1657460324,931,784
3428299424,3846866111,1643574198,1643574900,702,385
3505480563,3190035679,1647476355,1647477087,732,1048
3917684798,3698898645,1643398864,1643399847,983,23
3092292487,3662526382,1653487666,1653488386,720,1976
3851778010,3038067120,1656943001,1656943869,868,1658
3671974600,3547758342,1652104385,1652104598,213,2471
3415768719,3460027343,1663551241,1663551866,625,1966
3157190919,3260695363,1646721609,1646721675,66,1079
3632763218,3200468398,1667861292,1667862057,765,1521
3627981146,3285225403,1654065385,1654065621,236,410
3772340083,3433439185,1662947865,1662948499,634,482
3387938632,3310582583,1656193179,1656193358,179,2422
3128571119,3885393767,1648878537,1648878741,204,33
3097501233,3240249176,1668294436,1668294713,277,890
3141963631,3979696807,1665075874,1665076567,693,817
3787550831,3079137127,1648215052,1648215323,271,2064
3424768768,3292812509,1643695832,1643696471,639,1514
3786322776,3424453686,1662565177,1662565486,309,117
3078791988,3893227652,1658804257,1658804948,691,1808
3096854657,3499272388,1653026607,1653027596,989,2310
3876344592,3457390239,1660434469,1660435364,895,79
3545214789,3375290121,1668176541,1668176585,44,782
3588579914,3111639847,1664147993,1664148379,386,96
3896910823,3634328779,1657111014,1657111723,709,1561
3544353013,3250253670,1662654049,1662655024,975,960
3119718471,3452181736,1656448871,1656449053,182,41
3995868243,3834160941,1645682847,1645683242,395,1847
3111167324,3628963667,1661631771,1661632168,397,578
3693000511,3197371652,1664762164,1664762500,336,1763
3057721767,3597557082,1647202374,1647202795,421,395
3155320608,3795792181,1660202584,1660202711,127,1543
3379105646,3779319466,1646393472,1646394070,598,1101
3685158343,3048361071,1669676213,1669676590,377,1354
3272912522,3982538753,1650720122,1650720410,288,1411
3897659334,3087876190,1644292470,1644293333,863,23
3185250646,3377774902,1667616170,1667616707,537,105
3704871253,3931277047,1644726950,1644727460,510,1643
3707676798,3112270906,1665347221,1665347438,217,2100
3008062664,3241341174,1644904798,1644905387,589,2233
3329496705,3428557602,1649445061,1649445940,879,1998
3128287586,3015593061,1669711708,1669712379,671,659
3944198123,3034256232,1653441836,1653441997,161,761
3403925711,3481293963,1652901638,1652902302,664,2499
3164702890,3373962186,1652779052,1652779776,724,478
3401568650,3595499905,1662996141,1662996417,276,1796
3937077335,3196009998,1653663453,1653664373,920,1798
3348006171,3773177927,1666947486,1666948127,641,2242
3218964640,3119802700,1657109703,1657110548,845,1399
3978728021,3595284541,1648127201,1648128159,958,506
3252070101,3957216784,1660043642,1660044025,383,2454
3471993716,3796784054,1657960789,1657960904,115,407
3783051630,3387840253,1649994893,1649995502,609,1066
3463509445,3985243519,1648080803,1648081762,959,2302
3207013037,3545214789,1660253501,1660253823,322,2350
3151323388,3662578193,1660925424,1660926037,613,2173
3663038239,3125813072,1668063402,1668064055,653,2285
3160071792,3178981589,1661827073,1661828046,973,29
3880298832,3746351822,1646746583,1646747522,939,1318
3486582851,3563840007,1643097129,1643097513,384,79
3727544443,3730368703,1653809741,1653810150,409,449
3639515059,3152438109,1651757545,1651757722,177,705
3105630699,3405388298,1651977546,1651978494,948,352
3749211785,3441541439,1644918832,1644919825,993,2360
3074460772,3442244098,1656799901,1656800293,392,1828
3092365114,3218798966,1654908951,1654909343,392,1147
3583585259,3434608050,1662617821,1662618295,474,856
3793086361,3173586762,1650092306,1650092599,293,287
3471463543,3558281313,1654029949,1654030491,542,2358
3234620335,3321202962,1667539982,1667540748,766,1309
3382777450,3887586447,1667970441,1667971165,724,2474
3142274869,3783325820,1651289784,1651290028,244,894
3098083694,3779611783,1665913656,1665914342,686,432
3798597128,3763385597,1652685153,1652685408,255,871
3875118670,3120737114,1667502379,1667502679,300,65
3338715388,3124079349,1664670157,1664671099,942,916
3151346211,3876377964,1652044429,1652045273,844,530
3017407853,3468987116,1657407934,1657408644,710,952
3231988469,3969728585,1642880580,1642881561,981,1374
3376673600,3148259657,1652683325,1652683401,76,932
3167074299,3066757468,1650747963,1650748748,785,2186
3113423573,3339415879,1643213686,1643214068,382,1037
3373806425,3728224229,1657450821,1657450931,110,2159
3152860718,3449993526,1644358439,1644358636,197,1750
3980283928,3297949666,1659154967,1659155898,931,886
3722948390,3994577207,1658961877,1658962342,465,2488
3896308173,3033159477,1651866772,1651867436,664,1779
3270273033,3736535657,1665691467,1665692220,753,690
3869293895,3215443177,1650395283,1650396177,894,1448
3067150549,3017883382,1663759979,1663760926,947,1829
3612642897,3190003253,1651972500,1651972729,229,719
3867353788,3887337385,1657559038,1657559616,578,236
3430464852,3470482542,1657863913,1657864322,409,1775
3848936636,3213995449,1651766471,1651767241,770,1013
3366155048,3968795612,1660618501,1660619459,958,1287
3774806676,3766205598,1658096791,1658097190,399,1159
3340933137,3885493402,1654795466,1654795663,197,996
3185250646,3274588728,1646266165,1646267102,937,2411
3172130228,3324041559,1668564738,1668565335,597,2129
3115343467,3744726408,1644238586,1644239237,651,1258
3393406422,3651503901,1650075864,1650076443,579,1001
3131930167,3766160943,1662849394,1662849985,591,2419
3608200385,3947174877,1642057942,1642058199,257,2238
3278819973,3607354151,1661388530,1661389320,790,106
3562243381,3316031407,1656730299,1656731105,806,2371
3610480358,3639695113,1661545426,1661545783,357,659
3294276727,3181032246,1657197011,1657197230,219,1115
3868474839,3567959060,1663077417,1663078241,824,1581
3194603908,3301620813,1664800669,1664801483,814,7
3100201926,3033029762,1649077517,1649077893,376,1014
3145669202,3324998923,1649130961,1649131157,196,1335
3189358030,3408115806,1665599083,1665599756,673,590
3140608489,3906455689,1646984993,1646985452,459,2264
3587727278,3500948971,1654509050,1654509308,258,1113
3229321048,3079031370,1648351631,1648352466,835,471
3492247995,3761636372,1653295340,1653295376,36,1469
3129170273,3072277927,1663701444,1663702317,873,2254
3325735498,3252021647,1655754300,1655754660,360,836
3101669976,3605706184,1665028968,1665029361,393,2364
3428176980,3303973335,1661099641,1661100262,621,14
3126746702,3018946311,1669748847,1669749420,573,1145
3382015551,3657340310,1641075106,1641075586,480,1118
3744829701,3155835978,1661371096,1661371835,739,864
3663228098,3404785260,1663509661,1663510406,745,1174
3265611656,3759421049,1645170673,1645170927,254,1545
3021727735,3863948017,1655921816,1655922577,761,993
3657203747,3725117905,1653106038,1653106779,741,523
3022256617,3629797745,1646048726,1646049161,435,1292
3812997079,3055603453,1667498607,1667499432,825,1475
3557087358,3149181988,1668936655,1668937549,894,1140
3357692565,3826257607,1660987878,1660988230,352,2408
3604694727,3896019652,1655676828,1655676978,150,1226
3696096099,3900451371,1642274080,1642274716,636,229
3299821745,3270273033,1664293580,1664294507,927,570
3095437969,3003872692,1647858143,1647858414,271,13
3014354609,3340464785,1654030880,1654031554,674,342
3557734825,3349301564,1663318419,1663319082,663,1842
3500216283,3546605941,1668516618,1668517330,712,367
3933874233,3534224607,1666920682,1666921236,554,1041
3332012161,3492034029,1661896490,1661896584,94,932
3034147055,3956500972,1662847717,1662848302,585,888
3938337743,3617757019,1644046755,1644047718,963,872
3433439185,3686247296,1644364799,1644365165,366,605
3415535285,3886611745,1662649705,1662649757,52,68
3303358502,3145328663,1653390884,1653391563,679,778
3270935026,3443785253,1641485548,1641485825,277,1478
3141392063,3749208805,1669095492,1669096200,708,1578
3909281743,3031249180,1661196216,1661197203,987,900
3793738776,3115777637,1643909480,1643909974,494,552
3159897010,3617128437,1664413198,1664413731,533,135
3506345760,3612269633,1668686160,1668686562,402,2420
3788336754,3993756491,1657445425,1657445632,207,1035
3990870728,3287399418,1651678281,1651678487,206,1157
3271759672,3344787204,1665934347,1665934443,96,1755
3066451739,3058789362,1666399399,1666399593,194,1427
3304726864,3646908383,1662641107,1662641227,120,1187
3157546931,3264018414,1653451519,1653451976,457,1467
3199411589,3546284533,1642673716,1642673938,222,363
3531820891,3215870665,1664181270,1664181286,16,344
3551170621,3524109178,1657098067,1657098801,734,1442
3514894244,3030630339,1656204746,1656205743,997,1455
3401962895,3776944992,1652017950,1652018288,338,1167
3736681866,3454754318,1650625683,1650626036,353,1080
3219637680,3370217481,1642982250,1642982747,497,1162
3825971737,3594269515,1658805687,1658806070,383,1915
3580908290,3634044438,1669400923,1669401430,507,2001
3671830270,3922697372,1643935417,1643936091,674,115
3491718080,3370120843,1646937701,1646937816,115,2225
3711847265,3059416141,1663486894,1663486908,14,290
3203319376,3536443756,1648634812,1648635706,894,803
3602497998,3564033398,1665528632,1665528910,278,1022
3297681098,3631455637,1659547761,1659548371,610,1119
3602924213,3522623156,1659585525,1659586232,707,893
3702541874,3233536885,1658841755,1658842411,656,962
3328854884,3611763388,1658710388,1658710951,563,146
3963787394,3194204306,1651119465,1651119480,15,1064
3485046222,3444174394,1646473088,1646473159,71,1574
3595560993,3137412000,1664470775,1664471169,394,2421
3879967963,3225500469,1665420658,1665421545,887,1227
3807478002,3301119536,1659217543,1659218344,801,827
3664408598,3759656646,1643774564,1643775286,722,1158
3883874845,3897421758,1653987643,1653988325,682,601
3264434341,3183507473,1644652430,1644652464,34,1207
3882315040,3283447626,1656121370,1656121591,221,2333
3003402470,3235586138,1663118688,1663119521,833,1847
3808191596,3012593677,1641211844,1641212245,401,1891
3644164788,3784046500,1659303024,1659303785,761,82
3431175768,3658451605,1646226633,1646227023,390,1323
3836089663,3486582851,1667868118,1667868180,62,2223
3643276679,3982538753,1645000474,1645000561,87,106
3179180919,3259367927,1669530382,1669530480,98,825
3752701792,3861717658,1662795063,1662795239,176,2229
3177036721,3328479258,1658810413,1658810526,113,1548
3851540721,3089034472,1652667407,1652667946,539,1092
3822307865,3509619062,1662175485,1662176159,674,165
3173788210,3936468941,1659961775,1659962392,617,204
3904634428,3000254515,1667185969,1667186927,958,1451
3941783209,3949841652,1656429289,1656429783,494,1205
3656770582,3196302340,1651755366,1651755391,25,1784
3606954305,3052951476,1668625985,1668626382,397,1417
3645560004,3266121254,1660681601,1660682557,956,1791
3782266220,3839642166,1646877163,1646877426,263,134
3791419861,3504893701,1645224724,1645225215,491,1114
3952663430,3086076310,1659509436,1659510260,824,1841
3555560595,3847957207,1665053548,1665053944,396,509
3278854404,3656002043,1648356016,1648356997,981,1851
3055390520,3307033178,1644207568,1644207836,268,2182
3064522150,3260036272,1659640545,1659641385,840,622
3489453670,3867554012,1657665579,1657666386,807,1682
3182243157,3599354804,1662251188,1662252093,905,194
3639804787,3557215676,1660747834,1660748822,988,359
3524480094,3208802379,1665172771,1665173099,328,446
3673561332,3865503383,1643918405,1643919022,617,2216
3558281313,3688776786,1646922159,1646923039,880,1297
3457417743,3319037937,1649884907,1649885338,431,1135
3636237325,3950146840,1659976566,1659977046,480,2041
3053134032,3911632634,1646924812,1646925251,439,2047
3912014286,3748360490,1641349375,1641349568,193,1669
3602829591,3366643644,1641205482,1641205867,385,2202
3878005127,3072985971,1652574231,1652574954,723,493
3177879837,3986814631,1659538233,1659538317,84,1784
3823161778,3745248673,1668731923,1668732324,401,1121
3746050591,3874569616,1666095178,1666095738,560,1371
3094852425,3723700913,1656479780,1656480143,363,466
3098538909,3268670465,1662923608,1662924023,415,1059
3599160097,3643185661,1644369117,1644369328,211,854
3338715388,3594173372,1659782312,1659782462,150,1332
3881482215,3349433488,1641678360,1641679165,805,2399
3663814997,3190972776,1649701980,1649702977,997,508
3133427035,3431082237,1651407082,1651407126,44,390
3729768092,3870349696,1661977100,1661978095,995,1352
3153552268,3626020948,1644409128,1644409296,168,2390
3553471050,3342009927,1641986760,1641987583,823,1961
3839642166,3992708211,1660147424,1660147879,455,120
3758708262,3611139716,1662416530,1662416678,148,831
3365676412,3043753185,1653115685,1653116584,899,1137
3544020942,3634735892,1657156596,1657156876,280,1312
3103158328,3582478882,1666215234,1666216010,776,2125
3884256882,3293435801,1650824185,1650824899,714,39
3962695354,3095430228,1648626895,1648627466,571,1326
3202453519,3942862085,1642667373,1642667935,562,1665
3145039731,3917500425,1659791155,1659791542,387,369
3337601088,3426753006,1661059010,1661059401,391,682
3719445490,3033523546,1654590509,1654590583,74,1236
3994130271,3105250340,1649320434,1649321291,857,1103
3885493402,3808415962,1651879105,1651879262,157,1882
3098276544,3774991953,1661972640,1661973160,520,1523
3473728186,3897433648,1661291372,1661291690,318,1832
3487166896,3185611253,1648345814,1648346709,895,487
3787230225,3038424212,1658717334,1658718054,720,1148
3366410496,3225500469,1655969872,1655970656,784,2210
3053693777,3136174856,1645421655,1645422421,766,876
3118419220,3637944484,1659096561,1659096934,373,1308
3835976086,3339719117,1666895483,1666896294,811,1276
3310953839,3973401658,1665429811,1665430763,952,1704
3557087358,3582033850,1664946436,1664947180,744,1289
3059068631,3173788210,1665375548,1665376159,611,1069
3797653596,3032747459,1666295592,1666296083,491,1236
3376180688,3443785253,1641499854,1641500322,468,1474
3553048423,3348406323,1650715135,1650715325,190,1280
3747929255,3195534254,1662319158,1662319966,808,704
3154309446,3912183552,1643023873,1643024328,455,1509
3416945471,3673950693,1655665458,1655665829,371,732
3883846613,3891579335,1661751617,1661752339,722,2299
3063782933,3936122118,1649811958,1649812000,42,179
3984461468,3500097822,1642395407,1642395957,550,2155
3267650986,3112356239,1659366668,1659367385,717,1998
3760975208,3690349378,1665163329,1665164157,828,2458
3490415118,3112859411,1646805293,1646806249,956,2217
3407746149,3636619501,1654627528,1654628275,747,2027
3529681535,3948310967,1665728870,1665729706,836,451
3347397074,3624484272,1653204196,1653204763,567,997
3239158180,3616651934,1667941068,1667941629,561,1077
3795494127,3771826410,1666009097,1666009321,224,1124
3239158180,3525088003,1646223367,1646223736,369,731
3283056652,3453511353,1656947452,1656948282,830,2370
3129500635,3829606187,1648969038,1648969812,774,2366
3090731052,3536219260,1666429471,1666429532,61,2238
3917684798,3942852295,1669354189,1669354872,683,1346
3278566573,3642691052,1648828950,1648829432,482,929
3626015702,3831951487,1641527161,1641528103,942,1468
3580178697,3856386170,1664398778,1664399367,589,699
3603594711,3922423821,1658767920,1658768066,146,2404
3075001202,3639013476,1647626441,1647626894,453,2291
3957586219,3307067721,1644530686,1644530813,127,2234
3461630480,3735277639,1666341696,1666342392,696,901
3169559952,3579684205,1645950870,1645951323,453,2393
3590243603,3511397819,1661834849,1661835250,401,1908
3358571434,3101460702,1660656311,1660656365,54,1663
3574240169,3790783685,1646110241,1646110484,243,802
3640349880,3442735570,1667010131,1667010135,4,2166
3438574719,3414834461,1648144894,1648145287,393,163
3360575138,3319334426,1659082325,1659082867,542,642
3692904228,3170102962,1647873816,1647874618,802,733
3444149733,3237807880,1663808408,1663809313,905,446
3165700370,3676893681,1658676049,1658676623,574,302
3636621583,3093146280,1658510103,1658510679,576,144
3668645457,3040528605,1643850583,1643851517,934,1401
3154288650,3520341683,1646366230,1646366844,614,1622
3268826534,3801956152,1642116340,1642116688,348,317
3389105515,3307306078,1643337990,1643338485,495,110
3759393612,3804328787,1659704840,1659705817,977,2072
3625869317,3787298788,1649736672,1649736739,67,1861
3284137438,3853056907,1650745073,1650745788,715,698
3938505582,3545240944,1641587041,1641587923,882,109
3316952075,3467215587,1661170494,1661170567,73,727
3181912863,3472458500,1660889971,1660890395,424,816
3004100055,3114361358,1641385957,1641386032,75,2395
3061619114,3792117640,1659630334,1659631311,977,1575
3965585706,3816309635,1651497882,1651498615,733,586
3734367959,3041792624,1644609484,1644609808,324,729
3552101140,3885162740,1655695571,1655696266,695,2204
3142106289,3919196366,1652535159,1652535891,732,1651
3127467065,3805283132,1646876208,1646876327,119,1851
3307225202,3771758356,1657636686,1657637563,877,1311
3586128295,3713520914,1646362084,1646362116,32,2473
3047388698,3864436164,1659396508,1659396546,38,214
3711100517,3549752945,1667252876,1667253379,503,1751
3553000813,3632283664,1653477852,1653478243,391,1288
3940914301,3828516865,1658416381,1658417063,682,190
3739338939,3882414600,1641603467,1641604293,826,736
3740236087,3765827886,1652767025,1652767754,729,682
3343752753,3463669049,1655348405,1655348801,396,2229
3428142421,3124562368,1665612081,1665612367,286,2193
3292636621,3420676198,1641821743,1641821924,181,1784
3232781077,3530157274,1655636662,1655637012,350,1911
3004160380,3002029298,1668735342,1668736054,712,1579
3609880975,3972677516,1664353546,1664354028,482,437
3267045921,3545652885,1645384513,1645384834,321,1401
3528418687,3017075122,1661646447,1661646705,258,1337
3283037458,3910581173,1661807904,1661808256,352,2006
3359212197,3822126164,1657106403,1657106539,136,2276
3538039823,3298879351,1659773272,1659773583,311,1910
3540717336,3918581818,1662328919,1662329582,663,661
3484699376,3646159351,1647236483,1647237132,649,1718
3430638959,3880290667,1648795920,1648795965,45,1479
3151896132,3712727713,1657266559,1657266657,98,986
3382015551,3468455079,1668494033,1668494849,816,292
3564395523,3617795950,1662419852,1662420794,942,1713
3438550737,3914427859,1648342856,1648343539,683,2017
3587903968,3182243157,1658998139,1658998249,110,1244
3299472791,3158209281,1650771163,1650771238,75,965
3875434702,3412675211,1647494731,1647495383,652,1972
3461292351,3572276937,1647014409,1647014560,151,1725
3046500774,3986963711,1645162339,1645162980,641,781
3964524277,3118128782,1645630913,1645631610,697,1458
3317961564,3371745136,1654616215,1654616653,438,2422
3980851662,3990144819,1654605255,1654605922,667,1242
3984570592,3493752989,1651405951,1651406884,933,2092
3304523843,3194796707,1659539887,1659540825,938,1313
3098513510,3235586138,1652090842,1652091512,670,1913
3989646368,3995412026,1653886265,1653886843,578,691
3387774254,3723438987,1658880218,1658880482,264,1783
3430464852,3122002940,1663633068,1663633575,507,1268
3662763316,3673935826,1649892626,1649893049,423,2066
3125911793,3036488445,1646653855,1646654270,415,548
3433557410,3884412861,1657048822,1657048954,132,1402
3880638655,3848607936,1658761095,1658761889,794,1549
3508202949,3599694754,1659594999,1659595741,742,479
3880439495,3722422633,1663241650,1663241874,224,524
3282166903,3867799694,1669532460,1669532754,294,1864
3124147703,3267650986,1650598467,1650599373,906,765
3287600901,3329117199,1667077860,1667078593,733,728
3014462663,3258057377,1658257492,1658258104,612,2154
3061814600,3764343778,1654688580,1654689286,706,580
3912672075,3235825340,1641950172,1641950878,706,579
3126746702,3400114442,1643169928,1643170236,308,783
3015715378,3831585514,1654918556,1654919253,697,553
3806664868,3490430582,1650612986,1650613388,402,823
3985491144,3545188902,1647323636,1647324205,569,2253
3149818961,3308256167,1643726845,1643727711,866,2066
3201068600,3046618211,1666323938,1666324129,191,1226
3673892525,3296478783,1667435625,1667436449,824,2266
3164550059,3334030228,1644253212,1644253571,359,1626
3492258334,3788717673,1648700028,1648700182,154,1965
3382133724,3162844882,1652560243,1652560281,38,47
3103625074,3623351962,1653643241,1653643268,27,648
3304523843,3998209085,1647853060,1647853770,710,1790
3036448305,3663228098,1650800330,1650801077,747,1952
3898641431,3366845170,1665652259,1665652529,270,1145
3074051284,3382133724,1666637473,1666638096,623,1855
3930142533,3839566998,1655714499,1655715272,773,1439
3818508802,3391441349,1649406181,1649406789,608,2335
3010368174,3767868249,1653411435,1653412019,584,841
3634735892,3104050460,1655373294,1655373505,211,970
3626216693,3167058279,1653021429,1653021430,1,816
3040742963,3130181848,1654086900,1654087265,365,1203
3672693214,3813290629,1648301764,1648302429,665,1893
3055402951,3063714742,1651178846,1651179637,791,1999
3408396410,3789279639,1642843338,1642844093,755,1198
3126995401,3711576021,1642983011,1642983257,246,1835
3051253299,3295278768,1654750553,1654751080,527,831
3721870717,3566834497,1654614499,1654615233,734,367
3384460816,3813697780,1641138099,1641138200,101,753
3473571389,3459708884,1669708722,1669709634,912,69
3127142463,3047477485,1663605620,1663606229,609,68
3640745969,3804329236,1663290741,1663291676,935,1649
3751588241,3233920789,1662651592,1662652337,745,745
3362395200,3460428731,1651291314,1651292268,954,2296
3510318605,3411347712,1651861249,1651861960,711,1719
3283056652,3231517158,1654035114,1654036052,938,194
3427127427,3623092479,1660330920,1660331501,581,1780
3916244157,3356499294,1664983638,1664984532,894,2294
3176608983,3489466063,1663650050,1663650451,401,2377
3303815040,3103158328,1659003588,1659003828,240,2138
3157965235,3164467795,1664638142,1664638737,595,1344
3076307729,3616441586,1665104072,1665104944,872,1660
3967727550,3865299110,1663208758,1663208889,131,1581
3583029647,3043598133,1660938493,1660938586,93,1209
3095170532,3679939578,1644414648,1644415216,568,325
3620013325,3768253081,1657987134,1657987624,490,1250
3359722926,3152456543,1648910500,1648910739,239,2371
3666268915,3055044716,1663596292,1663596825,533,1049
3324113509,3658295713,1667607630,1667607874,244,368
3740284866,3002931773,1658969160,1658969195,35,1338
3586524207,3130134092,1659889175,1659889378,203,1890
3013073909,3187291408,1646216299,1646217177,878,738
3936154124,3203153576,1641148298,1641149025,727,1167
3408978529,3532926054,1645912479,1645913268,789,2058
3362091170,3553530817,1658821918,1658822465,547,924
3396149289,3773532257,1661486054,1661487036,982,909
3994130271,3829377486,1658256334,1658256846,512,1861
3644272268,3875243979,1667030683,1667030900,217,689
3071602516,3595336393,1646709102,1646709763,661,1912
3620748135,3496807015,1665174933,1665175140,207,2228
3456799118,3717406689,1641057399,1641057913,514,1249
3635324805,3595270507,1657493916,1657494620,704,665
3707676798,3306290309,1658429231,1658429627,396,790
3000165786,3840003483,1660774222,1660774299,77,1034
3141108539,3045070182,1655930193,1655930764,571,2375
3712443558,3977699882,1665849245,1665849494,249,150
3655566080,3920482918,1650740099,1650740571,472,1603
3638297718,3938583443,1668266746,1668267369,623,1023
3160242179,3817960208,1642321818,1642322613,795,835
3973440480,3460678842,1657841238,1657842078,840,2339
3473505436,3091595739,1669372151,1669372310,159,386
3462714323,3085136451,1669446350,1669447293,943,1819
3921754282,3898229065,1650033766,1650034515,749,1139
3267360802,3683038464,1659304426,1659304758,332,1104
3209288149,3363944559,1655770910,1655771520,610,663
3656865344,3325565610,1658047306,1658047845,539,653
3386809097,3468703620,1650767400,1650767437,37,2062
3469437983,3369049258,1641354899,1641355242,343,1110
3994783794,3673549679,1645600738,1645601668,930,783
3368420871,3017758671,1662903560,1662903687,127,1299
3429010148,3985620157,1668515081,1668515552,471,1702
3596883607,3831660488,1663980503,1663980823,320,690
3853644964,3619704547,1661701926,1661702769,843,1338
3156683897,3766196716,1649399689,1649400407,718,1337
3412501516,3920437320,1657152364,1657152825,461,1861
3951692395,3752297066,1655226203,1655227176,973,582
3470112947,3007480776,1643331969,1643332268,299,810
3552494506,3279538648,1650885648,1650885756,108,1922
3101609490,3818508802,1666391491,1666391906,415,1241
3310462353,3719146348,1644969581,1644969707,126,1217
3558370114,3658516535,1661848187,1661849093,906,902
3526061797,3481672220,1658716245,1658716895,650,29
3648924087,3755294305,1657450247,1657450777,530,1611
3971203354,3573941843,1651938745,1651939206,461,107
3049567508,3714122939,1647694989,1647695128,139,5
3967250644,3574394407,1648883796,1648884684,888,2369
3149804005,3044450059,1669535403,1669536283,880,490
3080287966,3380822514,1655242313,1655243274,961,893
3390431277,3722948390,1667414001,1667414661,660,641
3463800741,3557400406,1667070238,1667070899,661,1323
3993580342,3197201691,1662011772,1662012038,266,1076
3586128295,3594903436,1643358088,1643358188,100,1578
3053855376,3753657577,1668954907,1668955700,793,1327
3999788546,3658260972,1665079933,1665080862,929,655
3345905539,3487166896,1648721975,1648722364,389,1382
3465406980,3927666827,1651509538,1651509675,137,498
3508340066,3816240060,1668023258,1668024024,766,2052
3428287409,3449622291,1655072845,1655072860,15,2198
3262864867,3330548469,1655181301,1655181405,104,881
3557556781,3657305306,1645630370,1645630773,403,1100
3888469544,3030551637,1655178572,1655178767,195,682
3929901413,3437983939,1648754579,1648755271,692,1849
3126653341,3705809622,1644206956,1644207845,889,2025
3609664184,3163986082,1642491650,1642492221,571,1525
3120208739,3308891574,1645440936,1645441514,578,1362
3172825605,3375585327,1651758537,1651758859,322,808
3092956442,3530806404,1652136216,1652136429,213,1625
3803959008,3232737784,1665286730,1665287658,928,1187
3972677516,3099224416,1650995472,1650995939,467,2206
3442854678,3524480094,1660177310,1660178005,695,1163
3697822889,3053026624,1662775103,1662775626,523,1832
3280648157,3787230225,1646459026,1646459100,74,1356
3229060690,3455198360,1647576122,1647576688,566,1557
3587324906,3768211591,1659805157,1659805449,292,20
3051654064,3852344377,1649282119,1649282586,467,787
3925239812,3080195715,1651389390,1651390281,891,1184
3862939959,3346986628,1667863659,1667863983,324,7
3553096192,3714575918,1660377417,1660377474,57,860
3564883937,3264081641,1657415681,1657416201,520,924
3370867881,3023025075,1642316447,1642316823,376,661
3466459383,3656656446,1642082602,1642082746,144,408
3208220195,3254503569,1657022282,1657022504,222,1499
3739453348,3404200815,1664446018,1664446990,972,2386
3033438220,3941548978,1663992755,1663993007,252,1303
3492727050,3730845439,1669545341,1669545841,500,799
3570480973,3065298582,1656754386,1656755241,855,757
3795508879,3011458038,1664401820,1664402002,182,856
3222438717,3647685310,1669253981,1669254274,293,1179
3862456223,3867115890,1664612509,1664613277,768,970
3603071341,3266042074,1644638273,1644638801,528,1205
3674729672,3177651100,1669413020,1669413786,766,1892
3162939277,3827195774,1645354515,1645355257,742,724
3314190424,3604757184,1668901493,1668901866,373,506
3990379463,3744196402,1661286174,1661286566,392,638
3830579550,3858519840,1657925662,1657925955,293,948
3406239480,3971926686,1646564839,1646564882,43,1620
3623620611,3292111100,1653054470,1653055014,544,2228
3037846389,3973059785,1664946785,1664946920,135,1901
3505196729,3669324531,1647208005,1647208937,932,1347
3956836647,3804257503,1645947981,1645948507,526,1240
3740051209,3042045098,1655452780,1655453763,983,1286
3059322626,3810823450,1644191306,1644192086,780,23
3723110330,3031816406,1667897913,1667898266,353,544
3271605522,3363944559,1642336861,1642337490,629,880
3766818968,3948260526,1641604899,1641605525,626,1065
3068723030,3151323388,1650230265,1650230334,69,1971
3883874845,3980108258,1644999146,1644999321,175,2443
3320435078,3349879521,1667025985,1667026192,207,1324
3919478201,3565001530,1657329051,1657329284,233,2135
3097016405,3294703062,1641112650,1641113158,508,2482
3981348782,3154567629,1657708468,1657708744,276,2273
3095772004,3771460646,1646526470,1646527119,649,1943
3914275771,3697085492,1655905767,1655906185,418,2387
3449080412,3719146348,1645770452,1645770917,465,1569
3852704822,3534224607,1666627406,1666628325,919,1996
3402349073,3346604377,1642642261,1642642521,260,11
3154704216,3320767438,1666691476,1666691614,138,644
3585989542,3776148003,1659562028,1659562303,275,2438
3643132014,3811672443,1655288842,1655289838,996,305
3900876329,3986825518,1658530850,1658531341,491,2353
3309684706,3734311859,1659548958,1659549766,808,1241
3453143238,3482576542,1668317592,1668317792,200,2283
3095834081,3938773149,1650916878,1650917825,947,551
3295905536,3390431277,1654630329,1654630786,457,1148
3222446672,3973059785,1666725835,1666726686,851,1749
3551371020,3827810459,1665928402,1665928747,345,2368
3103404280,3618545572,1645836112,1645836233,121,1202
3833230225,3245723038,1659424139,1659424671,532,1344
3598223917,3817667121,1658551810,1658552247,437,2332
3103215750,3682747704,1662416763,1662417455,692,2493
3228518080,3974917779,1641312403,1641312405,2,637
3481293963,3975096180,1661647618,1661648457,839,370
3787058440,3679846649,1668898795,1668899472,677,975
3012930968,3942399353,1659749241,1659749564,323,1973
3156980878,3553241769,1657994813,1657995281,468,555
3536080615,3804978604,1648001902,1648002824,922,364
3171906034,3356034290,1667462078,1667462739,661,1676
3905581902,3580774207,1667038159,1667038228,69,2067
3425804563,3710422072,1647716272,1647716427,155,244
3309468510,3947083981,1649246462,1649247091,629,276
3475352970,3139604406,1655008907,1655009568,661,1539
3315185864,3194618871,1652894341,1652894684,343,1783
3777597419,3865463499,1651089875,1651090563,688,1912
3073474496,3171906034,1646213170,1646213821,651,1551
3822187489,3481149583,1659659194,1659659470,276,2480
3011686027,3252981510,1669102310,1669102346,36,2365
3808415962,3210078490,1657808059,1657808295,236,1107
3442447509,3280223679,1658631775,1658632330,555,864
3933752482,3276232281,1645072804,1645073745,941,2196
3023772977,3897212070,1648974637,1648975339,702,2280
3013457125,3272981808,1658738711,1658739124,413,401
3414370730,3048409719,1659078726,1659079161,435,722
3560043638,3280630861,1641826411,1641826501,90,188
3922341165,3274159957,1647484461,1647485256,795,1448
3507500782,3769786489,1657492296,1657492684,388,2088
3812385830,3495858842,1660350920,1660351842,922,2361
3696149430,3094147044,1654847942,1654848778,836,1918
3620616287,3627191763,1652109678,1652110491,813,20
3599604382,3486262024,1662502698,1662503527,829,837
3449504551,3084969131,1654073995,1654074151,156,1977
3103421893,3689375835,1666888462,1666889004,542,1984
3631152825,3209462413,1653590539,1653591215,676,1499
3558912751,3645523523,1665887302,1665888138,836,1337
3814899146,3988674966,1663800120,1663801014,894,353
3325981847,3759867623,1646354796,1646354812,16,1810
3438961567,3228518080,1649951974,1649952645,671,518
3590259850,3114733025,1667266580,1667267221,641,2425
3970288014,3924990392,1660786114,1660787008,894,1046
3196407951,3375655129,1646401526,1646402365,839,809
3144405714,3748988849,1658059114,1658059282,168,164
3612720177,3625504025,1653666007,1653666473,466,2040
3983113289,3194342775,1649222327,1649222823,496,174
3811730419,3809698347,1641061950,1641062656,706,905
3773742235,3379548317,1649825375,1649826367,992,1760
3449352254,3945370501,1653935604,1653936082,478,782
3657115450,3046738951,1647887053,1647887595,542,802
3414834461,3281923852,1655849219,1655849740,521,594
3344279346,3287399418,1655968237,1655968371,134,1161
3012845933,3970049421,1652646697,1652647039,342,1023
3739048247,3613021322,1657596687,1657597302,615,393
3761201412,3057314040,1648719040,1648720006,966,1659
3252790120,3061924533,1669621349,1669622126,777,2133
3101265323,3071341023,1659243949,1659244495,546,921
3304589206,3268349855,1649700259,1649701027,768,115
3032747459,3451771672,1668653019,1668653971,952,468
3878274883,3519726741,1647843521,1647843985,464,1011
3561529281,3223174482,1658351414,1658352097,683,1301
3729600228,3929282989,1645974357,1645974746,389,2457
3514218549,3389161785,1645185492,1645185530,38,1628
3050867171,3793840002,1641420262,1641421255,993,1265
3497911447,3978330638,1651416444,1651417026,582,1726
3291641388,3179180919,1656873284,1656874115,831,1537
3127549843,3890161181,1643019775,1643019894,119,1714
3297314002,3092956442,1661850130,1661850866,736,1585
3740274448,3427937915,1646053882,1646054083,201,13
3428593255,3321441782,1665627254,1665628000,746,2049
3014552263,3681001652,1650864261,1650864995,734,698
3529681535,3104164320,1648874155,1648874798,643,509
3205423909,3836565798,1647893506,1647894474,968,809
3156483651,3531574623,1655570868,1655570914,46,2497
3893872926,3084940745,1659813386,1659813756,370,282
3069536467,3373962186,1647120392,1647120575,183,2240
3261685435,3001302955,1667514256,1667514397,141,194
3310496626,3476283460,1648162908,1648163197,289,1254
3100176230,3364855872,1653545419,1653546405,986,99
3961830711,3637861848,1645841381,1645842009,628,842
3864249446,3246571420,1655608088,1655608128,40,2283
3389560959,3321835417,1646745187,1646745396,209,1997
3064461314,3031386210,1642338087,1642338094,7,1502
3431175768,3644951156,1669390304,1669391108,804,645
3938097708,3197693984,1662745513,1662745737,224,905
3785813162,3096386556,1663484791,1663485015,224,2126
3477827867,3635624917,1665104500,1665105035,535,1929
3775645582,3707342422,1667070510,1667070647,137,2066
3678482446,3530278315,1658242584,1658243165,581,6
3818039978,3904825547,1644540604,1644541195,591,2217
3047643464,3959408689,1666419609,1666419786,177,884
3178529360,3934890046,1644967193,1644967676,483,312
3741344192,3094147044,1669221720,1669221970,250,1209
3446490643,3066546417,1653088851,1653088880,29,1033
3241190614,3428763205,1652644920,1652645323,403,860
3065810858,3691607111,1653923212,1653923849,637,2016
3922251351,3047400344,1666055533,1666056061,528,1825
3917984429,3207994528,1655144436,1655144700,264,387
3996587507,3957798687,1645780378,1645780896,518,2357
3446699030,3373806425,1651178377,1651179204,827,2419
3070520574,3541413511,1669611504,1669612342,838,1081
3640387984,3105815944,1654374666,1654374728,62,2037
3521408145,3962062858,1662273074,1662273808,734,2434
3088465843,3434650074,1662854563,1662854929,366,578
3258352640,3467933841,1650069884,1650070086,202,578
3293775646,3115343467,1656568078,1656568612,534,1933
3291175188,3349716508,1668206462,1668206655,193,2013
3963257683,3321835417,1659993152,1659993273,121,299
3729768092,3943892886,1641060440,1641060759,319,738
3740051209,3837481005,1645136412,1645137103,691,1402
3006085284,3763300182,1656281046,1656281788,742,2177
3360040841,3329496705,1656261043,1656261529,486,1113
3866532806,3623685885,1652338204,1652338456,252,1027
3266867093,3741273371,1654027881,1654028591,710,145
3414930462,3728924033,1646361290,1646361937,647,1391
3681843847,3653218860,1661408245,1661408327,82,1361
3808397193,3163662966,1659980746,1659980897,151,470
3619714539,3545032372,1644726782,1644727614,832,2258
3577114014,3669880471,1663592412,1663593033,621,1616
3012032774,3168576951,1660756842,1660757172,330,1867
3605587138,3656654582,1663921538,1663921774,236,1650
3649649514,3339385127,1655975901,1655976679,778,30
3542285714,3832438123,1668832364,1668832734,370,335
3453884967,3641983006,1645172832,1645173758,926,46
3799900837,3929307105,1648145254,1648145691,437,2117
3243044619,3462033895,1658440877,1658441064,187,1559
3862918742,3343059553,1669125319,1669125950,631,1954
3213995449,3708809295,1666365627,1666366217,590,222
3448409263,3213124781,1652547306,1652548124,818,2488
3935210171,3360051725,1642928614,1642928767,153,500
3985037610,3176608983,1666452774,1666453689,915,2170
3642314622,3116584028,1662544620,1662545045,425,1259
3432563578,3695237310,1665877880,1665878780,900,2309
3749208805,3735817368,1642903960,1642904430,470,378
3244071979,3810823450,1649266240,1649266970,730,555
3347152834,3837481005,1651676557,1651677428,871,49
3762571799,3573692342,1643817084,1643817947,863,1409
3415686543,3263403144,1668130803,1668131176,373,2083
3540279517,3778402105,1644785614,1644785697,83,774
3775103844,3270914746,1648499331,1648499742,411,1703
3497271227,3133030435,1663678603,1663679580,977,463
3994409144,3591290407,1645783358,1645784000,642,100
3658513045,3625201370,1650917760,1650917771,11,635
3323109920,3350345176,1655447245,1655448035,790,496
3896777982,3373667144,1654938656,1654938755,99,1075
3043256301,3755580356,1658861976,1658862472,496,2494
3888703674,3664264570,1651246730,1651246825,95,1139
3664267954,3442408044,1655475617,1655475753,136,1385
3092941538,3774264905,1658526640,1658526965,325,1278
3908796611,3339962549,1667602436,1667602753,317,590
3169898520,3628830127,1647502617,1647502911,294,2441
3346012606,3851540721,1644919183,1644919448,265,1776
3243902799,3328589697,1648817812,1648818629,817,1721
3718182841,3937129101,1647572932,1647573116,184,1856
3700109325,3578002057,1654549835,1654550677,842,1943
3409949315,3278190233,1642668541,1642668755,214,2488
3106732056,3706209487,1641047150,1641047286,136,314
3764492400,3796198742,1652359852,1652359854,2,1250
3722551682,3284940142,1659486712,1659487206,494,993
3822736402,3244969283,1664740823,1664741745,922,253
3648118736,3604426149,1665054852,1665054861,9,1371
3592487083,3549768940,1642047083,1642047754,671,162
3549752945,3868348947,1658902746,1658902984,238,1723
3042739113,3150474600,1662141816,1662141953,137,2255
3428176980,3247787797,1653733990,1653734673,683,2131
3448726123,3673761066,1658135622,1658135941,319,1124
3672874828,3784123884,1651796736,1651797108,372,1755
3883338335,3432364009,1658304426,1658304986,560,476
3011459628,3102760949,1650941170,1650941398,228,188
3422703729,3636960130,1662913074,1662913334,260,2244
3870574001,3735801716,1646602601,1646602951,350,1065
3693041370,3661976391,1653594531,1653595052,521,2417
3218136112,3025108334,1667318147,1667318258,111,117
3280372392,3311280180,1669281914,1669282121,207,849
3466459383,3498758411,1652634270,1652634733,463,1011
3450502369,3539797487,1651209410,1651210090,680,1805
3985617701,3284630826,1661260551,1661260830,279,723
3936122118,3611967437,1660273260,1660274167,907,2213
3967747142,3436578278,1656946841,1656947114,273,2403
3725439899,3108566218,1651482434,1651482983,549,254
3912410470,3437221963,1644010861,1644010867,6,1619
3462825977,3579486534,1641583617,1641583833,216,1316
3404020970,3178643457,1668047704,1668047929,225,106
3799776825,3185745995,1645011631,1645011783,152,1926
3126746702,3581011004,1665125072,1665126069,997,1673
3904907996,3098369438,1644054804,1644055357,553,1380
3105460297,3246759301,1668775083,1668775880,797,375
3334743610,3224130773,1648723681,1648724298,617,182
3066956305,3735946925,1662526399,1662527260,861,1416
3178728299,3293611774,1668983310,1668984092,782,1592
3886611745,3678505160,1644875305,1644875331,26,1520
3686594925,3844560489,1643919052,1643919441,389,2389
3064961160,3220690215,1651840570,1651841444,874,500
3678505160,3368571252,1659381865,1659382660,795,628
3488001885,3104719783,1649377248,1649377683,435,1048
3668078009,3888392286,1662143956,1662144631,675,1568
3296956444,3057201124,1645079178,1645079450,272,2353
3812239613,3133767042,1663138092,1663138771,679,1163
3493232103,3894193367,1663613985,1663614361,376,1953
3627730665,3653286489,1661221348,1661222285,937,1990
3008850935,3700968228,1650747450,1650748262,812,568
3856587038,3526166184,1643830377,1643830826,449,2371
3138958890,3529898997,1667416973,1667417123,150,1187
3448734872,3722247979,1665748921,1665749417,496,1163
3687919265,3543732655,1642205546,1642205592,46,481
3847104925,3103421893,1663850467,1663850830,363,1344
3014185506,3982538753,1669491024,1669491029,5,886
3157308488,3120823401,1642292480,1642292685,205,1146
3028267408,3710851755,1653430988,1653431287,299,490
3957053810,3560015501,1666509283,1666509686,403,1067
3431883681,3066451739,1653072032,1653072788,756,385
3589366986,3594903436,1644668725,1644669009,284,229
3250381378,3972056646,1662851101,1662851139,38,207
3543696190,3008283469,1656385964,1656386745,781,815
3530376538,3719929552,1642102563,1642102576,13,2178
3467401235,3917526154,1655535487,1655535836,349,378
3700412611,3134166826,1658154490,1658154748,258,1476
3324394622,3019657030,1653290827,1653291488,661,1232
3880298832,3860745004,1661237569,1661238234,665,1491
3807323401,3424768768,1656267694,1656267779,85,1107
3423971586,3879322451,1663440811,1663441398,587,1348
3971588399,3614206353,1654017884,1654018677,793,65
3526239660,3712727713,1648437355,1648438071,716,315
3755580356,3510660628,1642697527,1642697566,39,1870
3603096470,3077683954,1658822511,1658823008,497,1558
3852017463,3190454065,1660276678,1660277201,523,1843
3460669513,3493232103,1657460918,1657461478,560,691
3729356619,3402439102,1668695133,1668695970,837,1660
3306439333,3469437983,1661466120,1661466363,243,2098
3149313426,3746443510,1654169389,1654169434,45,517
3562859716,3124044009,1642558069,1642558443,374,730
3507939773,3210036729,1661406742,1661407411,669,1954
3300479839,3295278768,1647566446,1647566752,306,1048
3603068932,3175979112,1665472133,1665472698,565,503
3165208023,3653285237,1662380017,1662380919,902,842
3491398730,3333095694,1659161198,1659161992,794,851
3459188746,3976267689,1668924830,1668925165,335,1312
3811472324,3495858842,1663009965,1663010144,179,1594
3590243603,3683246538,1650483084,1650483158,74,1497
3163012662,3942134694,1643664295,1643664305,10,2040
3571793713,3526239660,1641440479,1641441460,981,279
3855900879,3985585282,1652912135,1652913040,905,2490
3533172784,3619175296,1645750506,1645750543,37,775
3342199267,3670291498,1650760180,1650760271,91,744
3526365568,3553096192,1646716458,1646716501,43,584
3552457707,3634089207,1665227772,1665228067,295,1994
3104459009,3826433692,1665349029,1665349324,295,1272
3012034151,3787071341,1661325374,1661326017,643,1989
3239158180,3008609242,1646972392,1646972998,606,2005
3284832227,3157496248,1641972241,1641972535,294,1511
3347679085,3495798110,1650069103,1650069464,361,1738
3714535860,3135712818,1656864416,1656865153,737,1885
3917448920,3516624109,1663527930,1663528791,861,626
3165470497,3356765270,1657894703,1657895585,882,2144
3740438273,3592906293,1657185476,1657186296,820,746
3801768919,3938272679,1662134307,1662135038,731,426
3355184225,3182982515,1641259935,1641260913,978,1806
3085136451,3870458690,1643328921,1643329797,876,2451
3042034210,3383755219,1645123893,1645124809,916,580
3152036409,3576862500,1643050383,1643050508,125,947
3831585514,3063478155,1664377906,1664378066,160,822
3711576021,3686641761,1643600653,1643600779,126,2154
3039001408,3795940241,1641035700,1641036667,967,1170
3702302181,3807538433,1643293416,1643294293,877,307
3416945471,3460704532,1642575584,1642575775,191,1982
3074395717,3917229175,1668569405,1668569662,257,448
3154079557,3541372095,1651709691,1651710207,516,382
3452683650,3570955260,1662641105,1662641585,480,1594
3324473595,3713129998,1668864166,1668865098,932,284
3809387134,3571991159,1643794390,1643794499,109,41
3966130885,3294783182,1666522178,1666522641,463,1499
3496470143,3331904172,1664212155,1664212355,200,1091
3014275222,3261376049,1642990670,1642991407,737,1553
3137092101,3225477579,1649835541,1649835661,120,722
3356317749,3668753730,1655053119,1655053336,217,2052
3738359725,3017504746,1650922093,1650922397,304,68
3252843201,3976730264,1645677834,1645678200,366,248
3207283619,3008550397,1662239954,1662240375,421,1052
3347854994,3386918140,1650339508,1650339871,363,1069
3321835417,3318466045,1643072183,1643072484,301,638
3951354982,3568676955,1667645493,1667646289,796,2188
3254083367,3664264570,1644633760,1644633804,44,427
3741413739,3371063992,1668995429,1668995896,467,71
3101460702,3208757755,1660434808,1660435757,949,975
3498314038,3423088497,1661981359,1661982313,954,2196
3039932020,3517912492,1648463060,1648463854,794,1852
3260036272,3740807524,1648504877,1648505333,456,1137
3040136606,3424211722,1667762071,1667762314,243,79
3582033850,3876927357,1665242637,1665243587,950,1522
3828713812,3635624917,1650980999,1650981678,679,1389
3297290662,3096386556,1652025099,1652025472,373,2100
3611353561,3663814997,1641195592,1641196322,730,938
3109127825,3509999399,1642977247,1642977367,120,1283
3804648275,3835784338,1667479478,1667479955,477,301
3366822094,3746229411,1655438779,1655439229,450,2314
3465433147,3772910484,1646980613,1646981353,740,399
3894508827,3199288675,1656877869,1656878170,301,930
3779590261,3373962186,1658896639,1658897392,753,2476
3877811036,3086357122,1662585545,1662585820,275,1820
3992226673,3164355501,1653989507,1653990120,613,2461
3402511144,3358578228,1667684264,1667685136,872,858
3640756400,3536080615,1648763287,1648763937,650,1840
3057300178,3453076338,1656830131,1656830421,290,1334
3405352606,3730428171,1655485068,1655485390,322,2266
3555187890,3339633388,1652889393,1652889771,378,2083
3197739962,3878512967,1644443466,1644444013,547,1137
3709518724,3199288675,1664097786,1664098601,815,843
3647263296,3175676853,1668710310,1668710813,503,1888
3570423127,3858911279,1661986175,1661986451,276,317
3515941468,3714575918,1655190676,1655191530,854,963
3085412399,3097834756,1653481062,1653481592,530,1533
3705306826,3637269987,1655663230,1655663627,397,1049
3887054161,3275649997,1646736572,1646737341,769,2490
3534224607,3153831709,1661262091,1661262866,775,566
3037090215,3957586219,1643038474,1643039404,930,1372
3016482005,3156331863,1657199638,1657200540,902,1986
3822736402,3255904598,1650667361,1650667656,295,1465
3563972468,3103743198,1661990910,1661991901,991,697
3213836945,3861247260,1667981573,1667981867,294,2243
3877090261,3818023164,1641582560,1641583142,582,2260
3600856738,3003723782,1652884820,1652885328,508,359
3296066748,3105946115,1643285645,1643286080,435,1847
3489695411,3752442248,1644768846,1644769286,440,1339
3604596896,3650367155,1659895664,1659895769,105,2164
3078791988,3920261171,1660734113,1660734132,19,1635
3746979257,3713308621,1652416521,1652416602,81,2409
3032498591,3408978529,1663746634,1663746639,5,1521
3740438273,3097033729,1664599513,1664599551,38,1142
3001603320,3618380884,1656708768,1656709548,780,1767
3323198594,3327933393,1643644142,1643644857,715,2216
3916261675,3491356699,1649104482,1649105172,690,179
3003134699,3343048708,1664609369,1664609652,283,1794
3449115415,3673731636,1643345800,1643346731,931,1124
3348735740,3365829981,1648360221,1648360674,453,1525
3665148560,3355910238,1641246330,1641246939,609,43
3576422890,3274588728,1666524954,1666525189,235,2028
3258417294,3595738872,1657321872,1657322039,167,1627
3228737899,3955219063,1664238434,1664239348,914,362
3677306151,3933332705,1645833003,1645833219,216,632
3048788442,3154823834,1659148542,1659149085,543,592
3289061595,3468922263,1646116334,1646117021,687,1884
3147896698,3629593465,1652574130,1652575054,924,1215
3154079557,3507952797,1644910576,1644911539,963,1751
3502599631,3166517941,1653000635,1653001122,487,1910
3919478201,3150730013,1646638141,1646638165,24,1995
3845886572,3843953645,1645849874,1645850169,295,1640
3369469616,3960816300,1646229851,1646230720,869,1826
3912858275,3272912522,1664191146,1664191163,17,502
3257080734,3571173934,1653173959,1653174658,699,1513
3792708367,3215402575,1646315693,1646316612,919,747
3657044188,3630982131,1645441430,1645441585,155,1390
3469740343,3293237543,1662597870,1662597916,46,1
3635988688,3575457804,1665639074,1665639086,12,431
3346254669,3644951156,1664721185,1664721516,331,1510
3034014975,3590627159,1657584522,1657585370,848,810
3643637605,3909859344,1646410778,1646411525,747,566
3643382802,3991046503,1661638898,1661639888,990,2135
3599568023,3928989640,1666918385,1666919378,993,1627
3990870728,3575457804,1666246467,1666246509,42,2451
3150027454,3344472194,1647841647,1647842201,554,1635
3145961063,3337845468,1648141765,1648142673,908,1420
3686968293,3407778626,1654879457,1654879523,66,1375
3920910995,3136172164,1668438739,1668439054,315,581
3993995217,3660998516,1660570361,1660571295,934,168
3836762535,3490044613,1648398272,1648398460,188,374
3761609140,3040521946,1664259498,1664260118,620,691
3458116043,3120419076,1660247181,1660247191,10,1893
3302294195,3660129917,1642378907,1642378992,85,2115
3233425442,3180728306,1643730547,1643731377,830,1567
3910979746,3624298459,1658484424,1658485272,848,1460
3662788693,3608450611,1665915067,1665915941,874,1979
3365676412,3720248207,1660350106,1660350971,865,1120
3245354614,3159897010,1651487348,1651487510,162,1863
3876127195,3675093452,1656875870,1656876283,413,754
3319583055,3987423059,1648975542,1648975810,268,2163
3358277498,3104050460,1667055338,1667056005,667,331
3262377052,3983711613,1656087460,1656088128,668,1595
3134337442,3351087116,1641029667,1641030237,570,1895
3480375415,3657044188,1650799776,1650799996,220,2086
3489273340,3468987116,1651916099,1651916467,368,436
3845802546,3477770827,1657814536,1657814564,28,555
3962536480,3707767360,1653292272,1653292655,383,1348
3577817989,3057348673,1667222370,1667222541,171,1198
3404563689,3156261740,1660402491,1660402521,30,1555
3055545326,3281397783,1660325325,1660325966,641,173
3787058440,3643173963,1656829398,1656829494,96,1923
3912183552,3401134518,1666781435,1666781837,402,2473
3996989799,3572594221,1650524719,1650525326,607,774
3123441689,3532634291,1661698116,1661698971,855,200
3882978452,3719929552,1654167520,1654168275,755,1011
3377457710,3086324092,1659238087,1659238974,887,1673
3059176048,3694244943,1652101824,1652102409,585,1837
3599299457,3030630339,1667240754,1667241737,983,880
3470049551,3098290557,1651436698,1651437390,692,2266
3013814400,3135139573,1667454629,1667454713,84,1650
3741024153,3925523737,1663440675,1663441337,662,368
3895861447,3563246157,1669492215,1669492387,172,464
3584925664,3018325807,1653618048,1653619008,960,2093
3957577990,3341591226,1648060535,1648060571,36,1052
3911588238,3432522125,1643014823,1643015609,786,1040
3669647019,3135707503,1669437030,1669438003,973,1755
3896239645,3074269946,1665040599,1665041375,776,1447
3990312725,3886184659,1659677421,1659677509,88,2066
3062844769,3591348696,1648293132,1648293914,782,1781
3514013878,3701537998,1647615005,1647615387,382,159
3351906355,3316952075,1642109679,1642110628,949,414
3152988371,3341042744,1647425284,1647425474,190,2184
3725903222,3695419353,1653753398,1653753644,246,312
3938583443,3791894034,1665866685,1665867177,492,37
3880599649,3871845792,1661541503,1661541783,280,1529
3644951156,3545240944,1652541177,1652541201,24,1474
3477522732,3451089348,1660027774,1660028465,691,2051
3751588241,3258102756,1658537621,1658538124,503,978
3507376482,3026035554,1654956098,1654956808,710,509
3732456028,3711422567,1669243996,1669244545,549,2054
3562021711,3691032308,1665774494,1665775165,671,1584
3607385542,3432563578,1647092708,1647093521,813,1559
3327857419,3080454518,1661234660,1661235104,444,830
3807576323,3605706184,1666980813,1666981708,895,1283
3290176410,3611062566,1654724935,1654725890,955,299
3116584028,3229497695,1658006182,1658006698,516,1937
3875434702,3490286406,1661514409,1661515130,721,196
3832585790,3990849115,1661336611,1661336942,331,75
3220405755,3807538433,1651254543,1651255191,648,1779
3749308364,3922066704,1648945847,1648946566,719,1232
3792143103,3823942349,1653344766,1653345463,697,2430
3679939578,3364661787,1666393490,1666393652,162,938
3001794280,3399334455,1668658924,1668659195,271,1450
3413898378,3183259139,1648726187,1648726815,628,2385
3576284955,3413305965,1645659064,1645659618,554,1471
3326882521,3801107936,1650680633,1650680664,31,1901
3785721693,3349716508,1660734900,1660735653,753,2078
3537943189,3787514151,1664879901,1664880457,556,1239
3457191473,3548609816,1648677116,1648677383,267,1013
3307933176,3105946115,1651600447,1651600470,23,1577
3328699609,3022256617,1642980372,1642980726,354,1276
3952425376,3152537793,1654921280,1654922229,949,1003
3137529896,3357247840,1661089538,1661089937,399,1188
3687938178,3976453338,1654145384,1654145933,549,2255
3694618653,3789999187,1658512377,1658513103,726,34
3208106743,3538466951,1649261211,1649261393,182,131
3179354869,3319365305,1652961305,1652961458,153,2256
3101609490,3783916284,1662365638,1662366537,899,315
3537294800,3494498890,1650890787,1650891594,807,129
3286065477,3707940691,1662429206,1662429316,110,1446
3553436680,3505026131,1658532227,1658532378,151,279
3173809486,3938679223,1641270521,1641271338,817,1273
3362249024,3852673624,1641398575,1641398917,342,531
3770393539,3850906711,1650058829,1650059414,585,539
3214068022,3842413213,1654870257,1654870957,700,1973
3447743170,3219575313,1655443257,1655443917,660,1869
3586950573,3783515345,1651737140,1651737703,563,990
3835202206,3823692648,1658626238,1658627225,987,949
3437122732,3424790413,1668824594,1668825294,700,1523
3070241461,3084592361,1660086568,1660087252,684,2407
3626020948,3791107997,1666399479,1666400050,571,1991
3395479272,3005283650,1641309191,1641309303,112,1716
3749756110,3934199220,1642732048,1642732354,306,1145
3241021396,3880580622,1663577851,1663578110,259,1286
3892206642,3070520574,1647595714,1647595810,96,1593
3837447685,3936029875,1663119849,1663119892,43,2187
3782730026,3025333750,1650664038,1650664680,642,309
3997312859,3735817368,1644468849,1644469462,613,740
3397910828,3090804084,1651914726,1651914908,182,1267
3568097363,3941528766,1644005622,1644005697,75,1897
3228518080,3638822670,1663670577,1663670744,167,2354
3563750578,3673549679,1657305014,1657305624,610,2145
3139035952,3852633699,1656889485,1656890238,753,821
3629797745,3714065380,1658334505,1658335014,509,34
3458116043,3289332257,1652028764,1652029122,358,814
3954297181,3656027442,1653674355,1653674577,222,986
3274452346,3457361080,1664509465,1664509863,398,353
3984050382,3081005801,1659077049,1659077658,609,1870
3828833040,3477692188,1645442169,1645442669,500,1607
3027295354,3662023903,1660477361,1660477861,500,2076
3092564684,3524315738,1642329226,1642329739,513,949
3176941664,3203734562,1668488760,1668489474,714,403
3433237569,3654922401,1669486041,1669486723,682,1510
3978667945,3793086361,1648129452,1648129594,142,1486
3609043475,3292010262,1658733531,1658734412,881,1496
3268826534,3317431311,1665174689,1665175481,792,676
3851747907,3449915970,1656128599,1656129194,595,2069
3661243199,3270395343,1653260402,1653260941,539,759
3157965235,3412673526,1655989091,1655989339,248,422
3165807050,3991340294,1667177228,1667177510,282,1681
3867214487,3613018005,1642288351,1642289021,670,1052
3345543859,3253395374,1649953335,1649953430,95,861
3880620233,3644127860,1643058630,1643058842,212,1348
3863448086,3035803277,1651113812,1651114664,852,1175
3145393304,3634018428,1651777939,1651778315,376,1115
3650172161,3933940005,1662111645,1662112242,597,1482
3199892178,3896910823,1649947095,1649947290,195,570
3368630986,3697085492,1660209730,1660209958,228,1982
3784646522,3460572652,1658760892,1658761491,599,955
3624872846,3139455252,1655919526,1655920356,830,1510
3777609973,3069992620,1645234351,1645235335,984,756
3492376573,3805665502,1649641782,1649642607,825,2081
3647539125,3605587138,1665985834,1665986002,168,1574
3990343743,3032123620,1663746333,1663746700,367,1954
3389497658,3922728266,1661743165,1661743660,495,613
3738571497,3471463543,1644400393,1644401308,915,215
3178640485,3550107804,1655097494,1655098449,955,228
3779459643,3329154834,1666636371,1666636488,117,1814
3728240849,3350017208,1653208076,1653208890,814,1516
3054639823,3193483812,1646236196,1646236682,486,1068
3428889808,3240588695,1669643076,1669643337,261,1001
3949480596,3190906256,1644838829,1644839645,816,745
3335275571,3061366261,1643572592,1643572595,3,1770
3179354869,3848963466,1668277164,1668277885,721,2092
3269690639,3880290667,1660317363,1660318109,746,1519
3792117640,3920669948,1657627264,1657628014,750,2206
3342215329,3975096180,1653080657,1653081015,358,2396
3499787925,3468633309,1648381952,1648382093,141,1106
3328544337,3691367177,1669042237,1669042328,91,721
3592471391,3790157838,1643239918,1643240653,735,2199
3528069102,3630448266,1658680117,1658680848,731,1919
3799078288,3651535646,1664704910,1664705329,419,2153
3582531330,3116777827,1669753326,1669753727,401,2262
3518864357,3379548317,1641981710,1641981923,213,323
3081369661,3825824228,1665525986,1665526402,416,1933
3971934050,3947788644,1661614954,1661615021,67,221
3949480596,3126653341,1641886001,1641886333,332,2012
3671974600,3266962342,1648817880,1648818310,430,1992
3477692188,3634282428,1663904385,1663904453,68,1193
3884412861,3592379849,1669226333,1669226415,82,392
3043064916,3405749286,1660883968,1660884716,748,1020
3310582583,3347152834,1650603181,1650603346,165,719
3454851350,3487406679,1646875020,1646875522,502,1537
3374688375,3660983068,1657647972,1657648390,418,1735
3334792271,3913680174,1641782750,1641783538,788,2104
3369040211,3488962022,1652176470,1652177292,822,2430
3045427279,3999788546,1641637065,1641637074,9,1895
3165884724,3755236966,1658111432,1658111669,237,138
3322226292,3876687977,1664434473,1664434810,337,2051
3522549719,3924559198,1657609227,1657609293,66,421
3085311533,3457468984,1658002675,1658003117,442,289
3710466773,3239158180,1641591397,1641591981,584,659
3298857826,3727995134,1641669274,1641669881,607,2452
3372197177,3815507952,1660816375,1660816826,451,1244
3532021354,3224864814,1669716991,1669717848,857,1843
3998763119,3401382792,1651560727,1651561703,976,1215
3146378665,3107865208,1662272577,1662273468,891,512
3357048496,3542293606,1657511750,1657512531,781,241
3893475632,3478288963,1663393351,1663393727,376,200
3216470508,3720240255,1649574945,1649575139,194,1553
3401957566,3903108572,1661731694,1661732545,851,189
3172293659,3534517997,1659419796,1659420083,287,653
3924799278,3048781539,1642375372,1642375998,626,893
3172524712,3199322269,1642497796,1642497982,186,434
3001037251,3044345094,1668519785,1668520443,658,990
3672371563,3980934555,1649371876,1649372138,262,1302
3943836795,3046080865,1661430251,1661430909,658,1412
3695360424,3650675743,1664706309,1664706637,328,1683
3858519840,3680694926,1659613868,1659613969,101,370
3854351732,3207013037,1651137653,1651138338,685,604
3168084964,3631455637,1655762213,1655763026,813,933
3292782964,3888438556,1647766543,1647766574,31,2364
3325735696,3273379502,1645237272,1645237964,692,249
3252760026,3415788314,1656835876,1656836176,300,950
3100440036,3044390847,1659916985,1659917061,76,1730
3814608487,3612642897,1651183050,1651183691,641,53
3932002704,3339856407,1648543912,1648544193,281,995
3521410258,3809458973,1660975476,1660975640,164,2200
3210430918,3931108765,1661759421,1661759626,205,1010
3421600026,3409804938,1648520009,1648520998,989,2159
3417143667,3895842487,1666440181,1666440496,315,907
3526968501,3979522310,1646970200,1646971159,959,353
3875908590,3775665997,1641749777,1641750220,443,1245
3037279735,3834166808,1666065017,1666065075,58,1880
3605706184,3338154846,1659457058,1659457188,130,509
3512353520,3329135548,1642809322,1642809853,531,766
3537138552,3392105056,1650689717,1650690045,328,854
3316625530,3858459394,1669660875,1669661061,186,2072
3492376573,3605308632,1661389989,1661390027,38,701
3674059710,3880849800,1642415811,1642416042,231,772
3402426323,3999788546,1664770746,1664770870,124,1863
3226220903,3683793217,1647267135,1647268082,947,516
3606331231,3112270906,1660278249,1660278450,201,1726
3167737446,3985037610,1655509175,1655510140,965,795
3179547560,3355798436,1656770368,1656771076,708,707
3351182329,3612556887,1647736422,1647736487,65,1168
3396154732,3312930717,1644152167,1644152585,418,28
3959504618,3329135548,1651907839,1651907873,34,479
3424522509,3783992161,1642766358,1642766531,173,2364
3309106486,3954490536,1651460886,1651461128,242,1860
3246321113,3053991932,1666051235,1666051746,511,1186
3467613173,3604596822,1665955377,1665955526,149,2308
3288441459,3622933919,1658966227,1658966804,577,1643
3527291464,3272555962,1654039723,1654039822,99,1077
3358968371,3390441234,1647689532,1647690401,869,1452
3517260537,3650675743,1654677067,1654677209,142,72
3008470758,3318663320,1650575289,1650575704,415,958
3669874673,3986016860,1659276467,1659276688,221,1877
3044450059,3286466102,1643312401,1643312693,292,1788
3748841094,3271919876,1648062280,1648063115,835,407
3542688397,3490286406,1646329848,1646330080,232,1756
3388218000,3604461797,1646959818,1646960523,705,2340
3406357109,3915942384,1644270628,1644271053,425,2447
3070640991,3382526428,1658480358,1658481135,777,886
3267089074,3852344377,1662953166,1662954091,925,1862
3324455158,3272563093,1660549878,1660550861,983,2076
3219899577,3295518987,1656695429,1656696021,592,1726
3591724433,3112070783,1669212706,1669213178,472,2336
3425856728,3994913668,1654519104,1654519406,302,1334
3708032127,3096408604,1644498258,1644499133,875,1385
3747929255,3392569339,1662180793,1662181471,678,1204
3964738114,3299211422,1657423638,1657424217,579,1389
3825971737,3658260972,1646726582,1646726823,241,24
3057102903,3992818695,1661787157,1661788110,953,1096
3347679085,3855476133,1643459546,1643459762,216,398
3245906837,3846477373,1649439712,1649440331,619,1842
3978987003,3842677051,1641102879,1641103377,498,1307
3795794957,3240502673,1666738909,1666739146,237,1704
3983711613,3870779720,1644404346,1644405186,840,1844
3870463011,3601519220,1669563527,1669563982,455,2011
3308877364,3900571767,1644946381,1644946590,209,627
3021320868,3510323514,1643744795,1643745441,646,1915
3730845439,3709788465,1653030779,1653031514,735,1603
3287078889,3283301166,1657661225,1657662215,990,2402
3481149583,3629984199,1662957200,1662957861,661,2337
3439325479,3096695477,1644002234,1644003089,855,2244
3184000585,3359601528,1668345126,1668345571,445,857
3262864867,3449133548,1660737449,1660738318,869,2230
3331336589,3299362427,1649105882,1649106451,569,1497
3728419832,3939480099,1661616703,1661617615,912,2465
3216439052,3819468348,1655171942,1655172897,955,1524
3388328160,3226280658,1656166210,1656166363,153,1600
3787298788,3223159718,1664467840,1664468609,769,1782
3806251232,3956394849,1661230425,1661230974,549,1053
3947788644,3464770966,1660633515,1660633718,203,2177
3098083694,3112389617,1654175900,1654176732,832,467
3563428558,3787937000,1654866959,1654867325,366,1168
3398814666,3935978133,1643358712,1643358860,148,1598
3147047674,3217060058,1651195386,1651195513,127,2343
3140486428,3195159288,1663206934,1663207464,530,715
3870574001,3255248380,1663757150,1663757705,555,706
3788688228,3785361012,1653510297,1653510723,426,2083
3251744109,3842431875,1654333647,1654333786,139,2468
3507644528,3034601276,1642386200,1642386322,122,488
3323834326,3218903379,1666986991,1666987846,855,1279
3369792484,3567926021,1659499848,1659500217,369,383
3004624310,3234851871,1657509274,1657509638,364,1531
3743860568,3347942747,1642897364,1642898164,800,421
3872626198,3254144288,1651226707,1651227707,1000,1843
3697650296,3021287506,1652802842,1652803660,818,1632
3669520344,3569390971,1664269916,1664270788,872,1972
3135116989,3252843201,1651225136,1651226093,957,323
3679617161,3366192341,1663865116,1663865758,642,1744
3074477991,3266991557,1667431294,1667431328,34,242
3141997314,3492376573,1654936516,1654936576,60,1404
3356144129,3519269683,1655999969,1656000018,49,764
3041792624,3468922263,1647908432,1647909282,850,1215
3941548978,3122246747,1664545334,1664546221,887,2491
3543257848,3647480411,1651125093,1651125569,476,666
3072599295,3620223775,1651361160,1651362105,945,1744
3417532235,3270240132,1653677608,1653677910,302,1859
3537031182,3402354750,1647559639,1647559670,31,1965
3439303987,3309305862,1668372938,1668373512,574,1647
3461505923,3788717673,1668227106,1668227747,641,1610
3851780195,3780885377,1663854900,1663855158,258,1836
3059322626,3531898771,1652369338,1652369602,264,626
3095849365,3178742688,1664044581,1664045317,736,1295
3366354894,3813632607,1655074089,1655074707,618,2118
3130561868,3604881190,1653787525,1653788257,732,1308
3741413739,3693920541,1664721304,1664721622,318,1787
3435915872,3740854424,1666104293,1666104354,61,136
3649073682,3666268915,1660102770,1660103657,887,2491
3409050239,3112602434,1656620338,1656620667,329,672
3516140957,3802040767,1653212247,1653212297,50,1182
3139935588,3833683293,1652097640,1652098196,556,2012
3880608911,3724116295,1656987479,1656988311,832,1745
3764343778,3118807144,1644732221,1644732350,129,790
3426022733,3023880168,1643295686,1643296493,807,2409
3402259490,3315182095,1664423357,1664423407,50,1348
3655135775,3983536056,1651081036,1651081757,721,959
3366192341,3067539427,1656242261,1656242769,508,2431
3858951131,3788034142,1643548512,1643549179,667,2152
3893829650,3260861147,1650482543,1650482556,13,255
3433237569,3339911597,1668640104,1668640769,665,1696
3414488975,3980841914,1648780163,1648780894,731,1712
3574773588,3991046503,1659209445,1659210285,840,1947
3383179408,3219637680,1654287515,1654288227,712,1902
3713126710,3278190233,1644960841,1644961370,529,1526
3132349279,3356883463,1650672521,1650673262,741,969
3135951344,3114097031,1664759854,1664760740,886,2489
3901616267,3011686027,1642079514,1642079968,454,298
3962045766,3334298803,1653594584,1653595400,816,1657
3451285207,3039962870,1667897900,1667898610,710,330
3446914685,3077590635,1645063794,1645064168,374,781
3450023391,3972917056,1654083734,1654083842,108,864
3091062283,3813811121,1652007841,1652008065,224,2019
3713834683,3935822380,1653833520,1653834175,655,941
3332144974,3725439899,1665382651,1665383587,936,1196
3557791528,3912183552,1654148076,1654148665,589,825
3751300388,3156452001,1659593779,1659594384,605,1257
3373962186,3371536214,1649621827,1649621994,167,941
3550329232,3753596469,1660147289,1660147915,626,1576
3316031407,3339633388,1646031593,1646032241,648,1242
3040867771,3838851134,1645235887,1645236694,807,1031
3057090135,3680139573,1664876057,1664876542,485,1025
3560043638,3603096470,1663192813,1663192942,129,2458
3617128437,3164467795,1652857759,1652858608,849,506
3892469874,3816538905,1664169234,1664170055,821,88
3462412055,3823951765,1668263426,1668264106,680,2124
3391441349,3376180688,1651688104,1651688651,547,584
3761201412,3836331716,1654006678,1654006977,299,702
3936468941,3055545326,1666975780,1666976072,292,686
3948964302,3050267205,1645128510,1645128879,369,1143
3825462888,3608297293,1650153574,1650153682,108,1298
3154309446,3340331761,1669095247,1669095555,308,2271
3829874150,3244946730,1651927423,1651927533,110,2199
3275436235,3636132038,1660155388,1660155589,201,2129
3013862518,3793840002,1666325119,1666325947,828,2100
3215423327,3608597242,1662224692,1662225196,504,1818
3458645622,3723784545,1659205192,1659205665,473,1232
3517149250,3361365460,1658564899,1658565875,976,1560
3862456223,3283671920,1661321881,1661322838,957,540
3702178313,3503453854,1649300291,1649300819,528,1256
3072080605,3357966828,1652226117,1652226324,207,456
3327873529,3114863942,1649825711,1649825980,269,2200
3118959727,3310512172,1668185276,1668186136,860,2043
3327504995,3819468348,1664358163,1664358613,450,1707
3994721189,3645484554,1644564222,1644564689,467,1232
3674037967,3325360523,1668964507,1668964650,143,751
3138638384,3567959060,1666700408,1666701006,598,1165
3413305965,3828810890,1644987642,1644988237,595,1989
3661494924,3911960681,1660070310,1660070457,147,1233
3024611625,3211965606,1668384974,1668385086,112,2228
3854848967,3687307113,1644099802,1644100211,409,2332
3203128336,3135707503,1656690265,1656690752,487,1806
3006953744,3311015405,1656582853,1656583292,439,82
3324069408,3838774657,1661782253,1661782820,567,74
3291838772,3362405611,1664394238,1664395095,857,2111
3469471892,3957689713,1664982849,1664983380,531,2065
3029460549,3714698686,1646924521,1646924632,111,937
3881851624,3392121294,1660640781,1660640890,109,1918
3756778635,3791633858,1668125146,1668125630,484,410
3722220404,3806251232,1657424575,1657424928,353,382
3578219289,3428287409,1647066516,1647067070,554,247
3917715509,3962676436,1646186287,1646186875,588,2275
3921754282,3620725243,1655367901,1655368757,856,1735
3672274616,3803606691,1654472267,1654472438,171,658
3319583055,3284159385,1656466819,1656467158,339,139
3040627958,3761142574,1643547514,1643548503,989,1706
3470446722,3173667762,1645528957,1645529178,221,2409
3670075164,3664337365,1650188871,1650189410,539,1349
3038014403,3051253299,1665153183,1665153927,744,799
3764298989,3698906761,1662107149,1662107884,735,2413
3139434250,3643173963,1659053948,1659054217,269,2048
3409050239,3448459810,1649071112,1649072090,978,51
3755413351,3345413125,1656563175,1656563393,218,1359
3884346810,3487387362,1659730785,1659731628,843,2185
3362647814,3570872297,1653072792,1653073213,421,2016
3292368988,3963303057,1649429469,1649429656,187,1647
3086135849,3078231218,1650316186,1650316284,98,28
3056030317,3539571109,1645379680,1645380302,622,770
3710888381,3506585658,1662997447,1662997502,55,890
3898641431,3876097800,1655071378,1655071546,168,308
3085182687,3755962729,1652758180,1652758608,428,721
3824545323,3751826055,1645324658,1645325343,685,2462
3969728585,3319128889,1650705553,1650705665,112,2495
3109108614,3857434991,1647862371,1647862371,0,2323
3777938800,3906903088,1659904209,1659904495,286,264
3846323092,3717926703,1666836460,1666836628,168,2197
3534224607,3535467955,1647241111,1647241271,160,1919
3423306122,3625979408,1642108495,1642109251,756,2237
3425002636,3135579253,1667204233,1667204549,316,1682
3876696308,3543257848,1662680536,1662681114,578,273
3587440298,3130462571,1667269114,1667269275,161,940
3628034615,3856756422,1658123891,1658124665,774,1134
3176252124,3052233179,1664472262,1664472667,405,362
3327681313,3648118736,1641316434,1641317389,955,2101
3480905975,3118305321,1662296903,1662297155,252,2466
3513368682,3260246509,1662782722,1662783700,978,218
3600573063,3403471618,1643642453,1643642970,517,1361
3751826055,3532634291,1647590819,1647591547,728,1235
3364661787,3231496949,1645718205,1645719133,928,632
3968076690,3014511835,1642236641,1642236712,71,380
3277298737,3635324805,1660058682,1660059135,453,2408
3869692733,3534545428,1652904515,1652904888,373,2166
3967250644,3904203375,1661757870,1661757995,125,157
3898188404,3204359619,1659566952,1659567189,237,1407
3379756257,3447203087,1648190929,1648191124,195,543
3867554012,3052438592,1668643611,1668643631,20,767
3449136061,3189358030,1647437833,1647438269,436,1514
3239527114,3528505546,1644953747,1644954392,645,1310
3047126246,3295278768,1659904055,1659905015,960,2407
3417798594,3534450842,1645033875,1645034281,406,1581
3639035607,3904634428,1641774052,1641774131,79,1174
3659771853,3398876044,1644195066,1644195685,619,2
3927388172,3957577990,1648093808,1648094449,641,479
3547334414,3072734804,1661929831,1661929837,6,1600
3392535031,3816309635,1641222302,1641222641,339,506
3321752938,3397940369,1649557778,1649558212,434,1785
3862528538,3802040767,1666696686,1666697565,879,2166
3197371652,3233040662,1646658842,1646659501,659,1731
3217719618,3233146767,1659142603,1659142618,15,1998
3731588710,3242948145,1651120896,1651121562,666,2355
3893227652,3198338148,1662388337,1662388433,96,2195
3971024525,3260157601,1644141215,1644141757,542,2034
3919792223,3690015481,1650085916,1650086166,250,1581
3180984174,3771623134,1655581125,1655581460,335,956
3052875832,3108566218,1652173378,1652174000,622,310
3779319466,3725439899,1656307020,1656307833,813,94
3707778731,3485526833,1662804624,1662805342,718,1270
3349666443,3287600901,1660076377,1660076490,113,2131
3557325531,3447257561,1659860677,1659861072,395,594
3059447105,3723438987,1658901621,1658902160,539,1891
3331439996,3782730026,1667566920,1667567614,694,2497
3444349973,3952346496,1641319025,1641319399,374,1963
3708754161,3159638305,1652685138,1652686129,991,795
3397376963,3019631963,1667874144,1667874832,688,345
3179280029,3441680015,1662445694,1662446447,753,2307
3303418943,3556803718,1655803323,1655803831,508,1335
3707867178,3550874434,1661126060,1661126677,617,910
3133030435,3360342048,1651540289,1651540589,300,2128
3553467860,3568645029,1669271394,1669272021,627,1503
3373729748,3662526382,1656660855,1656661644,789,1958
3650342769,3852834619,1661364118,1661365055,937,1883
3307393195,3894359262,1642885669,1642886572,903,2235
3397397223,3020106315,1652605040,1652605219,179,159
3890194122,3063715610,1665456224,1665456790,566,1086
3077590635,3055020688,1652739370,1652739977,607,1245
3054171550,3682747704,1643208202,1643208820,618,2045
3353855658,3265324040,1652402558,1652403167,609,1810
3902437090,3289402711,1654561236,1654561913,677,1918
3858225831,3049727234,1661596268,1661596316,48,6
3776128581,3417298701,1657503543,1657503742,199,1185
3014392598,3938615588,1653049872,1653050806,934,28
3254144288,3393406422,1661289446,1661289606,160,711
3913608544,3794074656,1644925785,1644926596,811,1806
3307775998,3351786927,1666751085,1666752060,975,293
3501732936,3092365114,1648501002,1648501319,317,1479
3649073682,3734381035,1651565246,1651565267,21,1302
3201968141,3487756836,1644317365,1644317628,263,2475
3167557703,3166206557,1649740019,1649741000,981,856
3111080178,3333095694,1648798241,1648798708,467,1058
3268216928,3007934266,1649733391,1649734366,975,2223
3365807352,3880837935,1665604008,1665604550,542,1862
3985491144,3850546468,1650632372,1650632999,627,849
3454754318,3709075485,1662580222,1662580985,763,1331
3448378304,3051642574,1663010555,1663011334,779,867
3747302768,3843347515,1645399432,1645400029,597,855
3090441115,3368322774,1653706619,1653707136,517,1031
3318594125,3172293659,1655271400,1655271439,39,1214
3548351680,3054659800,1659284639,1659285510,871,2499
3875892624,3918602291,1659783419,1659783575,156,1836
3106630738,3683460040,1661524503,1661524749,246,1523
3249512921,3242088486,1657094593,1657094720,127,2284
3908443461,3828219822,1645326231,1645326370,139,2348
3754139010,3140486428,1654703109,1654703305,196,1794
3442593383,3106788261,1660929425,1660929837,412,33
3306144283,3113760926,1667616722,1667617276,554,497
3606111278,3125479535,1644101703,1644101977,274,2451
3432462167,3579093901,1669455230,1669455681,451,560
3275494433,3534192041,1651188536,1651189453,917,1029
3932002704,3693028654,1647086690,1647086808,118,498
3599551667,3952889735,1650199767,1650200669,902,1180
3109108614,3316398180,1662927703,1662927833,130,1422
3938154365,3688910009,1668388502,1668388746,244,1035
3889544424,3695360424,1642224105,1642224991,886,2255
3860879385,3186897818,1663626961,1663627123,162,2440
3370771897,3927273567,1657747593,1657748119,526,1504
3255460937,3659299466,1650490816,1650491468,652,1503
3631703207,3985513037,1644007060,1644007900,840,463
3158871377,3572009360,1667634891,1667635847,956,1959
3755294305,3098083694,1658354346,1658354374,28,1649
3556620301,3866922475,1652936294,1652936629,335,530
3153413554,3678720106,1666460961,1666461224,263,2185
3767508362,3508340066,1663509580,1663509891,311,660
3361652898,3343729897,1657138690,1657139421,731,344
3360158658,3486096604,1654733993,1654734753,760,1525
3540029077,3827937024,1658609982,1658610051,69,1889
3866921322,3115367011,1651494219,1651494382,163,471
3468803992,3499481051,1660234243,1660234735,492,1313
3073967597,3640523860,1661352250,1661352577,327,1605
3202625372,3978925529,1658540528,1658541007,479,1122
3291286959,3531842620,1655633120,1655633550,430,1070
3640349880,3101609490,1668559218,1668559339,121,701
3742275397,3089699104,1654526529,1654526792,263,879
3379935974,3707342422,1668117946,1668118796,850,762
3208243335,3647938021,1662823931,1662824563,632,723
3587508502,3489858368,1653563502,1653564101,599,2270
3540799427,3520523282,1656579877,1656580205,328,1386
3600977488,3056721560,1658775912,1658776831,919,2462
3549703546,3016068435,1657320841,1657321440,599,958
3027570184,3379285136,1644997053,1644997940,887,842
3364409507,3110395191,1659908495,1659908735,240,1946
3257947713,3464330947,1661567828,1661567834,6,447
3663038239,3913071406,1660609153,1660610124,971,1503
3870243569,3467650879,1644517051,1644517880,829,2223
3661705197,3034147055,1641759970,1641760831,861,1713
3631340178,3948754212,1665019480,1665020460,980,1111
3061814600,3411340387,1655876620,1655876751,131,2314
3047126246,3899618702,1644995680,1644996327,647,1031
3099224416,3697028552,1657772008,1657772257,249,1141
3351145248,3752442248,1661717611,1661718303,692,2091
3016299339,3804145408,1658239281,1658239914,633,2188
3582138072,3199395221,1643187571,1643187841,270,312
3316237227,3285225403,1652944952,1652945070,118,1679
3666148943,3801038758,1648305837,1648305854,17,1364
3998200859,3274507247,1657851766,1657852590,824,2097
3178981589,3486793392,1669307711,1669308518,807,1950
3911849911,3787058440,1650956919,1650957760,841,1149
3166274990,3525152477,1666919114,1666920073,959,1329
3468654589,3895991710,1648430523,1648430785,262,711
3630744377,3622997863,1657101809,1657101823,14,2290
3914006102,3543668840,1645016950,1645017003,53,1051
3798512184,3649036403,1647647315,1647648198,883,1988
3801358344,3044226207,1666934664,1666935533,869,70
3254866960,3044345094,1646462303,1646462692,389,289
3693270664,3216241275,1642346013,1642346454,441,1142
3558370114,3961183307,1656387577,1656388341,764,348
3307306078,3852633699,1669492727,1669493099,372,1386
3165208023,3273827707,1645317578,1645318538,960,1770
3374692305,3245247493,1668376875,1668377349,474,1964
3272856923,3876097800,1653612061,1653612843,782,1828
3928867307,3959093613,1644105735,1644105847,112,683
3552282443,3112602434,1653355198,1653355859,661,788
3105946115,3250786481,1666083375,1666083620,245,1030
3914166761,3500264647,1664428452,1664428560,108,358
3893475632,3760047951,1659719169,1659719169,0,1773
3507960689,3799287196,1641818252,1641818966,714,1289
3377781677,3423043196,1648137109,1648137166,57,1802
3760432849,3220405755,1664956322,1664957176,854,969
3402511144,3019657030,1663340642,1663340971,329,1212
3243649022,3909292537,1649992965,1649993944,979,1706
3726378645,3135579253,1647887547,1647888137,590,191
3265725715,3520107804,1663720977,1663721959,982,76
3307775998,3438084709,1669170749,1669171516,767,107
3279351366,3240347468,1660171691,1660172260,569,1621
3114348300,3481293963,1650659521,1650660216,695,688
3908997041,3601562567,1644353100,1644353995,895,709
3301620813,3037741311,1644481017,1644481049,32,577
3832072924,3456546904,1658493261,1658493368,107,1709
3982058383,3535631980,1650071923,1650072281,358,294
3003402470,3043180716,1646186961,1646187531,570,2118
3463973561,3587727278,1652002677,1652003632,955,308
3202424407,3656654582,1645783941,1645784798,857,1015
3748812993,3359601528,1667097792,1667098290,498,1437
3944247629,3120208739,1663799863,1663800182,319,2216
3652898768,3958507300,1644624867,1644625079,212,2017
3021006721,3190226527,1667685615,1667686166,551,850
3205153391,3409055122,1668892418,1668892452,34,789
3698156103,3657597585,1645967531,1645968473,942,1093
3467391664,3851780195,1668898283,1668899233,950,1140
3591724433,3042739113,1645595300,1645596273,973,680
3545188902,3089525434,1644949450,1644949634,184,131
3292782964,3009177873,1642207551,1642208542,991,713
3387938632,3823802882,1658721052,1658721600,548,2
3601851578,3934988354,1643742180,1643742839,659,1641
3981348782,3921490578,1663163248,1663163539,291,492
3685473604,3240347468,1664317650,1664318028,378,2489
3744347272,3906024837,1667316754,1667316875,121,1689
3707947874,3038067120,1644104536,1644105224,688,1766
3802018450,3250824932,1651472669,1651473333,664,1753
3786194675,3478404891,1666930516,1666930887,371,532
3360575138,3369469616,1667082238,1667082475,237,1143
3570230022,3292010262,1644922582,1644923140,558,271
3198319752,3303025505,1655975253,1655975408,155,722
3062506508,3358959910,1665509153,1665509731,578,1477
3824083602,3430464852,1641689719,1641690143,424,294
3366896849,3270919620,1650554092,1650554487,395,1404
3176526207,3943947223,1660482545,1660482667,122,40
3132802864,3439442608,1649753680,1649754626,946,1995
3655981198,3902329320,1668415009,1668416003,994,442
3961189789,3942575505,1642014845,1642015304,459,2476
3319877479,3961420550,1646210093,1646210853,760,624
3407909365,3078306926,1649076954,1649076965,11,2449
3713693431,3147336288,1669588406,1669588887,481,614
3025215569,3489466063,1659206862,1659207803,941,96
3107541952,3198520645,1649739257,1649739844,587,820
3653739025,3596932196,1669291641,1669292198,557,1026
3006456611,3171413650,1659479451,1659479500,49,1387
3038067120,3948833001,1645212470,1645212544,74,265
3658017612,3231727990,1650058108,1650058435,327,1182
3744386868,3935022176,1646264503,1646265334,831,1879
3258460512,3736885329,1646577028,1646577041,13,1331
3829209875,3398795724,1668094488,1668095246,758,1685
3699730203,3104271824,1646597030,1646597996,966,1931
3117234289,3892142252,1656056402,1656056820,418,1027
3486096604,3405168756,1667649184,1667649631,447,201
3336494171,3562105236,1656453784,1656453871,87,783
3105460297,3172305265,1664035754,1664035917,163,1270
3552457707,3636621583,1642572326,1642573015,689,1986
3049147900,3487547990,1653302409,1653302530,121,1974
3123458167,3318227153,1656768903,1656769792,889,887
3183507473,3189038779,1658362252,1658362432,180,2446
3594777411,3116777827,1643639219,1643640146,927,619
3664408598,3124363805,1662331373,1662331984,611,1891
3285333536,3792834070,1668947162,1668947780,618,747
3017504746,3610577318,1645225924,1645226495,571,2439
3674271275,3041563987,1662498993,1662499568,575,1728
3884247169,3389926670,1663039303,1663039872,569,2298
3175505409,3194664110,1659293081,1659293871,790,1938
3233318289,3985825297,1645480225,1645480683,458,19
3549033213,3264339209,1648015609,1648015905,296,1958
3348234563,3774816472,1646259816,1646260423,607,1389
3661037098,3032498591,1668635689,1668636034,345,2364
3153085443,3375585327,1652052314,1652052348,34,2146
3804657904,3000725837,1643977184,1643977895,711,1199
3478959759,3008576449,1652007164,1652007849,685,1284
3469722588,3795264165,1665049151,1665049576,425,1621
3211945942,3021515419,1654571278,1654571760,482,2488
3889840253,3348770994,1665877478,1665878176,698,1136
3980207883,3755580356,1646516289,1646517178,889,944
3800392649,3958710935,1661466121,1661466301,180,1149
3954799831,3625684557,1652193677,1652194127,450,997
3658516535,3552305242,1666623605,1666624349,744,1732
3939711103,3454754318,1661000228,1661001086,858,532
3533403208,3624644696,1660736970,1660737548,578,273
3017484255,3010173509,1657607203,1657608180,977,1002
3877090261,3155835978,1650899148,1650899761,613,506
3719455699,3115029581,1659776123,1659776314,191,121
3793117012,3564883937,1661083533,1661084412,879,507
3666179764,3608485872,1652537520,1652537893,373,534
3004870031,3147376468,1652495977,1652496248,271,2175
3437221963,3690043318,1667198582,1667198924,342,701
3976223971,3894359262,1650008648,1650009562,914,2163
3047402472,3614399988,1652236115,1652236663,548,344
3165884724,3671971306,1665206573,1665206693,120,844
3666174374,3489858368,1655856345,1655856667,322,129
3014798893,3168871510,1655750396,1655750616,220,1374
3636879699,3228277648,1657370797,1657370886,89,408
3772980352,3997177535,1656555036,1656555349,313,174
3795940241,3825930964,1657030168,1657030749,581,972
3901026791,3034643506,1668770802,1668770868,66,486
3950047958,3047477485,1644408252,1644408719,467,929
3863676573,3262203147,1658398454,1658399347,893,1483
3633856416,3142463511,1667887471,1667887816,345,751
3855900879,3738359725,1663734019,1663734806,787,303
3668421848,3545394112,1660216192,1660216918,726,1337
3428299424,3346164838,1642971283,1642972271,988,2361
3550889203,3060121211,1663675571,1663676508,937,2360
3822693340,3558848518,1648269556,1648270407,851,1331
3407513744,3388814754,1653432868,1653433130,262,2047
3213124781,3341300979,1650249942,1650250397,455,2020
3891400237,3785584501,1668894634,1668895001,367,1134
3022256617,3349566530,1653293647,1653293751,104,1128
3052063374,3606643671,1668570652,1668570982,330,1333
3948577391,3880849800,1650421094,1650421332,238,1861
3890033502,3953655387,1651122074,1651122419,345,13
3818039978,3029374380,1661588913,1661588954,41,1533
3176753600,3178728299,1641439593,1641440470,877,1922
3258417294,3909558934,1656596365,1656597250,885,1718
3614064639,3243044619,1667496377,1667496527,150,2145
3057922933,3311118815,1650202026,1650202682,656,916
3894036055,3661747291,1647323956,1647324341,385,464
3830303170,3735817368,1645656224,1645656502,278,2159
3749811473,3128514837,1648024437,1648024762,325,695
3950666008,3103228367,1660331088,1660331158,70,1056
3456660113,3604236901,1664609429,1664610093,664,2054
3774102998,3135116989,1657821161,1657821369,208,2244
3242064640,3400730635,1649497170,1649497587,417,976
3232333937,3014535209,1652029680,1652030308,628,1635
3710394011,3209748014,1656128121,1656128583,462,930
3645768666,3180051747,1667954771,1667954894,123,280
3128613298,3418007140,1658502404,1658502782,378,631
3518817978,3070640991,1644927611,1644928548,937,854
3383755219,3696359426,1641240399,1641241234,835,1643
3850546468,3060450258,1660325519,1660325597,78,876
3718182841,3743687544,1651197786,1651198635,849,1917
3862829462,3943622737,1663561785,1663562766,981,1620
3068129646,3797778150,1656282495,1656283363,868,2409
3749188570,3324041559,1646339587,1646339972,385,574
3199395221,3766205598,1650898141,1650898602,461,630
3822126164,3468633309,1664727147,1664727326,179,987
3473525108,3798631691,1668159303,1668159429,126,1625
3859249968,3092800496,1668843042,1668843215,173,1409
3790748869,3925690262,1646953933,1646954527,594,2310
3439325479,3889854774,1645102535,1645103424,889,2472
3217494787,3369049258,1657745321,1657745617,296,22
3447326124,3740051209,1652767361,1652767824,463,695
3411921561,3922066704,1644138175,1644138693,518,907
3504893701,3620725243,1666148484,1666148951,467,1312
3893601176,3616651934,1668131236,1668131564,328,2174
3307067721,3670112572,1641949759,1641950735,976,356
3520107804,3895990286,1661486669,1661487467,798,206
3055211808,3579728276,1647632177,1647632548,371,449
3102760949,3427225872,1663775762,1663776453,691,2334
3070087815,3103404280,1666088783,1666089649,866,572
3960417596,3665086817,1660067041,1660067517,476,25
3284433811,3175832070,1650103338,1650104307,969,1695
3655924018,3835976086,1667039781,1667040321,540,615
3469583371,3935022176,1645371833,1645372027,194,2274
3852344377,3137324029,1656948686,1656949480,794,241
3186207758,3396365443,1641371984,1641372625,641,1222
3578219289,3436582780,1648091315,1648092125,810,317
3691021918,3585100772,1644626587,1644627244,657,1575
3890054358,3441383531,1655811799,1655812419,620,607
3074795505,3907872554,1644051478,1644052008,530,2444
3965118569,3522623156,1667874261,1667874634,373,2237
3801768919,3284443787,1644287383,1644288355,972,2487
3259367927,3693102953,1659006308,1659006571,263,2338
3846007471,3431498601,1645132962,1645133733,771,954
3198240429,3805826972,1662080641,1662080855,214,1111
3243840165,3822736402,1659443105,1659443111,6,1863
3509047408,3437221963,1647450583,1647451221,638,879
3875908590,3917684798,1657713471,1657713619,148,1180
3927920093,3084531614,1641251152,1641251492,340,1988
3036470049,3487547990,1657967182,1657967531,349,820
3214711870,3365134626,1650062642,1650063248,606,511
3212841978,3040742963,1641927447,1641928232,785,661
3276576100,3027129249,1669549708,1669549995,287,14
3246796194,3404959548,1664898939,1664898955,16,1578
3669386720,3314932010,1646621414,1646621771,357,156
3012929490,3106465076,1642504821,1642505646,825,1092
3224952698,3313426081,1660163531,1660164419,888,2383
3969241066,3040715509,1655170547,1655171139,592,1294
3269573550,3686968293,1666486866,1666487151,285,2446
3736085476,3457108498,1668746550,1668747171,621,521
3945370501,3520324090,1652867109,1652867165,56,1289
3944476586,3340331761,1646072615,1646073102,487,498
3517556603,3776862606,1652495274,1652495336,62,1858
3085001659,3377911201,1663817924,1663818767,843,2328
3319877479,3876427301,1655055050,1655055219,169,1364
3057721767,3585989542,1661839061,1661839529,468,1713
3049727234,3298038439,1662756266,1662757187,921,2393
3890492731,3027064938,1650261200,1650262165,965,631
3100670764,3763270952,1651243240,1651243371,131,139
3092365114,3855548589,1668699637,1668700072,435,1273
3656002043,3399604947,1650615070,1650616034,964,615
3995288261,3460552791,1650964634,1650964736,102,1868
3429052801,3328798665,1650805750,1650806244,494,1482
3031249180,3672070606,1646795235,1646796148,913,1999
3371745136,3017005264,1644203861,1644204129,268,727
3628729475,3203319376,1653668094,1653668350,256,1012
3719744431,3361652898,1641017363,1641018113,750,1544
3557556781,3108998670,1669672096,1669672368,272,1725
3247758952,3439905167,1661784954,1661785596,642,2495
3899618702,3161063958,1661757403,1661757671,268,477
3493138014,3356028416,1666583936,1666584558,622,474
3147896698,3831380073,1651235282,1651235353,71,1006
3324073911,3105558193,1652828130,1652828858,728,1950
3359541123,3156189187,1667825796,1667826577,781,970
3818453534,3769198196,1641317426,1641318054,628,1357
3649774117,3224130773,1665173613,1665173718,105,20
3568162481,3382856674,1666098873,1666099204,331,604
3316952075,3956547336,1664059261,1664059306,45,532
3823951765,3549752945,1656832106,1656832290,184,629
3465229825,3862890852,1649656613,1649657360,747,2275
3281907019,3784414098,1666519921,1666520513,592,806
3746890721,3025611145,1651190978,1651191476,498,1535
3720934127,3021613958,1642932474,1642933097,623,2465
3421294150,3042176960,1641328057,1641328197,140,1248
3213397142,3031649001,1665503029,1665503680,651,1561
3081641451,3132207782,1644845618,1644846486,868,457
3257947713,3448726123,1644094929,1644095438,509,1672
3929307105,3720381616,1653889015,1653889389,374,378
3145344208,3567328601,1653968259,1653968574,315,586
3621416999,3065350513,1654574710,1654575463,753,1320
3579684205,3925496970,1642540637,1642541079,442,733
3840416991,3433937560,1652674737,1652675054,317,800
3463032893,3441581446,1660867675,1660868164,489,1898
3291394293,3098538909,1654606654,1654607436,782,1295
3280328195,3830975217,1665267735,1665267810,75,2102
3924838447,3524217572,1655297630,1655298320,690,1061
3326881805,3430375744,1647554806,1647554979,173,284
3212218759,3471221302,1667408846,1667409311,465,1669
3124415148,3798369315,1647060296,1647061164,868,2062
3098546487,3814641263,1661503127,1661504017,890,1970
3102251970,3609310097,1650342478,1650342704,226,1101
3830850007,3653739025,1641568775,1641569444,669,790
3985879853,3528475061,1669274668,1669275472,804,2319
3283301166,3823790407,1667898651,1667899452,801,2280
3152518339,3505272067,1660734072,1660734962,890,601
3005854023,3151554851,1641862156,1641862468,312,600
3606331231,3013862518,1650148465,1650148792,327,1594
3497079704,3628927796,1641555931,1641556019,88,576
3911290843,3775948778,1641232282,1641233190,908,404
3364586923,3781789585,1665333902,1665334220,318,2169
3647685310,3710466773,1667157066,1667157907,841,1942
3518583464,3065246027,1656708037,1656708484,447,254
3911671645,3385264040,1660179345,1660179437,92,219
3138801114,3734533600,1668901538,1668901723,185,1024
3641542734,3249261763,1669116707,1669117660,953,226
3352729606,3615387566,1667394192,1667395094,902,839
3232285701,3429660049,1661709934,1661710335,401,2368
3106429728,3621452884,1658882155,1658883036,881,1495
3443297756,3306188967,1659322716,1659323140,424,1932
3624484272,3785813162,1652591516,1652592387,871,1299
3294357161,3563343479,1649960618,1649960852,234,2348
3377798373,3517992014,1646307078,1646307774,696,239
3332056702,3038832798,1657106491,1657106803,312,988
3068723030,3118976994,1662375525,1662375712,187,279
3776685300,3898603481,1668920242,1668921065,823,183
3655250241,3952552328,1661451100,1661451594,494,1356
3165039316,3039035602,1641644276,1641644498,222,434
3929975862,3541372095,1650679873,1650680549,676,973
3062410888,3470482542,1669242544,1669242681,137,968
3698898645,3166483466,1644686548,1644686713,165,302
3878005127,3226451761,1645613686,1645614571,885,1313
3142747577,3707676798,1647830003,1647830971,968,1014
3415124478,3969046292,1663658827,1663658868,41,1492
3276617814,3595049641,1641820435,1641820717,282,930
3088604045,3691879230,1642500243,1642501169,926,1676
3309922968,3222060578,1665101723,1665101828,105,188
3056726479,3049141347,1650111513,1650112239,726,1306
3077143208,3180534430,1652936090,1652936222,132,1871
3575535453,3478280943,1646482117,1646482506,389,1030
3516019563,3829347049,1644680263,1644680317,54,596
3968297784,3532190519,1650397002,1650397951,949,1540
3688076815,3031816428,1662574717,1662574965,248,940
3628963667,3769647112,1644225114,1644225324,210,104
3280328195,3502947486,1655519276,1655519305,29,1124
3541881881,3568097363,1660674953,1660675651,698,2318
3459599732,3957824946,1660279469,1660280212,743,1674
3118443532,3387840253,1666353235,1666353596,361,1712
3707947874,3174373725,1647766160,1647767105,945,1386
3271479070,3204735172,1663232411,1663232897,486,1046
3973010524,3138638384,1655907288,1655908178,890,483
3391857064,3991727598,1666494541,1666495180,639,2240
3130181848,3160515169,1649047172,1649047597,425,1836
3540279517,3413514902,1653136658,1653136696,38,492
3995654203,3581216621,1659046004,1659046801,797,1460
3100201926,3082026010,1642021149,1642021570,421,1224
3753657577,3786724835,1662796569,1662796828,259,1007
3123166182,3280818938,1667234452,1667235236,784,2285
3193095337,3048361071,1641340082,1641340666,584,1524
3250852254,3109390601,1656579587,1656580175,588,1288
3075563867,3153831709,1658300016,1658300602,586,608
3593861215,3278792522,1657182905,1657182999,94,2330
3145393304,3734579045,1668511758,1668512176,418,1386
3669744444,3511397819,1660775350,1660775596,246,1017
3597485446,3263350346,1657180290,1657181201,911,1619
3697822889,3045016501,1661909235,1661910092,857,1640
3172524712,3654899608,1668508571,1668509475,904,1839
3411347712,3677965553,1650510840,1650511245,405,2277
3979845809,3487030175,1662075115,1662075175,60,1288
3963134791,3859164696,1646350301,1646351259,958,789
3564839908,3370834194,1642880936,1642881034,98,553
3244946730,3670550887,1661166131,1661166380,249,333
3052499026,3823419231,1656617260,1656618096,836,1651
3590831664,3604514331,1649923592,1649923787,195,835
3180252962,3732349114,1642743426,1642744001,575,2440
3173791920,3393032827,1665993484,1665993587,103,216
3822935707,3776429592,1659601028,1659601287,259,621
3304559201,3963370859,1649552059,1649552448,389,799
3679533416,3081188307,1666609018,1666609793,775,811
3656158144,3941548978,1664558944,1664559221,277,760
3059848821,3254991122,1642127023,1642127220,197,108
3992927391,3963615140,1641109329,1641109901,572,1746
3320488617,3710769510,1641405793,1641406211,418,2136
3707578213,3986311619,1665943943,1665944465,522,786
3381692213,3342054027,1669238856,1669239707,851,1538
3936135558,3152537793,1654191841,1654192605,764,1270
3550329232,3663474230,1666240812,1666241347,535,1995
3947788644,3135406478,1643684373,1643685274,901,931
3127565673,3582168015,1645137648,1645137910,262,619
3672274616,3250208944,1663960640,1663961388,748,1906
3216550436,3755413351,1658842109,1658842440,331,1309
3447447895,3392535031,1645120331,1645121295,964,1551
3335976452,3445023517,1667450323,1667451259,936,1514
3607352755,3550329232,1666464186,1666464907,721,2283
3910846571,3257594028,1644044658,1644045386,728,1599
3198731476,3797930164,1665950206,1665950326,120,461
3059416141,3563103144,1657690953,1657691687,734,1225
3148691436,3936914064,1649668508,1649668646,138,1023
3310951639,3895274115,1644323699,1644324157,458,985
3637457925,3764173171,1654287081,1654287569,488,484
3051395031,3796504737,1653724660,1653725025,365,1603
3366609475,3850214790,1645693053,1645693150,97,674
3414488975,3083144170,1648850538,1648851091,553,130
3328373210,3077238667,1660180215,1660180389,174,76
3046991819,3633730527,1664231867,1664232373,506,2254
3421671936,3551380152,1646206460,1646207412,952,2004
3296519089,3470112947,1654617604,1654618309,705,157
3949668592,3885694482,1657167363,1657168044,681,481
3056252574,3914429910,1653278908,1653279180,272,1005
3341897848,3795264165,1659915619,1659915818,199,2153
3317382420,3182752768,1645415161,1645416068,907,1700
3750698244,3502587181,1644394792,1644395226,434,39
3310970237,3277926691,1662151459,1662151529,70,1403
3011466658,3904825547,1660483562,1660483652,90,2390
3390919111,3499841500,1653555328,1653555658,330,1030
3768087701,3112074335,1651156943,1651157071,128,11
3497271227,3580330506,1641621759,1641621980,221,2079
3660551283,3272563093,1664142596,1664143585,989,638
3910502945,3841672169,1644404813,1644404868,55,1893
3271689881,3422046745,1660851923,1660852361,438,851
3938949913,3637663893,1668351888,1668352303,415,2037
3826823415,3173108957,1669756460,1669757450,990,511
3672059189,3395457102,1655867573,1655868011,438,1131
3142160799,3091418450,1645850950,1645851046,96,822
3687938178,3492629459,1667865326,1667865353,27,2097
3928212115,3098546487,1658684045,1658684238,193,1694
3514894244,3713126710,1649713499,1649713663,164,836
3600796487,3407156969,1660687241,1660688216,975,664
3690171214,3883864322,1656371304,1656371840,536,500
3059858458,3636619501,1656280386,1656280562,176,709
3872493238,3463003824,1659903229,1659903674,445,2322
3257690557,3806251232,1645580880,1645581104,224,464
3124941982,3141480547,1666770856,1666771361,505,2044
3319583055,3338715388,1643807801,1643808382,581,1285
3279069375,3677574672,1668478782,1668479647,865,98
3118305321,3834268660,1648810420,1648810858,438,2190
3655924018,3853163109,1655669180,1655670133,953,2268
3741978230,3760042128,1646571132,1646571969,837,724
3244198823,3404904674,1668148647,1668149509,862,2457
3680060067,3480523769,1653499157,1653499828,671,2479
3541200701,3626824650,1655866628,1655867358,730,2398
3196934109,3555912894,1645448796,1645449383,587,1016
3716977635,3122288373,1647347369,1647347716,347,151
3816026938,3403337910,1669490132,1669490969,837,10
3207283619,3991552312,1649093541,1649093945,404,308
3545240944,3512720372,1655539452,1655540019,567,543
3587324906,3451299629,1667111390,1667112115,725,727
3798597128,3528439013,1656235505,1656235541,36,1801
3296895937,3456546904,1663374152,1663374194,42,987
3687689210,3380213005,1659624810,1659624816,6,491
3660732427,3013314607,1663693879,1663694596,717,1945
3158894896,3269357443,1662949524,1662949960,436,2080
3388004574,3399552669,1641223347,1641223592,245,1960
3885162740,3034014975,1654064759,1654065343,584,1925
3099224416,3762690279,1666920436,1666921369,933,481
3145669202,3000600578,1654912751,1654913009,258,2334
3366385571,3799624292,1644528666,1644528941,275,934
3065434950,3420180743,1647447776,1647447877,101,1684
3034601276,3121762934,1661027616,1661027924,308,798
3856160688,3488484971,1665605948,1665605997,49,1082
3497271227,3900843323,1663541139,1663541869,730,1922
3195629628,3575512492,1642831486,1642832041,555,619
3336300808,3249759052,1668760170,1668761002,832,59
3034255613,3080735392,1661313784,1661314297,513,573
3572594221,3962722941,1649325624,1649326398,774,828
3768482482,3101460702,1665595460,1665596075,615,1042
3852741277,3164410972,1649911248,1649912067,819,2162
3124927662,3395479272,1650054154,1650054364,210,1870
3828485006,3795342940,1649402194,1649402611,417,1875
3832703867,3815462032,1658708094,1658708453,359,1092
3121762934,3595713931,1642295792,1642296218,426,1153
3351843519,3230836206,1649315699,1649316624,925,811
3890161181,3853448159,1650783247,1650783275,28,1287
3773408264,3158962971,1646771827,1646772580,753,2462
3163326257,3086575348,1663846781,1663847169,388,2329
3452920322,3424650360,1655726446,1655727306,860,653
3303561746,3641983006,1661442378,1661442995,617,97
3611062566,3646596750,1667005463,1667005856,393,1648
3604852600,3697028552,1657570791,1657571047,256,118
3880295026,3765475472,1662184635,1662184912,277,2289
3661369487,3718905579,1650937982,1650938563,581,1427
3702671465,3693862073,1662695793,1662695813,20,430
3054927562,3757719267,1658047857,1658048192,335,1285
3343855888,3485815053,1667169163,1667169265,102,1620
3979522310,3806647877,1644065134,1644066068,934,1514
3333776110,3530162623,1669325792,1669326783,991,1066
3260085949,3119718471,1668257684,1668258334,650,525
3017075122,3617200235,1645971561,1645971856,295,308
3686704798,3595560993,1650618752,1650619318,566,1444
3776939860,3550908209,1668385700,1668385734,34,1193
3827954829,3562579840,1648036912,1648037554,642,507
3425804563,3016283694,1654870987,1654871212,225,258
3796875669,3826737259,1654819867,1654820717,850,814
3996963058,3236308141,1645688493,1645689227,734,86
3796754155,3925688803,1666216835,1666217217,382,223
3206399216,3739320901,1669407081,1669407609,528,2014
3537107415,3109702081,1657574801,1657575084,283,1987
3294478149,3198731476,1647681475,1647682253,778,2487
3456285013,3319334426,1654040468,1654041464,996,2163
3643382802,3535414109,1659732565,1659733252,687,1996
3812385830,3342054027,1649647460,1649647486,26,2487
3851879278,3969110896,1666957619,1666958436,817,1421
3595670942,3401138486,1653084651,1653084736,85,1105
3172429422,3423971586,1641312250,1641312322,72,330
3823692648,3282425868,1645964495,1645965167,672,1178
3906455689,3390976131,1650209016,1650209903,887,1948
3027110508,3526797183,1646520531,1646520865,334,1877
3656175066,3332458882,1643378544,1643379357,813,1760
3998987664,3055603453,1651442860,1651443831,971,640
3467933841,3375585327,1666605813,1666606768,955,983
3259260257,3520341683,1667401660,1667402161,501,2426
3327795374,3330058679,1652049606,1652050433,827,462
3527106895,3214282155,1643865105,1643865586,481,27
3236975783,3853056907,1668721241,1668722137,896,1202
3329498574,3763453899,1643968107,1643969082,975,1299
3412673526,3643372353,1643767811,1643768765,954,1321
3426899836,3000165786,1653098115,1653098275,160,1178
3693102953,3176526207,1665050076,1665050387,311,220
3877902487,3934326645,1664560742,1664560939,197,2402
3492376573,3624103484,1647181474,1647182309,835,939
3548133562,3428595992,1660960207,1660960487,280,2102
3913288832,3284829365,1660458523,1660459073,550,855
3350872529,3838250910,1646763113,1646764022,909,1156
3457284809,3346288809,1657921415,1657922309,894,1313
3730684727,3971180079,1643273249,1643274236,987,444
3069353793,3627385112,1641850544,1641851445,901,1054
3777835723,3824845857,1664339741,1664340039,298,680
3900876329,3724455974,1655763593,1655764435,842,2315
3549635553,3331554085,1669666521,1669666763,242,693
3281753784,3474808421,1644394538,1644395340,802,1660
3622334419,3094418033,1665544481,1665544984,503,363
3471587065,3460047535,1657341447,1657341865,418,1654
3255252214,3523236646,1642347347,1642348263,916,1372
3331554085,3959086145,1663782348,1663782695,347,683
3273701051,3038424212,1666562519,1666562860,341,1348
3209150433,3049567508,1651391203,1651391437,234,1762
3151386327,3195813968,1666801305,1666801974,669,393
3321391869,3447407380,1658592503,1658592626,123,302
3813511439,3105871139,1661652483,1661652549,66,1531
3855769157,3983166385,1649866768,1649867239,471,1896
3815235622,3748841094,1656385069,1656386007,938,366
3385430413,3023265778,1659523467,1659524236,769,234
3819812955,3625606853,1659570732,1659571233,501,1456
3780991625,3987732407,1648061864,1648062286,422,2133
3232160942,3868116298,1642131934,1642132216,282,469
3978690472,3286463125,1660013602,1660014173,571,1926
3425804563,3767983934,1667002678,1667002766,88,708
3768558350,3890335277,1663581002,1663581111,109,167
3992528955,3188726102,1646141186,1646141258,72,1973
3705996677,3506273643,1650339171,1650339887,716,1968
3228737899,3142848483,1667435107,1667436107,1000,640
3935379393,3143962586,1644892564,1644893272,708,1911
3828833040,3882038749,1664390298,1664390406,108,847
3112313754,3591724433,1648804517,1648805127,610,2470
3804145408,3995365519,1667038113,1667038524,411,28
3696437293,3866260144,1663098357,1663098542,185,341
3027295354,3138755786,1645847251,1645847979,728,776
3256873642,3748812993,1656884791,1656884987,196,1687
3741413739,3141196312,1657989777,1657990468,691,1703
3122109326,3188567155,1665593060,1665593263,203,672
3296919195,3583985803,1667588004,1667588794,790,1422
3501520918,3814809809,1655507167,1655507928,761,1979
3846493363,3126038266,1645689339,1645689343,4,1034
3439799907,3955307397,1655956487,1655956913,426,2128
3474975781,3154309446,1642628364,1642629106,742,1678
3674729672,3014438377,1668268256,1668268767,511,978
3397052856,3404873411,1645111511,1645111787,276,228
3938154365,3439442608,1657534744,1657534889,145,1447
3183079019,3594254200,1641047217,1641047475,258,1434
3587874085,3448734872,1655460375,1655460901,526,1256
3799014776,3241033604,1650383477,1650383855,378,1855
3939725219,3721136961,1658919173,1658919576,403,2219
3779299713,3392469094,1657299645,1657299830,185,1495
3159240548,3893475632,1665005058,1665005915,857,640
3376266236,3059322626,1665845725,1665845757,32,1952
3038849431,3304958701,1648619132,1648619993,861,1018
3957803611,3945607460,1661460450,1661461406,956,2194
3747302768,3672482112,1644120786,1644121328,542,66
3959408689,3837904800,1651201828,1651202489,661,2240
3725653558,3991963732,1651773968,1651774147,179,121
3107982351,3553530817,1653684472,1653685041,569,2432
3624139591,3529056509,1649948495,1649949328,833,321
3886611745,3132376039,1648127063,1648128027,964,1377
3440324329,3536128186,1648904287,1648904618,331,1553
3392293203,3153552268,1653344995,1653345165,170,1637
3710708040,3059322626,1651123892,1651124164,272,1962
3266867093,3107541952,1655068927,1655068985,58,1473
3487475790,3071602516,1657534516,1657535075,559,571
3970286228,3980867331,1650162048,1650162452,404,734
3387840253,3960036547,1668606270,1668607183,913,1678
3838823979,3411023911,1647255207,1647256073,866,494
3295352365,3421600026,1668128676,1668128978,302,2276
3087333030,3796990042,1659090172,1659091007,835,2378
3917956140,3535941714,1662314978,1662315873,895,2269
3910149883,3254030842,1662984173,1662984751,578,1379
3092003105,3361422449,1647097658,1647097889,231,233
3270914746,3224715818,1655558220,1655558824,604,671
3390441234,3106436957,1666479243,1666479379,136,1204
3986979175,3880196075,1653386881,1653387738,857,1810
3174544371,3547072063,1668025181,1668025759,578,2463
3579642249,3746050591,1649902226,1649903152,926,104
3408944120,3897433648,1667943107,1667943250,143,2221
3152456543,3365340586,1655238966,1655239233,267,71
3548132533,3088604045,1647034899,1647035883,984,404
3629984961,3059858458,1662328310,1662329199,889,410
3618397647,3500595056,1667061886,1667061924,38,1198
3567491118,3644334498,1649545615,1649546288,673,1870
3596841713,3516547882,1650118787,1650118967,180,812
3191970772,3207210781,1653478588,1653479578,990,2094
3478502336,3035976552,1642164523,1642164576,53,513
3353422891,3564839908,1656544400,1656544729,329,449
3171569619,3242912660,1666126817,1666127363,546,950
3665075758,3243018622,1652566869,1652567140,271,2259
3003005378,3065434950,1643109427,1643109832,405,344
3215815915,3414277030,1647884160,1647884743,583,2135
3293387588,3717137928,1642753811,1642754302,491,1876
3730428171,3553939893,1669494110,1669494440,330,887
3918234060,3432209746,1644097848,1644098802,954,703
3858150562,3361670451,1643795166,1643795851,685,1587
3400786498,3262864867,1655132451,1655132482,31,189
3707342422,3465796988,1667524211,1667525194,983,1649
3503489321,3696205962,1665091355,1665091885,530,57
3846007471,3744575844,1663438184,1663438301,117,1580
3467686942,3327061038,1667519391,1667519422,31,917
3046006152,3596007538,1655524876,1655525541,665,1364
3612878721,3438892275,1661936943,1661937390,447,521
3292667822,3692691710,1653056655,1653056794,139,2067
3779236518,3775103844,1660356614,1660357073,459,993
3862102577,3592043925,1654386348,1654387243,895,2040
3447447895,3990870728,1668524172,1668524939,767,1352
3390723607,3262379384,1644375419,1644375592,173,1522
3143909362,3946306714,1655556596,1655557557,961,46
3940914301,3448952875,1643190182,1643190694,512,1226
3261837009,3285030317,1664602256,1664602929,673,2171
3099984232,3516140957,1665292389,1665293262,873,2452
3813403697,3112622637,1666198488,1666198705,217,1922
3670266153,3086084685,1645968019,1645968274,255,2451
3576100130,3792027887,1662640460,1662640716,256,1544
3013064040,3310255083,1658094083,1658094563,480,1345
3282275875,3790783685,1655619996,1655620861,865,936
3639804787,3136810446,1660814675,1660815588,913,1561
3661642309,3962746969,1660380173,1660380185,12,16
3442209140,3414901923,1667918252,1667918598,346,1469
3878808489,3194259307,1646920708,1646921580,872,857
3607978764,3269653223,1665307585,1665308462,877,124
3361870766,3865947139,1665884585,1665884647,62,1253
3323698166,3011458038,1654430726,1654430888,162,1198
3795817960,3319037937,1648832383,1648832411,28,1630
3211641180,3288106394,1653103116,1653103423,307,1755
3891027417,3765660727,1646283557,1646283885,328,1534
3747621620,3824478322,1656554193,1656554546,353,1341
3199797181,3584925664,1662676102,1662676110,8,644
3784828021,3344177563,1657816446,1657817197,751,879
3924167113,3050267205,1657547915,1657548143,228,217
3057300178,3906772132,1642666370,1642666473,103,2330
3975065378,3994014690,1656508799,1656509530,731,124
3728878635,3183256246,1648054937,1648055600,663,400
3706215600,3873554599,1654320261,1654321101,840,1929
3189435516,3628963667,1669249807,1669250369,562,1041
3460047535,3693475435,1644034852,1644035267,415,183
3511593307,3710189327,1665584771,1665585442,671,622
3725903222,3357247840,1664008466,1664008814,348,2367
3025108334,3616429615,1648602534,1648603235,701,520
3271864656,3337305693,1659353161,1659354036,875,1076
3494179125,3672087645,1655868826,1655869608,782,1180
3552457707,3589157304,1667387057,1667387513,456,221
3839947308,3601690466,1668558627,1668558935,308,602
3134872743,3247047829,1667992313,1667993286,973,58
3923683467,3491272857,1657919842,1657920094,252,1513
3425856728,3896091695,1658441357,1658441530,173,1956
3635624917,3831009076,1645402617,1645403500,883,1112
3929305160,3960897829,1649398202,1649398386,184,1220
3778228977,3696149430,1666271162,1666271200,38,117
3037042091,3740376361,1656851453,1656851567,114,1716
3581207584,3711048943,1649985494,1649986238,744,1978
3589441972,3683134571,1666695148,1666695287,139,1770
3023880168,3713308621,1652254590,1652254747,157,225
3393406422,3480905975,1658118462,1658118718,256,2108
3492134379,3997312859,1657337333,1657337560,227,1824
3224617784,3589972665,1658493167,1658493910,743,1525
3911588238,3769944434,1661843178,1661843340,162,218
3819547274,3339415879,1650226284,1650227086,802,2498
3531842620,3361508949,1646626120,1646626675,555,1767
3146653168,3141480547,1641326255,1641326993,738,2333
3168329235,3052681277,1666468489,1666468942,453,2257
3859864317,3794575914,1643747694,1643748617,923,1163
3144551332,3255248380,1654759038,1654759327,289,1009
3678197665,3011567148,1651394993,1651395229,236,1176
3296556189,3032800454,1656395969,1656396397,428,1895
3058834310,3689680251,1641873545,1641874188,643,1157
3359078190,3607959490,1645381296,1645381644,348,1189
3922251351,3713455058,1649583862,1649583946,84,715
3037583613,3286555687,1660581440,1660582296,856,2484
3365939940,3250824932,1652400609,1652400813,204,562
3897412947,3047388698,1660473963,1660474259,296,1265
3067229796,3507363672,1666075184,1666075291,107,479
3898959510,3400604704,1660150069,1660150216,147,1449
3533279961,3037279735,1644734666,1644734843,177,2156
3269653223,3182502852,1650477724,1650478479,755,212
3947158263,3041385548,1656712615,1656713280,665,2096
3319224567,3776783076,1642509673,1642509947,274,1375
3700109325,3547483148,1645177718,1645178612,894,2145
3177951035,3368987950,1646358113,1646358461,348,1396
3181237998,3793086361,1659169720,1659170553,833,278
3653285237,3866922475,1660638932,1660639857,925,1363
3328146266,3155366529,1648025404,1648026038,634,189
3288309878,3201629659,1661206603,1661206996,393,1417
3057922933,3976223971,1664981582,1664982049,467,1334
3909837555,3175595669,1658864990,1658865557,567,1109
3027064938,3566534974,1654117157,1654117388,231,346
3933940005,3277521554,1646521143,1646522061,918,597
3060450258,3954799831,1648327897,1648328048,151,1418
3204083684,3090139002,1643085543,1643085922,379,900
3690646467,3695935038,1643142302,1643142753,451,2423
3985620157,3366354894,1651698722,1651699149,427,177
3282168599,3964565126,1647592768,1647593746,978,2333
3793518113,3572896327,1669291199,1669291747,548,242
3369356299,3082026010,1643717397,1643718312,915,2223
3047628685,3174639274,1659544383,1659545150,767,2042
3891053268,3559267449,1667202720,1667203534,814,1736
3229979386,3827851972,1658829789,1658830339,550,2000
3743682237,3925690262,1644967196,1644967600,404,2425
3153391276,3371790369,1661044759,1661045623,864,2407
3447447895,3481881323,1669458669,1669458842,173,882
3927214415,3658910038,1644778425,1644778751,326,1830
3597794683,3604596822,1669066004,1669066543,539,1886
3260571568,3864485247,1668227863,1668228796,933,693
3370350588,3575816255,1667683218,1667683853,635,1413
3793117012,3888469544,1662914851,1662915095,244,1022
3761576790,3644127860,1655184902,1655185825,923,1599
3837157118,3917526154,1662382856,1662383506,650,722
3222563704,3837447685,1650134480,1650135301,821,253
3677539420,3404934353,1645971961,1645972354,393,2423
3717926703,3841050085,1662018946,1662019335,389,1121
3421294150,3279671068,1653803268,1653803601,333,892
3194125043,3897222406,1646132243,1646133120,877,1845
3681170705,3549635553,1665944259,1665945217,958,778
3341248102,3959629367,1641619406,1641619446,40,2189
3353878603,3501508123,1657224538,1657224683,145,1065
3499091436,3653577731,1653357311,1653357837,526,305
3056267922,3811730419,1660166796,1660167733,937,1421
3622062401,3012155922,1658977466,1658978348,882,1476
3394999152,3037301537,1659571085,1659571344,259,2329
3288529545,3752289852,1653411167,1653411903,736,1732
3918552618,3414502284,1645689687,1645690026,339,2278
3881554146,3083020614,1663245956,1663246390,434,105
3777938800,3027129249,1644526240,1644527175,935,737
3346254669,3823917098,1668868563,1668869049,486,1497
3151938386,3615359458,1641336197,1641336895,698,1991
3343177837,3023530031,1657723265,1657723765,500,121
3553960271,3819415032,1666759713,1666759975,262,645
3144175285,3615419444,1643321221,1643322121,900,1270
3129683689,3012845933,1661570331,1661571275,944,1496
3765472006,3814899146,1647193123,1647193922,799,955
3211641180,3878695242,1642784062,1642784069,7,1583
3996989799,3318466045,1645007555,1645008007,452,1446
3786811867,3992927391,1662607136,1662607921,785,1064
3883071832,3546284533,1654660611,1654661515,904,2447
3189396065,3048402049,1657939652,1657940284,632,864
3468987116,3382983805,1665178623,1665178685,62,1072
3171906034,3034325039,1643939131,1643939654,523,394
3091709202,3014392598,1653996034,1653996778,744,2412
3431892611,3385413048,1653194230,1653194527,297,676
3573961768,3296151097,1642884314,1642884698,384,296
3005809519,3331539245,1653385799,1653386496,697,1598
3022707615,3554741157,1641600976,1641601624,648,1645
3391658891,3400899022,1668665529,1668665781,252,2229
3598645736,3197497279,1644207509,1644207616,107,651
3884067849,3531898771,1641651108,1641651139,31,682
3014993252,3454062338,1652564556,1652565547,991,1707
3929887239,3479580096,1646258875,1646259051,176,976
3058789362,3215423327,1661364215,1661364431,216,1260
3629984199,3834573240,1648196351,1648197263,912,1879
3346978275,3228110844,1658559011,1658559409,398,2069
3135211724,3852205498,1664089091,1664089859,768,1048
3063674428,3450023391,1655470611,1655471267,656,652
3112389617,3969563324,1660056635,1660056810,175,670
3462825977,3137594486,1660304984,1660305099,115,649
3053100790,3175295329,1657326168,1657326275,107,218
3329825462,3150627841,1646205156,1646205830,674,1599
3641752896,3017758671,1660175758,1660176117,359,1326
3402259490,3008470758,1651752399,1651752823,424,1728
3072985971,3794408677,1658045844,1658046152,308,761
3863427189,3828322397,1662732344,1662732632,288,1362
3169955779,3181388502,1644505963,1644506396,433,1724
3915111520,3925754107,1657687843,1657688704,861,1070
3937197371,3656789430,1660199560,1660199608,48,1390
3037090215,3752000675,1655444434,1655444526,92,1340
3486541605,3509328343,1665656322,1665656518,196,164
3821299576,3619399873,1653486649,1653487533,884,2233
3730270448,3089590512,1652850206,1652850755,549,333
3077552507,3008470758,1645834491,1645835254,763,57
3740236087,3218780941,1661416554,1661417154,600,713
3955663201,3567520646,1666120313,1666120403,90,280
3264121565,3345650412,1663734054,1663734212,158,35
3749756110,3903108572,1658452866,1658453021,155,235
3451106027,3686968293,1649543880,1649544135,255,358
3753657577,3210913409,1643878393,1643878458,65,26
3319946083,3875750764,1646720854,1646721604,750,664
3352986307,3228319450,1663702630,1663703611,981,1344
3573939226,3542369467,1652055657,1652055851,194,63
3498441448,3023075779,1659493798,1659494559,761,1036
3761609140,3893389283,1641529876,1641530629,753,1510
3291667893,3628729475,1645274827,1645275296,469,216
3110395191,3564839908,1669501047,1669501679,632,60
3883071832,3912916652,1654023695,1654024245,550,339
3552494506,3336300808,1666520818,1666521234,416,1988
3375769320,3287171733,1652446360,1652446880,520,327
3364456908,3112070783,1656739975,1656740969,994,1798
3617533561,3816995343,1649945504,1649945669,165,2219
3002727939,3932002704,1648600967,1648601771,804,2459
3333336166,3229881750,1660118270,1660118300,30,1107
3581570568,3075313832,1659724304,1659724566,262,2249
3920028342,3221276652,1642292636,1642292738,102,1004
3127467065,3265725715,1662283526,1662284398,872,367
3523631626,3779611783,1653607561,1653608223,662,2201
3735855753,3309468510,1659715402,1659715914,512,42
3298505096,3636621583,1654416203,1654416603,400,200
3428142421,3985513037,1647825535,1647825693,158,2410
3194871172,3523236646,1662036769,1662037522,753,2147
3120823401,3048497124,1645185930,1645186460,530,689
3792924517,3223463387,1657757952,1657758872,920,2254
3110691442,3153040217,1663860409,1663860607,198,1757
3977107209,3112419355,1668253036,1668253403,367,1223
3241190614,3804318840,1667617843,1667618629,786,1678
3307393195,3045127324,1657033152,1657033386,234,2301
3595049641,3328544337,1654085915,1654086054,139,1232
3829901682,3052376951,1660229903,1660230259,356,1090
3773434774,3549635553,1667595227,1667595810,583,443
3576386271,3975663862,1669566353,1669566569,216,1296
3981778568,3935822380,1650676184,1650677153,969,2252
3403512366,3120737114,1663107838,1663107947,109,1661
3283211870,3773770885,1660970494,1660971481,987,360
3477243904,3349724698,1653609866,1653610379,513,1476
3809698347,3066546417,1669011916,1669012168,252,163
3328544337,3852818295,1658703893,1658704309,416,15
3391711118,3053991932,1643543599,1643543839,240,298
3288016190,3897739549,1668220652,1668220733,81,1894
3965137487,3608200385,1651197438,1651198069,631,827
3903068218,3417742545,1653466255,1653466683,428,572
3669324531,3516838480,1645030952,1645031014,62,577
3860879385,3724770746,1647927976,1647928336,360,2415
3551104975,3825036404,1659287109,1659287379,270,896
3250926786,3116684420,1662565426,1662565827,401,2164
3308256167,3938776287,1664331491,1664331801,310,2347
3145378445,3603786519,1663727742,1663728616,874,1285
3592320524,3844939526,1659267329,1659268004,675,1750
3148259657,3329449985,1656982045,1656982101,56,2364
3373239702,3029468819,1669117752,1669118394,642,855
3440324329,3466473464,1653924112,1653924731,619,1059
3112859411,3855734814,1665439507,1665439811,304,1984
3269966376,3037940560,1665105342,1665106122,780,1363
3989646368,3913366963,1642710447,1642710832,385,158
3949970421,3526166184,1650117603,1650117689,86,1779
3450074680,3175505409,1660510494,1660511276,782,1401
3170036337,3928951547,1662256605,1662257480,875,753
3895274115,3764343778,1657731901,1657732822,921,2407
3545067538,3293865251,1657647439,1657648220,781,76
3280717680,3688776786,1664692575,1664693472,897,783
3238443990,3642946322,1669339575,1669339623,48,2297
3772980352,3664408598,1663340315,1663341099,784,248
3392535031,3933892798,1643480606,1643480959,353,2417
3622656083,3567520646,1656903468,1656904117,649,835
3523045898,3037301537,1656204495,1656205252,757,2305
3773658133,3287440691,1656278856,1656279634,778,1640
3486061006,3837550746,1664886998,1664887929,931,240
3393911160,3256787088,1669419251,1669420229,978,2026
3586814275,3483827042,1658472626,1658473331,705,761
3049147900,3092925867,1641686240,1641686643,403,1359
3047628685,3942140107,1669700313,1669700789,476,781
3329498574,3413948595,1665680321,1665681210,889,368
3085936525,3404908537,1653582120,1653582481,361,1089
3268745445,3759008568,1664670982,1664671470,488,2067
3434833146,3655135775,1669707678,1669708480,802,2367
3602238630,3208490048,1651417988,1651418269,281,1002
3768482482,3322337553,1650334124,1650334293,169,107
3120208739,3220750989,1648149663,1648149811,148,1845
3443190053,3616218859,1664322253,1664322397,144,582
3045427279,3707940691,1648489193,1648489238,45,238
3806629780,3118358674,1660676928,1660677841,913,1637
3545394112,3657251975,1656949063,1656949542,479,2334
3085412399,3089471552,1648053129,1648053217,88,1185
3625606853,3715766296,1651004196,1651004597,401,207
3265181921,3571972204,1656653467,1656653915,448,1466
3890194122,3853448159,1664885230,1664885237,7,18
3695237310,3282231108,1660201849,1660202067,218,230
3431175768,3971024525,1641348149,1641348237,88,1088
3556823098,3610239794,1641384743,1641384911,168,2187
3397987502,3596454426,1641868024,1641868406,382,495
3888312656,3439120258,1664203035,1664203076,41,2194
3535575355,3134117241,1665658735,1665659173,438,793
3572325072,3278827891,1651205092,1651206015,923,1042
3398443861,3673731636,1669473314,1669473997,683,762
3491306285,3223174482,1666644460,1666644665,205,1791
3450535254,3167058279,1659300441,1659301350,909,2107
3393199571,3249305465,1660275989,1660276125,136,1156
3903068218,3536903033,1667213749,1667213814,65,13
3034147055,3787058440,1663051807,1663052000,193,943
3673892525,3623191811,1643124147,1643124380,233,490
3298042916,3753180150,1666096760,1666097034,274,614
3239469849,3865847882,1643267461,1643268380,919,1663
3541560120,3006953744,1667773366,1667773709,343,1861
3092925867,3469462520,1662507577,1662508320,743,856
3555903175,3045070182,1661541055,1661541592,537,1156
3903321481,3787714854,1648597657,1648597669,12,2443
3880052402,3314872000,1655024331,1655024636,305,1573
3790829012,3983536056,1657990100,1657990157,57,1559
3199892178,3586770678,1654089402,1654089615,213,1632
3837447685,3780182766,1648467733,1648468177,444,2440
3278819973,3093254727,1664069758,1664070049,291,556
3391540103,3979352608,1658182352,1658183008,656,958
3768087701,3504446959,1658551822,1658552487,665,499
3245522058,3708309303,1653121119,1653121783,664,1198
3930994715,3265571367,1650097578,1650098318,740,1554
3875243979,3479401102,1649492178,1649492879,701,72
3773532257,3177951035,1663773581,1663774524,943,2381
3230277243,3573158941,1659090572,1659090743,171,1464
3209464030,3850906711,1668318424,1668318698,274,2396
3856882586,3083388257,1647600272,1647600749,477,1360
3766062750,3481620613,1669258328,1669258506,178,482
3225901381,3037940560,1658743588,1658744266,678,182
3550516008,3247269367,1658855543,1658856094,551,383
3887791096,3782673553,1649105939,1649106428,489,1668
3186897818,3530462613,1645280281,1645281181,900,2387
3040219251,3939755962,1641469467,1641470185,718,2390
3106465076,3880353584,1666839448,1666839978,530,1690
3022403169,3721751204,1655395735,1655395875,140,373
3534200501,3028364856,1669673206,1669673860,654,183
3104306511,3269680998,1659983363,1659983491,128,872
3979899306,3103856643,1651645265,1651646014,749,438
3189358030,3749897140,1655350814,1655351503,689,1610
3146481001,3832336338,1656749209,1656750159,950,1362
3753657577,3526315797,1655530235,1655530975,740,2485
3294569676,3941548978,1666997422,1666998002,580,1589
3003705867,3424897066,1666021015,1666021087,72,323
3184669033,3983391279,1649821358,1649821462,104,257
3611353561,3932077086,1660508449,1660508737,288,861
3470570814,3942399353,1648085200,1648085484,284,362
3573450428,3101265323,1655955319,1655956042,723,213
3857460953,3048402049,1666918978,1666919690,712,2358
3855548589,3130166522,1654119147,1654119911,764,496
3488001885,3152456543,1649509562,1649510416,854,2434
3442477300,3279351366,1659242128,1659242161,33,1068
3840659531,3396406579,1663189563,1663190125,562,354
3400730635,3373512814,1641047112,1641048067,955,1816
3280046501,3178643457,1659712717,1659713156,439,223
3320488617,3423909447,1658622784,1658623095,311,1613
3877049401,3958507465,1652078987,1652079905,918,2037
3929925771,3841318125,1668805071,1668805433,362,220
3651812819,3281146609,1667352673,1667353656,983,851
3580774207,3369356299,1663523950,1663524003,53,284
3626156541,3142313032,1667906004,1667906305,301,237
3507960689,3626156541,1662429324,1662429747,423,253
3622656083,3142777936,1654410870,1654411277,407,1906
3102753256,3168983812,1644348580,1644349163,583,406
3854535872,3573193288,1668698846,1668699089,243,2153
3833572466,3957051129,1648711100,1648711823,723,659
3904874839,3790329301,1666367546,1666368401,855,1008
3135116989,3736104902,1649350175,1649350316,141,2429
3315650808,3066639403,1642394155,1642394523,368,52
3261128926,3731116644,1648569698,1648569785,87,2204
3765472006,3934773931,1655349187,1655349941,754,2371
3343162937,3953927472,1665974373,1665974484,111,434
3458116043,3192005711,1666613221,1666614133,912,1212
3804948415,3411272565,1642271580,1642272115,535,1497
3949002357,3476060971,1661749553,1661750037,484,2120
3311529434,3766528617,1644788573,1644788931,358,273
3715200176,3225068874,1660365249,1660365588,339,522
3520392773,3851778010,1648525018,1648525525,507,1726
3501786397,3168919126,1664258498,1664259207,709,592
3949201468,3115494713,1647296838,1647297410,572,2285
3314190424,3855984822,1663505172,1663505364,192,1170
3549671217,3971588399,1659468346,1659469334,988,2408
3494680258,3982538753,1663639978,1663640140,162,665
3284948113,3637923107,1643935103,1643935134,31,768
3722483331,3408300554,1644027620,1644028525,905,1344
3114361358,3900101700,1668057241,1668057792,551,322
3072741474,3088132769,1669281705,1669281944,239,1484
3531842620,3059447105,1643089996,1643090263,267,572
3927886349,3522365623,1660966848,1660966862,14,81
3012339110,3382526428,1642285465,1642285547,82,957
3976156173,3274985034,1669575288,1669575520,232,1944
3867101565,3005926074,1665246789,1665247338,549,1397
3323698166,3569552798,1658287199,1658287532,333,1789
3897412947,3741273371,1644078842,1644079008,166,1916
3461017113,3052681277,1660302417,1660302818,401,1178
3861153303,3877090261,1649173608,1649173763,155,1928
3603096470,3924559198,1648502872,1648503431,559,471
3176410131,3856600876,1654493900,1654494482,582,1794
3641983006,3268745445,1665396203,1665396241,38,1578
3773408264,3214558994,1658552980,1658553357,377,1630
3139434250,3867868879,1660570625,1660571593,968,2085
3584139105,3972052329,1655481426,1655482387,961,1658
3481584783,3878810894,1644115468,1644116371,903,105
3339856407,3845130884,1642001960,1642002122,162,1151
3112313754,3052822229,1656107917,1656108796,879,2105
3884798812,3148259657,1649296177,1649296431,254,866
3098891437,3938025728,1654694472,1654694608,136,755
3306838717,3485801867,1645333310,1645333960,650,1046
3414748923,3763455710,1643516689,1643517445,756,638
3082912574,3407770585,1650832788,1650833523,735,329
3570906118,3337684100,1650457925,1650458299,374,1717
3943622737,3356765270,1660774600,1660774632,32,529
3271864656,3024268753,1656497414,1656497672,258,1511
3240324089,3028803724,1644323109,1644323183,74,1252
3958733956,3310523513,1667209527,1667210358,831,396
3937729247,3770561730,1649463073,1649463227,154,104
3486606390,3911891369,1663010836,1663011476,640,217
3679519826,3104210284,1643329465,1643329808,343,842
3205383513,3722247979,1667978143,1667979010,867,492
3090103866,3630963449,1645532039,1645532912,873,195
3639059199,3620939715,1648190020,1648190948,928,545
3899247202,3340933137,1661453950,1661454478,528,475
3894030912,3548511640,1666619519,1666619643,124,1135
3494613087,3975096180,1659592388,1659592976,588,1387
3489225147,3595612540,1646531529,1646532038,509,190
3187807330,3219435736,1664373343,1664373745,402,2131
3762690279,3242064640,1666014459,1666015096,637,1938
3534224607,3148259657,1656487686,1656488606,920,1292
3736885329,3035976552,1648883275,1648884254,979,1834
3948710872,3829971179,1665611808,1665612302,494,2098
3149191705,3958733956,1664109691,1664109955,264,1199
3099818927,3836331716,1668695243,1668695666,423,171
3768558350,3524942512,1659716062,1659716577,515,34
3120705176,3643185661,1641763927,1641764071,144,780
3133694612,3041223311,1656035244,1656035893,649,1290
3490435539,3623869570,1663438928,1663439545,617,1373
3340511048,3456433627,1656054125,1656054693,568,2406
3104816625,3793117012,1649090438,1649091296,858,1073
3153858233,3390431277,1641561646,1641562105,459,668
3204333859,3207801201,1664536990,1664537150,160,2223
3731399462,3837157118,1661349598,1661349729,131,569
3022453107,3935210171,1646006186,1646007176,990,1046
3254991122,3090179745,1667329405,1667329951,546,689
3967255191,3463003824,1669539027,1669539500,473,567
3342820244,3421078448,1642387329,1642388014,685,1255
3163395401,3969503443,1647704081,1647704997,916,1706
3479580096,3262203147,1642922875,1642923057,182,2133
3828555703,3759393612,1641892876,1641893847,971,1176
3135116989,3734331528,1646203747,1646204364,617,2449
3863485115,3741413739,1664774729,1664775729,1000,920
3413300274,3653183152,1658835379,1658836062,683,209
3631587282,3300412448,1642851386,1642851935,549,1550
3520341683,3546799061,1653362660,1653363571,911,2481
3095170532,3006456611,1663672627,1663673607,980,1731
3563488722,3239527114,1656336852,1656337588,736,1823
3256374123,3161243271,1667443070,1667443903,833,1675
3963370859,3040897601,1648848123,1648848669,546,503
3962658092,3513847916,1665502923,1665503380,457,842
3895274115,3022767670,1648094056,1648094542,486,1096
3219869001,3840846518,1643156736,1643157038,302,151
3252535116,3246796194,1665490774,1665491552,778,693
3645625556,3239517474,1665355790,1665356590,800,170
3624103484,3748837929,1654771838,1654772411,573,2158
3566834497,3713404433,1645236090,1645236574,484,2024
3736085476,3930142533,1659658757,1659659468,711,1165
3705919583,3014275222,1655935106,1655935798,692,2044
3418276734,3960267299,1665705489,1665706211,722,1665
3166206557,3493424957,1665582539,1665582843,304,1353
3064831559,3901579796,1668362247,1668362477,230,733
3888895982,3316031407,1668156773,1668157060,287,2095
3163552496,3019669727,1664898251,1664898302,51,639
3534201448,3744726408,1658641404,1658641789,385,1802
3295262122,3315569726,1654300453,1654301128,675,2253
3599604382,3328798665,1644198082,1644198570,488,2477
3223694966,3001603320,1643878986,1643879173,187,1378
3158554223,3211064928,1660526026,1660526464,438,2083
3579404607,3913905115,1665545935,1665546551,616,2003
3789380087,3356883463,1647927461,1647927462,1,2108
3273701051,3453076338,1651654634,1651655560,926,1646
3339459948,3112419355,1663052020,1663052059,39,1187
3207994528,3027478849,1668096999,1668097390,391,2438
3902739418,3323783108,1665850750,1665851103,353,898
3046043182,3323684905,1648599930,1648600860,930,338
3042034210,3907872554,1666308230,1666308709,479,666
3583864167,3235049473,1646092629,1646093123,494,152
3699263886,3882412784,1665734811,1665735178,367,573
3608843912,3689231617,1664219385,1664219732,347,308
3976858724,3424522509,1644460518,1644461245,727,2343
3307730398,3687938178,1665386513,1665386929,416,73
3463009951,3298879351,1656419922,1656420257,335,2228
3507363672,3256615260,1657689510,1657690422,912,686
3093589416,3844348081,1654681101,1654682088,987,413
3651847351,3586489382,1668306929,1668307567,638,1166
3494971523,3915637706,1642470940,1642471054,114,1981
3911364139,3693183129,1656997132,1656997407,275,681
3115928790,3999788546,1654714443,1654714745,302,754
3262711330,3226234284,1656290864,1656291659,795,1813
3745737102,3981515277,1657327280,1657328074,794,2348
3217583205,3289402711,1668549155,1668550046,891,1783
3866215730,3466282430,1661106049,1661106328,279,224
3384536407,3672482112,1654749119,1654749467,348,1152
3818039978,3711442352,1648659511,1648659759,248,2198
3895855296,3183340735,1650064516,1650065391,875,441
3730684727,3417532235,1645314015,1645314315,300,944
3028841213,3976817467,1646373728,1646373873,145,811
3927273567,3183079019,1661923975,1661924336,361,2386
3579684205,3181329363,1668648598,1668649057,459,302
3404020970,3790783685,1648300299,1648301215,916,2398
3764492400,3319605191,1662598258,1662598371,113,81
3739233756,3264401846,1665798143,1665798322,179,1947
3522444883,3378814600,1641092127,1641092644,517,288
3983988321,3412675211,1642505229,1642505348,119,2104
3233282653,3717406689,1659982781,1659983354,573,2320
3963702135,3540730645,1656536781,1656537049,268,365
3708101315,3132674107,1659353064,1659353926,862,1457
3491306285,3786194675,1646281247,1646282044,797,935
3271479070,3959093613,1647955772,1647956765,993,1883
3511569871,3140608489,1651082176,1651082453,277,782
3958275419,3746351822,1669716524,1669716903,379,1444
3650041115,3822126164,1659716483,1659717407,924,2078
3799900837,3270177744,1647109582,1647109728,146,1960
3118754726,3871851890,1666045639,1666046229,590,1697
3314872000,3823288349,1646046042,1646046788,746,622
3912106632,3066639403,1665376883,1665376927,44,1412
3836535079,3059322626,1654051048,1654051595,547,557
3949480596,3046080865,1665745210,1665745468,258,1223
3432892677,3066426534,1648936211,1648936569,358,1131
3488001885,3079013365,1648679850,1648680051,201,216
3254367735,3105829075,1649993077,1649993447,370,495
3340427847,3491398730,1661671154,1661671761,607,1512
3298635617,3893475632,1669261725,1669261782,57,59
3205162065,3273059265,1650386714,1650387011,297,71
3010173509,3409779636,1651858278,1651858397,119,801
3936943386,3295278768,1641977319,1641977976,657,2255
3003617799,3707892765,1665221858,1665222510,652,1276
3809387134,3495858842,1651036417,1651037024,607,1844
3810861883,3215040043,1662255565,1662256487,922,313
3152554117,3252981510,1669057065,1669057320,255,1597
3784912315,3854184537,1655194473,1655194627,154,977
3236308141,3149046961,1658825187,1658826061,874,185
3090506589,3473394094,1644128227,1644128264,37,1913
3098369438,3354200745,1651341902,1651341990,88,1363
3868348947,3236819846,1656819170,1656819617,447,1497
3912858275,3239527114,1647350567,1647351314,747,1760
3473355243,3327857419,1667771740,1667772669,929,2276
3680677416,3954285582,1641283910,1641283955,45,2123
3339415879,3356028416,1654497644,1654497855,211,2452
3462280366,3356690610,1644752161,1644752226,65,2400
3688300477,3663718795,1662431827,1662432224,397,1090
3772762015,3816015403,1650316857,1650317314,457,984
3759393612,3206386504,1656907104,1656907783,679,318
3795326002,3161999632,1657563293,1657563656,363,1492
3105789496,3086084685,1655577542,1655578253,711,1283
3084592361,3031560160,1656801816,1656802445,629,440
3476903669,3691062084,1656214611,1656215003,392,743
3626156541,3669299007,1650167400,1650168346,946,894
3257449240,3491022991,1665791660,1665791666,6,1766
3149135097,3604852600,1649402380,1649403228,848,79
3389161785,3220577762,1664942773,1664943148,375,1114
3841672169,3121128511,1650956521,1650956614,93,228
3585982995,3332012161,1653900536,1653900746,210,1346
3129034897,3779611783,1651573564,1651573819,255,310
3951216492,3959093613,1651068416,1651069287,871,1216
3395316132,3528439013,1663708767,1663709270,503,1241
3667258476,3101669976,1641943006,1641943345,339,146
3834843479,3624103484,1643476063,1643476701,638,2015
3061366261,3911621945,1658428971,1658429969,998,449
3023772977,3055211808,1654750478,1654751453,975,324
3192505750,3486606390,1644746325,1644746542,217,98
3824227701,3246796194,1669710525,1669711102,577,88
3097031283,3522365623,1655778083,1655779076,993,1900
3859680527,3252664436,1649165335,1649165637,302,1024
3672874828,3088595440,1652311646,1652311718,72,420
3650902153,3273059265,1656197854,1656198406,552,1481
3076285457,3449114289,1652826484,1652827435,951,1132
3942520090,3366321387,1667817417,1667817807,390,1500
3804329236,3900356013,1652780519,1652780889,370,1843
3683460040,3078791988,1649567783,1649568187,404,100
3161805415,3153085443,1661383731,1661384058,327,1936
3774437189,3061461510,1666021770,1666021998,228,1682
3206425813,3224491185,1661371582,1661372286,704,1482
3303719777,3409779636,1663461962,1663462591,629,594
3906396830,3999228111,1659917344,1659917847,503,1501
3011466658,3203691315,1668323133,1668323375,242,454
3722199706,3596932196,1653599391,1653599766,375,373
3011863548,3456791834,1659736704,1659737440,736,2242
3034807560,3587440298,1665419493,1665419585,92,1762
3351145248,3520392773,1656250803,1656251706,903,822
3349626057,3798833025,1658193334,1658194274,940,1784
3620985435,3089471552,1666234783,1666235231,448,1988
3668174777,3857434991,1669322770,1669323184,414,1028
3749379449,3752522830,1655822838,1655822901,63,1192
3173642675,3759986276,1651291125,1651291411,286,179
3482166014,3992909356,1645612260,1645612783,523,1548
3811930283,3784594026,1658144962,1658145282,320,1612
3482268698,3536443756,1663084862,1663084921,59,536
3112622637,3987510303,1642246572,1642246996,424,1391
3415522797,3805314214,1650183588,1650184059,471,2433
3749327438,3159525512,1662524447,1662525034,587,1604
3532450192,3018262582,1656743910,1656744785,875,1854
3306619417,3938417195,1643307218,1643307869,651,1622
3651812819,3291512173,1652097576,1652098541,965,1796
3110691442,3936980618,1655234381,1655235000,619,1089
3949841652,3053100790,1641047549,1641048412,863,66
3529764378,3851780195,1665009414,1665010162,748,477
3414719919,3658656847,1652922466,1652922915,449,299
3131548243,3832334966,1665817515,1665817783,268,1890
3430145466,3294526671,1655906508,1655906744,236,245
3059416141,3749756110,1667008661,1667008838,177,350
3774823325,3713116694,1663021881,1663022077,196,1218
3879299283,3402354750,1655878438,1655878924,486,1878
3541597384,3282168599,1642975644,1642976290,646,889
3702932977,3211003582,1657321347,1657321847,500,1075
3984977278,3529381895,1658154838,1658155280,442,2026
3718710270,3697822889,1653130468,1653130618,150,690
3447946570,3229497695,1650348622,1650348731,109,2240
3936659399,3729389785,1660544230,1660544806,576,1171
3885694482,3925364546,1642928274,1642928857,583,2069
3435292986,3831770571,1647932350,1647932506,156,755
3145389444,3692498377,1649708707,1649709447,740,1569
3790157838,3739731580,1641999424,1641999894,470,991
3114183830,3668235327,1644520124,1644520310,186,1346
3660489961,3123677020,1647160258,1647161097,839,2021
3972955608,3093773162,1662770768,1662771057,289,1109
3540550798,3167142908,1645726521,1645727378,857,20
3209064637,3673935826,1654441223,1654442183,960,1490
3827557826,3693797946,1668884107,1668884979,872,143
3465064732,3922251351,1649615741,1649616347,606,375
3116751960,3019204329,1656145421,1656145834,413,2341
3505753274,3012323943,1661075029,1661075569,540,56
3577651077,3460047535,1659297091,1659297196,105,1875
3128133737,3938370016,1659793025,1659793634,609,854
3653770219,3300412448,1644505592,1644506425,833,1541
3170537714,3419422052,1652511019,1652511596,577,2425
3228794031,3285030317,1654366391,1654366466,75,940
3942399353,3880196075,1643287837,1643288682,845,2437
3825849470,3134436515,1657948950,1657949738,788,819
3105243389,3216171635,1664256650,1664257584,934,384
3782730026,3540279517,1653256089,1653256838,749,1707
3995654203,3556000533,1661602916,1661603100,184,1260
3124723265,3604762599,1657166000,1657166861,861,231
3464770966,3602238630,1662113307,1662113774,467,408
3032123620,3234064286,1644280289,1644280643,354,688
3505417530,3295020761,1652627465,1652627687,222,238
3523465225,3180984174,1641476357,1641476796,439,182
3882438892,3705601482,1661989839,1661990095,256,1953
3938025728,3809059026,1661047218,1661048156,938,950
3719503327,3840659531,1658482825,1658483540,715,481
3857211245,3554275173,1656783752,1656783756,4,959
3982644241,3065810858,1648539425,1648540379,954,348
3972397754,3071765048,1643718422,1643719087,665,1251
3154704216,3368294774,1666165273,1666165555,282,2
3411128747,3609310097,1659050210,1659050989,779,2137
3747630644,3698898645,1665140946,1665141235,289,822
3463009951,3808900684,1662609276,1662610091,815,180
3927273567,3961973688,1659888184,1659888727,543,1834
3254227672,3350566867,1645186108,1645186549,441,426
3838851134,3006456611,1659082020,1659082130,110,2222
3840155828,3985854594,1665143930,1665144244,314,2332
3819791378,3204114911,1657300108,1657300208,100,760
3748944220,3763723423,1651024872,1651024957,85,1655
3109284478,3428026242,1641617943,1641618771,828,432
3344394548,3905922866,1643570420,1643570867,447,1601
3609601814,3596483616,1659389793,1659389850,57,2047
3680100111,3894359262,1643986905,1643987262,357,1377
3713006411,3239377872,1664134233,1664134817,584,1623
3200468398,3703457098,1646688543,1646689236,693,356
3962722941,3998728915,1655827111,1655827179,68,1258
3160515169,3679867888,1664377433,1664377659,226,782
3396146110,3029807207,1650649324,1650650207,883,1214
3924865492,3975075818,1660781008,1660781651,643,1937
3140608489,3656878544,1666816019,1666816403,384,458
3247688800,3426491499,1658283896,1658284551,655,1950
3937758732,3624060457,1664489606,1664490272,666,1665
3965000413,3332914132,1668743645,1668743860,215,2368
3252157235,3983536056,1649262174,1649262712,538,1676
3716461226,3073474496,1655653044,1655653915,871,1696
3730702889,3871971681,1650156137,1650156459,322,2231
3662409391,3029374380,1653925353,1653925951,598,1563
3452258976,3542078032,1645349360,1645350301,941,1959
3319877479,3569200063,1668399257,1668400026,769,704
3146378665,3000780515,1662302876,1662303722,846,2408
3828713812,3825462888,1657717950,1657718946,996,906
3114733025,3151564731,1654682734,1654682803,69,967
3458815526,3554676369,1668008534,1668009194,660,1398
3372197177,3801847517,1647775125,1647776103,978,1948
3039893721,3920327961,1663534485,1663534723,238,463
3260802289,3330548469,1665293022,1665293667,645,1796
3933196862,3730845439,1655023489,1655024172,683,1294
3361167735,3438465122,1651511607,1651512102,495,1891
3784808734,3006388757,1660568564,1660569417,853,532
3281146609,3960417596,1661458611,1661459314,703,1253
3857400676,3424768768,1669476677,1669477233,556,684
3158894896,3447527130,1655474958,1655475592,634,985
3877902487,3904445895,1667051760,1667051790,30,1632
3995358434,3091530738,1666216912,1666217758,846,602
3109108614,3978667945,1656618681,1656619641,960,35
3333037570,3296957627,1642066921,1642067617,696,2475
3890117007,3070557341,1666273233,1666273354,121,1154
3177951035,3314190424,1667348105,1667348810,705,1644
3502432342,3545781567,1644816970,1644817073,103,1334
3805665502,3197300293,1648929434,1648929811,377,290
3872306673,3595560993,1645568313,1645568495,182,1100
3928361511,3924865492,1665544768,1665545143,375,273
3378522829,3894247542,1658368202,1658368465,263,794
3893601176,3227951880,1649503076,1649503387,311,1783
3290800332,3607352755,1651884199,1651884827,628,1821
3565803867,3017075122,1664916345,1664917157,812,2291
3111823829,3244946730,1646549164,1646550110,946,517
3722380765,3086076310,1644210549,1644211303,754,1941
3313615371,3831346903,1644488744,1644489542,798,1393
3998728915,3740728884,1649272089,1649272599,510,1199
3045302814,3723784545,1665643497,1665643709,212,2025
3608297293,3688405055,1664716223,1664716765,542,335
3970970054,3391118279,1651594769,1651595344,575,699
3724977571,3614399988,1656467472,1656467570,98,398
3093131372,3990144819,1646335563,1646336148,585,821
3106437492,3391441349,1644630936,1644631098,162,134
3946409673,3958733956,1655561012,1655561780,768,55
3133647753,3468682335,1659513624,1659514011,387,1130
3627981146,3399334455,1643046943,1643047529,586,1174
3531256735,3678149544,1641908201,1641908644,443,2116
3729299306,3835612256,1650214323,1650214942,619,1741
3889288487,3069318012,1665522877,1665523726,849,1724
3729340640,3897222406,1664806059,1664806451,392,468
3413777646,3835842311,1668351216,1668351627,411,563
3067539427,3165208023,1649071077,1649071419,342,791
3137529896,3995270744,1643505462,1643506368,906,946
3467233007,3201630796,1656084494,1656085332,838,624
3270453709,3362898304,1647562476,1647563409,933,1198
3712869836,3686704798,1652367169,1652367984,815,1583
3904907996,3710786724,1644377850,1644378629,779,2216
3084531614,3189111071,1663079366,1663080081,715,1593
3117575075,3525088003,1659155116,1659155925,809,621
3250312962,3112259657,1646860420,1646860802,382,529
3816015403,3310882037,1668484695,1668485677,982,797
3485815053,3820466728,1647015081,1647016012,931,1626
3249512921,3185985712,1668072698,1668073020,322,734
3976055046,3204359619,1642568056,1642568582,526,932
3502947486,3940948395,1659587629,1659588096,467,786
3000725837,3303025505,1647282050,1647282395,345,508
3933251803,3611763388,1664257622,1664258107,485,2312
3763093748,3890181496,1661824208,1661824718,510,1623
3450817021,3423782681,1669274064,1669274983,919,1095
3795765856,3351145248,1665003918,1665004065,147,2186
3551170621,3942134694,1644155250,1644155995,745,2368
3620939715,3264460374,1651479731,1651480383,652,2163
3875945215,3101669976,1668996152,1668996200,48,102
3011466658,3820466728,1651166501,1651166770,269,693
3429887771,3154288650,1663767944,1663768333,389,2261
3630621507,3517631415,1645338238,1645338251,13,448
3905581902,3522132687,1655598214,1655598751,537,799
3538863873,3614741796,1650250736,1650251127,391,2296
3788911315,3428062841,1648154883,1648155164,281,30
3223313152,3884802599,1656907386,1656908344,958,2140
3561562385,3570429285,1654028571,1654028625,54,1540
3585816096,3845818528,1662220072,1662220112,40,1842
3470446722,3143962586,1651965434,1651965743,309,2466
3744347272,3997397652,1661536678,1661537182,504,2200
3938773149,3862685266,1644914173,1644914696,523,1827
3368987950,3678805802,1665543282,1665544213,931,1573
3860268588,3931230284,1644961685,1644961985,300,75
3481090623,3666174374,1645078326,1645079129,803,1573
3438553592,3157212376,1665700501,1665701187,686,2144
3429074631,3197693984,1653708745,1653708841,96,1309
3599354804,3804145408,1665828922,1665829504,582,100
3450689808,3271885744,1647926699,1647927311,612,839
3381060534,3392271707,1651894133,1651895121,988,1658
3124063685,3468803992,1654042168,1654042222,54,2350
3054927562,3070795112,1643874226,1643874756,530,1835
3920277028,3113938510,1667578833,1667579648,815,396
3266828046,3332721407,1654816386,1654816703,317,1099
3741978230,3580178697,1652232805,1652232992,187,1762
3111163302,3023772977,1666404281,1666404373,92,786
3753985186,3682793223,1651557850,1651558310,460,750
3879967963,3159645889,1654055025,1654055949,924,1583
3371790369,3427405967,1655424880,1655425348,468,2490
3390431277,3541423460,1667159840,1667160080,240,235
3692441467,3216810372,1665869670,1665870091,421,136
3796559738,3885926991,1649739728,1649739806,78,2463
3462825977,3822143503,1646954292,1646955233,941,362
3571719140,3222871111,1646740274,1646740831,557,2481
3488962022,3606954305,1646407157,1646407191,34,803
3705217157,3559176364,1641890799,1641891429,630,1798
3450893865,3074477991,1649623902,1649623990,88,1513
3885786333,3674729672,1658671568,1658672119,551,1274
3385760763,3629933310,1665439856,1665440491,635,1259
3502599631,3904517073,1649484460,1649485255,795,2005
3540717336,3054573274,1660306201,1660306523,322,1577
3784828021,3518620219,1657180420,1657181040,620,718
3719146348,3763991129,1647418937,1647419113,176,1954
3105946115,3163552496,1657673236,1657673745,509,2076
3668441547,3713482005,1649095171,1649095691,520,1738
3866922475,3166483466,1669442794,1669443063,269,909
3040867771,3012152244,1659935111,1659935838,727,2304
3011466658,3343543154,1656781055,1656781663,608,2041
3974092782,3406868680,1644119521,1644120282,761,1634
3956055955,3500320805,1661846315,1661846816,501,2289
3907004279,3268745445,1658670270,1658670828,558,698
3936042616,3316287541,1644473527,1644474077,550,2097
3010819705,3992919381,1661737936,1661738098,162,2495
3603786519,3359600983,1653405931,1653406569,638,257
3862468039,3865847882,1668753130,1668753542,412,944
3049147900,3620985435,1649053298,1649053963,665,2466
3003116947,3833230225,1644682754,1644682863,109,495
3423522480,3561562385,1667231677,1667232247,570,1224
3794251958,3751475341,1646285406,1646286221,815,662
3568289450,3917984429,1657087064,1657087435,371,91
3374692305,3722569299,1661155992,1661156131,139,2443
3196616254,3081701001,1664666464,1664666716,252,138
3352444293,3513180024,1664617133,1664617224,91,998
3997581459,3609003771,1669589730,1669590535,805,2310
3324455158,3718882981,1655430439,1655430678,239,1514
3852555743,3271156755,1652961082,1652961935,853,1760
3695292102,3685715658,1644654905,1644655061,156,1904
3663884600,3438553592,1655278780,1655279699,919,349
3065405448,3103625074,1645750050,1645750152,102,749
3937129101,3424453686,1645143802,1645144537,735,1358
3223174482,3520825972,1663770376,1663770647,271,1469
3532450192,3949133704,1665905733,1665905997,264,1382
3112739600,3894593426,1655813569,1655813739,170,1982
3298527612,3794447092,1667088902,1667089338,436,2074
3226298244,3696856656,1666750669,1666751039,370,2056
3853448159,3570230022,1641218614,1641218959,345,2434
3660839110,3616890026,1661036795,1661037216,421,1600
3304252236,3059447105,1660238024,1660238724,700,2015
3516410980,3821864560,1659266946,1659266956,10,1688
3946911182,3741692259,1660694665,1660695203,538,1957
3841660750,3379726555,1662486660,1662487506,846,1264
3930118877,3021289375,1660859417,1660860251,834,1799
3397987502,3152518339,1662982493,1662983483,990,1811
3207801201,3713693431,1664452822,1664453656,834,216
3306378570,3722323538,1641507669,1641507872,203,828
3554822566,3864249446,1656004812,1656004983,171,2361
3010819705,3495420849,1645771135,1645771305,170,696
3555966791,3096746005,1663595770,1663596565,795,142
3070087815,3274452346,1669287117,1669287748,631,1266
3988337484,3091108616,1657544012,1657544962,950,464
3651055879,3137529896,1664700564,1664700653,89,1003
3204346356,3718909055,1645489752,1645490635,883,1627
3174499556,3153858233,1652854110,1652854373,263,1932
3744234480,3486793392,1651061093,1651061827,734,1902
3307393195,3772034355,1650210321,1650210585,264,2117
3967754963,3179547560,1661002310,1661003192,882,2420
3373566394,3988790434,1643342769,1643343235,466,569
3536903033,3642946322,1666671878,1666672025,147,370
3516488694,3921816397,1663670292,1663671007,715,1041
3911671645,3771931468,1659125759,1659126253,494,1028
3062261092,3247163175,1657992244,1657992782,538,1726
3375799029,3674349184,1666105362,1666105882,520,1412
3064323869,3390445291,1662572134,1662572664,530,1658
3013775923,3978720869,1641714718,1641715011,293,1123
3304559201,3299211422,1653824216,1653824236,20,2470
3909168020,3980675077,1665390116,1665390268,152,1317
3462743550,3284443787,1654201464,1654201932,468,1218
3846007471,3071810518,1662344141,1662344555,414,1893
3031386210,3380930960,1666660161,1666660870,709,2378
3526793212,3931624174,1658711308,1658711885,577,1123
3925344243,3639659256,1662702892,1662703443,551,1610
3252981510,3192836427,1651102896,1651103698,802,2109
3025310934,3002316212,1647194463,1647194614,151,1288
3146634302,3735943539,1662261628,1662261632,4,2189
3337738889,3046617108,1667735060,1667735790,730,933
3120984531,3197371652,1645089111,1645089651,540,120
3250023388,3471587065,1661583393,1661584064,671,1255
3101886383,3659204779,1655186805,1655186916,111,1983
3426617058,3004964162,1651288547,1651289530,983,1990
3790298140,3149602037,1664219491,1664220104,613,376
3378613925,3926467866,1651474696,1651475373,677,1474
3859680527,3855165548,1644540859,1644541382,523,1366
3831951487,3450294094,1659165571,1659165571,0,478
3451227417,3478288963,1654783394,1654784100,706,1441
3052861028,3811930283,1660033502,1660034073,571,1738
3554089401,3273348089,1647906357,1647907247,890,599
3100716894,3406239480,1666087903,1666087912,9,2453
3877902487,3468324129,1654703806,1654703867,61,2490
3893828389,3309468510,1642317192,1642317768,576,600
3337673105,3083144170,1651404915,1651405235,320,2046
3616218859,3844499309,1652247249,1652247261,12,1902
3971722824,3758708262,1644061591,1644062277,686,270
3296957627,3444349973,1655126978,1655127510,532,11
3151982756,3240502673,1654384763,1654385352,589,2214
3594853846,3625894399,1665246513,1665246612,99,110
3766186320,3003705867,1658149510,1658150276,766,2314
3312888621,3474115926,1641148331,1641148923,592,120
3543105564,3364893066,1660268913,1660269075,162,571
3037867406,3755294305,1658607970,1658608670,700,1671
3514894244,3585674939,1642957075,1642957854,779,17
3696205962,3331426472,1659550289,1659550859,570,631
3825849470,3650471605,1643513890,1643514207,317,1409
3910149883,3835612256,1660488412,1660488676,264,551
3736260750,3045925838,1652326644,1652326784,140,2338
3810573183,3792834070,1658618142,1658618480,338,2234
3551243497,3828219822,1641859757,1641860424,667,1485
3907700603,3306871271,1650026749,1650027640,891,986
3966056341,3149668198,1664664693,1664664910,217,496
3379076226,3400542216,1642708232,1642709125,893,250
3573826666,3902705203,1653273065,1653274027,962,1023
3941689381,3339459948,1663972078,1663973067,989,87
3468516508,3057028614,1647145110,1647145934,824,2345
3060310842,3565805050,1655931482,1655932171,689,509
3907713562,3436422088,1649277575,1649278115,540,203
3626015702,3707362025,1643049842,1643050446,604,1646
3600067650,3925496970,1662623815,1662624303,488,229
3763455710,3490087619,1653300665,1653300742,77,2125
3889840253,3336423969,1647996059,1647996542,483,239
3450074680,3643615690,1644221199,1644221883,684,214
3975065378,3314495556,1647547725,1647548171,446,1984
3651421358,3358968371,1656225634,1656226167,533,10
3300456889,3914796719,1655575659,1655576498,839,1852
3913288832,3825484587,1668183861,1668183977,116,1407
3136564426,3639090741,1667677825,1667677830,5,1165
3897293094,3494544431,1645011230,1645011247,17,1956
3217029107,3098108231,1646156644,1646157303,659,489
3887409378,3409055122,1654502129,1654503116,987,975
3181778467,3295806447,1669651667,1669652084,417,2064
3695237310,3227368879,1644846699,1644847176,477,580
3678778706,3625894399,1663248871,1663249058,187,2406
3151704655,3513180024,1650898193,1650898984,791,678
3930205120,3880837935,1642498256,1642498386,130,2107
3689020840,3463121212,1652995359,1652995463,104,843
3002415281,3344455273,1650469785,1650470261,476,1523
3487526777,3425803609,1656621300,1656621962,662,168
3658451605,3022348535,1662624603,1662625247,644,1402
3271156755,3462072699,1653226764,1653227474,710,1505
3496040749,3911632634,1661398682,1661399494,812,1003
3459188746,3373239702,1653130376,1653130451,75,587
3141480547,3934383056,1664654431,1664654618,187,1854
3397910828,3905067771,1664014890,1664015304,414,1651
3535325513,3830850007,1660879073,1660879271,198,91
3767453896,3710851755,1653835981,1653836215,234,2024
3392569339,3897433648,1651977053,1651977771,718,2338
3935936621,3615362859,1641244414,1641244805,391,1866
3935057012,3816647849,1668446934,1668447208,274,1417
3804768140,3769269484,1651474121,1651475120,999,18
3014462663,3962453693,1641174017,1641174566,549,1630
3610480358,3959783422,1653070288,1653070703,415,2348
3880638655,3501770020,1656684342,1656685062,720,1674
3872928406,3115669693,1655893008,1655893862,854,1319
3012264999,3780808964,1657878896,1657879647,751,1446
3336300808,3802410450,1642514515,1642514533,18,1157
3357048496,3585097526,1660755761,1660756269,508,86
3267248595,3957798687,1643250963,1643251596,633,167
3505272067,3952252601,1656707303,1656708112,809,348
3362173874,3319506258,1650236221,1650236938,717,1221
3734035375,3270111894,1645524764,1645525531,767,39
3299472791,3022428512,1659252745,1659253519,774,104
3762571799,3518932161,1667934870,1667935508,638,154
3882559155,3488551185,1655897127,1655897651,524,2428
3169559952,3445689630,1647517963,1647518957,994,1800
3079137127,3880638655,1650325349,1650325689,340,1016
3767724034,3056982737,1647514875,1647515314,439,479
3165700370,3470112947,1665602839,1665602943,104,2457
3903112291,3464235741,1662155317,1662155449,132,2375
3097609387,3892469874,1650269811,1650270294,483,1826
3090588645,3075563867,1643533242,1643533580,338,1494
3550908209,3856600876,1646604025,1646604358,333,1274
3888764578,3479308343,1655108610,1655109091,481,261
3065405448,3427520419,1649593310,1649594122,812,74
3329848036,3657251975,1646001577,1646001645,68,2054
3271201418,3162641272,1646999815,1646999993,178,398
3203691315,3691834770,1651359169,1651359773,604,1655
3131683456,3993923271,1642542421,1642542709,288,869
3737504606,3605195406,1665513898,1665514254,356,2131
3993572792,3707892765,1650344724,1650344784,60,1300
3232333937,3093716530,1667942506,1667942684,178,1552
3282587673,3631568439,1643150117,1643150862,745,1779
3964565126,3223204355,1665485838,1665486365,527,848
3750192699,3565278029,1661196408,1661196652,244,45
3618941109,3804145408,1643810464,1643811155,691,2292
3788034142,3512353520,1644538137,1644538866,729,1770
3050229164,3892023630,1652795568,1652795991,423,814
3269699819,3723870491,1644560651,1644561294,643,221
3923647484,3713116694,1644080003,1644080134,131,177
3825645806,3147792323,1650059465,1650059478,13,2425
3923259150,3124927662,1652981332,1652982007,675,184
3660548799,3829901682,1667957255,1667958009,754,975
3294783182,3878925459,1668705562,1668705759,197,70
3734893217,3543256939,1661496607,1661496650,43,906
3881578299,3982644241,1668197511,1668197730,219,1622
3896997211,3249071020,1664779304,1664779648,344,357
3488484971,3519828744,1647809394,1647810059,665,272
3196302340,3043753185,1661137970,1661138854,884,281
3657587705,3463509445,1643163216,1643164052,836,757
3076307729,3177036721,1649669339,1649670251,912,646
3622933919,3546782886,1651030005,1651030013,8,1751
3524466015,3215088423,1661446302,1661446612,310,1769
3081213963,3991310779,1669091500,1669091783,283,1487
3712727713,3131938458,1655078494,1655078936,442,1138
3116584028,3500320805,1666105091,1666106059,968,2384
3015814199,3071602516,1664636702,1664637314,612,1083
3700287335,3924990392,1664301143,1664301448,305,467
3948833001,3041652512,1647604029,1647604560,531,843
3313265862,3331882759,1651378868,1651379018,150,2315
3185512282,3864485247,1651030706,1651031124,418,2313
3083388257,3625606853,1660151373,1660152299,926,2039
3069225011,3334102064,1647251005,1647251853,848,1943
3425856728,3699258770,1643129578,1643130183,605,1608
3031209415,3355942761,1643577666,1643577698,32,764
3532307372,3586778995,1648698380,1648699134,754,1745
3605519659,3763093748,1668784207,1668784970,763,53
3317961564,3220736075,1667535495,1667535772,277,365
3060989519,3455040603,1641616460,1641617068,608,2220
3005356433,3868427833,1657286009,1657287006,997,1098
3187561832,3016283694,1650517647,1650517731,84,2226
3481308282,3035402024,1655799145,1655799515,370,501
3066990756,3476558133,1660397322,1660397404,82,1098
3406595083,3362388538,1653664660,1653664679,19,1190
3103728720,3690350377,1649902551,1649903273,722,1955
3623876940,3688345244,1648005433,1648005780,347,1211
3508202949,3260571568,1643286359,1643287153,794,332
3146653168,3258739109,1656028229,1656028953,724,1946
3239158180,3207389119,1650086339,1650086629,290,1658
3583985803,3679983127,1643624015,1643624095,80,299
3293865251,3008372630,1643579660,1643579752,92,2004
3924969388,3616441586,1657624531,1657625198,667,687
3016992122,3890181496,1663633530,1663634170,640,1229
3034827961,3710331536,1649554077,1649554286,209,2341
3877483900,3045925816,1669324112,1669324820,708,337
3188588023,3096854657,1646445630,1646446606,976,590
3569525429,3316855337,1651100937,1651101912,975,1707
3963546042,3297681098,1644436798,1644436920,122,681
3678305236,3209332658,1649538984,1649539700,716,656
3224309877,3183079019,1657329480,1657329832,352,1859
3928020650,3875483766,1660466578,1660467562,984,865
3364938815,3641911946,1656691195,1656691752,557,1007
3659158165,3814017798,1650093559,1650094168,609,1374
3472855930,3745712275,1661267609,1661267748,139,2402
3493447321,3093364150,1654169901,1654170294,393,1654
3080703553,3836565798,1649381019,1649381451,432,1447
3915637706,3047643464,1652455970,1652456369,399,44
3311529434,3232128014,1657759780,1657760267,487,2396
3294276727,3921317746,1655630296,1655631286,990,2329
3154139372,3142765587,1656821208,1656822056,848,2057
3773532257,3002829154,1667557060,1667557879,819,2277
3208106743,3930474522,1645147802,1645148761,959,2418
3160135389,3969036937,1656550153,1656551037,884,2168
3030174879,3271314900,1655814200,1655814305,105,2398
3701979416,3816538946,1658028549,1658029404,855,1156
3884959127,3317431311,1662772384,1662773094,710,941
3385273825,3137350861,1652785291,1652785799,508,813
3269763687,3543257848,1663262210,1663262797,587,1912
3195159288,3291267409,1657417879,1657418491,612,1215
3881861537,3758115218,1646983987,1646984715,728,843
3695411154,3551104975,1642849584,1642849748,164,1374
3233938614,3158554223,1655093057,1655093241,184,961
3516624109,3602497998,1653215195,1653215979,784,36
3766160943,3927666827,1644735088,1644735973,885,1859
3932530423,3351361711,1644590171,1644590498,327,1893
3645943439,3712115076,1657113018,1657113231,213,364
3971524060,3608597242,1664411434,1664411960,526,1413
3967250644,3401138486,1664033346,1664033359,13,54
3024447668,3021727735,1648226608,1648227020,412,1012
3365289656,3154079557,1646413365,1646413570,205,2264
3923137418,3909765076,1660600295,1660600584,289,2459
3006507589,3141108539,1661009142,1661009843,701,560
3091817310,3671147965,1662590889,1662591309,420,299
3582267659,3316287541,1642558923,1642559229,306,1459
3003145369,3840558415,1658999381,1659000153,772,922
3608297293,3719084637,1665384369,1665384793,424,865
3096854657,3272981808,1651454027,1651454949,922,2476
3988913212,3306460846,1659747089,1659747733,644,1429
3834720743,3875570780,1658433398,1658433724,326,1079
3300479839,3775103844,1642262761,1642263380,619,440
3929497543,3342538148,1647586373,1647587050,677,1231
3270453709,3232304638,1653084870,1653084960,90,768
3197739962,3153446106,1650540086,1650540597,511,1624
3973666003,3505295000,1653361365,1653361389,24,1483
3689518345,3577990920,1663473767,1663474451,684,570
3601604629,3612061421,1659640780,1659641234,454,1056
3632283664,3952663430,1655102325,1655103206,881,652
3287784262,3558281313,1659322995,1659323923,928,188
3256648307,3967425379,1667245685,1667246679,994,188
3468173779,3326046744,1666079067,1666079482,415,2106
3428287409,3948710872,1662202284,1662202362,78,344
3211064928,3290681709,1653667775,1653668411,636,1467
3990870728,3914427859,1649009618,1649009906,288,116
3771111014,3621726953,1658688018,1658688117,99,102
3486061006,3180984174,1646359145,1646359920,775,1816
3925481419,3941903445,1647237279,1647237906,627,171
3147047674,3497507557,1659009962,1659010429,467,46
3719084637,3129170273,1641705990,1641706003,13,218
3042836639,3214817416,1655613487,1655613901,414,2203
3771146763,3755962729,1647656889,1647657414,525,1739
3351245855,3635921511,1661553204,1661554199,995,257
3505761464,3886344418,1651978997,1651979775,778,2498
3241944871,3029943531,1656079397,1656080233,836,1440
3125314664,3154729703,1668089809,1668090794,985,1801
3153831709,3611967437,1658511160,1658511836,676,1170
3690646467,3287399418,1651767169,1651768155,986,1383
3624644696,3325735498,1665482505,1665482763,258,2171
3202783831,3131938458,1656999180,1656999995,815,73
3736260750,3315402916,1653482455,1653483292,837,297
3360158658,3765504986,1663010691,1663010721,30,821
3626118668,3197660189,1650997526,1650998509,983,943
3180062640,3888505889,1653289158,1653290053,895,1598
3309286736,3246321113,1656553884,1656554763,879,1088
3754631129,3862890852,1650319543,1650319967,424,472
3037577001,3530806404,1646749993,1646750988,995,1177
3972917056,3228366627,1664897002,1664897105,103,1738
3961903747,3626216693,1656483861,1656484121,260,666
3939768853,3289153734,1644932872,1644933182,310,913
3357048496,3703615574,1657041307,1657041463,156,2133
3510528970,3403512366,1641075486,1641076081,595,1157
3378168172,3081028310,1660626132,1660626715,583,2105
3356883463,3861499264,1664090481,1664091432,951,1349
3769786489,3007328261,1652465622,1652465899,277,1738
3990144819,3993623323,1653420782,1653421567,785,1826
3221885729,3878274883,1649360320,1649361220,900,314
3570747542,3431082237,1644635067,1644635318,251,1228
3713834683,3080214168,1646539879,1646540769,890,1815
3131331478,3907635993,1669057977,1669057996,19,2338
3112298724,3036470049,1663307000,1663307448,448,937
3854184537,3177190923,1647626493,1647626934,441,1667
3109500957,3800312034,1669547589,1669548208,619,1353
3761307187,3887108152,1643070386,1643070937,551,271
3183507473,3766196716,1669722941,1669723651,710,361
3191265442,3800337461,1654760528,1654761156,628,628
3422106507,3720012234,1662437301,1662437453,152,1546
3347397074,3653770219,1669685436,1669685927,491,953
3517992014,3027295354,1667074327,1667075162,835,1901
3562105236,3428593255,1668514024,1668514217,193,1199
3588728644,3038244365,1647515553,1647516208,655,1317
3060718787,3107482740,1652336978,1652337602,624,2380
3091709202,3294635633,1662944156,1662944835,679,1095
3650431460,3206386504,1642967040,1642968027,987,733
3265324040,3566534974,1653085402,1653086120,718,2371
3304596274,3956054666,1653688531,1653688704,173,834
3936029875,3730845439,1647476166,1647476352,186,612
3358571434,3277875103,1660895045,1660895666,621,2268
3944476586,3363802434,1652785965,1652786785,820,194
3675703241,3014646091,1659630577,1659630589,12,1405
3420298161,3131753608,1663974430,1663974481,51,1439
3216665855,3944247629,1667123830,1667124345,515,68
3951845301,3139198469,1662318093,1662318814,721,1769
3830015015,3911632634,1662350250,1662350653,403,1572
3582168015,3882414600,1663882603,1663883420,817,121
3045587450,3999180921,1655295223,1655295913,690,1964
3087662482,3397169008,1657388369,1657389180,811,1542
3855754332,3252753513,1663241073,1663241482,409,2335
3798833025,3779590261,1647812086,1647812222,136,906
3869794122,3636237325,1658573104,1658573931,827,2183
3246159564,3312930717,1653565696,1653566052,356,1787
3118526217,3581302872,1651747117,1651747861,744,490
3217173480,3961672171,1662127628,1662128317,689,1050
3116777827,3902705203,1642593000,1642593820,820,709
3313619618,3159240548,1654018259,1654018479,220,871
3404034127,3886611745,1655346150,1655346298,148,1094
3967727550,3620616287,1651130288,1651131024,736,1086
3468586613,3120762596,1661157794,1661158627,833,381
3880052402,3228366627,1644811406,1644811969,563,824
3677001111,3353956873,1664273224,1664273862,638,83
3241425701,3422728078,1666166227,1666166696,469,1046
3334207071,3956796805,1664948000,1664948631,631,1567
3832880789,3581449963,1648973273,1648973785,512,381
3907705988,3555186812,1668965009,1668965713,704,1398
3811337280,3005926074,1665632002,1665632074,72,1230
3719929552,3742344076,1654355353,1654355911,558,2135
3034255613,3099649164,1653555142,1653555341,199,333
3922728266,3316855337,1652131900,1652132028,128,989
3916674515,3304490341,1646245296,1646245431,135,56
3662507847,3176753600,1660739256,1660739831,575,443
3950666008,3297477157,1654570949,1654571232,283,425
3781580109,3472375572,1664335709,1664335934,225,1130
3282839568,3710043628,1645512916,1645513614,698,1835
3153851884,3028705386,1641960021,1641960782,761,1652
3056982737,3692368068,1655104829,1655105467,638,953
3475686271,3614179985,1656338178,1656338986,808,1634
3034440971,3997312859,1662129943,1662130646,703,1330
3695292102,3880353584,1663954165,1663954838,673,1880
3510761729,3331426472,1659838767,1659839560,793,2475
3880837935,3573961768,1643230477,1643231358,881,209
3927214415,3534182480,1661352511,1661352746,235,1947
3912803496,3613730980,1655352256,1655353183,927,1299
3990312725,3479401102,1663612666,1663613489,823,2314
3660839110,3833333678,1644509381,1644509915,534,655
3400163448,3000254515,1653142999,1653143309,310,505
3825036404,3517912492,1668817326,1668818102,776,1628
3868348947,3193830008,1641841829,1641842244,415,1935
3174425370,3331554085,1646518782,1646519620,838,2145
3569573616,3577718759,1666936300,1666937228,928,1331
3581570568,3474742534,1651890423,1651891096,673,1309
3335976452,3799624292,1662844887,1662845578,691,1466
3759230876,3393156673,1650666834,1650666867,33,1069
3892469874,3222749852,1658283152,1658283894,742,722
3832072924,3240435560,1649110810,1649111650,840,1157
3526747987,3152456543,1664877096,1664877902,806,288
3081005801,3571793713,1654585884,1654586788,904,887
3990109853,3161999632,1655434461,1655434604,143,583
3202187490,3885458258,1643524591,1643524621,30,2297
3925496970,3743886187,1655195895,1655196155,260,1594
3826737259,3449133548,1642111163,1642111538,375,712
3730845439,3216092524,1646850512,1646850633,121,1055
3398814666,3797769846,1666256271,1666257061,790,854
3342260000,3850427038,1652472371,1652472624,253,2499
3858459394,3602955685,1664746111,1664746848,737,2024
3536156667,3154158203,1653702003,1653702445,442,537
3209464030,3640587334,1647556117,1647556853,736,956
3573915559,3971934050,1667290610,1667291552,942,1573
3170158934,3634044438,1661069311,1661069549,238,1823
3762422234,3503453854,1654887266,1654888240,974,2342
3870349696,3118502732,1654415089,1654415270,181,2240
3486793392,3682993605,1656286446,1656286708,262,2256
3579921083,3348770994,1650217601,1650217673,72,1473
3889967886,3355078629,1647556498,1647556555,57,1846
3596567072,3875908590,1645811296,1645811399,103,730
3636948225,3411128747,1668921942,1668922716,774,1868
3832296106,3446481380,1658240882,1658241777,895,976
3468914867,3205472801,1665103250,1665103783,533,1622
3017740025,3060450258,1648442757,1648443630,873,2005
3458645622,3129677855,1658648315,1658648517,202,65
3601519220,3516410980,1656531684,1656531820,136,1831
3114361358,3043258601,1641855114,1641855488,374,262
3184344401,3023448006,1649059605,1649059894,289,2271
3938370016,3537031182,1641668895,1641669131,236,516
3197739962,3704604706,1647310077,1647310835,758,1257
3922385616,3051642574,1652834487,1652834910,423,1410
3952282084,3233938614,1655198824,1655198829,5,1046
3701668957,3922675517,1657508472,1657508919,447,2265
3289332257,3809965750,1658864977,1658865541,564,357
3963547295,3267319115,1642324153,1642325084,931,2469
3984215552,3695419353,1648332387,1648332469,82,1785
3187257156,3869692733,1663689231,1663689393,162,761
3817579913,3928951547,1668783749,1668784663,914,1488
3900051900,3938025728,1669711450,1669711734,284,942
3225857817,3864045087,1658704566,1658705315,749,1762
3930124385,3731206373,1669629281,1669629945,664,1180
3387311534,3513193858,1656459707,1656460448,741,133
3063715610,3254194915,1654454728,1654454806,78,1493
3516107946,3995654203,1642042478,1642043409,931,1404
3409804938,3106705860,1660584913,1660585295,382,361
3641460659,3090506589,1653869383,1653869747,364,994
3133805973,3941689381,1656246577,1656247125,548,375
3780652187,3276763839,1643340735,1643340864,129,326
3734367959,3921962724,1663424167,1663425001,834,2492
3169486525,3381060534,1659957444,1659958144,700,675
3673743780,3129283198,1665049133,1665049198,65,1040
3169265310,3019512245,1669693251,1669693796,545,2241
3139268488,3032431944,1658270604,1658271012,408,52
3233932115,3116584028,1662515830,1662516425,595,778
3476820014,3598522904,1645815385,1645815434,49,50
3857687791,3774958505,1657381802,1657382711,909,616
3954285582,3799117805,1666744503,1666744982,479,179
3309219121,3217583205,1662197974,1662198247,273,1071
3059447105,3304252236,1649510801,1649511211,410,1919
3467215587,3369049258,1661795047,1661795738,691,2391
3265181921,3417298701,1669732597,1669733122,525,2446
3404317985,3255978821,1667034746,1667034795,49,1360
3666174374,3796348557,1659319752,1659320222,470,2272
3163552496,3791406454,1664059018,1664059872,854,1603
3035158102,3274159957,1649621816,1649622051,235,1437
3560967248,3176526207,1649541200,1649542161,961,48
3832072924,3787071341,1668070814,1668071495,681,2003
3220903356,3924607271,1646059480,1646060328,848,1661
3506307976,3222282745,1653501055,1653501938,883,1512
3841287368,3113427537,1664256606,1664257078,472,737
3540730645,3615595663,1664680457,1664680875,418,181
3403786938,3968682824,1643907775,1643908707,932,9
3189300345,3359278409,1668804342,1668805198,856,350
3385846184,3553241769,1666375448,1666375853,405,1109
3012930968,3616712503,1648049451,1648050037,586,1596
3748812993,3012930953,1650734100,1650734857,757,1880
3289437738,3982538753,1667515063,1667515825,762,668
3796936978,3913645530,1652952905,1652953318,413,1913
3388218000,3930591160,1663337784,1663338623,839,1626
3821180393,3708922840,1662481785,1662482229,444,1495
3079013365,3939948508,1649342442,1649342640,198,1959
3936943386,3058290794,1659584331,1659585162,831,1785
3342215329,3464734783,1652104127,1652104938,811,168
3827122083,3955750752,1656184014,1656184560,546,246
3181047536,3495919793,1651333338,1651333939,601,531
3288490513,3090910630,1667381614,1667381723,109,2281
3174499556,3433418040,1662768499,1662769420,921,1423
3324618357,3415888174,1648440834,1648441610,776,2194
3392213771,3320488617,1657596635,1657596903,268,904
3975096180,3499994307,1669220650,1669221368,718,2238
3013681789,3164702890,1647672608,1647672827,219,86
3932161358,3035976552,1658787369,1658787764,395,2375
3353257973,3949970421,1661549317,1661549675,358,2017
3422745115,3520523282,1653196725,1653197222,497,274
3724770746,3037984397,1650150325,1650150907,582,882
3983727854,3703457098,1652568543,1652569326,783,1617
3091062283,3973666003,1663297793,1663298375,582,2225
3304087986,3984274810,1666748620,1666748750,130,2444
3506750759,3782741533,1659222516,1659223134,618,2288
3450353368,3802410450,1667959249,1667959863,614,1925
3805314214,3770771031,1660341732,1660342384,652,1490
3583918364,3265324040,1642003189,1642004073,884,1878
3032123620,3204302089,1649487114,1649487547,433,714
3015814199,3224130773,1653266832,1653267197,365,683
3635502276,3015246686,1646063932,1646064139,207,2418
3743669526,3142160799,1663496094,1663496341,247,1580
3220405755,3487030175,1654429657,1654430564,907,1601
3583307819,3516410980,1651074353,1651075193,840,1653
3724861653,3734381035,1663227798,1663227892,94,924
3564026629,3382015551,1659298338,1659298574,236,2309
3706560099,3521112560,1659018602,1659018747,145,775
3639819433,3961973688,1645953611,1645954406,795,53
3566919425,3599915754,1652306566,1652306622,56,2024
3723438987,3239792198,1667656256,1667657091,835,1738
3411708498,3467383586,1647316634,1647317468,834,1827
3269865212,3927666827,1641535803,1641535842,39,1007
3642377610,3084385255,1642922552,1642922796,244,1793
3600977488,3843347515,1656047477,1656048454,977,2441
3625772064,3739453348,1659385644,1659385778,134,2365
3019761756,3569525429,1667489961,1667490533,572,1104
3021006721,3880580622,1645950443,1645951095,652,2411
3986885276,3963385029,1666772237,1666772309,72,590
3931789231,3086871623,1642431815,1642432388,573,1906
3020285623,3573961768,1653995362,1653996244,882,2017
3526166184,3389114774,1643826800,1643827031,231,976
3331335383,3106276005,1647420522,1647421301,779,311
3313295291,3329848036,1642542646,1642543257,611,1186
3907299052,3134425396,1663270049,1663270236,187,1179
3834843479,3324394622,1643672476,1643672515,39,1235
3221885729,3509167906,1645733727,1645734550,823,755
3638595264,3066531358,1654502718,1654503288,570,2
3804749299,3634936481,1666155087,1666155802,715,621
3237224664,3368294774,1661146976,1661147342,366,2310
3645768666,3278297907,1649143095,1649143581,486,421
3190003253,3065246027,1653989051,1653989583,532,516
3232209052,3921754282,1669532742,1669532950,208,834
3206119800,3894175918,1658353077,1658353508,431,1908
3188643066,3256873642,1653500494,1653501483,989,1159
3709263457,3039081980,1663616801,1663617395,594,2328
3509864353,3777872237,1653136800,1653136864,64,1872
3379285136,3061814600,1644529461,1644529985,524,79
3873002836,3591348696,1645639098,1645639821,723,361
3804064265,3616890026,1653609484,1653610155,671,368
3035464149,3066439887,1660958257,1660958604,347,115
3811482837,3492034029,1652432901,1652433317,416,1066
3569600936,3751600788,1653281666,1653282042,376,2410
3307185651,3175979112,1654682224,1654682717,493,1309
3171235556,3001794280,1654942559,1654942810,251,172
3869991101,3403389913,1654834380,1654834888,508,1191
3938949913,3625684557,1646744440,1646745200,760,532
3079038995,3165208023,1652043540,1652044415,875,1483
3090179745,3377847710,1643575532,1643576462,930,1891
3826530948,3820374377,1651701342,1651702181,839,478
3264879958,3364456908,1656857867,1656858639,772,51
3563407459,3120105783,1645757344,1645758243,899,416
3404432145,3327873529,1646084542,1646084819,277,145
3970049421,3996319604,1649553829,1649554159,330,2298
3983727854,3494498890,1659387214,1659388195,981,1146
3668421848,3918812791,1644470157,1644470192,35,1154
3049141347,3439325479,1658444654,1658445511,857,1395
3835701186,3371002443,1659319570,1659319676,106,1227
3065246027,3571477883,1660364438,1660365290,852,1653
3354579861,3680694926,1643932554,1643932855,301,914
3986970365,3214698363,1651972506,1651973258,752,1499
3419422052,3601690466,1643418339,1643418865,526,2387
3730337290,3687243333,1652946370,1652946615,245,1519
3095621927,3917715509,1646355980,1646356471,491,769
3619399873,3472474698,1650102959,1650103252,293,1295
3025133604,3102588374,1647781398,1647781481,83,2221
3309196902,3825036404,1660657516,1660657550,34,1696
3016283694,3843917747,1651983901,1651984786,885,1587
3322226292,3468633309,1658047258,1658047272,14,1986
3833046871,3993917332,1643061916,1643062217,301,297
3641455530,3800014504,1653145290,1653145543,253,1215
3437705581,3843157491,1647390977,1647391709,732,390
3928235124,3695161514,1662702182,1662702872,690,2433
3256628168,3052396813,1645506579,1645507504,925,549
3778675824,3475897333,1665395454,1665395889,435,310
3874913687,3787654868,1641425528,1641426320,792,865
3003116947,3883286458,1647174745,1647175198,453,164
3235992794,3509167906,1643594550,1643595376,826,423
3160515169,3218746999,1654274453,1654274507,54,2286
3435319506,3895370398,1654929640,1654930611,971,85
3645666563,3648447244,1659972956,1659973492,536,1778
3267650986,3811318665,1647446198,1647447168,970,1082
3465842758,3011686027,1664339815,1664340468,653,984
3400154631,3785584501,1648636146,1648636575,429,2214
3208346862,3666268915,1643012852,1643013021,169,645
3568162481,3010546611,1650718168,1650719054,886,5
3112356239,3165307890,1661065317,1661065351,34,463
3054171550,3232436630,1654343004,1654343858,854,476
3921962724,3572009360,1645938332,1645939043,711,142
3820225206,3275494433,1645610703,1645610982,279,1252
3772739629,3021320868,1645100253,1645100510,257,2065
3202063550,3480523769,1658275780,1658276147,367,780
3359278409,3387170357,1660888617,1660888810,193,2305
3185469541,3140608489,1669659268,1669659596,328,2306
3039972849,3733975709,1656065773,1656066646,873,1508
3922423821,3624644696,1661400743,1661401216,473,1574
3987162833,3067220098,1665895285,1665895810,525,1119
3661705197,3365340586,1659341154,1659341535,381,1700
3053991932,3142923526,1655258645,1655259344,699,1401
3613188168,3994721189,1646715470,1646715660,190,2364
3453227348,3744563835,1655254674,1655255358,684,336
3155044579,3633111737,1646251047,1646251478,431,91
3897433648,3584925664,1643867673,1643868329,656,347
3522623156,3865950417,1662738647,1662738895,248,1392
3290481654,3993076833,1645131656,1645131991,335,951
3650563043,3400542216,1661192078,1661192632,554,162
3102760949,3007686100,1647584103,1647584624,521,1521
3542293606,3947521897,1646681826,1646682249,423,2433
3835842311,3303815040,1647803680,1647804351,671,1811
3043611684,3668078009,1658967969,1658968550,581,673
3879967963,3940520472,1650711304,1650712167,863,600
3285747162,3014552263,1660613358,1660614126,768,3
3899315309,3934453508,1648442223,1648443061,838,541
3113423573,3752297066,1644538512,1644538581,69,2195
3205418435,3853912096,1668913284,1668913712,428,956
3451167153,3074832079,1650399496,1650399767,271,2462
3517449502,3877902487,1654833357,1654833822,465,2484
3832786192,3227652803,1659073531,1659074082,551,563
3442330693,3878177076,1667136880,1667137372,492,1087
3341573446,3012155922,1663260801,1663261580,779,466
3603702697,3543105564,1650390159,1650390874,715,1079
3401463703,3112615469,1652936616,1652937540,924,64
3037048394,3058290794,1657167445,1657168204,759,1083
3213995449,3316625530,1669634748,1669635747,999,13
3422745115,3126746702,1669203690,1669204479,789,371
3298635617,3832296106,1668698722,1668699315,593,704
3086325930,3013681789,1642336773,1642337093,320,202
3065298582,3046085814,1668505569,1668506347,778,29
3705755036,3169072505,1645584900,1645585401,501,1342
3245247493,3918491301,1658369250,1658369375,125,78
3884959127,3462744404,1663497861,1663498646,785,2172
3809332572,3374940485,1652480518,1652481434,916,146
3258577325,3235049473,1645918540,1645919420,880,2445
3780546851,3796990042,1653189229,1653189610,381,976
3048402049,3041632417,1667958576,1667959440,864,2466
3119523311,3594777411,1653823081,1653823380,299,499
3938973292,3826573375,1664456903,1664457586,683,680
3960633649,3624872846,1659386587,1659386695,108,1299
3486810833,3351610798,1651114843,1651115273,430,87
3606994517,3542369467,1653280521,1653281376,855,1644
3854737938,3540550798,1642168350,1642169336,986,1438
3648975076,3878512967,1661431810,1661432769,959,1714
3276232281,3656000543,1654907904,1654908341,437,1499
3217029107,3131735006,1645319253,1645319766,513,2326
3482891017,3587727278,1652011204,1652011446,242,1678
3267319115,3420180743,1643505209,1643505558,349,1745
3563840007,3603853942,1667129682,1667130244,562,2110
3736871918,3187982526,1642439313,1642439900,587,2010
3284159385,3890181496,1644679713,1644679811,98,969
3358277498,3774722709,1663651312,1663651663,351,1728
3303884789,3318345517,1657528924,1657529242,318,1348
3855113371,3082359035,1661231696,1661231892,196,417
3148203422,3344279346,1648795072,1648795691,619,253
3506307976,3311303975,1649136402,1649137188,786,935
3193344217,3712195438,1659961612,1659961923,311,143
3444809495,3472375572,1661993969,1661994075,106,962
3353295219,3823761286,1653467288,1653468042,754,1368
3589984222,3291267409,1642467473,1642467695,222,1470
3073967597,3332506866,1643612185,1643612793,608,807
3257449240,3527349190,1664820729,1664820794,65,344
3298436959,3910581173,1644493743,1644494508,765,877
3769786489,3307305290,1658506690,1658507204,514,1607
3926467866,3033692011,1645920199,1645920486,287,650
3534201448,3272879760,1656519929,1656520535,606,1809
3780654306,3242785599,1661903211,1661904195,984,1990
3787333178,3628556060,1648093200,1648093872,672,1400
3698906761,3230843282,1644277018,1644277478,460,886
3476403398,3986081370,1644046718,1644047241,523,2280
3037984397,3394249709,1656184872,1656185578,706,549
3708134798,3991477345,1657712770,1657713044,274,586
3252843201,3886521075,1643618862,1643619555,693,1858
3449115415,3309286736,1641953025,1641953650,625,163
3150485567,3718176139,1668814326,1668814790,464,316
3377086230,3194140038,1642813326,1642814263,937,2261
3903321481,3187257156,1648227535,1648228122,587,1221
3564444579,3347854994,1648805742,1648806066,324,1149
3974804920,3313782821,1642862613,1642863164,551,1640
3921261515,3780652187,1646498264,1646498837,573,2079
3849902434,3367849829,1654805219,1654805550,331,2472
3532569602,3840533238,1656719919,1656720838,919,1782
3088587729,3542078032,1667062518,1667063102,584,342
3156210736,3697118662,1644551793,1644551930,137,2368
3963303057,3575457804,1667802129,1667803017,888,1420
3224491185,3492909923,1652899142,1652899447,305,2429
3364600825,3029263333,1646409906,1646410758,852,2097
3605706184,3564198089,1669110305,1669111247,942,106
3662040060,3595713931,1643569485,1643570329,844,1150
3571348230,3143274658,1643158678,1643158923,245,1414
3556823098,3559301819,1660464911,1660465857,946,1648
3864044700,3032888380,1666487708,1666488469,761,1260
3281397783,3536931244,1644043507,1644044480,973,1418
3030551637,3472855930,1661145983,1661146151,168,2107
3648257100,3666072303,1642215400,1642215996,596,179
3259880338,3133030435,1668189863,1668190734,871,798
3364540592,3250108907,1662566145,1662566258,113,727
3486096604,3118502732,1664110973,1664110992,19,1356
3815718297,3795299092,1658658483,1658658886,403,1506
3320792244,3915206176,1668332082,1668332606,524,865
3055944630,3388004574,1641475432,1641476342,910,359
3514498367,3303418943,1656001874,1656002063,189,968
3229080104,3419809319,1652645793,1652646049,256,2006
3476820014,3733143454,1642977044,1642977807,763,855
3963793916,3269198119,1647617409,1647617858,449,401
3868827867,3662507847,1648473402,1648474204,802,2389
3915439541,3043611684,1663401959,1663402137,178,96
3289799796,3026209549,1647789231,1647789630,399,2046
3785725492,3868630067,1656606496,1656607189,693,2031
3297001171,3041296119,1642350329,1642350884,555,1855
3897421758,3558912751,1669009545,1669009881,336,879
3768311968,3698906761,1660749819,1660750480,661,1308
3841170833,3875343154,1652183930,1652183965,35,1683
3366609475,3419422052,1660694711,1660694806,95,1125
3136172164,3614064639,1642237900,1642238527,627,710
3254473094,3187807330,1649768648,1649768870,222,757
3776685300,3217173480,1657788754,1657789319,565,478
3280372392,3746890721,1661192683,1661192711,28,1222
3587727278,3112356239,1665675019,1665675084,65,1246
3672274616,3123781164,1667380470,1667380745,275,1876
3735691730,3022252567,1655666727,1655667239,512,127
3545394112,3749619105,1661724373,1661724502,129,1211
3482148686,3030630339,1649412396,1649412669,273,846
3017758671,3292812509,1658462835,1658463154,319,1268
3718684083,3125459736,1645802745,1645803710,965,1283
3481672220,3653881945,1650130649,1650131580,931,2156
3083791573,3997886077,1667585268,1667586017,749,4
3935383578,3662289637,1654802826,1654803278,452,1617
3485644295,3544353013,1668157887,1668158031,144,331
3391898268,3010819705,1665993002,1665993656,654,969
3388218000,3098667748,1645965157,1645966048,891,443
3816240060,3252973419,1664009835,1664010236,401,2441
3446289365,3044483301,1658319396,1658319812,416,734
3085412399,3300203056,1659322449,1659323194,745,668
3758323845,3318848700,1643687373,1643688088,715,1417
3163552496,3280558341,1667698710,1667698854,144,2230
3328245802,3462072699,1659435246,1659435634,388,1781
3481922555,3193095337,1668641939,1668642011,72,1483
3276763839,3054639823,1646184206,1646184308,102,1378
3560043638,3369731959,1648341049,1648341416,367,1407
3052822229,3311280180,1645089477,1645089780,303,1304
3806167216,3170579908,1667939176,1667939332,156,856
3050370620,3318594125,1656551004,1656551605,601,1026
3457451540,3031209415,1659771733,1659772421,688,336
3271885744,3431909978,1649022610,1649023536,926,678
3110121278,3809698347,1641850789,1641851161,372,2070
3585553252,3841170833,1650753539,1650754382,843,224
3130899709,3662355477,1663057972,1663058149,177,1822
3740183658,3106328456,1662411627,1662412046,419,1845
3252981510,3747697794,1656630740,1656631586,846,150
3798512184,3109390601,1668912311,1668912909,598,130
3156098708,3209544947,1658627363,1658627972,609,667
3406042920,3997312356,1645117056,1645117753,697,1037
3855521057,3949841652,1661124858,1661125222,364,1212
3500455630,3722859316,1650007228,1650008020,792,1444
3012034151,3901026791,1658756600,1658757212,612,117
3781537659,3076307729,1653256481,1653256838,357,1875
3295146156,3002396640,1666111737,1666112547,810,1488
3890335277,3790751649,1647171283,1647171398,115,98
3281597338,3250867562,1644465104,1644465492,388,566
3642771281,3198999623,1652199265,1652199948,683,2143
3634010080,3049913617,1644313832,1644314722,890,1962
3375404573,3492134379,1660564139,1660564541,402,931
3112960048,3622478840,1644929721,1644929948,227,1822
3217583205,3003005378,1655629376,1655630230,854,1643
3414026708,3619704547,1659882944,1659883311,367,934
3932002704,3719124928,1644453392,1644453467,75,1632
3321202962,3784414098,1656311249,1656312067,818,975
3027110508,3799287196,1665254882,1665255362,480,965
3712443558,3279454391,1643007825,1643008681,856,2491
3356883463,3688300477,1648623728,1648624371,643,1927
3353527086,3936821313,1659652473,1659653203,730,1502
3523654557,3170740142,1662299582,1662300320,738,366
3018325807,3385183586,1647335349,1647335632,283,1408
3346631744,3319334426,1655347034,1655347168,134,1775
3663474230,3494544431,1662390142,1662390605,463,1634
3852834619,3486061006,1652603667,1652604329,662,1122
3584660761,3181578884,1664882485,1664882578,93,539
3409050239,3466642935,1649242517,1649242983,466,1171
3658423327,3711016575,1664509223,1664510036,813,33
3690657404,3207801201,1664840006,1664840994,988,2070
3785586097,3837550746,1652859674,1652859817,143,1304
3825930964,3147047674,1652553133,1652553490,357,241
3804914454,3813318946,1666400548,1666400824,276,1926
3550741990,3077590635,1658627656,1658627697,41,575
3623294630,3973264936,1666270217,1666270270,53,1329
3808397193,3987510303,1644353253,1644354204,951,207
3856882586,3045127324,1641151529,1641151908,379,1758
3982960576,3162939277,1661424127,1661424190,63,1811
3489473144,3393406422,1646434000,1646434262,262,1364
3998728915,3443084089,1655008119,1655008284,165,756
3209464030,3868116298,1666811820,1666812108,288,418
3592471391,3630448266,1660484577,1660484783,206,1457
3573969593,3521160717,1651769318,1651769747,429,724
3941317555,3700419429,1652713993,1652714726,733,154
3268745445,3222749852,1647818765,1647818902,137,2201
3609310097,3723944830,1668445627,1668446176,549,2194
3327166880,3413319616,1644901762,1644902482,720,1308
3650471605,3710708040,1643723504,1643724186,682,983
3868474839,3848607936,1648180990,1648181676,686,526
3192612662,3295352365,1662721692,1662722530,838,551
3222749852,3126653341,1659375460,1659376066,606,1724
3611062566,3253931464,1661969066,1661970014,948,1081
3498466937,3011981503,1654448953,1654449294,341,2197
3357478199,3933450798,1663892484,1663893176,692,1836
3280328195,3761142574,1665957415,1665958018,603,1965
3669880471,3881861537,1648626914,1648627574,660,682
3003422357,3215870665,1662206567,1662207107,540,1974
3363733362,3830408109,1654470207,1654470499,292,191
3634999231,3636528701,1650611334,1650611913,579,239
3604881190,3012930953,1650511030,1650511260,230,593
3512935575,3335976452,1659730506,1659730790,284,1755
3624911947,3452391459,1644247711,1644248517,806,2216
3347317107,3641752896,1669292555,1669292816,261,1093
3895332326,3287901684,1647024124,1647024566,442,633
3382133724,3720223108,1667446660,1667446812,152,773
3174722772,3118443532,1664561817,1664562545,728,2097
3064701445,3821180393,1662170614,1662170758,144,987
3440324329,3697322167,1646998115,1646998330,215,474
3446812207,3505197900,1661064370,1661064707,337,332
3623206706,3722569299,1645013202,1645014012,810,325
3059491889,3102820806,1665734336,1665734980,644,1933
3648370843,3076767349,1667909512,1667910339,827,882
3095661205,3461108375,1646438102,1646439090,988,613
3532190519,3641618845,1645446135,1645446227,92,529
3331255997,3249759052,1657223538,1657224242,704,2389
3798833025,3903978752,1658565452,1658565504,52,1486
3731399462,3948942044,1657314817,1657315058,241,2068
3154551351,3202225412,1664606141,1664606294,153,74
3298879351,3284838720,1663641877,1663642657,780,1172
3656865344,3218738751,1658392893,1658393776,883,891
3839967647,3814588354,1664671514,1664671835,321,1342
3378162995,3409332035,1648052217,1648052414,197,2236
3790157838,3156210736,1645775641,1645776190,549,1501
3283056652,3067229796,1658674601,1658675246,645,674
3208220195,3898188404,1644927174,1644928107,933,628
3011861880,3636808827,1641361464,1641362100,636,2164
3114605564,3717137928,1659954314,1659954858,544,888
3740051209,3138411685,1649508871,1649509833,962,1399
3913645530,3463032893,1668285596,1668285679,83,1187
3612649935,3639695113,1651623367,1651623649,282,945
3760047951,3829856490,1655693972,1655694200,228,969
3854184537,3206422081,1658811271,1658811680,409,2077
3855013110,3618397647,1647838740,1647839330,590,1230
3500320805,3294478149,1651390862,1651391143,281,1748
3123999917,3106437492,1664342543,1664343041,498,140
3814278185,3556647439,1655381046,1655381478,432,1376
3696947299,3710844932,1650571482,1650572377,895,314
3557791528,3193830008,1642416414,1642416797,383,767
3676352528,3130134092,1649385899,1649385940,41,476
3095661205,3469583371,1660879673,1660880404,731,308
3352389016,3616803531,1649506754,1649507158,404,1818
3585495750,3358277498,1646782927,1646783366,439,1374
3455209070,3164467795,1664124292,1664125115,823,2308
3060883368,3383110959,1646916160,1646916437,277,1017
3254496907,3872928406,1655477064,1655477760,696,474
3621969167,3322287315,1658454642,1658455095,453,1354
3052438592,3129138715,1667273392,1667273540,148,1390
3990233750,3645860854,1658398900,1658399653,753,2398
3084007689,3516488694,1663116574,1663116597,23,1982
3570872297,3254030842,1661678362,1661678497,135,699
3856386170,3002013720,1668705248,1668705273,25,442
3253568318,3062423981,1666659145,1666659296,151,1710
3744575844,3957053810,1652026939,1652027727,788,1338
3036953061,3122109326,1644906845,1644907818,973,2360
3689828648,3038424212,1647202473,1647203273,800,2313
3191414403,3116281998,1641534524,1641535430,906,2389
3342054027,3351786927,1645728100,1645728337,237,1127
3990870728,3622230392,1659808719,1659809671,952,602
3804257503,3653183152,1660936953,1660937333,380,1948
3531859919,3172352127,1664023113,1664023181,68,603
3911960681,3324003851,1666548930,1666549542,612,2471
3533290388,3878925459,1662227587,1662227643,56,1049
3550516008,3573692342,1644243188,1644243205,17,56
3162844882,3108427765,1647029190,1647030164,974,363
3327504995,3763912599,1654675109,1654675691,582,921
3861652282,3178981589,1648016756,1648017264,508,1306
3566936390,3799014776,1663287890,1663288490,600,2232
3086950119,3783515345,1651776593,1651776789,196,3
3959408689,3761201412,1646034389,1646034735,346,2035
3348282881,3172619193,1660652419,1660653040,621,210
3114863942,3052875832,1654197297,1654197616,319,1589
3683460040,3185558387,1655951202,1655951937,735,520
3073762858,3223313152,1660605251,1660605853,602,1172
3391037775,3958507465,1646049754,1646050739,985,1726
3033523546,3895990286,1665722471,1665722752,281,277
3813511439,3618313240,1648329606,1648329682,76,1069
3947879014,3288529545,1649946341,1649946868,527,103
3870998298,3595560993,1661195416,1661196062,646,2460
3572214339,3762525964,1666899375,1666899865,490,1841
3309219121,3533274758,1648721078,1648721749,671,1920
3143226144,3034440971,1658577247,1658577716,469,86
3329135548,3412307376,1662674281,1662675227,946,860
3615177362,3473037406,1664441239,1664442162,923,1701
3426617058,3204359619,1645976107,1645976982,875,353
3310523513,3264879958,1650546542,1650547287,745,1871
3656674833,3584139105,1664168475,1664169013,538,1626
3142106289,3389097842,1661518315,1661519209,894,1546
3356034290,3194204306,1650716129,1650716567,438,73
3039544352,3346948485,1658924298,1658925291,993,717
3328544337,3986311619,1649450190,1649450220,30,1656
3410150990,3670158499,1649944352,1649945201,849,1905
3309799085,3142274869,1653029599,1653030552,953,2137
3990949387,3539866422,1665372618,1665372723,105,312
3206386504,3025108334,1667072113,1667072504,391,386
3281923852,3639035607,1649078245,1649078497,252,2175
3000011580,3746155501,1661080308,1661081008,700,748
3164702890,3800201060,1667282937,1667283713,776,1460
3849902434,3703615574,1641898490,1641899323,833,1508
3551371020,3841318125,1655380333,1655380403,70,1799
3057574793,3708809295,1650831221,1650831729,508,794
3967147343,3666072303,1662091165,1662091314,149,1831
3571793713,3257947713,1665831814,1665832569,755,1432
3773408264,3146634302,1661268738,1661268820,82,2469
3867640062,3132863382,1660252396,1660253244,848,785
3269763687,3885084129,1664458595,1664459473,878,598
3210036729,3138539283,1653438435,1653438700,265,339
3202783831,3684537058,1647286799,1647287600,801,951
3514894244,3791510494,1664024206,1664025010,804,927
3900876329,3202460554,1652262941,1652263626,685,1783
3981932099,3639659256,1663337394,1663337494,100,2210
3691607111,3635616513,1668760776,1668761572,796,2105
3177427428,3439510951,1665802711,1665802936,225,2412
3464734783,3426666423,1667271126,1667272121,995,2468
3740438273,3975405530,1655541469,1655541743,274,2027
3056726479,3200646968,1665108670,1665109600,930,2125
3108805085,3331539245,1664594350,1664594671,321,256
3347854994,3128532251,1644072564,1644073383,819,1395
3355135607,3042034210,1647872042,1647872717,675,1387
3955307397,3206061644,1647645550,1647646505,955,2436
3092564684,3598522904,1657650279,1657650871,592,236
3834160941,3093523046,1652209106,1652209802,696,2322
3388159268,3651535646,1667631943,1667632415,472,24
3633856416,3364911803,1663619318,1663619659,341,1112
3069818047,3079038995,1657234541,1657234936,395,2086
3625869317,3172310061,1647912370,1647913103,733,2365
3052396813,3750765878,1641728371,1641729133,762,424
3499541432,3210986714,1660575584,1660576433,849,1704
3439303987,3591101388,1645975602,1645976214,612,82
3276666399,3786924052,1646188735,1646189379,644,793
3279370751,3028063669,1641585899,1641585936,37,1831
3821998886,3915111520,1653914326,1653915016,690,1532
3007911826,3574985668,1645010681,1645010979,298,2230
3075519908,3002876565,1651319306,1651320136,830,183
3288261603,3626505512,1658583557,1658584331,774,492
3143318519,3040867771,1657150897,1657151507,610,58
3453736515,3357403419,1667171382,1667171991,609,1769
3577216621,3442725932,1666707624,1666707703,79,2060
3665557228,3834401696,1669455622,1669456593,971,1438
3003022656,3322801895,1661125182,1661125565,383,917
3834174227,3746243275,1641954548,1641955002,454,1501
3667414511,3390416640,1652827751,1652827780,29,484
3392293203,3854906546,1643915838,1643915877,39,1806
3223159718,3747907269,1662954194,1662954345,151,730
3312930717,3773996198,1646287164,1646287516,352,852
3424211722,3031209415,1657897167,1657897284,117,2453
3882030333,3537443088,1647408530,1647408809,279,1097
3429887771,3486059916,1642662061,1642662063,2,1521
3296531648,3620787716,1657890318,1657891231,913,11
3856882586,3612612273,1651036017,1651036071,54,624
3307305290,3438130685,1652045616,1652046089,473,851
3435224460,3476728930,1643008646,1643008721,75,1411
3321202962,3241425701,1665071430,1665072208,778,923
3113251460,3454546723,1662449691,1662450222,531,1633
3413781764,3135579253,1655338302,1655338831,529,2448
3337108824,3504919226,1648480018,1648480030,12,460
3065216937,3792924517,1667063929,1667064319,390,1338
3146634302,3143689256,1665473903,1665474812,909,1978
3409662195,3897421758,1648331626,1648332445,819,821
3922675517,3546943801,1666524643,1666524761,118,1077
3037042091,3804328787,1644001698,1644002266,568,878
3036194601,3867857893,1642116793,1642117142,349,98
3294984880,3105449263,1661437559,1661438067,508,169
3772853715,3677965553,1657069902,1657070375,473,1881
3597904540,3671699977,1668169279,1668169720,441,730
3284550954,3029451399,1650177171,1650177926,755,244
3410972917,3840416991,1645880102,1645880943,841,283
3282425868,3809642935,1651632444,1651633254,810,1303
3030630339,3242088486,1647954627,1647955049,422,655
3800566657,3399055713,1656078807,1656078994,187,2407
3761587047,3442209140,1645878401,1645878499,98,1172
3734534401,3765617850,1658453685,1658454160,475,277
3568965374,3497045946,1652439017,1652439162,145,115
3683326795,3250786481,1659143393,1659143758,365,2497
3039106188,3290359932,1666683534,1666684053,519,2254
3197362399,3663155034,1643508333,1643509174,841,2255
3710422072,3802040767,1641103385,1641103826,441,903
3764492400,3661559275,1654933304,1654933938,634,1316
3521944506,3234559565,1657198287,1657199019,732,2160
3756028002,3967439884,1661122350,1661122475,125,1584
3620395885,3776398060,1654181203,1654182035,832,1687
3283171763,3323109920,1645047285,1645047825,540,2021
3891400237,3318594125,1641231162,1641231261,99,301
3543150979,3694762938,1657668122,1657668620,498,2062
3462483679,3791107997,1645913805,1645914777,972,158
3671748544,3346288809,1651804946,1651805002,56,2476
3285757325,3349692109,1664243455,1664244370,915,2401
3047400344,3135211724,1644596022,1644596542,520,1113
3550889203,3786840082,1659650623,1659651060,437,2248
3795264165,3664408598,1648300472,1648300498,26,1383
3513847916,3716461226,1655276523,1655277449,926,558
3776685300,3423522480,1660774819,1660775148,329,79
3680060067,3797484306,1665866791,1665866999,208,11
3092365114,3231501792,1651383878,1651384693,815,1342
3857211245,3965629952,1641214686,1641215646,960,1359
3973264936,3406215034,1663921138,1663921368,230,1662
3889126069,3787550831,1646636473,1646636703,230,82
3992571464,3037846389,1641424248,1641424338,90,399
3006507589,3264148498,1655928285,1655928645,360,542
3375769320,3799036179,1658705407,1658706156,749,914
3074269946,3930794939,1656685843,1656686394,551,1602
3880580622,3465500045,1649873993,1649874833,840,1673
3055211808,3317431311,1644229333,1644229675,342,198
3178529360,3152795421,1647994855,1647995846,991,1807
3707476548,3289153734,1654715787,1654716282,495,1285
3563428558,3416230781,1654246744,1654246883,139,1576
3024268753,3691032308,1643628613,1643629146,533,1953
3130434426,3618313240,1665749577,1665749722,145,266
3272623699,3608200385,1655720035,1655720170,135,1251
3564839908,3268216928,1659774245,1659775026,781,336
3359601528,3095743155,1668111945,1668112502,557,76
3378791519,3097489594,1652466178,1652466519,341,1346
3611100286,3653069495,1669358500,1669358663,163,1330
3553467860,3186787984,1648574375,1648574817,442,332
3129993467,3831660488,1665933221,1665933265,44,643
3129176226,3493138014,1658286623,1658287224,601,54
3332592315,3006508919,1641975026,1641975737,711,121
3564667780,3517541359,1644195459,1644195894,435,1584
3906024837,3863676573,1651241098,1651241911,813,825
3727131221,3049727234,1659531244,1659531408,164,263
3881482215,3997810649,1649539567,1649539788,221,1402
3657587705,3777022057,1651649827,1651650738,911,2257
3367279073,3350566867,1646940832,1646941635,803,180
3557791528,3231496949,1647290803,1647291667,864,2357
3514354263,3882748527,1661368653,1661368668,15,551
3727995134,3930909418,1647227297,1647227332,35,178
3963257683,3739613077,1653569628,1653569823,195,363
3354055639,3877205464,1648015175,1648015182,7,1149
3006603067,3109980927,1645660664,1645661648,984,97
3371818930,3737153063,1661823840,1661824003,163,412
3785721693,3241425701,1656867816,1656868556,740,90
3258926142,3783119155,1648701434,1648701847,413,2035
3011686027,3124321462,1650649089,1650649308,219,1622
3140682569,3953118937,1651917419,1651918233,814,2473
3371970996,3272250396,1653109597,1653110082,485,1272
3137594486,3742275397,1655276134,1655276645,511,2195
3538466951,3390441234,1656507098,1656507512,414,281
3179891006,3095594016,1652392897,1652393290,393,1043
3162641272,3913905115,1660367461,1660368294,833,1570
3167737446,3889537515,1653895223,1653895598,375,2374
3984818292,3835036552,1661365202,1661365831,629,1977
3928290954,3650041115,1641781351,1641782342,991,1896
3469812263,3355266666,1646274255,1646275156,901,1373
3649036403,3917500425,1653635919,1653636763,844,1199
3501729913,3184455755,1649675936,1649676393,457,1215
3199288675,3028910693,1645804715,1645804946,231,1894
3122288373,3245491745,1663497234,1663497237,3,2030
3986081370,3393501277,1661858727,1661859344,617,681
3300983140,3542129823,1656969312,1656969869,557,2272
3562456307,3028267408,1643023389,1643023599,210,2439
3926815435,3946015739,1641466982,1641467491,509,1119
3669018473,3789279639,1649341098,1649341815,717,1960
3095932716,3774264905,1641911976,1641912544,568,1628
3464653044,3695237310,1650557646,1650557709,63,65
3884959127,3163708045,1645217440,1645217483,43,1075
3740009683,3441581446,1646346969,1646347115,146,1608
3668491789,3215443177,1656081031,1656081286,255,1469
3191792012,3262845808,1650902484,1650902937,453,1277
3625179175,3709681519,1669131284,1669132243,959,164
3207283619,3632283664,1641161123,1641161191,68,1127
3095430228,3485695895,1663922600,1663922894,294,684
3639659256,3027870588,1651641079,1651642057,978,338
3331882759,3925523737,1657279425,1657279845,420,2216
3631152825,3402349073,1665981123,1665981254,131,1944
3952425376,3768211591,1668806863,1668807500,637,2058
3025581381,3201068600,1643318397,1643319016,619,344
3879001343,3932161358,1650343356,1650343706,350,1581
3257821708,3039106188,1653638182,1653638779,597,2078
3525088003,3796255141,1664023809,1664024272,463,2436
3228497776,3636001595,1657858814,1657858954,140,1864
3461263871,3995358434,1642811998,1642812325,327,46
3186483050,3906903088,1668454860,1668455070,210,312
3070557341,3993332175,1666980790,1666981021,231,2448
3534223960,3292454121,1661785958,1661786602,644,1789
3181578884,3537915144,1641977458,1641977510,52,1377
3393528919,3253395374,1658311246,1658311327,81,1523
3183672525,3903709933,1657153537,1657153787,250,830
3910029798,3486208738,1645608361,1645608390,29,99
3437254567,3742746848,1644783827,1644784027,200,1209
3675359399,3515856480,1641899502,1641900419,917,1932
3539402223,3404317985,1642336286,1642336564,278,1809
3328471090,3105946115,1646081036,1646081783,747,2353
3583591867,3419783275,1665907743,1665907862,119,294
3574708692,3586776572,1650343360,1650343927,567,1714
3257080734,3177915558,1668451554,1668452337,783,1499
3579486534,3963515530,1659202706,1659203309,603,1031
3437707461,3962536480,1650629775,1650630050,275,174
3520872962,3657699213,1643352004,1643352254,250,242
3799117805,3804094924,1665686010,1665686168,158,139
3797182963,3393314546,1650669681,1650670104,423,2397
3260695363,3400397224,1663316697,1663316787,90,525
3848936636,3340933137,1665539815,1665540296,481,2241
3692441467,3929794333,1668458665,1668458830,165,873
3732796331,3785222888,1669283808,1669284233,425,1980
3987860424,3133655192,1646385620,1646385723,103,2345
3156538951,3596883607,1658205561,1658205904,343,2347
3778587500,3994348053,1657006253,1657006345,92,897
3824625919,3922675517,1643852671,1643853181,510,808
3558517913,3107541952,1656216472,1656216712,240,1886
3513349474,3855548589,1645841121,1645841521,400,785
3359901981,3372471333,1658186494,1658187288,794,1629
3414834461,3649036403,1641832561,1641833236,675,2134
3763991129,3090354216,1659154728,1659155067,339,278
3346978275,3174658362,1667478731,1667479603,872,687
3208464777,3329253794,1662877798,1662877991,193,2125
3962784099,3277577090,1667850649,1667850693,44,840
3890580849,3307251676,1647336008,1647336095,87,673
3959408689,3068661794,1661416506,1661417337,831,138
3263350346,3623936873,1654479390,1654480240,850,2147
3067641822,3867640062,1644357974,1644358296,322,1184
3256566881,3862583365,1647724191,1647725023,832,1811
3069431080,3095621927,1651304591,1651305488,897,1736
3204083684,3384307655,1645827342,1645828237,895,251
3955219063,3994383813,1648150839,1648151764,925,1130
3028364856,3338715388,1650442165,1650442399,234,1592
3682747704,3124147703,1662328520,1662329216,696,1509
3572594221,3650041115,1651269473,1651269563,90,1214
3561899633,3258098890,1643077844,1643078204,360,2339
3474975781,3656175066,1669616054,1669616213,159,503
3342315965,3445558523,1648604764,1648605373,609,1043
3698025795,3676634608,1656143642,1656143722,80,1474
3727020814,3957689713,1657455544,1657456246,702,427
3821594953,3911849911,1664059501,1664060060,559,1850
3711442352,3984259471,1665412134,1665412257,123,1858
3635988688,3098422570,1665018134,1665018329,195,990
3692095834,3983166385,1668097849,1668098849,1000,2175
3819235768,3808952164,1664102569,1664103530,961,2403
3643173963,3046127876,1662614122,1662614650,528,504
3101460702,3332721407,1641182547,1641183140,593,1466
3059068631,3160349110,1646039773,1646040682,909,1986
3786516095,3985418000,1650044125,1650045077,952,527
3410258020,3658782272,1644293000,1644293224,224,2069
3878083942,3443084089,1661343396,1661343734,338,1629
3699427202,3821594953,1661489011,1661489301,290,1469
3608893234,3779998740,1656545358,1656545925,567,589
3452258976,3861123581,1642067074,1642067422,348,448
3033523546,3641185549,1668951405,1668951851,446,928
3828890005,3973440480,1641734444,1641734784,340,2252
3678152024,3239575265,1656175000,1656175919,919,1621
3716257088,3299840986,1669462151,1669462558,407,972
3761584126,3069746677,1668905402,1668905884,482,2046
3432910993,3928235124,1659256913,1659257484,571,1904
3740284866,3643372353,1667295341,1667296053,712,648
3923907099,3787920743,1647777371,1647777897,526,1217
3181047536,3917229175,1654796337,1654797022,685,1997
3611139716,3486793392,1652392277,1652392840,563,1837
3172305265,3569051470,1647264188,1647264787,599,398
3977495302,3300063136,1653400419,1653400888,469,981
3526088150,3351921075,1646268347,1646268971,624,1433
3827891957,3640387984,1646351102,1646351640,538,1228
3396154732,3333347852,1663528681,1663529596,915,1537
3545032372,3634539557,1668755378,1668755836,458,2036
3708654413,3690518174,1656127981,1656128902,921,2317
3486286893,3462862340,1642092401,1642093001,600,328
3787058440,3890852478,1647735734,1647736359,625,1354
3329825235,3602829591,1652344629,1652345565,936,667
3110339164,3361016803,1648059124,1648059624,500,427
3720381616,3163662966,1656030896,1656031823,927,332
3301471485,3855476133,1651903720,1651904522,802,1285
3312203382,3809623566,1642787142,1642788018,876,61
3542293606,3298879351,1644900981,1644901278,297,2265
3388218000,3710708040,1648574101,1648575050,949,60
3150027454,3794548376,1664566531,1664567142,611,1358
3720475877,3327311623,1641367865,1641368201,336,1601
3819415032,3128532251,1659792954,1659793495,541,1164
3131683456,3924167113,1662986271,1662986482,211,228
3723780339,3294984880,1663002633,1663003357,724,130
3648263372,3299389436,1658599017,1658599654,637,1426
3561881366,3029849131,1647838273,1647839029,756,2472
3633479779,3967727550,1648706276,1648707038,762,438
3007328261,3068982966,1641214107,1641214554,447,1351
3959651432,3264081641,1660502895,1660503072,177,2197
3224095644,3952389962,1653095595,1653095943,348,1013
3981273706,3530162623,1669746004,1669746015,11,1183
3303973335,3994913668,1655634886,1655634896,10,1021
3405373154,3626457002,1660606350,1660606520,170,1464
3343153937,3498466937,1643259276,1643260202,926,2104
3184000585,3052681277,1641297869,1641298417,548,2143
3166492454,3026769225,1668773192,1668773823,631,1455
3813511439,3959383415,1645202988,1645203768,780,1853
3249705811,3426666423,1650649660,1650650250,590,1368
3014511835,3128529900,1658607411,1658608352,941,61
3832640445,3802749978,1649910182,1649910732,550,2248
3281061177,3962695354,1653402007,1653402387,380,1815
3878083942,3431283022,1667756481,1667757154,673,1124
3809965750,3431283022,1667792176,1667792364,188,372
3064574238,3753391012,1642406687,1642407394,707,1251
3102588374,3400604704,1644892815,1644893284,469,405
3425490548,3629412022,1642277061,1642278005,944,1712
3206399216,3105789496,1655453718,1655453823,105,1628
3308028752,3334792271,1645686907,1645687552,645,2382
3271318708,3059322626,1654681244,1654681553,309,717
3019204329,3543696190,1652831057,1652831616,559,627
3647263296,3911849911,1661652316,1661653127,811,2133
3882415224,3087326516,1644926354,1644927017,663,1958
3748511559,3911364139,1641868751,1641869747,996,1438
3418276734,3156261740,1664788561,1664788836,275,733
3031103174,3575512492,1644926120,1644926844,724,1021
3598665921,3679519826,1643099732,1643100211,479,1788
3819791378,3668441547,1655219146,1655220020,874,1649
3982960576,3623685885,1667503009,1667503895,886,2319
3640585545,3969435749,1657315248,1657315736,488,1740
3965000413,3974804920,1655114608,1655114640,32,1824
3814588354,3157965235,1644815477,1644815592,115,1446
3879898101,3903709933,1652666589,1652667045,456,280
3665798527,3254866960,1666739828,1666740267,439,115
3290844621,3836565798,1653195889,1653196668,779,928
3226234284,3838082378,1669642515,1669642590,75,1912
3883703576,3260802289,1656556517,1656556751,234,500
3401957566,3840155828,1669202022,1669202123,101,2493
3622656083,3281597338,1658605554,1658606157,603,1939
3232794733,3948769271,1663374304,1663374967,663,1101
3719744431,3342708435,1658191576,1658192267,691,409
3949713678,3396149289,1647432735,1647433236,501,373
3425815854,3096274177,1656993711,1656994470,759,1006
3061366261,3379296882,1642422232,1642422766,534,300
3400154631,3782182063,1664039227,1664040128,901,27
3311329069,3597459911,1660601549,1660601600,51,1658
3614741796,3462280366,1647917309,1647917675,366,1975
3651900802,3826737259,1659437049,1659437101,52,1935
3213115605,3778625091,1657852828,1657853231,403,1597
3635052101,3246028948,1645328616,1645329055,439,2364
3349870020,3366262960,1667869211,1667869785,574,1182
3118057575,3010649870,1657446658,1657447352,694,1592
3446987671,3398257086,1665436890,1665437125,235,409
3939480099,3907213401,1669160687,1669160998,311,752
3265324040,3925239812,1668457633,1668458252,619,1739
3373962186,3929975862,1665837588,1665837590,2,605
3408115806,3585526520,1662558611,1662558831,220,1829
3058846696,3069818047,1669732031,1669732981,950,612
3954434825,3952283751,1654257470,1654257478,8,2356
3306457934,3119702215,1669276392,1669276894,502,1962
3750083020,3625950355,1666001805,1666002312,507,2262
3331882759,3202783831,1652644491,1652645087,596,1942
3991727598,3483827042,1643298361,1643299112,751,931
3401382792,3086076310,1657734969,1657735016,47,1831
3556456137,3800271865,1661239175,1661240040,865,1709
3148549210,3198654347,1645930948,1645931221,273,891
3532634291,3205359825,1643343757,1643344062,305,320
3814355412,3814608487,1669078542,1669079462,920,1280
3021320868,3106395050,1646682421,1646682612,191,1120
3872170030,3390416640,1666002807,1666003464,657,747
3460047535,3351145248,1645158010,1645158800,790,2087
3072720499,3951845301,1655795679,1655795940,261,795
3506090868,3956394849,1644804393,1644804822,429,2199
3233375810,3891850013,1662632044,1662632646,602,564
3391324219,3984570592,1657382304,1657383003,699,1337
3137412000,3464983756,1665950489,1665950707,218,1923
3346012606,3267600229,1641715004,1641715783,779,2233
3911439857,3478741068,1659485037,1659485583,546,1067
3960417596,3985879853,1668123769,1668124724,955,1405
3775146250,3478280943,1644559156,1644559568,412,865
3407322181,3661372760,1655208786,1655208941,155,1648
3174639274,3503394389,1644439276,1644440120,844,1263
3382840804,3505789435,1653521276,1653521292,16,35
3235992794,3807538433,1641869491,1641870363,872,137
3032018734,3681498352,1658022787,1658022934,147,520
3072599295,3235476099,1668057727,1668057741,14,83
3048296949,3515837186,1669552725,1669553701,976,1716
3774413169,3484634326,1660024750,1660025507,757,1366
3478404891,3472706088,1668524071,1668524738,667,2384
3584402021,3292172583,1652023511,1652023565,54,622
3060728062,3740274448,1653890370,1653891116,746,2011
3413300274,3210036729,1647213149,1647213872,723,1639
3693920569,3071322324,1641404961,1641405044,83,1790
3785586097,3536219260,1668864678,1668865459,781,1264
3925754107,3623936873,1645600642,1645601160,518,484
3273379502,3343941091,1656633668,1656634251,583,528
3582076532,3038244365,1655497673,1655498143,470,141
3293339453,3023140319,1667132342,1667132672,330,1995
3548670552,3603399306,1665701308,1665702223,915,1969
3748110496,3209462413,1642760278,1642760413,135,1985
3938583443,3711589639,1645703704,1645703762,58,314
3387247558,3734893217,1664030985,1664031545,560,1939
3857687791,3948515015,1643465134,1643465429,295,2174
3737809844,3994913668,1645472885,1645473634,749,1981
3405799068,3787920743,1665407902,1665408204,302,1983
3218738751,3460572652,1658076807,1658077552,745,1356
3284838720,3003641311,1653592234,1653592625,391,1496
3225616352,3658477943,1667994060,1667994323,263,1682
3636621583,3485298583,1665675357,1665676350,993,316
3112602434,3070117232,1655767253,1655767527,274,2340
3508809990,3038529026,1646111480,1646111603,123,388
3862138776,3729820423,1652479103,1652479174,71,63
3277327180,3871180604,1641342313,1641342957,644,1707
3945358150,3901902653,1652921364,1652921377,13,2021
3048497124,3547072063,1665622926,1665623039,113,1754
3844348081,3586776572,1659440109,1659440731,622,1223
3325735696,3012119082,1654201964,1654202754,790,276
3840003483,3914796719,1660594605,1660594909,304,583
3292797747,3651098556,1663067887,1663068548,661,985
3651803323,3464330947,1653979499,1653980364,865,389
3885087517,3165039316,1642406134,1642407089,955,464
3372544937,3878943307,1644993591,1644994332,741,16
3708032127,3787654868,1667033636,1667034620,984,665
3312336013,3418338710,1645195890,1645196805,915,208
3351218513,3792834070,1662101183,1662101618,435,761
3753180150,3437254567,1651731596,1651732374,778,1224
3972917056,3413984037,1666130400,1666131395,995,569
3887519119,3901902653,1655768363,1655768809,446,2098
3906308749,3008062664,1653979806,1653980221,415,1668
3132959520,3952283751,1652573208,1652574158,950,1755
3563246157,3437122732,1649939866,1649940659,793,1895
3534200501,3649774117,1665813992,1665814562,570,456
3710043628,3242785599,1666981776,1666982586,810,2471
3323109920,3795934256,1664016111,1664016711,600,2307
3360575138,3050701199,1646339383,1646339789,406,265
3798597128,3929638122,1654182859,1654183855,996,2423
3661135703,3243840165,1656964694,1656965397,703,2279
3276576100,3037844343,1646349353,1646350046,693,366
3108500091,3760432849,1645828896,1645829050,154,1698
3246260241,3097501233,1643905663,1643906595,932,251
3361422449,3936468941,1666724871,1666725285,414,288
3173230685,3244514632,1663663298,1663664198,900,1090
3365829981,3522715448,1647808031,1647808304,273,1593
3200059644,3378522829,1667677692,1667678642,950,906
3590831664,3898495918,1658120959,1658121236,277,1130
3132863382,3439700326,1658702553,1658703085,532,2043
3823962241,3825824228,1660364957,1660365709,752,2211
3583585259,3248167631,1646313807,1646313847,40,2420
3933940005,3881578299,1643468901,1643469291,390,226
3645666563,3457361080,1653630321,1653630609,288,1080
3918234060,3970653700,1658302472,1658303397,925,432
3871971681,3977008878,1660584582,1660584701,119,1702
3195598526,3595499905,1644700694,1644701547,853,646
3135712818,3687215472,1658205061,1658205797,736,2069
3482235012,3948754212,1652369561,1652370074,513,848
3897756969,3240037909,1659653221,1659653240,19,72
3037279735,3325334543,1642519286,1642519801,515,1198
3980867331,3763912599,1668450365,1668450755,390,2469
3249916829,3070087815,1649102632,1649103010,378,290
3554089401,3771931468,1641319315,1641319357,42,888
3105250340,3678152024,1669574595,1669575260,665,1059
3656175066,3832243899,1644731145,1644731628,483,1217
3752858965,3040867771,1668728461,1668729038,577,416
3622933919,3790298140,1667481083,1667481691,608,840
3432899117,3836089663,1645003003,1645003109,106,647
3786478382,3532190519,1642950867,1642951457,590,433
3972195042,3750123961,1663399637,1663400433,796,1724
3352262794,3411340387,1648175383,1648175893,510,755
3319422840,3014354609,1660089964,1660089964,0,447
3448203668,3793232281,1647125710,1647126710,1000,2044
3385183586,3516089114,1652017914,1652018406,492,475
3570955260,3640010781,1657030213,1657030845,632,469
3825036404,3256231811,1667522352,1667522647,295,1154
3424994271,3944247629,1660521396,1660522223,827,1503
3069523420,3647480411,1642570852,1642571063,211,870
3128401376,3321835417,1667992924,1667993723,799,1779
3727020814,3654841867,1649116973,1649117883,910,1885
3802614854,3959261742,1658972323,1658973161,838,840
3260867614,3816935536,1662913124,1662913826,702,2236
3710318693,3177943874,1665632376,1665633073,697,1344
3103728720,3580178697,1664189196,1664190166,970,1835
3081188307,3316398180,1663185935,1663186777,842,205
3432209746,3438084709,1657097158,1657097867,709,1189
3547334414,3460027343,1647708357,1647708820,463,1525
3821979869,3288529545,1661793482,1661793894,412,552
3319546209,3830541998,1642736301,1642737042,741,460
3561573044,3918491301,1646631018,1646631149,131,2436
3919196366,3721541321,1655332890,1655333277,387,2058
3011690678,3446952845,1643406757,1643407044,287,657
3042052031,3452275962,1644125718,1644125972,254,40
3447326124,3678624517,1660420888,1660421249,361,2461
3085412399,3352376449,1650268689,1650268775,86,718
3893671286,3569743064,1646442038,1646442385,347,965
3694591547,3683134571,1661038616,1661039243,627,2308
3079137127,3817000379,1652566835,1652567058,223,1218
3311015405,3644961840,1643522492,1643523117,625,707
3184178717,3382856674,1668057887,1668058072,185,2156
3813921952,3639035607,1668893618,1668894477,859,2318
3088553332,3409962434,1661566778,1661567689,911,2298
3942273552,3289108426,1643652252,1643652314,62,514
3254181971,3913994422,1669434605,1669435345,740,426
3489811088,3994577207,1662077493,1662077894,401,231
3069431080,3727618645,1648555420,1648556350,930,1136
3297123407,3473399101,1656036143,1656037011,868,1858
3060121211,3429328367,1653609456,1653609665,209,1920
3233536885,3510761729,1654786705,1654787012,307,2117
3172305265,3640745969,1647191998,1647192746,748,1585
3467233007,3970886019,1667715964,1667716815,851,1265
3366354894,3922423821,1651600449,1651601287,838,1987
3021320868,3781580109,1666469840,1666470657,817,2262
3797259426,3080734335,1649345448,1649346171,723,1570
3254174311,3267319115,1657896702,1657897343,641,2221
3607393629,3915986965,1669030438,1669031196,758,2484
3521217476,3630012590,1661524830,1661525573,743,1032
3286476251,3080679691,1643999349,1644000113,764,2130
3744293001,3311860866,1666971565,1666972505,940,1587
3572018229,3486606390,1645543614,1645544405,791,1817
3722483331,3307393195,1641437238,1641437433,195,347
3972294801,3148256129,1648588292,1648588599,307,503
3930852270,3304490341,1650865689,1650866405,716,1524
3337624186,3300015174,1644250980,1644251742,762,12
3311860866,3180534430,1660597292,1660597658,366,1763
3335976452,3639117164,1651386249,1651386659,410,2259
3607608267,3609804397,1653359662,1653360615,953,1780
3613801852,3397376963,1656690251,1656690819,568,1597
3445031830,3520699413,1645741389,1645742344,955,2382
3549482615,3482826953,1657455395,1657455665,270,1026
3244599174,3454554705,1653574232,1653574535,303,2380
3153902371,3641682706,1645620621,1645620625,4,699
3723780339,3501308694,1667347880,1667348789,909,1443
3198195956,3343059553,1667963245,1667964173,928,854
3149688689,3886184659,1656566455,1656566998,543,260
3331426472,3371430360,1647804582,1647805134,552,869
3106328456,3174373725,1648676144,1648677003,859,1489
3896982954,3378864156,1662490697,1662491375,678,1333
3678336055,3082359035,1654387945,1654388415,470,383
3518583464,3133767042,1653446306,1653446973,667,705
3289061595,3760972512,1650209188,1650209907,719,183
3897211381,3424944206,1659516708,1659517682,974,1730
3110395191,3746971515,1654538177,1654538673,496,140
3506345760,3466156489,1654776402,1654777215,813,1995
3763912599,3294569676,1641724716,1641725564,848,2094
3357247840,3904352989,1644625652,1644625853,201,1400
3908153195,3640010781,1655361851,1655361861,10,1239
3823692648,3469507401,1662285247,1662285637,390,106
3737400101,3056721560,1667883987,1667884277,290,2438
3936943386,3901126730,1653274063,1653274439,376,571
3029374380,3446699030,1656652446,1656652466,20,203
3840659531,3433576059,1659879610,1659880252,642,919
3428026242,3963995256,1660908345,1660909096,751,869
3912111332,3215502915,1660700510,1660700550,40,2467
3110482626,3455209070,1652048121,1652048733,612,886
3594471575,3118358674,1652493065,1652493920,855,2010
3097563397,3256231811,1663483863,1663484494,631,456
3112622637,3845256746,1651114006,1651114763,757,1531
3254503569,3744575844,1653592704,1653593622,918,1821
3231496949,3301148308,1651144343,1651145067,724,368
3963793916,3232304638,1652168462,1652169239,777,1174
3107199564,3569573616,1667286928,1667286974,46,548
3658271419,3218686367,1653823686,1653823856,170,223
3149545838,3569578952,1666581862,1666582454,592,267
3053005521,3675703241,1643794358,1643794545,187,2412
3668421848,3143679923,1648150082,1648150322,240,251
3733004020,3375769320,1642855821,1642856028,207,1050
3811672443,3299211422,1655084042,1655084628,586,1892
3510166785,3664930564,1651602623,1651603169,546,373
3851778010,3306910493,1658847866,1658848689,823,1638
3321441782,3980824960,1647518071,1647518328,257,1882
3437122732,3851327758,1660684859,1660685450,591,1421
3923635120,3661372760,1642935908,1642936633,725,1807
3552494506,3710318693,1668320864,1668321414,550,1499
3699427202,3479738009,1656118257,1656118480,223,1278
3461674303,3820302319,1650426542,1650427176,634,2101
3076431464,3838851134,1662511676,1662512553,877,1843
3312124839,3488962022,1652876649,1652877357,708,40
3764343778,3671869525,1653141627,1653142217,590,2038
3873002836,3651503901,1649860753,1649861170,417,504
3937728696,3635487786,1655988826,1655989381,555,72
3118305321,3431411171,1665418739,1665419111,372,283
3598576303,3598409790,1667985811,1667985944,133,5
3854390772,3485459472,1668858416,1668858672,256,2171
3477692188,3124277484,1662504581,1662505464,883,1088
3920437320,3546486600,1660817853,1660818502,649,1371
3457468984,3957665117,1646776017,1646776298,281,1879
3290481654,3046510463,1656862616,1656863025,409,1660
3976757440,3278190233,1660851703,1660852366,663,2039
3324634418,3609058442,1651658738,1651659368,630,1980
3450503481,3928727074,1664125769,1664126459,690,73
3704517188,3683460040,1658026333,1658027033,700,141
3855537172,3702709444,1669467517,1669467693,176,2126
3624294521,3134793811,1645820378,1645821006,628,2130
3336551797,3462412055,1655194170,1655194847,677,596
3496470143,3942325631,1644107672,1644108119,447,1945
3204359619,3931277047,1658955901,1658956668,767,154
3292869706,3700287335,1666846621,1666847329,708,1418
3776785233,3827937024,1660981005,1660981873,868,482
3346484497,3197300293,1660408872,1660409803,931,650
3177433990,3872170030,1662677001,1662677091,90,2484
3173586762,3931677547,1641284270,1641284832,562,297
3237245622,3229060690,1657667174,1657667642,468,1923
3640349880,3888469544,1655694137,1655694476,339,2259
3569563212,3811672443,1664723862,1664724637,775,2038
3571477883,3032123620,1653188701,1653189428,727,156
3070520574,3424553049,1653944879,1653945484,605,1853
3196079047,3766160943,1659037197,1659037606,409,2254
3970820689,3840558415,1659942138,1659942948,810,2232
3431562624,3711576021,1643124033,1643124614,581,2058
3417820101,3170036337,1662498829,1662498860,31,199
3274159957,3047402472,1656592881,1656593412,531,562
3645868952,3186897818,1669651390,1669651870,480,1496
3117141664,3943892886,1665348917,1665349904,987,2182
3652177742,3032465570,1647521716,1647521829,113,614
3971093415,3525088003,1662103146,1662103173,27,1284
3760304580,3696947299,1667090201,1667091019,818,1288
3567328601,3450628929,1669013180,1669013334,154,757
3828738126,3600856738,1654528428,1654528498,70,185
3015715378,3687243333,1643161666,1643162654,988,2355
3939098308,3919792223,1665357743,1665358574,831,2095
3711048943,3768814245,1641423231,1641424108,877,877
3932077086,3529764378,1665957075,1665957291,216,955
3575784654,3963334554,1647640397,1647640508,111,2175
3774945806,3745248673,1658190022,1658190878,856,2171
3431175768,3884256882,1660853131,1660853266,135,2296
3315391438,3645860854,1652621077,1652622054,977,1423
3653285237,3845886572,1654154873,1654154971,98,1529
3075288965,3059848821,1666228476,1666228493,17,1545
3399604947,3351087116,1659739899,1659739948,49,2476
3231938844,3558281313,1644935861,1644936333,472,2036
3268670465,3741413739,1662891819,1662892588,769,1685
3874664424,3184344401,1663543533,1663544118,585,1060
3138755786,3627730665,1657008661,1657009406,745,1302
3168655636,3782673553,1656386543,1656386714,171,563
3569761806,3656674833,1660131795,1660132714,919,601
3462825977,3510660628,1663424033,1663424414,381,2059
3067403592,3297123407,1647986797,1647987332,535,1548
3719455699,3141503682,1654151867,1654152015,148,295
3646797040,3239527114,1662943903,1662944603,700,2330
3843576243,3948833001,1667782349,1667782449,100,1511
3815462032,3163470555,1642452043,1642452507,464,2042
3719965258,3364893066,1667643191,1667643395,204,123
3502316165,3808415962,1669543084,1669543428,344,1681
3520344153,3485578733,1656706694,1656707410,716,314
3096854657,3605492251,1660565920,1660566027,107,18
3964636806,3881861537,1646461132,1646461777,645,1217
3660998516,3741344192,1645251875,1645252700,825,1386
3903108572,3648370843,1646304653,1646305602,949,794
3307185651,3282079727,1669571193,1669571687,494,1626
3853912096,3045016501,1665249655,1665249981,326,1774
3398840886,3526797183,1650574898,1650575464,566,1682
3752289852,3644272268,1655491623,1655491814,191,573
3118443532,3160242179,1658544959,1658545021,62,414
3553241769,3371785046,1653472720,1653473712,992,239
3582531330,3386961417,1655838996,1655839070,74,2175
3444313610,3844348081,1655714392,1655715388,996,286
3509047408,3862918742,1641927259,1641927428,169,1931
3694210631,3073474496,1641916453,1641916965,512,2066
3289630313,3464595898,1651828747,1651828952,205,994
3398814666,3861153303,1661440078,1661440398,320,1473
3272428764,3340337106,1649192336,1649192665,329,778
3526239660,3335976452,1654119633,1654120621,988,749
3878925459,3830015015,1644386482,1644387032,550,1281
3603594711,3786861325,1667196677,1667197293,616,645
3106429728,3994409144,1660106394,1660106408,14,643
3443773400,3961140276,1644894678,1644895413,735,435
3609058442,3639121807,1647284513,1647285238,725,2099
3701151902,3239020709,1666813322,1666813883,561,227
3680804477,3426491499,1668255541,1668256214,673,1185
3770393539,3516399207,1651046341,1651046631,290,317
3804329236,3866836302,1663805639,1663806415,776,701
3280372392,3112070783,1649280921,1649281904,983,1769
3472603348,3043258601,1649218164,1649218385,221,2369
3594707374,3385846184,1665191199,1665191594,395,2391
3513169935,3131753608,1665729475,1665730349,874,1746
3371790369,3614206353,1659227807,1659228102,295,1174
3357029840,3300662625,1658683826,1658683992,166,753
3927657297,3869930031,1668654861,1668655403,542,541
3637412110,3205383513,1669393389,1669394333,944,260
3140407144,3112739600,1641979286,1641979582,296,285
3563343479,3447077543,1664617170,1664617195,25,1247
3311329069,3423971586,1668682541,1668682801,260,1989
3589366986,3508224327,1658635546,1658635662,116,31
3673948643,3248308163,1653734877,1653735648,771,1929
3980934555,3311860866,1667610870,1667611190,320,1053
3486814228,3766193314,1648303902,1648304850,948,1447
3223313152,3655981198,1656744793,1656745434,641,1896
3546486600,3908007955,1666811960,1666812351,391,1950
3102089102,3094596605,1656733863,1656733890,27,639
3276617814,3806737055,1658812428,1658812916,488,1113
3177370273,3980139195,1642447509,1642448502,993,1953
3141503682,3770061469,1665145334,1665145405,71,2197
3797778150,3194664110,1643283438,1643283966,528,1289
3489909547,3018325807,1642789010,1642789719,709,2169
3342538148,3981379416,1655608074,1655608362,288,1904
3933558253,3525377731,1663930929,1663931644,715,879
3186371475,3361422449,1655703753,1655704700,947,263
3007934266,3273857586,1654189123,1654189826,703,1718
3350387055,3801736024,1649788576,1649788845,269,1477
3733770591,3812800144,1664410046,1664410901,855,287
3526491245,3419751912,1667590949,1667591618,669,1256
3622230392,3297001171,1669548475,1669548965,490,1498
3642771281,3527221438,1651375603,1651376322,719,64
3757044916,3138958890,1641997335,1641997954,619,1418
3559615011,3286463125,1642010098,1642010117,19,1821
3961601633,3878925459,1647301422,1647302201,779,1762
3002631535,3979696807,1641489456,1641490084,628,835
3247948931,3757499622,1658594408,1658594609,201,7
3341694529,3787937000,1659912536,1659912812,276,720
3772178120,3462072699,1665234023,1665234591,568,1709
3191460519,3352389016,1663868060,1663869008,948,1426
3006085284,3627503494,1660729611,1660729772,161,2298
3469812263,3548351680,1649512761,1649513504,743,1413
3444313610,3974804920,1655373618,1655374027,409,1860
3861247260,3357966828,1649518732,1649518897,165,1665
3623869570,3526630913,1666388247,1666388609,362,534
3922972838,3722948390,1657795190,1657795379,189,2025
3840502377,3036448305,1650873037,1650873715,678,30
3755580356,3842844573,1645663205,1645663517,312,2024
3928852706,3472820961,1663654385,1663655297,912,2075
3064758483,3521112560,1650068727,1650069044,317,2101
3948577391,3075563867,1649779727,1649779935,208,1745
3176753600,3339048327,1659455541,1659455590,49,1433
3749161560,3144175285,1652589051,1652589975,924,2105
3150551034,3395609056,1662647035,1662647089,54,1158
3870320323,3085429140,1654147267,1654148127,860,772
3098108231,3481308282,1649836934,1649837314,380,424
3595049641,3427405967,1645715105,1645715144,39,2385
3531842620,3687552718,1661569495,1661570438,943,2097
3734534401,3254367735,1645159413,1645159432,19,397
3331255997,3682803273,1644883487,1644884381,894,1208
3170924487,3369469616,1647268227,1647268587,360,98
3183165788,3255904598,1650752353,1650752509,156,651
3693691265,3203128336,1665752677,1665753453,776,2405
3799078288,3228497776,1659079772,1659080405,633,1658
3125818794,3945611603,1647382239,1647382732,493,2484
3313292041,3329825462,1643405000,1643405965,965,368
3567614002,3457390239,1661565867,1661566359,492,1186
3199563620,3950763153,1650885979,1650886700,721,2341
3242235161,3002876565,1667252551,1667252816,265,336
3005356433,3804094924,1650810265,1650810318,53,2240
3573158941,3656846834,1662233140,1662233751,611,464
3039962870,3751826055,1644487196,1644487201,5,102
3391426421,3389926670,1642464107,1642465021,914,1901
3679141266,3398257086,1662371075,1662371104,29,2021
3826433692,3898494020,1654347555,1654347644,89,417
3942140107,3649774117,1651907746,1651908458,712,2470
3730368703,3697028347,1653439623,1653439688,65,1294
3707778731,3080007856,1650851330,1650852120,790,911
3847297747,3025133604,1667172554,1667173248,694,499
3693862073,3244198823,1644363711,1644364148,437,2028
3036346251,3748511559,1662625270,1662625339,69,114
3413898378,3440598942,1649087778,1649087836,58,1002
3567328601,3528288695,1653822342,1653822871,529,341
3609104298,3262978596,1667735675,1667735907,232,1351
3277327180,3223094463,1643570866,1643571177,311,1435
3375125376,3231938844,1647991930,1647992637,707,123
3442967650,3005125326,1641581129,1641581965,836,2018
3096710771,3361652898,1650816850,1650817809,959,2379
3003972844,3392105056,1650320574,1650321195,621,2203
3953796727,3233823273,1656591666,1656592588,922,1250
3271759672,3274452346,1660309428,1660310405,977,2131
3820254686,3658562439,1651396129,1651396871,742,1822
3432462167,3404034127,1665394873,1665394966,93,2028
3576425783,3676634608,1665103161,1665103286,125,2424
3495798110,3547923552,1645196174,1645196896,722,96
3172502658,3151923668,1650324005,1650324196,191,380
3670579691,3928685907,1644415724,1644416514,790,2131
3536931244,3261527870,1644582045,1644582893,848,1890
3093178960,3543696190,1652283675,1652284025,350,414
3643939596,3702064029,1660602705,1660603022,317,1935
3915315003,3534218813,1663528249,1663528372,123,2449
3880290667,3632156948,1661821759,1661821990,231,1325
3094414065,3236975783,1645644546,1645644596,50,1940
3701537998,3980851662,1668562652,1668562880,228,804
3951845301,3697291064,1650431603,1650432528,925,652
3572594221,3488962022,1641407372,1641407411,39,2390
3475322181,3712727713,1651113588,1651113889,301,1519
3992226673,3800312034,1657438384,1657438929,545,2353
3573915559,3632763218,1647643161,1647643518,357,425
3956491451,3747363730,1643783423,1643784285,862,1214
3173788210,3111639847,1668743315,1668744081,766,2241
3821312248,3133153956,1650150632,1650150870,238,896
3300662625,3915315003,1643528326,1643529025,699,1182
3735855753,3442674561,1643313865,1643314781,916,583
3686530724,3987318292,1667523898,1667524471,573,1293
3759008568,3325313312,1646711621,1646711866,245,2335
3509634549,3444668733,1641029101,1641030021,920,2402
3918891410,3979522310,1642237535,1642238053,518,503
3677001111,3907872554,1641706123,1641706702,579,1379
3092360885,3747302768,1650244317,1650244410,93,1163
3024979152,3442209140,1660246120,1660247030,910,780
3296478783,3222082052,1651878668,1651879462,794,1481
3160963185,3257821708,1664200093,1664200509,416,1653
3153541916,3967250644,1641086573,1641086797,224,1596
3635052101,3254144288,1661948613,1661949552,939,1158
3206198477,3496369924,1644804863,1644805519,656,1560
3656770582,3672751607,1641952203,1641952724,521,1217
3919162177,3611967437,1651238915,1651238970,55,457
3830866959,3870475008,1665484371,1665485200,829,24
3055169776,3186897818,1650603841,1650604196,355,2354
3904907996,3211015636,1658595224,1658595936,712,1199
3689680251,3965563922,1654619771,1654620470,699,1599
3837877764,3404945581,1644771562,1644772375,813,1135
3604593541,3778147762,1660033876,1660034499,623,2246
3530162623,3266681677,1656008189,1656009018,829,1369
3676352528,3568676955,1666343021,1666343056,35,574
3549033213,3333336166,1652878937,1652879095,158,793
3030117347,3147245859,1645508706,1645509144,438,2363
3690349378,3862138776,1656731577,1656732453,876,2315
3769290304,3085921604,1667928985,1667929172,187,221
3855734814,3864045087,1647493489,1647494297,808,1460
3342820244,3730106432,1664505281,1664505627,346,136
3016299339,3331604266,1650131502,1650132038,536,1426
3857460953,3035895563,1656206629,1656206841,212,861
3232497890,3785725492,1652234949,1652234962,13,1082
3267107046,3499272388,1646101974,1646102462,488,1432
3261195333,3678624517,1665010997,1665011669,672,1933
3426617058,3009781198,1662921067,1662921679,612,40
3055145919,3760975208,1658447461,1658447852,391,162
3719744431,3408903285,1650675442,1650676395,953,277
3682274097,3963995256,1645170085,1645170181,96,1612
3837904800,3193483812,1645015293,1645015590,297,998
3973226891,3555912894,1660791146,1660791972,826,994
3618532396,3178732875,1663010600,1663011522,922,647
3514680311,3326882521,1656776136,1656776831,695,989
3098290557,3136810446,1662102892,1662103233,341,602
3710769510,3890580849,1656339376,1656340318,942,399
3390723607,3058064037,1648449266,1648450011,745,1489
3736085476,3802823421,1655162013,1655162347,334,259
3627902900,3702932977,1657883725,1657884594,869,677
3311280180,3595499905,1665391170,1665392143,973,115
3717926703,3710782213,1659685231,1659685959,728,649
3831585514,3785721693,1643569821,1643570724,903,1000
3049147900,3314953470,1653286975,1653287367,392,2207
3665798527,3446289365,1641151592,1641151673,81,661
3108288045,3051642574,1650945705,1650945737,32,1913
3286065477,3172773924,1642130173,1642130610,437,1888
3050607996,3924990392,1642612392,1642613034,642,1204
3617200235,3453431236,1664205115,1664206019,904,2054
3095559156,3318848700,1656342540,1656342829,289,2175
3668645457,3623620611,1660532281,1660533018,737,2327
3072985971,3450102071,1646224664,1646225425,761,214
3631568439,3991859515,1642218333,1642219171,838,666
3282839568,3347854994,1669230596,1669230924,328,2028
3262864867,3342009927,1657684735,1657685007,272,2279
3222446672,3311871585,1655273536,1655273981,445,208
3321699949,3728974462,1654879118,1654879717,599,1915
3798512184,3217857851,1642537530,1642538497,967,2423
3433439185,3284832227,1643245918,1643246082,164,2009
3751418832,3585919417,1664681587,1664681957,370,1412
3217494787,3623876940,1664222431,1664223150,719,97
3322019981,3425006843,1659375420,1659376416,996,2109
3188643066,3542832965,1667607204,1667607710,506,470
3612878721,3689020840,1651486484,1651486965,481,2005
3335063983,3673731636,1648165966,1648166264,298,538
3734533600,3766186320,1668128317,1668128494,177,186
3223159718,3535941714,1642571697,1642571744,47,733
3818039978,3336551797,1647216042,1647216270,228,1057
3364855872,3034601276,1658976477,1658977038,561,1439
3411921561,3807440065,1643904896,1643905596,700,2108
3467391664,3927388172,1653453367,1653454300,933,1550
3425613329,3075293628,1666888468,1666888905,437,1217
3910839994,3306290309,1646599488,1646599998,510,1344
3064461314,3598841094,1641014576,1641015228,652,1003
3818655962,3072720499,1643292292,1643292586,294,667
3894036055,3965118569,1655592096,1655592158,62,1478
3647479988,3971391515,1664290210,1664290553,343,1462
3823962241,3185250646,1651782783,1651782967,184,1918
3797294746,3181086026,1653628501,1653628593,92,146
3043310672,3898403925,1659054810,1659055280,470,2493
3507500782,3210986714,1651416261,1651416704,443,218
3313426081,3645585393,1667859976,1667860827,851,2117
3288937566,3977107209,1651599115,1651599264,149,181
3145039731,3637518238,1649547822,1649547979,157,1448
3298748343,3855984822,1665567476,1665568336,860,1725
3234064286,3247688800,1659881256,1659881690,434,2267
3806652632,3488484971,1656268249,1656269098,849,1823
3745712275,3246571420,1667847600,1667848577,977,228
3614399988,3984215552,1644778819,1644779782,963,87
3626216693,3687938178,1653346814,1653347704,890,2436
3306378570,3608512295,1647760076,1647761054,978,1474
3672070606,3461508348,1647176903,1647177153,250,663
3386961417,3093024844,1655632994,1655633586,592,771
3798447157,3671296032,1657766735,1657767400,665,1426
3778068384,3739233756,1649083418,1649083469,51,2051
3285333536,3904203375,1657339968,1657340659,691,1656
3391711118,3855537172,1652830603,1652830826,223,1674
3175976694,3303418943,1661855930,1661856834,904,548
3996587507,3315182095,1655040247,1655040682,435,354
3437593879,3883537438,1657207358,1657207666,308,730
3194204306,3038823274,1650114278,1650114977,699,801
3971024525,3644951156,1661581929,1661582066,137,993
3373962186,3261169929,1648940909,1648941403,494,9
3158503756,3814017798,1642010643,1642011641,998,2449
3793966136,3729356619,1644237726,1644238167,441,1991
3292368988,3686743575,1664060947,1664061045,98,316
3362395200,3397052856,1653998442,1653998825,383,312
3735167946,3350345176,1666861894,1666861992,98,980
3223518905,3637292465,1666395958,1666396141,183,2223
3641682706,3600015858,1662872513,1662872639,126,1515
3915315003,3612642563,1649254545,1649255003,458,2
3191460519,3097834756,1664375033,1664375908,875,478
3550702679,3003705867,1665976540,1665977048,508,607
3665798527,3197660189,1641047508,1641048105,597,1455
3167864948,3893018254,1658649237,1658649870,633,464
3349718189,3108288045,1645211684,1645212420,736,2214
3238443990,3882978452,1644647593,1644648275,682,2400
3618352797,3180252962,1644888394,1644888695,301,1897
3343232841,3277926691,1661070019,1661070443,424,2474
3818823702,3580594125,1641236597,1641237267,670,1880
3486442976,3675429073,1664987036,1664987716,680,389
3449504551,3985620157,1645212562,1645213544,982,1478
3759008568,3333776110,1662159808,1662159857,49,2087
3113427537,3769836039,1664601690,1664602058,368,2427
3674729672,3658271419,1646694779,1646695261,482,2269
3308531560,3611062566,1642287523,1642288051,528,2358
3750543433,3179547560,1669247129,1669247858,729,2294
3959086145,3884551317,1643285645,1643286360,715,272
3692095366,3042176960,1646798775,1646799474,699,314
3434864548,3134793811,1649370128,1649370519,391,55
3373512814,3548133562,1668414366,1668414428,62,488
3430375744,3887305908,1650869381,1650869754,373,235
3629225227,3677574672,1653500576,1653501393,817,1976
3892023630,3041632417,1643164977,1643165883,906,934
3860422016,3650342769,1650769737,1650770176,439,435
3379935974,3585919417,1667349189,1667349380,191,1800
3766914780,3200059644,1647256949,1647257049,100,958
3570955260,3202881162,1661333591,1661334237,646,852
3397987502,3627981146,1647617102,1647617521,419,1261
3572276937,3673810421,1646858985,1646859651,666,61
3735855753,3568645029,1667208310,1667208925,615,1592
3248733503,3243018622,1659873539,1659874033,494,1728
3706209487,3340427847,1652602964,1652603302,338,209
3653031568,3513368682,1649883305,1649884076,771,2485
3029849131,3935259918,1643444612,1643444928,316,2069
3110639083,3449133548,1665458866,1665459325,459,1260
3628830127,3135951344,1642646780,1642647047,267,2443
3997312859,3424553049,1666221747,1666222453,706,1019
3896357807,3475322181,1653727804,1653728358,554,712
3340486436,3084940745,1654524882,1654525620,738,543
3254930364,3671154785,1651741126,1651741680,554,846
3084138267,3291838772,1647647815,1647648660,845,1363
3467613173,3397169008,1664792646,1664793442,796,1726
3950936299,3501866086,1653819019,1653819884,865,729
3075088680,3225901381,1659604861,1659605317,456,352
3995654203,3471376255,1668021367,1668022338,971,1600
3855223575,3886651871,1643681407,1643681750,343,1786
3414852594,3654841867,1643771034,1643772008,974,1542
3526218972,3784948704,1642237911,1642238621,710,1458
3048361071,3358745496,1660269801,1660270777,976,1399
3628729475,3849201069,1641825265,1641825973,708,2473
3733440098,3352595765,1647107103,1647107666,563,197
3118976994,3300479839,1648786603,1648786945,342,1616
3271278790,3370889279,1651307533,1651307671,138,1698
3277284318,3154288650,1648199439,1648199652,213,564
3767724034,3054803754,1646982328,1646982479,151,2421
3428260922,3037375725,1660726912,1660727161,249,630
3219869001,3005231138,1647605459,1647605536,77,1077
3620395885,3075563867,1651275552,1651275870,318,2072
3896922629,3997758248,1662583073,1662583915,842,332
3195032074,3773789419,1659336978,1659337100,122,152
3030117347,3043153412,1663704672,1663705195,523,1408
3506733308,3255460937,1653150855,1653151195,340,1754
3876927357,3947712728,1649766175,1649766671,496,539
3543105564,3892848585,1663417320,1663417946,626,834
3698358344,3892336923,1646250319,1646250952,633,1897
3393606099,3947879014,1658371207,1658371522,315,1852
3692512390,3147336288,1647350862,1647351190,328,1078
3505295000,3826530948,1646612274,1646612643,369,2309
3525088003,3016616906,1664888966,1664889435,469,18
3746979257,3948002281,1666954919,1666955696,777,2327
3303986609,3407778626,1642910737,1642911577,840,1110
3688076815,3381313507,1651153230,1651153840,610,760
3985326073,3284948113,1666978047,1666978936,889,1741
3555912894,3813666053,1658579240,1658579815,575,523
3425490548,3486262024,1662221001,1662221694,693,2383
3262978596,3737809844,1657172330,1657173033,703,1377
3900241568,3619660501,1661440373,1661441371,998,2326
3359896430,3739453348,1652313071,1652313100,29,830
3927649358,3092003105,1661102128,1661103023,895,1985
3451249074,3816995343,1643971551,1643971670,119,2265
3621462507,3412675211,1641099574,1641099863,289,1538
3959383415,3834268660,1668439450,1668439949,499,1292
3915637706,3284284605,1655398883,1655398900,17,690
3709665583,3340331761,1651697157,1651697961,804,1100
3049579265,3462410204,1669003540,1669003798,258,2247
3041290048,3263842575,1666234635,1666235337,702,2297
3046526062,3936980618,1664786709,1664786975,266,2034
3093716530,3565287194,1666414721,1666415636,915,1809
3782266785,3464595898,1663906562,1663906981,419,2259
3912111332,3470570814,1664804258,1664804983,725,2151
3624103484,3711314965,1661746854,1661747666,812,1262
3524508110,3895277580,1656618879,1656619801,922,387
3736483863,3404934353,1655672383,1655672769,386,824
3934953223,3713231806,1660775145,1660775956,811,2182
3533290388,3807473345,1659931769,1659931810,41,1768
3463875425,3724157579,1669643026,1669643138,112,805
3718905579,3264148498,1647806588,1647806692,104,478
3424368056,3609003771,1664935319,1664936237,918,1681
3702178313,3753180150,1650043699,1650043753,54,589
3683038464,3866532806,1641990023,1641990294,271,568
3307721045,3737603669,1653406131,1653406413,282,188
3614179985,3387311534,1648062300,1648062872,572,1714
3522715448,3564592902,1653666118,1653666191,73,331
3953258545,3634010080,1662170334,1662171073,739,213
3706215600,3159562411,1643292413,1643293303,890,2365
3880608911,3853448159,1650023634,1650024552,918,767
3660891061,3612973191,1643178522,1643179152,630,2339
3837904800,3893829650,1654016113,1654016568,455,1237
3384536407,3160061122,1666230763,1666231319,556,365
3991859515,3522549719,1653214165,1653215151,986,1338
3986970365,3486814228,1653228725,1653228954,229,1529
3454135300,3764318951,1668899582,1668900280,698,0
3047922240,3896910823,1665131374,1665132034,660,2370
3983158937,3762422234,1645167115,1645167188,73,1264
3143293050,3023254734,1641821676,1641822083,407,1798
3486793392,3777938800,1643126062,1643126542,480,1573
3939768853,3661507330,1658966514,1658966543,29,335
3186787984,3463135439,1657727463,1657727729,266,839
3302113605,3943184820,1652428009,1652428906,897,840
3977107209,3190417421,1649843687,1649844665,978,2260
3694762938,3792012199,1665511197,1665511627,430,2232
3337765684,3734099449,1658160924,1658161426,502,2417
3862583365,3687239883,1669752437,1669752554,117,404
3776334300,3884018587,1658027838,1658028761,923,1597
3006085284,3004160380,1643435880,1643436856,976,893
3003087336,3194125043,1666674614,1666674900,286,1660
3136200575,3108342285,1642126148,1642126798,650,592
3255460937,3904517073,1659594594,1659594761,167,238
3758115218,3906903088,1653979357,1653979493,136,2037
3530286335,3749756110,1655162873,1655163300,427,1503
3670266153,3921490578,1665295398,1665296373,975,1850
3208464348,3991963732,1661949610,1661949658,48,535
3336965818,3998200859,1661580368,1661580669,301,1154
3994388981,3369731959,1652797073,1652797678,605,2317
3233507128,3066429600,1643324499,1643325225,726,544
3513925385,3476283460,1645094282,1645094895,613,16
3061556470,3155797946,1664529773,1664530611,838,2455
3592887882,3962453693,1644576664,1644576754,90,2058
3714575918,3778575442,1660433766,1660434224,458,446
3744759130,3877902487,1644463589,1644464136,547,2348
3278612503,3210136888,1644114704,1644114982,278,956
3985825297,3973440480,1653898035,1653898528,493,0
3791107997,3726520685,1658978572,1658978584,12,890
3898229031,3449395269,1663327045,1663327601,556,1420
3754795349,3473525108,1663757451,1663757602,151,590
3992226673,3398278082,1665687235,1665687588,353,1560
3921229994,3191460519,1662225768,1662226081,313,1114
3422046745,3592453741,1646621631,1646622160,529,0
3885694482,3127771930,1664296742,1664297616,874,2282
3205153391,3688776786,1656511850,1656512840,990,397
3307775998,3524482926,1649802330,1649802401,71,1993
3394220993,3189396065,1646785800,1646786139,339,1426
3680255689,3502554871,1664181585,1664182361,776,313
3759986276,3125436993,1663580279,1663580372,93,1836
3002727939,3252961062,1655621892,1655622212,320,2016
3529898997,3997051818,1668754003,1668754287,284,806
3463009951,3624085921,1656285486,1656286477,991,138
3157155319,3957210150,1662633761,1662634136,375,43
3336423969,3902329320,1651434519,1651434567,48,2468
3502947486,3622478840,1655968654,1655968848,194,2344
3375021204,3901579796,1644545375,1644545841,466,2023
3405168756,3665086817,1642388242,1642388685,443,652
3526630913,3082359035,1644308312,1644308590,278,2221
3137594486,3624748073,1655539058,1655539817,759,2014
3492215792,3021769525,1668190464,1668191383,919,339
3498314038,3736260750,1656736320,1656736921,601,1476
3634044438,3555903175,1642783949,1642784029,80,1468
3336127092,3716257088,1648646953,1648647773,820,1251
3745532894,3373656201,1661953759,1661954144,385,482
3366845170,3281907019,1651265442,1651266354,912,1099
3209097023,3424621981,1662906889,1662907819,930,1416
3064032505,3079530021,1647747049,1647747355,306,593
3814899146,3137529896,1646388014,1646388920,906,1680
3327061038,3325334366,1641280100,1641281006,906,244
3879299283,3437309077,1646224260,1646224884,624,1473
3384307655,3871137970,1641206331,1641206935,604,2037
3815507952,3502484697,1659205812,1659205951,139,1481
3889854774,3378948752,1651355952,1651356744,792,1904
3364409507,3720475877,1667051171,1667051525,354,1161
3616901816,3528505546,1667756271,1667757162,891,1418
3937729247,3458116043,1651440969,1651441715,746,142
3311303975,3739338939,1668408382,1668408500,118,2084
3752669447,3743860568,1662482245,1662482767,522,1207
3241341174,3083182515,1643267610,1643267889,279,298
3986247608,3070087815,1644502693,1644503068,375,1988
3412955545,3361508949,1664412767,1664413054,287,1419
3957824946,3071810518,1650923326,1650923694,368,1517
3089034472,3032465570,1641507021,1641507900,879,387
3216667034,3767868249,1648183145,1648183994,849,1109
3026244912,3808022912,1653937521,1653937529,8,1154
3038014403,3947921257,1647206046,1647206281,235,114
3364945349,3310951639,1641071758,1641072468,710,32
3948260526,3765660727,1668663320,1668663382,62,1792
3662023903,3272912522,1666916584,1666916690,106,1350
3336376139,3355184225,1642751229,1642751786,557,1053
3911364139,3266498789,1656484352,1656484478,126,791
3772739629,3116684420,1659854351,1659855279,928,2062
3168984273,3460687455,1645288005,1645288608,603,433
3845010730,3197300293,1653794895,1653795076,181,754
3784105182,3650172161,1643582291,1643582573,282,2448
3827810459,3784808734,1656807461,1656807804,343,773
3648593799,3204912218,1650582253,1650583073,820,653
3104719783,3516865615,1652161381,1652161434,53,124
3825332100,3086076310,1652195155,1652195431,276,1517
3900843323,3151697582,1644208309,1644208810,501,1250
3948769271,3145220460,1669285535,1669285579,44,1615
3892023630,3263372197,1659249255,1659249470,215,1802
3802694367,3086357122,1665159988,1665160987,999,42
3594009328,3027064938,1662977530,1662978493,963,2477
3966881800,3270923168,1655600710,1655601598,888,1882
3710769510,3768087701,1656423133,1656423718,585,2109
3021320868,3688910009,1654080667,1654080847,180,888
3090383487,3568162481,1666971453,1666972130,677,1190
3438188875,3619714539,1648620798,1648621523,725,1965
3260695363,3733004020,1666357260,1666357900,640,506
3686530724,3145039731,1649996591,1649997349,758,865
3041296119,3606994517,1659133378,1659133530,152,2213
3887743057,3331335383,1663430747,1663430892,145,628
3309869716,3409949315,1662594572,1662595253,681,778
3400329831,3066360181,1641834055,1641834331,276,2376
3934953223,3366262960,1641627704,1641628019,315,157
3421645346,3473505436,1647600126,1647601124,998,142
3977359273,3629824081,1669281782,1669282287,505,159
3130561868,3625894399,1649519422,1649519592,170,704
3022252567,3882603510,1668685887,1668685972,85,2285
3831380073,3683134571,1654458901,1654459661,760,1452
3003321686,3067229796,1645824047,1645824845,798,1930
3406357109,3061924533,1660713999,1660714206,207,1371
3399552669,3223154180,1646426698,1646427397,699,649
3019302226,3904203375,1653695874,1653696415,541,314
3577718759,3183672525,1664255209,1664255709,500,20
3909765076,3387264235,1654480456,1654481208,752,2007
3321074447,3124063685,1666176108,1666176367,259,2093
3617545187,3351361711,1647163297,1647164096,799,1472
3828713812,3377855107,1650024101,1650024890,789,1683
3456602518,3177370273,1663453972,1663454462,490,1783
3932212405,3740376361,1655748960,1655749283,323,2221
3447555067,3111639847,1661588224,1661588653,429,172
3274159957,3568404894,1653802982,1653803245,263,853
3370701718,3343279177,1657585896,1657586320,424,65
3393501277,3408396410,1647743116,1647743549,433,450
3686240080,3465500045,1658218154,1658219023,869,1504
3660575608,3556000533,1641339843,1641340587,744,834
3513349474,3686743575,1643221686,1643221771,85,1498
3888392286,3747302768,1650790547,1650790549,2,1115
3300203056,3791315348,1643678884,1643679639,755,1747
3357692565,3212095735,1644385626,1644385912,286,2105
3998316020,3784040148,1662044936,1662045094,158,1914
3777597419,3761584126,1663947889,1663948404,515,1089
3645850762,3519828744,1656629764,1656629915,151,2489
3933752482,3893601176,1667750472,1667750859,387,2235
3302344507,3284550954,1653699534,1653699923,389,2114
3700419429,3539839307,1663520072,1663520327,255,808
3264345880,3184178717,1654501991,1654502493,502,207
3418338710,3044390847,1642544935,1642545593,658,596
3766186320,3258102756,1642681441,1642682093,652,2057
3970654045,3651271289,1669115586,1669116549,963,1804
3746872131,3801768919,1668577203,1668577548,345,2007
3196079047,3166518187,1657245226,1657245910,684,1385
3263403144,3417820101,1665302702,1665302722,20,947
3636001595,3389560959,1644662884,1644663489,605,1239
3294783182,3753863307,1645917069,1645917981,912,2294
3792143103,3118443010,1662323081,1662324056,975,174
3165929307,3538686599,1665975548,1665975765,217,1871
3163012662,3418364050,1664214947,1664215178,231,2323
3321346285,3302455172,1666452473,1666453173,700,1390
3353388722,3617533561,1650033156,1650033250,94,873
3605412707,3362091170,1649510958,1649511842,884,1319
3672694122,3402690548,1654755691,1654756492,801,1859
3997167780,3542293606,1663572550,1663572775,225,2184
3730702889,3603853942,1643196256,1643197058,802,480
3358374850,3356144129,1659380232,1659380310,78,2160
3771504908,3990849115,1641658698,1641658867,169,777
3084138267,3991859515,1658965985,1658966301,316,281
3981049957,3553939893,1668486365,1668487152,787,290
3211015636,3970444667,1647349430,1647350085,655,2218
3624103484,3880046311,1643708925,1643709721,796,1198
3063969367,3067897101,1654488098,1654488118,20,1191
3767508362,3251409316,1653547713,1653548130,417,368
3023140319,3506733308,1668249662,1668250183,521,774
3111965011,3029053911,1658991173,1658992099,926,1505
3671355250,3651803323,1651484513,1651484698,185,881
3338749992,3582267659,1669040341,1669040383,42,2396
3932161358,3709518724,1644812796,1644813508,712,1589
3124415148,3546954605,1660035816,1660036686,870,41
3739320901,3533954093,1646979797,1646980068,271,1850
3341573446,3385846184,1665601167,1665601737,570,208
3021679982,3631703207,1652590111,1652591068,957,2236
3068242755,3550702679,1642915375,1642915471,96,1426
3529764378,3940391939,1647072078,1647072704,626,2363
3816015403,3970288014,1668711818,1668712761,943,2325
3546432752,3526793212,1660620516,1660621352,836,728
3293924278,3712276884,1652581445,1652582252,807,1573
3667414511,3048402049,1644878688,1644878965,277,1675
3140407144,3117262222,1648331699,1648332102,403,1236
3620395885,3891400237,1667703243,1667703262,19,1586
3166274990,3306910493,1663734140,1663734756,616,1124
3015593061,3498461454,1668263316,1668263440,124,1502
3768814245,3695545980,1661846143,1661846809,666,2119
3156452001,3872444916,1669096838,1669097365,527,72
3125818794,3697692313,1649102029,1649102394,365,392
3371063992,3471638565,1648372404,1648372466,62,479
3587497382,3141108539,1646910893,1646911744,851,470
3787937000,3680694926,1662018461,1662019454,993,1317
3419809319,3930994715,1647635828,1647636340,512,1913
3047629830,3024554792,1668803107,1668803186,79,74
3093523046,3051253299,1650367778,1650368763,985,1485
3822458181,3890181496,1668557996,1668558284,288,2460
3109500957,3196975901,1648439400,1648440264,864,0
3830303170,3526968501,1654042487,1654043088,601,1688
3589984222,3092925867,1653211015,1653211553,538,580
3793086361,3908312889,1648971659,1648971997,338,214
3355976871,3222438717,1662808751,1662809447,696,1814
3270935026,3285303154,1652000342,1652001110,768,1381
3863448086,3254496907,1663450416,1663451044,628,1186
3020452542,3031103174,1648747571,1648748192,621,1600
3150793263,3132376039,1657265665,1657266455,790,1369
3028841213,3120092137,1650879480,1650879759,279,283
3534715157,3288329354,1645785992,1645786763,771,1840
3430165544,3189396065,1666747928,1666748545,617,135
3314953470,3040563913,1658485787,1658486345,558,2021
3830053941,3939244771,1659286979,1659287752,773,490
3599795440,3570906118,1645798039,1645798847,808,568
3910149883,3783325820,1649858735,1649859530,795,2185
3182643672,3897421758,1660879735,1660880542,807,553
3579921083,3155756336,1652338193,1652339072,879,1555
3262711330,3594903436,1660385692,1660385987,295,932
3774724683,3512631937,1646268937,1646269143,206,2277
3654861844,3258577325,1666231317,1666231928,611,1642
3383791217,3686826205,1644105750,1644106275,525,39
3522465860,3170158934,1658047644,1658047976,332,845
3409949315,3273059265,1651615932,1651616341,409,633
3181912863,3258782646,1648455120,1648455937,817,930
3077145114,3504446959,1655142821,1655143460,639,2380
3890117007,3189300345,1664119134,1664119790,656,2483
3197545162,3231496949,1654593422,1654593732,310,392
3677574672,3315185864,1641404643,1641405623,980,346
3368322774,3693453006,1655905939,1655906759,820,2242
3343162937,3344455273,1667128116,1667128859,743,2132
3095661578,3730106432,1654689203,1654689774,571,340
3070841779,3762422234,1662094443,1662094679,236,455
3284958290,3089126812,1641645542,1641646255,713,8
3412673526,3021769525,1658721320,1658721552,232,843
3513349474,3680682585,1651018555,1651019369,814,405
3537151295,3233146767,1644743385,1644744059,674,1915
3294526671,3233375810,1662194294,1662194301,7,323
3580953063,3666268915,1651331332,1651331907,575,1153
3275494433,3517260537,1651918378,1651919080,702,1597
3687617825,3814045699,1658502525,1658502617,92,2181
3692691710,3353257973,1666250257,1666250362,105,590
3980841914,3145438438,1646575787,1646576260,473,244
3311280180,3248250292,1655011530,1655011940,410,1304
3222438717,3153858233,1668802050,1668802733,683,1795
3343543154,3761269014,1658459416,1658460376,960,2294
3139126728,3588684575,1649120368,1649120455,87,1625
3814029511,3460047535,1668514806,1668514956,150,1304
3426585956,3517912492,1666919340,1666920330,990,2018
3768549498,3767983934,1655025529,1655025837,308,2009
3785586097,3454135300,1654881460,1654881891,431,913
3927273567,3586600196,1649443461,1649443555,94,2027
3183079019,3724861653,1652120936,1652121365,429,1403
3474259908,3267151775,1652420389,1652420728,339,1298
3389773271,3527291464,1650065229,1650066122,893,2343
3070087815,3020526331,1650142298,1650143150,852,668
3106490071,3077552507,1660629576,1660629652,76,2156
3849379963,3904517073,1664798780,1664799151,371,1195
3928685907,3066546417,1648863569,1648864318,749,1868
3528418687,3799900837,1653593009,1653593198,189,1198
3938370016,3734518688,1655903723,1655904176,453,655
3939948508,3347896915,1643700232,1643701112,880,1259
3106732056,3015156809,1643089051,1643089680,629,1249
3573975780,3952670371,1656561521,1656562099,578,2028
3293201387,3342215329,1652206233,1652206245,12,2313
3939977057,3331439996,1668002139,1668002588,449,461
3186584232,3457390239,1654721637,1654721673,36,2187
3075765827,3321074447,1661166901,1661167819,918,1289
3183256246,3080876844,1665329847,1665330168,321,1200
3406509436,3010161936,1663579611,1663579757,146,1323
3910979746,3660891061,1643175317,1643175426,109,381
3922925129,3898959510,1669433422,1669433636,214,398
3243831128,3986311619,1658872245,1658873015,770,1696
3647398701,3043310672,1641854117,1641854262,145,1227
3623294630,3273827707,1660821190,1660821723,533,1377
3772035177,3328148239,1667648970,1667649953,983,299
3636960130,3517260537,1648465612,1648466200,588,1203
3423043196,3556848299,1646418689,1646419055,366,630
3152200344,3226092646,1663672003,1663672379,376,1366
3679519826,3677001111,1645687769,1645688473,704,473
3347990376,3347942747,1650016449,1650017427,978,847
3886521997,3335709869,1648429975,1648430524,549,1254
3826823415,3494179125,1643329893,1643330850,957,535
3519828744,3844939526,1668379033,1668379504,471,503
3431614426,3946068928,1668184828,1668185518,690,295
3687278591,3090103866,1666825155,1666826130,975,654
3734331528,3125019722,1652219697,1652220508,811,2487
3749619105,3595612540,1662340266,1662341001,735,889
3291641388,3391658891,1660442246,1660443042,796,1018
3956796805,3783119155,1657492429,1657492852,423,1123
3738981251,3621416999,1660261083,1660261280,197,1141
3556000533,3830053941,1666868001,1666868584,583,1870
3509864353,3377868003,1663376115,1663376185,70,2293
3889705477,3518864357,1650626687,1650627510,823,333
3282275875,3185444969,1658991051,1658991509,458,1584
3657115450,3434182192,1665376616,1665376820,204,1298
3648447244,3227951880,1649285367,1649285440,73,1167
3074477991,3993756491,1652151269,1652152009,740,806
3622596133,3554977739,1648059603,1648060509,906,1991
3415768719,3193095337,1662640374,1662641101,727,85
3622478840,3530491537,1652599785,1652600430,645,1833
3172305265,3292275609,1645431136,1645432029,893,564
3898391169,3184455727,1658409972,1658410220,248,1926
3425006843,3788717673,1668764703,1668765309,606,1952
3128532251,3492909923,1651721899,1651722024,125,2042
3520511256,3673761066,1667816286,1667816421,135,1778
3029468613,3996587507,1660047477,1660047606,129,1604
3692345317,3090090794,1657414930,1657415072,142,1945
3624188526,3397169008,1668902567,1668902908,341,2253
3826823415,3403512366,1655378845,1655379670,825,1291
3747697794,3817057878,1657285992,1657286476,484,1812
3963334554,3628792484,1656362200,1656362337,137,1278
3084430345,3609310097,1641610704,1641611246,542,388
3296151097,3331882759,1661694025,1661694088,63,2023
3303986609,3243902799,1653962275,1653962805,530,1123
3557325531,3120105783,1668368026,1668368113,87,777
3274752508,3906216789,1664055286,1664056060,774,1510
3149143223,3130093617,1642507363,1642508337,974,1203
3885786333,3161063958,1663987269,1663987685,416,1078
3085931016,3232285701,1646269334,1646270177,843,850
3840807781,3329135548,1661707481,1661708109,628,1691
3848866443,3674049704,1665067410,1665067720,310,735
3748944220,3196403466,1656397653,1656397816,163,1702
3360115986,3377855107,1658815117,1658815205,88,1231
3795250558,3128529900,1651651278,1651652089,811,1602
3380053573,3664267954,1643391992,1643392302,310,2229
3103215750,3123815439,1662838392,1662838763,371,1180
3947174877,3824168840,1643017453,1643017889,436,1347
3069536467,3417138981,1641690705,1641690925,220,81
3123677020,3544020942,1649823262,1649823332,70,67
3952425376,3002829154,1667060098,1667060489,391,440
3518079213,3447077543,1663872268,1663873192,924,844
3377457710,3604757184,1642825490,1642826128,638,2488
3671054235,3223064733,1651334763,1651335401,638,735
3928685907,3636446257,1665593342,1665593977,635,461
3585097526,3576100130,1644918212,1644919066,854,385
3175929512,3649447383,1652948242,1652949199,957,1024
3858459394,3008760173,1665942924,1665943534,610,1454
3149818961,3348282881,1652177350,1652177915,565,694
3994913668,3393156673,1655848159,1655848320,161,787
3286065477,3061362091,1648667903,1648668264,361,860
3233425442,3240452269,1645854973,1645855392,419,1733
3531345844,3206061644,1658540965,1658541437,472,753
3183515887,3199411589,1650948232,1650948363,131,1646
3319877479,3094596605,1655264369,1655265189,820,1377
3073332785,3343279177,1658871831,1658872235,404,1675
3404468022,3246759301,1665362852,1665363455,603,113
3049567508,3056982737,1658920934,1658921692,758,1058
3314495556,3048781539,1669397418,1669397535,117,717
3785222888,3247551122,1652895062,1652895577,515,612
3644127860,3571991159,1648557410,1648557780,370,1040
3905167655,3377847710,1654594231,1654594314,83,2373
3227567293,3681795615,1664857065,1664857754,689,1965
3235672444,3370263528,1650139286,1650140091,805,1943
3170058626,3840502377,1656835835,1656836040,205,1136
3955825968,3199892178,1644291915,1644292465,550,2355
3068129646,3863652254,1664236016,1664236542,526,80
3798527829,3239418137,1648962227,1648963158,931,414
3368204842,3428287409,1666505677,1666505974,297,507
3443297756,3333347852,1663853371,1663854113,742,695
3802545642,3531118058,1647415194,1647415960,766,2493
3562110382,3532270724,1647933840,1647934054,214,2219
3560756539,3129860388,1655050840,1655051190,350,1016
3653770219,3866215730,1646588461,1646589243,782,1698
3743669526,3132349279,1663670807,1663671403,596,1384
3953465037,3840306405,1666334903,1666335524,621,1657
3871137970,3463800741,1652767647,1652767948,301,2411
3944476586,3625034951,1657123325,1657124019,694,595
3158894896,3139198469,1641892690,1641893399,709,1887
3216753609,3212841978,1641649502,1641649933,431,1261
3041386590,3095743155,1658002298,1658002528,230,2486
3933845116,3722301598,1659193643,1659194572,929,1597
3576961863,3825332100,1651439897,1651439913,16,2077
3457390239,3217137285,1642846111,1642846970,859,1625
3740854424,3271409183,1665784302,1665784604,302,1697
3761584126,3917448920,1647647985,1647648556,571,658
3572325072,3265655534,1668730326,1668731254,928,2273
3714259747,3271436858,1661847716,1661848171,455,501
3866431229,3352634974,1661602794,1661603312,518,357
3661976391,3515460273,1656658873,1656658922,49,345
3028841213,3857434991,1653865269,1653866222,953,1733
3656000543,3782752586,1645914006,1645914430,424,1244
3451249074,3636001595,1646842925,1646843670,745,2174
3198195956,3473728186,1647008090,1647008185,95,1603
3467211844,3618545572,1656484770,1656485002,232,1706
3168919126,3159638305,1644508622,1644508981,359,2473
3849977339,3605519659,1663239003,1663239446,443,2328
3557835284,3687689210,1662888439,1662888462,23,1722
3887409378,3085001659,1652542101,1652542979,878,2190
3145393304,3145378445,1643277708,1643278156,448,1068
3489466063,3537294800,1646715114,1646715315,201,864
3321391869,3718882981,1653655760,1653656458,698,1758
3671296032,3906065558,1652787043,1652787273,230,1909
3801736024,3741273371,1649595474,1649595665,191,547
3022401876,3993623323,1647795033,1647795821,788,497
3413810353,3003087336,1653625228,1653626203,975,2334
3325735696,3890026377,1662884276,1662884924,648,219
3327145204,3815718297,1651871477,1651871811,334,1162
3654899608,3377855107,1647237212,1647237403,191,2438
3623206706,3463965663,1649073789,1649074102,313,909
3568488180,3708034201,1663665925,1663666684,759,1165
3760972512,3043656500,1664925465,1664926288,823,1477
3090731052,3071929787,1664124302,1664124457,155,657
3512631937,3447926518,1657934676,1657935331,655,2058
3762829533,3076570841,1646986647,1646986924,277,2189
3149602037,3999551936,1659711554,1659712385,831,682
3922972838,3428325312,1654020327,1654020816,489,552
3968337751,3990144819,1657108123,1657108753,630,1312
3874626130,3793232281,1662025783,1662025854,71,1705
3931854815,3128532251,1654884858,1654885130,272,171
3390441234,3689741006,1669366434,1669366526,92,1036
3824353209,3233146767,1665632361,1665632937,576,1349
3544020942,3024554792,1665972422,1665972589,167,1461
3694244943,3839967647,1664518713,1664519475,762,2108
3471797400,3012845933,1641129395,1641130241,846,1315
3470404771,3025333750,1643839376,1643839423,47,1571
3169559952,3177190923,1642800167,1642800313,146,1148
3417138981,3197371652,1653653984,1653654008,24,1603
3285225403,3570747542,1656764494,1656764735,241,162
3051776472,3696432858,1644289059,1644290037,978,1561
3091072272,3765504986,1651890003,1651890424,421,1813
3227246451,3049567508,1655293859,1655294453,594,1851
3580953063,3141688992,1650534486,1650535104,618,1599
3953483372,3756020689,1645919805,1645920452,647,1890
3009835115,3039544352,1665508579,1665509492,913,1005
3946015739,3863448086,1654946865,1654947283,418,1057
3712549911,3773658133,1658499636,1658500438,802,1349
3576422890,3197739962,1658393957,1658394887,930,536
3802410450,3968682824,1662889910,1662890215,305,820
3097469330,3686944200,1651006786,1651007455,669,200
3573692342,3098264219,1646317790,1646318198,408,42
3714188043,3823942349,1666526463,1666526496,33,1588
3813290629,3857400676,1662034565,1662035097,532,312
3253568318,3796343532,1652506773,1652506775,2,739
3068723030,3728506494,1652222782,1652223411,629,1938
3445031830,3947712728,1644917219,1644917315,96,2037
3218903379,3898946519,1657267381,1657268256,875,1301
3855218155,3024813851,1657231075,1657231162,87,312
3827851972,3653069495,1643701431,1643701739,308,1276
3711710728,3037867406,1648480919,1648481562,643,1537
3790996735,3714719241,1657191894,1657192803,909,215
3132210207,3555560595,1659836330,1659836812,482,2117
3551810435,3651900802,1652029684,1652030086,402,766
3486793392,3284958290,1665081653,1665082254,601,90
3477770827,3894359262,1666944460,1666944922,462,368
3749529134,3428889808,1658156911,1658157365,454,1336
3833594316,3618101679,1662247335,1662247486,151,2186
3851879278,3033523546,1667978606,1667979104,498,801
3518864357,3043310672,1660400466,1660400590,124,2372
3300456889,3474315750,1661494072,1661494688,616,207
3718823049,3367865740,1666445033,1666445292,259,369
3995358434,3930124385,1666034764,1666035697,933,2325
3911621945,3526365568,1668334869,1668335716,847,1397
3706206403,3129667560,1655492191,1655492848,657,84
3307185651,3825484587,1655428577,1655429319,742,1909
3033349787,3756473550,1660966105,1660966481,376,297
3017740025,3725439899,1664820521,1664821167,646,1098
3748360490,3735700656,1655160215,1655160450,235,275
3678482446,3526218972,1661705978,1661706193,215,942
3878852082,3381313507,1667332808,1667333288,480,1728
3104793032,3138001926,1669453014,1669453050,36,307
3659752387,3483666747,1645263485,1645263650,165,2179
3937129101,3180728306,1669362430,1669362997,567,1194
3835355277,3781789585,1648533713,1648533885,172,1216
3990109853,3942399353,1649457636,1649457829,193,946
3316485303,3387938632,1660704901,1660705213,312,1262
3080703553,3757044916,1653641262,1653641699,437,902
3988264152,3028803724,1650336137,1650336857,720,619
3221685249,3046787822,1649429440,1649429907,467,323
3338715388,3449125023,1661389651,1661390317,666,2010
3973959874,3533954093,1657277690,1657278273,583,2167
3710202750,3738571497,1659971309,1659971938,629,2132
3139376524,3143909362,1642429304,1642429655,351,1319
3463003824,3107482740,1661765619,1661766511,892,1913
3605195406,3920277028,1667442989,1667443293,304,1037
3079029428,3120737114,1645906837,1645907456,619,1723
3890875667,3735098036,1664043829,1664044345,516,2382
3052875832,3760975208,1649567364,1649568032,668,943
3546284533,3418276734,1649339249,1649340155,906,2332
3037279735,3981778568,1662298244,1662299017,773,1738
3537457982,3202225412,1655672748,1655673026,278,2361
3275301708,3567237541,1643752867,1643753496,629,1334
3742275397,3924167113,1646296916,1646297169,253,457
3068242755,3623876940,1663307040,1663307336,296,1005
3393199571,3581971425,1648716897,1648716968,71,198
3990109853,3993066194,1643293528,1643293998,470,2312
3688345244,3240839516,1662497910,1662498873,963,39
3299191225,3490435539,1662106604,1662106861,257,1811
3908209550,3521410258,1642899985,1642900198,213,2070
3349030618,3515837186,1657161516,1657162343,827,275
3352005808,3985854594,1667213364,1667214026,662,1312
3622848449,3787880772,1659185902,1659185902,0,52
3994388981,3640765121,1659809706,1659809789,83,583
3466735449,3630744403,1652454353,1652455304,951,1920
3983988321,3309869716,1654706245,1654706559,314,1501
3591290407,3095437969,1648616390,1648617121,731,918
3653031568,3278077270,1666341957,1666342731,774,1065
3404959548,3054979282,1646721513,1646722359,846,1102
3074477991,3643276679,1645128421,1645129312,891,1243
3226298244,3096408604,1665141556,1665142068,512,720
3880608911,3948577391,1651616150,1651616217,67,815
3656865344,3736535657,1647939801,1647940243,442,1337
3527349190,3194712532,1649973251,1649973793,542,135
3832370690,3801956152,1651296714,1651296747,33,1216
3837550746,3887036201,1657771091,1657771729,638,558
3323809275,3170296955,1643137358,1643138025,667,2127
3962695354,3749593178,1666755111,1666755852,741,1099
3757305418,3258782646,1660980920,1660981798,878,2287
3893849847,3071341023,1656576184,1656576717,533,361
3993756491,3436578278,1652962827,1652963601,774,1894
3344549344,3130561868,1645667773,1645668182,409,796
3998316020,3620303845,1659940991,1659941635,644,1898
3556823098,3796159106,1650729003,1650729929,926,1459
3307251676,3849902434,1655477401,1655477642,241,1926
3888757366,3600573063,1652175670,1652175897,227,1678
3949771162,3928212115,1659889147,1659889629,482,1179
3601499230,3946015739,1656891320,1656891683,363,1029
3333543321,3652728312,1656100929,1656101481,552,1181
3821039922,3068659940,1648717457,1648717983,526,918
3541200701,3122624322,1659453821,1659454535,714,2476
3080200257,3927329503,1642721494,1642721897,403,2122
3697692313,3641682706,1655431608,1655432251,643,455
3145045320,3542996543,1658323704,1658324223,519,1660
3619800237,3802890793,1664280174,1664280980,806,1661
3049727234,3264865965,1648476793,1648477651,858,62
3768558350,3845818528,1669208134,1669208682,548,161
3868215944,3051395031,1643547404,1643547548,144,1102
3615666134,3539364028,1664724171,1664724193,22,373
3975065378,3233282653,1659104394,1659104958,564,1622
3203734562,3577530061,1669066205,1669066205,0,962
3964637208,3973050834,1653755744,1653756705,961,2065
3331554085,3855013110,1646068167,1646068544,377,725
3046043182,3637412110,1667756657,1667757140,483,2405
3891053268,3101161243,1668961038,1668961578,540,2450
3344285047,3649036403,1657695090,1657695277,187,915
3407579711,3097128642,1667440434,1667440994,560,2087
3154680228,3523508617,1655113029,1655113672,643,1901
3584910336,3057308926,1661734978,1661735495,517,289
3468914867,3991727598,1656782191,1656782658,467,833
3093300732,3066892936,1650134689,1650135287,598,492
3664627036,3773996198,1667198095,1667198888,793,221
3763300182,3010488834,1651671661,1651671776,115,2203
3118959727,3446572964,1641863665,1641864550,885,2109
3431909978,3084066396,1643374089,1643374279,190,724
3045587450,3555105048,1668383484,1668384001,517,1440
3786811867,3280399460,1647584520,1647584681,161,1324
3974318707,3573915559,1657249236,1657249691,455,1001
3447326124,3947788644,1650350421,1650351263,842,912
3821768923,3897756969,1667838671,1667839374,703,1018
3454851350,3242785599,1669119011,1669119296,285,1112
3787937000,3156098708,1646559291,1646559892,601,1961
3863948017,3635487786,1642589579,1642589898,319,1928
3899247202,3826502515,1641211912,1641212882,970,450
3184916120,3174373725,1652599472,1652600412,940,1751
3227310314,3358968691,1657775514,1657775693,179,281
3875570780,3482406705,1661570540,1661571470,930,800
3679533416,3202460554,1646502866,1646503180,314,2122
3395782360,3722578408,1643564285,1643565281,996,222
3129170273,3096274177,1660547064,1660547432,368,2304
3019669727,3381398230,1643639574,1643640323,749,268
3509047408,3827551944,1651625626,1651626306,680,1742
3136200575,3014354609,1656280989,1656281344,355,904
3412989654,3778068384,1663711131,1663712115,984,617
3082359035,3401138486,1662335529,1662336241,712,1111
3961973688,3268821463,1667049368,1667049813,445,275
3708101315,3252421501,1645339444,1645340389,945,407
3865463499,3623092479,1661171102,1661171616,514,1249
3809623566,3775146250,1643778320,1643778693,373,1101
3271436858,3988913212,1661600543,1661601442,899,1764
3393314546,3790883274,1655443397,1655443888,491,1584
3449395269,3526218972,1644212120,1644212374,254,2266
3173791920,3977139394,1650121879,1650122156,277,177
3882879531,3139126728,1662313412,1662313431,19,1791
3156331863,3099785418,1641334005,1641334142,137,1203
3539797487,3882903150,1660082233,1660082997,764,891
3938097708,3805314214,1664426927,1664427645,718,519
3670267009,3395753607,1646186166,1646186743,577,1886
3838823979,3905744284,1664154708,1664155306,598,624
3643939596,3656158144,1658430501,1658430707,206,1815
3256736613,3774806676,1662274721,1662275352,631,710
3887054161,3434817228,1647376918,1647377059,141,1813
3589571844,3586101932,1656915441,1656915630,189,67
3746243275,3959383415,1647731351,1647731663,312,567
3655924018,3923980052,1656340769,1656341237,468,2233
3189111071,3354579861,1654766850,1654767461,611,1636
3996587507,3072219388,1654201637,1654201899,262,1872
3166492454,3203904444,1646761071,1646761237,166,668
3711059561,3493226566,1657576649,1657576790,141,1727
3070395663,3127812666,1662540673,1662540909,236,2062
3200978578,3750160040,1665656244,1665656908,664,1117
3532401461,3173909495,1641487398,1641488329,931,2119
3655924018,3491398730,1658494762,1658495448,686,1655
3802410450,3794715398,1642008225,1642008317,92,163
3232737784,3777597419,1665930640,1665931383,743,807
3260174905,3281907019,1641372846,1641373824,978,1564
3581207584,3307730398,1642726486,1642727142,656,2429
3341591226,3897491493,1666922184,1666922888,704,196
3127419046,3248900308,1644855350,1644855648,298,812
3845496977,3357403419,1664095115,1664095373,258,202
3881554146,3462224632,1649012370,1649013253,883,2068
3408240731,3642771281,1656297378,1656297536,158,267
3957430800,3428287409,1661074634,1661074806,172,638
3535941714,3614206353,1666079012,1666079074,62,1359
3647549073,3066546417,1667181592,1667182589,997,1729
3306871271,3190969092,1660381973,1660382417,444,2451
3929901413,3751475341,1669420366,1669420471,105,810
3360575138,3911392700,1646965611,1646965965,354,2153
3533274758,3630318253,1659776686,1659776920,234,1329
3511397819,3438892275,1666829822,1666830260,438,649
3604435641,3637981738,1647068008,1647068134,126,294
3994927164,3357858376,1654184874,1654185084,210,2296
3038823274,3075780193,1658745627,1658746449,822,1110
3181181141,3000780515,1648190745,1648190760,15,2213
3901026791,3574285791,1653446971,1653447931,960,234
3316496524,3085001659,1649263847,1649263957,110,565
3744386868,3640571571,1668670057,1668670313,256,947
3188384391,3301119536,1667057087,1667058043,956,317
3539866422,3980781580,1642926954,1642927552,598,438
3925364546,3285030317,1652363884,1652364533,649,501
3184178717,3539303536,1647511507,1647512307,800,947
3291175188,3758708262,1647769353,1647769785,432,2175
3870877628,3517149250,1649860527,1649860557,30,1110
3128529900,3173667762,1650625424,1650625737,313,2409
3537214664,3134890095,1650815289,1650815353,64,2188
3628963667,3781446747,1662298221,1662299096,875,1943
3614627046,3440324329,1663115607,1663115706,99,1622
3158209281,3212043381,1669523738,1669524085,347,337
3845496977,3065298582,1664119613,1664120267,654,1129
3936329512,3968564476,1661748768,1661749399,631,2283
3061924533,3314583046,1661049521,1661050200,679,613
3046006152,3075563867,1650357499,1650358030,531,2304
3060970440,3553301078,1665685068,1665685494,426,1121
3879257961,3769647112,1659230338,1659231096,758,1028
3648593799,3204963755,1655784719,1655785070,351,1744
3471638565,3342315965,1657202112,1657202622,510,2215
3430464852,3884018587,1653351008,1653351273,265,113
3011225738,3541060382,1665932135,1665932963,828,86
3734004050,3920277028,1642222006,1642222380,374,1489
3660839110,3143226144,1664322519,1664323492,973,1814
3683739941,3445666899,1668317295,1668317650,355,2241
3786861325,3587874085,1657686659,1657687073,414,693
3660577882,3749702246,1663359957,1663360665,708,91
3506345760,3063791472,1665448096,1665449057,961,554
3650444993,3432186900,1649163349,1649163797,448,15
3301093931,3915986965,1652958795,1652958931,136,1984
3446812207,3054639823,1663412798,1663412827,29,244
3821064356,3269629374,1646697751,1646698020,269,1468
3590361712,3465406980,1642055156,1642055819,663,1595
3368654717,3809059026,1659811319,1659811601,282,2017
3651055879,3690349378,1648821609,1648822015,406,646
3423918005,3541200701,1656330176,1656330224,48,1127
3991542844,3907213401,1659344802,1659345529,727,2158
3523099697,3672482112,1652608275,1652608341,66,924
3815507952,3593603889,1645966816,1645966825,9,2106
3391262941,3832252723,1660531889,1660531979,90,739
3976156173,3260571568,1642304785,1642305420,635,141
3713129998,3611062566,1651938133,1651938646,513,409
3809642935,3573941843,1648804977,1648805705,728,716
3540799427,3554676369,1645262714,1645262900,186,1756
3018651462,3480314503,1653492158,1653492740,582,899
3302294195,3283155844,1648342917,1648343601,684,2039
3339025394,3513349474,1661888224,1661888329,105,56
3077143208,3981846169,1645489168,1645489189,21,978
3450023391,3253059691,1650995893,1650996333,440,531
3914601322,3839566998,1647063972,1647063984,12,1595
3472375572,3225989431,1658096165,1658097162,997,2395
3122818832,3151346211,1668591391,1668591588,197,1913
3148691436,3152933136,1649623051,1649623983,932,2486
3972195042,3363611494,1667711627,1667711641,14,1709
3289615980,3777846262,1665166851,1665167546,695,45
3481811999,3802790977,1641815817,1641816296,479,1807
3527995096,3011466658,1646429572,1646429982,410,1455
3446289365,3710394011,1649584861,1649585086,225,2173
3163662966,3367768003,1643895770,1643896473,703,1085
3515845767,3225616352,1667985500,1667986344,844,1212
3108427765,3191792012,1665390495,1665391179,684,1668
3566834497,3773207612,1645671560,1645671789,229,155
3965434074,3827195774,1646379309,1646379688,379,401
3048388831,3356034290,1657418848,1657419330,482,720
3520943619,3284628242,1654782052,1654782089,37,635
3258460512,3672524498,1659148224,1659148682,458,321
3854390772,3366354894,1650599521,1650600495,974,1788
3708809295,3153831709,1657048512,1657049391,879,936
3520324090,3811672443,1656405123,1656405647,524,2018
3637609349,3842445140,1654098466,1654099087,621,119
3733975709,3736260750,1642817221,1642817659,438,1438
3108230028,3670291498,1643581546,1643581764,218,1647
3421078448,3555912894,1658588058,1658588736,678,975
3840807781,3615666134,1649419965,1649419972,7,426
3317318302,3518322544,1668750425,1668750790,365,1773
3271759672,3156928973,1664186034,1664186705,671,150
3883703576,3637518238,1660881366,1660882305,939,885
3275301708,3355798436,1647895173,1647896030,857,945
3877090261,3587497382,1669057148,1669058069,921,318
3818319301,3597661669,1644703090,1644703717,627,1224
3947879014,3559023463,1645437217,1645437885,668,1098
3281923852,3612612273,1651610475,1651610529,54,689
3960494982,3985491144,1645448473,1645448496,23,547
3462825977,3763804073,1647384371,1647384680,309,1616
3389448374,3840953967,1658951972,1658952037,65,1494
3824545323,3110121278,1647980378,1647981268,890,2489
3176252124,3663474230,1658626648,1658627286,638,928
3681795615,3875243979,1668906834,1668907144,310,1236
3211514286,3294783182,1650116987,1650117488,501,1314
3334171572,3824478322,1647807619,1647808056,437,289
3060674509,3830975217,1666898440,1666898971,531,1549
3038244365,3482933937,1648699417,1648700088,671,1912
3763991129,3742005806,1646007413,1646007520,107,576
3544965463,3970820689,1646211115,1646211244,129,31
3741983763,3310512172,1666531579,1666532172,593,2238
3359212197,3426666423,1644254094,1644254501,407,1853
3794103075,3806652632,1641223433,1641224007,574,573
3987979637,3929638122,1642796277,1642796483,206,1475
3563103144,3878810894,1645303330,1645303566,236,1140
3814017798,3002029298,1660649450,1660649812,362,2338
3928930330,3092118254,1650084181,1650084938,757,1141
3540737045,3405388298,1667279646,1667280321,675,2457
3113321914,3817252660,1647727295,1647728038,743,602
3012930968,3862583365,1652139811,1652140760,949,908
3243086924,3865282317,1652480924,1652481428,504,109
3642498039,3704818655,1655330803,1655331314,511,2265
3515367610,3793232281,1642282697,1642282899,202,181
3583859826,3513925385,1643957689,1643957722,33,356
3347462301,3344394548,1641259960,1641260482,522,819
3217719618,3341248102,1664436240,1664436358,118,468
3376287193,3527869582,1653591363,1653591810,447,28
3052063374,3048386186,1668279085,1668280011,926,596
3926088173,3722859316,1664765686,1664765963,277,1178
3211945942,3730337290,1658782132,1658782434,302,1456
3189300345,3131735006,1655892259,1655893065,806,550
3069225011,3850474820,1644640068,1644640438,370,1301
3015956370,3605308632,1665662616,1665662777,161,2444
3003243547,3402354750,1655539595,1655539684,89,828
3548609816,3537450451,1660748039,1660748990,951,2410
3409034003,3258399411,1646297410,1646297512,102,1187
3201629659,3572896327,1661905487,1661906370,883,2479
3608048838,3656829277,1668707769,1668708522,753,1379
3431892611,3664989774,1662488967,1662488977,10,1652
3344279346,3032800454,1662895549,1662895593,44,1088
3062844769,3429684538,1664419388,1664419489,101,1901
3738981251,3379726555,1655040542,1655040881,339,2305
3381845607,3131156982,1647270276,1647271256,980,1501
3377528840,3409962434,1662066853,1662067846,993,1443
3018013930,3653218860,1650803796,1650804343,547,1512
3821120962,3435578430,1649194114,1649194565,451,824
3912183552,3431892611,1665578335,1665578697,362,2352
3526815452,3759967696,1663347294,1663347318,24,552
3569738818,3107530825,1653772735,1653772766,31,1142
3002876565,3225741855,1665310313,1665310385,72,1928
3845522882,3353956873,1656897044,1656897209,165,481
3390329949,3264081641,1658876670,1658877234,564,1481
3752621490,3474216203,1649982493,1649982772,279,1423
3968337751,3070676307,1668265368,1668265612,244,96
3525978019,3465229825,1669691372,1669691577,205,1456
3265262512,3766274699,1665334880,1665335470,590,1766
3927920093,3275494433,1645728759,1645728890,131,1234
3964524277,3356883463,1654843962,1654844486,524,1587
3382943055,3269622220,1647241455,1647242152,697,78
3387264235,3910427189,1653980612,1653981569,957,761
3949445116,3921189235,1654966518,1654966970,452,193
3489909547,3723110330,1650814101,1650814161,60,1096
3180062640,3195138141,1654057750,1654058339,589,1048
3897433648,3882030333,1643620031,1643620239,208,1739
3849902434,3080829502,1658305261,1658306044,783,1462
3997810649,3675418278,1650320294,1650320352,58,1134
3218686367,3914613880,1651048616,1651049094,478,1536
3986825518,3232794733,1649863157,1649863393,236,83
3389497658,3379548317,1648140301,1648141106,805,127
3557556781,3150884811,1659330403,1659331189,786,173
3773434774,3656448203,1663839446,1663839850,404,832
3272250396,3625691221,1644166082,1644166505,423,1350
3844822083,3284940142,1657041280,1657042105,825,270
3250566757,3660891061,1666919444,1666919498,54,1373
3662876111,3785657136,1649999288,1650000161,873,111
3036801405,3282261851,1653989819,1653989839,20,721
3235049473,3225068874,1666902258,1666902771,513,211
3232436630,3070241461,1653978082,1653978182,100,608
3816194055,3828196026,1656388686,1656389681,995,688
3076307729,3019576854,1643703653,1643704242,589,1018
3198240429,3930205120,1650250290,1650250959,669,390
3010649870,3665668423,1658673403,1658674162,759,2082
3315544584,3606998838,1651123126,1651123290,164,752
3750083020,3251409316,1653422979,1653423595,616,2252
3891850013,3692861248,1667102754,1667102900,146,547
3834011879,3678720106,1661483866,1661484185,319,301
3428987981,3781537659,1643513675,1643513925,250,1071
3186371475,3634871077,1647588395,1647589334,939,1291
3026095831,3432186900,1641679648,1641679753,105,997
3971391515,3694762938,1643561992,1643562185,193,1899
3076431464,3997810649,1669726734,1669727516,782,614
3511325003,3699183333,1643679747,1643680299,552,459
3513349474,3040037607,1644311650,1644311718,68,1933
3934890046,3139928298,1656080649,1656080703,54,659
3030192990,3401738714,1643180049,1643180603,554,2370
3895277580,3428287409,1647593818,1647594451,633,90
3814045699,3708896596,1647615554,1647615698,144,82
3642946322,3313687025,1657150469,1657151407,938,651
3776148003,3846585557,1641318289,1641318519,230,772
3551884757,3439660528,1656686376,1656686812,436,1425
3501770020,3725480364,1659706810,1659707782,972,1867
3890940747,3294319716,1659542752,1659542934,182,616
3926467866,3007339106,1664760785,1664760853,68,618
3414277030,3824353209,1654601568,1654601765,197,1214
3993798870,3654899608,1658615622,1658616195,573,1923
3435252882,3277327180,1660051062,1660051333,271,2239
3604769442,3177427428,1665174552,1665175387,835,1965
3469524230,3458645622,1650760591,1650761396,805,1041
3208220195,3522621112,1664998592,1664999061,469,1771
3649036884,3269573550,1657585708,1657586023,315,609
3978987003,3551344746,1641532211,1641532582,371,2282
3659204779,3599160097,1650533524,1650534161,637,607
3109127825,3003422357,1658510693,1658511582,889,2293
3611967437,3360051725,1656559154,1656559792,638,1794
3571766829,3013314607,1661563671,1661564650,979,564
3233040662,3812800144,1658532546,1658532772,226,2291
3900535275,3757044916,1666184127,1666184896,769,569
3176526207,3868460834,1648593012,1648593997,985,160
3888703674,3458493864,1665590054,1665591026,972,2143
3990870728,3662355477,1663554586,1663555523,937,18
3154991935,3981657344,1654345186,1654345557,371,247
3075288965,3738624659,1666998166,1666998486,320,2459
3106429728,3115367011,1654876444,1654877045,601,1551
3048296949,3664242822,1645803027,1645803783,756,1974
3934326645,3747062640,1642650169,1642651044,875,671
3608048838,3044390847,1654629494,1654630441,947,948
3226559906,3289330422,1652747146,1652747276,130,910
3914348680,3335242048,1655542801,1655543704,903,2211
3051903509,3453839667,1652690393,1652690987,594,697
3828322397,3291984936,1653807169,1653807986,817,1634
3818655962,3456811507,1646422431,1646422601,170,2379
3022428512,3961672171,1644797155,1644797345,190,988
3041563987,3227652803,1663753077,1663753592,515,598
3764343778,3481085072,1643056319,1643056613,294,2441
3331604266,3836331716,1665369825,1665370757,932,1257
3687874431,3031816428,1662374553,1662375100,547,1089
3268670465,3391056146,1668662509,1668663106,597,845
3731116644,3130612494,1652187461,1652188389,928,1711
3211047702,3599714580,1644558602,1644559386,784,547
3888851378,3166274990,1668843490,1668843914,424,910
3522814184,3928685907,1652482320,1652482881,561,1130
3592596587,3637663893,1646185324,1646186279,955,1991
3615387566,3043256301,1657987372,1657987900,528,2394
3261403182,3612061421,1661253184,1661253676,492,1546
3064701445,3074269946,1659830893,1659831663,770,1578
3927066139,3583307819,1651127957,1651128458,501,362
3067403592,3138958890,1655705018,1655705275,257,983
3653881945,3075313832,1642808573,1642808847,274,2435
3397169008,3543872563,1649923116,1649923739,623,1409
3391711118,3526798607,1657841105,1657841863,758,168
3999551936,3329887381,1640999195,1640999307,112,116
3091882022,3230775095,1652805876,1652806197,321,296
3598841094,3114764410,1660661015,1660661914,899,1804
3634010080,3351182329,1647477481,1647477950,469,1318
3547334414,3566534974,1667371056,1667371735,679,2090
3409962434,3250253670,1648621098,1648622049,951,483
3131683456,3894616795,1651775726,1651775864,138,350
3634871077,3284840023,1650993511,1650994339,828,1127
3282261851,3873840731,1641056936,1641057144,208,1376
3261866390,3282079727,1647306959,1647307547,588,406
3700813458,3243883781,1652204450,1652205163,713,1208
3086322921,3727618645,1661727399,1661727610,211,1940
3400233871,3024431618,1652131369,1652132353,984,1487
3268745445,3269680998,1658630004,1658630673,669,1026
3707070213,3030174879,1659985675,1659985773,98,624
3224617784,3794462820,1666807785,1666808489,704,2082
3963546042,3128287586,1668197209,1668197494,285,1832
3840953967,3620395885,1666541349,1666542163,814,2228
3272428764,3421178618,1658164701,1658164820,119,792
3212218759,3947158263,1648651041,1648651708,667,1061
3711442352,3867860336,1666056860,1666057472,612,79
3641959079,3785586097,1652639048,1652639255,207,1793
3119752328,3035895563,1648482819,1648483627,808,1569
3368204842,3014552263,1668401395,1668401870,475,2127
3893671286,3501972053,1666473291,1666473494,203,1816
3991673197,3042702763,1644532545,1644532609,64,156
3780182766,3496617169,1641836427,1641837407,980,712
3106490071,3729321195,1657846215,1657847080,865,2076
3581449963,3269956451,1667864938,1667865573,635,422
3826827617,3852633699,1643603667,1643604625,958,1803
3701151902,3885087517,1646053926,1646054020,94,298
3552494506,3468922263,1665597368,1665597404,36,1400
3522103750,3286696325,1665450660,1665450885,225,897
3113005024,3235476099,1643557156,1643557506,350,1661
3685505113,3276618988,1659714823,1659715487,664,2294
3073474496,3183640403,1647803189,1647803633,444,40
3967372197,3294984880,1646609587,1646610317,730,311
3424790413,3088562105,1668749058,1668749475,417,868
3528069102,3818823702,1662988696,1662989516,820,685
3222282745,3393458100,1654594231,1654594350,119,1832
3676690161,3806251232,1666713315,1666713617,302,423
3748944220,3256873642,1650252035,1650252544,509,181
3822146001,3061462743,1653969107,1653969246,139,154
3775753518,3803000258,1662901599,1662901745,146,12
3753391012,3045691620,1661290845,1661291289,444,174
3710422072,3468963532,1661532794,1661532973,179,2237
3511325003,3045570288,1658746781,1658746903,122,1256
3607717009,3052822229,1666860016,1666860783,767,2071
3433237569,3031827531,1647043271,1647043854,583,288
3249261763,3457284809,1649677845,1649678127,282,1764
3823133313,3895334140,1667925466,1667926266,800,1876
3805928545,3258057377,1655807587,1655808525,938,750
3878177076,3337601088,1662116615,1662116727,112,593
3920028342,3961189789,1646812812,1646813272,460,2138
3077827896,3599007187,1660547937,1660547997,60,2329
3165492854,3081213963,1666843892,1666843995,103,927
3061924533,3350812449,1669125211,1669125421,210,574
3392469094,3113427537,1643949408,1643949710,302,1679
3593861215,3729325351,1660473416,1660473873,457,2032
3895855296,3081725518,1642569114,1642569150,36,477
3852633699,3268826534,1669735598,1669735886,288,1525
3520385284,3099424302,1660423987,1660424874,887,1811
3067220098,3126499590,1657000112,1657000469,357,2480
3590259850,3423825173,1668385547,1668386291,744,1220
3235586138,3550889203,1651832463,1651833325,862,1219
3506822540,3902705203,1658893206,1658893888,682,2393
3172524712,3382015551,1659249262,1659249286,24,1834
3823942349,3148041041,1662793589,1662794532,943,1220
3162836777,3411181030,1642903740,1642904060,320,989
3114183830,3366262960,1643370816,1643371166,350,1608
3194379247,3238081511,1641898831,1641899108,277,2090
3985585282,3201068600,1664865227,1664865553,326,1702
3935822380,3322287315,1642613158,1642613659,501,318
3916557399,3812034379,1660296310,1660296391,81,1421
3232285701,3772337054,1648123416,1648124171,755,2326
3534218813,3750474676,1667545969,1667546651,682,1894
3140055258,3470570814,1663356521,1663357051,530,1680
3028535162,3981065835,1655450635,1655451446,811,1588
3976095218,3202161567,1654708392,1654708588,196,1756
3335565751,3634885711,1642083104,1642084061,957,814
3790896269,3692568210,1662327194,1662327446,252,2121
3759867623,3168625610,1646711126,1646712038,912,1327
3254194915,3242406857,1667666074,1667667019,945,1770
3995868243,3381398230,1666798620,1666799076,456,2021
3093254727,3345138946,1645448510,1645448933,423,588
3929407612,3410655469,1651866763,1651866834,71,397
3431892611,3687689210,1659164636,1659165068,432,1312
3174425370,3862468039,1659926772,1659927486,714,1834
3127447356,3562547940,1653999219,1653999358,139,1852
3095430228,3014511835,1663238755,1663239511,756,2407
3007328261,3620303845,1643397958,1643397991,33,1710
3681631482,3665599335,1667794963,1667795264,301,295
3404034127,3467613173,1651666844,1651667563,719,1442
3572164547,3336551797,1661291310,1661291942,632,2360
3307225202,3902970032,1643670561,1643671514,953,654
3927649358,3585100772,1641286897,1641286946,49,1862
3466204914,3510936211,1661498647,1661499287,640,1407
3537107415,3538823780,1656958485,1656958752,267,97
3404945581,3243502165,1650438888,1650439241,353,32
3579404607,3841660750,1668529827,1668530252,425,740
3715540162,3185512282,1646032464,1646032634,170,886
3324455158,3749756110,1656819221,1656819547,326,1576
3430387951,3867101565,1644940120,1644940310,190,613
3376552382,3814045699,1665105837,1665106738,901,1421
3118358674,3099818927,1645346879,1645347470,591,1721
3919478201,3894175918,1667576697,1667577116,419,218
3574773588,3745712275,1669746268,1669747050,782,1654
3186367687,3128613298,1650111151,1650111197,46,1685
3728498046,3243883781,1654238301,1654238632,331,1333
3572792752,3173909495,1659415212,1659415315,103,809
3623685885,3592519306,1660124451,1660125035,584,956
3021287506,3111163302,1651188472,1651188762,290,2417
3072347750,3839688715,1659093911,1659094455,544,553
3067150549,3421178618,1654473988,1654474482,494,1606
3048328762,3671789954,1662568347,1662568403,56,104
3962261300,3311244386,1643502256,1643502907,651,1109
3918383192,3866541862,1648288386,1648289066,680,1980
3098342545,3540737045,1659222809,1659223799,990,910
3786516095,3927952722,1661599696,1661599700,4,413
3392569339,3007911826,1651301480,1651302237,757,558
3405346555,3753180150,1651923847,1651924113,266,269
3128839608,3676132016,1661359873,1661360331,458,288
3723957807,3163012662,1642667613,1642668361,748,1552
3057574793,3782878084,1669502602,1669502718,116,124
3105789496,3913071555,1665523536,1665523750,214,564
3476283460,3976817467,1644245107,1644245634,527,532
3356728242,3720240255,1643412812,1643412887,75,1761
3670063835,3095932716,1653127754,1653128147,393,2219
3954799831,3927214415,1664395013,1664395654,641,1815
3671154785,3854859043,1646243474,1646243959,485,385
3132210207,3345186165,1644668709,1644669573,864,520
3043656500,3557556781,1666267400,1666268202,802,2410
3759986276,3814588354,1650036982,1650037418,436,2382
3780678233,3887586447,1644130750,1644130932,182,1403
3311921613,3071765048,1643821450,1643822136,686,2235
3118976994,3759787118,1645422462,1645422685,223,667
3136707992,3813318946,1660556798,1660556990,192,2427
3234141140,3719965258,1645097548,1645097744,196,1826
3141196312,3636619501,1656076499,1656077180,681,324
3830850007,3180728306,1657610746,1657611361,615,590
3248452729,3267045921,1664804918,1664805025,107,1397
3562104036,3381398230,1665945002,1665945004,2,994
3654861844,3163662966,1660066115,1660067104,989,1812
3124051904,3514335388,1655705542,1655705744,202,2068
3297963936,3799624292,1667043127,1667043943,816,1348
3175976694,3198149459,1647296284,1647297121,837,877
3536832504,3037279735,1661366795,1661366976,181,303
3683361867,3276763839,1653694441,1653695041,600,683
3294569676,3351218513,1648466182,1648467120,938,2498
3968000691,3532926054,1669089291,1669089841,550,2365
3345650412,3660162411,1656390208,1656390418,210,2230
3928354041,3273827707,1650509309,1650509890,581,2392
3581570568,3993504996,1656399828,1656400022,194,232
3476405785,3102669962,1661940178,1661940386,208,1933
3914601322,3920277028,1667115672,1667116410,738,2275
3205472801,3882903150,1650412025,1650412722,697,1102
3760930897,3600977488,1651669355,1651670268,913,390
3313615371,3465229825,1662699746,1662699973,227,1169
3454392909,3592264904,1657514326,1657515194,868,461
3604755020,3526798607,1643875771,1643876503,732,2067
3226092646,3222119601,1664211998,1664212933,935,647
3900951859,3481620613,1647690857,1647691313,456,95
3069353793,3150793263,1665419997,1665420021,24,2480
3003005378,3709736172,1665572671,1665573008,337,1530
3121651540,3261376049,1658652630,1658653300,670,1488
3327873529,3587171844,1650092225,1650092310,85,1046
3155320608,3182703869,1655391549,1655392133,584,2301
3570152654,3834160941,1660693910,1660694049,139,313
3014975304,3976095218,1656048434,1656049117,683,1508
3354330082,3153552268,1663433559,1663434020,461,675
3306290309,3103228367,1656888003,1656888422,419,1245
3321105707,3533936136,1666179573,1666179957,384,1981
3577216621,3833345079,1663624579,1663624582,3,1331
3596500107,3879520142,1669757852,1669758845,993,686
3622596133,3486096604,1641556336,1641556885,549,1961
3132863382,3439120258,1664450131,1664450707,576,1908
3294703062,3137200123,1666087439,1666088102,663,2250
3011459628,3949133704,1662863572,1662863766,194,1549
3778068384,3885235661,1657912786,1657912829,43,2292
3095594016,3893872926,1656999115,1656999380,265,424
3151896132,3658017612,1642138434,1642138673,239,745
3182643672,3303973335,1660997276,1660998265,989,2062
3294357161,3952670371,1667292698,1667293021,323,1200
3937628057,3346530861,1661730716,1661731193,477,1346
3889730114,3095621927,1652311318,1652312090,772,2064
3553301078,3516488694,1666759131,1666759502,371,1445
3442244098,3425282516,1652664040,1652664059,19,1028
3965220830,3174544371,1664344360,1664345116,756,1477
3576317139,3761147252,1664598057,1664598934,877,937
3691925367,3222119601,1654692280,1654692283,3,2343
3363651899,3628963667,1647639739,1647640202,463,1171
3281725583,3153989234,1658799590,1658799877,287,2059
3135405364,3637923107,1664193108,1664193575,467,482
3947521897,3250208944,1650871404,1650872310,906,841
3014517714,3768013956,1645393243,1645394009,766,1551
3806875541,3505295000,1652632499,1652633396,897,1991
3206512870,3164391025,1659431451,1659431591,140,1316
3742005806,3668456327,1645606786,1645607321,535,1120
3474376744,3358374850,1653637075,1653637683,608,962
3042052031,3461938856,1663780858,1663781355,497,2485
3555186812,3857081560,1656900373,1656900817,444,337
3808952164,3478570785,1649842813,1649843016,203,2419
3977539783,3157600969,1652919565,1652920155,590,1912
3784698616,3429660049,1669559721,1669560098,377,376
3235992794,3584704567,1668619538,1668619578,40,2316
3855537172,3042446262,1666818008,1666818976,968,1802
3981515277,3155807587,1662926133,1662926729,596,851
3125436993,3147245859,1659512593,1659512714,121,1347
3453070428,3749897140,1651595972,1651596631,659,1672
3971203354,3947158263,1657691058,1657691777,719,61
3236132865,3528439013,1652617148,1652617782,634,1446
3002396640,3700419429,1644119696,1644120257,561,1218
3206512870,3049579265,1647640804,1647641616,812,1925
3424897066,3449395269,1646698451,1646698885,434,709
3632155506,3166483466,1655425785,1655426356,571,1966
3826737259,3097563397,1659675420,1659676278,858,699
3602829591,3611269407,1658410196,1658410680,484,2361
3528271389,3732796331,1651934271,1651935266,995,2156
3731588710,3810861883,1658014139,1658014478,339,1461
3857841054,3474081200,1650832083,1650832231,148,2257
3125813072,3118443532,1654803332,1654804202,870,1708
3260861147,3526687041,1657584426,1657584615,189,713
3321699949,3819467184,1667250790,1667251347,557,79
3459018363,3680694926,1667580580,1667581170,590,1287
3354574342,3823682564,1643885631,1643886251,620,2047
3574773588,3611685224,1647986056,1647987031,975,2205
3289696366,3301148308,1668960133,1668960759,626,2336
3789380087,3271409183,1651928973,1651929232,259,378
3346948485,3024554792,1666649749,1666650246,497,590
3996469603,3937728696,1646016675,1646016737,62,1463
3474376744,3325944344,1650573396,1650574109,713,1593
3654861844,3598841094,1651017585,1651018465,880,132
3463032893,3723944830,1666225751,1666226492,741,1508
3594009328,3267248595,1658538231,1658538781,550,1019
3133767042,3248395971,1642818996,1642819569,573,1396
3507338655,3647549073,1650350570,1650351447,877,853
3546824914,3354395496,1659939777,1659940732,955,239
3537592483,3248733503,1666585910,1666586798,888,853
3481466662,3792708367,1641649872,1641649916,44,1266
3278397100,3570335491,1645173417,1645174120,703,162
3989991456,3791279041,1668980959,1668981476,517,859
3956887611,3101265323,1644171884,1644172487,603,1145
3088595440,3523465225,1657572770,1657573118,348,2147
3197661010,3333336166,1663762802,1663763100,298,547
3958539607,3012917381,1657755177,1657755260,83,1156
3132207782,3561881366,1666200794,1666201275,481,1207
3517149250,3062464540,1668498480,1668499172,692,988
3783119155,3715731774,1653300538,1653300682,144,1470
3582471153,3995270744,1646272847,1646273358,511,1685
3216241275,3367768003,1656822186,1656823129,943,1240
3465229825,3252021647,1668679526,1668680459,933,2255
3151697582,3579684205,1652097842,1652098484,642,856
3068161140,3478280943,1641542384,1641542589,205,2217
3734779425,3711048943,1643927419,1643927466,47,2010
3119036139,3473170336,1664538255,1664539080,825,512
3592320524,3058290794,1652547413,1652547587,174,2449
3329887381,3936193189,1667965170,1667965474,304,1823
3131735006,3603399306,1656049145,1656050113,968,1862
3991310779,3099013723,1662740475,1662740932,457,719
3522103750,3268182022,1655354594,1655354629,35,800
3829347049,3259260257,1656569182,1656569432,250,2277
3861123581,3785883615,1657101053,1657101561,508,631
3925523737,3464235741,1668302111,1668302323,212,2105
3252973419,3316318605,1656159483,1656160393,910,592
3488151008,3752000675,1653238854,1653239353,499,1470
3125314664,3597251704,1651610273,1651611038,765,1867
3436198180,3678149544,1657260083,1657260900,817,2263
3562472924,3162641272,1663071011,1663071392,381,1580
3686944200,3093523046,1645718902,1645719534,632,697
3177951035,3118057575,1641606626,1641606779,153,404
3881143383,3976817467,1645174857,1645175745,888,827
3912672075,3229318915,1652482223,1652482423,200,1943
3880476189,3660891061,1654394613,1654395424,811,2143
3060989519,3037090215,1650961140,1650961525,385,1107
3289061595,3285747162,1668714526,1668714953,427,135
3673549679,3281061177,1654957809,1654958715,906,1558
3678152024,3163662966,1643520575,1643521534,959,141
3695411154,3180534430,1653645701,1653645748,47,1983
3722380765,3877049401,1658381631,1658381975,344,1032
3045879019,3284630826,1647187084,1647187964,880,2451
3315583401,3837062335,1661135361,1661135369,8,1788
3343153937,3196304056,1649756223,1649756238,15,1174
3172018366,3429101401,1643399965,1643400435,470,1126
3006388757,3357692565,1644371935,1644372482,547,346
3750192699,3154551351,1648467582,1648467864,282,25
3626345917,3636572173,1656037385,1656037965,580,448
3331882759,3266498789,1665085671,1665086029,358,525
3260246509,3545781567,1659538090,1659538645,555,2431
3164550059,3620223775,1660806475,1660807069,594,2321
3444067052,3112356239,1642948846,1642949361,515,434
3843576243,3856160688,1654822056,1654822605,549,934
3711847265,3202460554,1659113195,1659113393,198,636
3047372637,3079905449,1655369330,1655370171,841,91
3891027417,3990312725,1661467193,1661467835,642,1626
3760047951,3242912660,1646988965,1646989866,901,2391
3025310934,3090731052,1667458556,1667459512,956,1170
3725903222,3453839667,1646563202,1646564138,936,1301
3195629628,3515941468,1642718785,1642719623,838,550
3135951344,3104210284,1650691512,1650692320,808,2218
3524282034,3882879531,1657817886,1657818414,528,707
3457284809,3681489851,1661765217,1661765262,45,749
3818655962,3911849911,1655182794,1655183425,631,181
3764175850,3889544424,1668776383,1668776603,220,322
3486286893,3689375835,1669647345,1669648316,971,981
3415041326,3928930330,1655263534,1655264332,798,1925
3980867331,3291286959,1648223358,1648224266,908,2052
3480642253,3988674966,1654363116,1654363745,629,700
3051395031,3308531560,1645758164,1645758391,227,71
3784105182,3210986714,1654387891,1654388060,169,138
3365807352,3046500774,1662707868,1662708371,503,1172
3270919620,3022252567,1660681700,1660682585,885,1478
3968795612,3359296227,1665597416,1665597570,154,1161
3915344164,3334207071,1647167978,1647168619,641,269
3286463125,3180600647,1662419573,1662419713,140,2407
3741494242,3881554146,1658251581,1658251748,167,304
3216657133,3093589416,1653714620,1653715583,963,2161
3181237998,3577627752,1650947775,1650947802,27,1784
3945358150,3510634049,1656342785,1656343433,648,556
3510761729,3110591514,1661680258,1661680799,541,1904
3462483679,3325735696,1668602942,1668603311,369,620
3102753256,3232128014,1655758216,1655758977,761,1643
3740728884,3966881800,1658689272,1658689976,704,1037
3183079019,3273289104,1656452400,1656452407,7,96
3553328177,3680810431,1656417463,1656418292,829,1062
3400000869,3393314546,1659637344,1659638062,718,136
3049579265,3016992122,1655974046,1655974616,570,808
3190508233,3359417056,1660921534,1660922201,667,129
3923137418,3623782659,1651670028,1651670476,448,516
3452564658,3738981251,1655376445,1655377353,908,330
3003858315,3915111520,1663160653,1663161436,783,598
3438084709,3711943152,1661697173,1661697744,571,706
3675481622,3002931773,1643124605,1643125488,883,1562
3585816096,3947083981,1647177234,1647178011,777,1440
3878698797,3969744786,1650033485,1650033506,21,621
3764343778,3210913409,1655835674,1655836005,331,925
3898494020,3532355049,1668166106,1668166113,7,2021
3276142713,3446946900,1651981300,1651982120,820,610
3786811867,3721751204,1666397813,1666397918,105,2439
3053991932,3042176960,1654115689,1654115757,68,1770
3155871721,3987979637,1650310307,1650310563,256,90
3881942272,3105903246,1650829914,1650830703,789,960
3328699609,3597557082,1666308001,1666308544,543,1861
3345875910,3821391381,1669254298,1669254451,153,1353
3482483232,3340511048,1663757427,1663758226,799,854
3217494787,3163551629,1659200347,1659201341,994,2220
3666072303,3070676307,1650637220,1650637874,654,1767
3357478199,3762816561,1659857214,1659857403,189,109
3438474821,3370834194,1644260156,1644260418,262,2116
3796587240,3429445014,1641956976,1641957523,547,1960
3404020970,3103215750,1649804776,1649805701,925,2448
3324395012,3955219063,1660768977,1660769239,262,104
3749308364,3255492165,1658940814,1658941539,725,544
3220736075,3204336699,1645237240,1645237804,564,1956
3881143383,3697085492,1651750102,1651750992,890,1874
3508858140,3050701199,1653469189,1653469535,346,1054
3569743064,3025611145,1644549435,1644549664,229,439
3347317107,3639695113,1651704876,1651705831,955,373
3215040043,3343033950,1664436292,1664437174,882,758
3150289965,3130181848,1666509642,1666510362,720,888
3228073924,3055710852,1664274033,1664274467,434,342
3923683467,3637518238,1662617765,1662617971,206,2041
3217375075,3790964737,1649187225,1649187666,441,572
3185210514,3522103750,1660477991,1660478337,346,131
3711943152,3556648442,1648958117,1648958869,752,1153
3511593307,3022428512,1665351178,1665351275,97,2285
3293007803,3829209875,1655027957,1655028182,225,1199
3320792244,3249759052,1651117293,1651117998,705,2301
3634282428,3815462032,1657886715,1657887186,471,910
3975065378,3087640528,1642762586,1642762942,356,525
3474666564,3512100935,1663145566,1663146152,586,439
3034985161,3720248207,1652169042,1652169290,248,754
3070087815,3344285047,1653762977,1653763742,765,1997
3521023027,3645868952,1659617190,1659617301,111,265
3335565751,3556577780,1644914997,1644915247,250,582
3972397754,3785813162,1646402553,1646402817,264,1376
3610239794,3881000980,1661115523,1661116401,878,565
3478288963,3468324129,1645311225,1645311926,701,1857
3123441689,3787048351,1644750537,1644750868,331,372
3592453741,3795990774,1646004025,1646004502,477,1557
3976267689,3387938632,1650415101,1650415554,453,2327
3807549475,3143274658,1654803970,1654804065,95,390
3481293963,3796784054,1643369606,1643370037,431,129
3733484132,3161243271,1646111643,1646112386,743,1780
3095621927,3870574001,1659175179,1659175415,236,1115
3391898268,3312580754,1649139765,1649140459,694,939
3822935707,3250627439,1646798869,1646799405,536,1421
3128043317,3109465057,1642035706,1642036559,853,2095
3430464852,3572009360,1651294589,1651294995,406,1297
3935656272,3583307819,1645919283,1645919337,54,14
3939948508,3711048943,1648759505,1648760257,752,1483
3225857817,3790964737,1651778573,1651779053,480,784
3344637531,3802823421,1649485315,1649485865,550,569
3035135381,3657464089,1658712483,1658712918,435,1253
3804748811,3764298989,1650574576,1650575227,651,1762
3787048351,3060970440,1648801357,1648801705,348,2040
3084592361,3211839563,1644589879,1644590603,724,122
3861247260,3567980215,1661751652,1661752515,863,740
3111965011,3514680311,1661734834,1661735784,950,1385
3879766152,3288788264,1643826222,1643827153,931,908
3327795374,3742220718,1662926872,1662927701,829,2063
3881519714,3034147055,1660424354,1660425174,820,1887
3351218513,3444349973,1644875859,1644876203,344,843
3159525512,3469887287,1666909794,1666910474,680,354
3664273227,3490286406,1653468545,1653468653,108,1287
3858121838,3295385873,1641380087,1641380972,885,475
3145220460,3165129580,1650196883,1650197353,470,336
3200795190,3249512921,1657822169,1657822211,42,730
3946833004,3935822380,1656748106,1656748663,557,1611
3131820605,3816240060,1664139106,1664139928,822,1822
3584910336,3679045431,1668928684,1668929486,802,1664
3918397944,3975663862,1661833759,1661834459,700,1404
3398242179,3048388831,1651992277,1651992877,600,2060
3636621583,3745419810,1656796926,1656797337,411,1691
3793298032,3402578446,1654212113,1654212717,604,17
3533898881,3600796487,1641519015,1641519488,473,281
3066053770,3556577780,1652738559,1652739421,862,525
3004951157,3353422891,1665209063,1665209080,17,182
3816921514,3054160201,1652780226,1652780245,19,1998
3023576817,3081725518,1641659672,1641660553,881,2307
3469462520,3728797277,1643509215,1643510156,941,1000
3819415032,3660548799,1656576985,1656577705,720,989
3312336013,3624298459,1656380697,1656381631,934,601
3184680353,3375769320,1662739970,1662740637,667,1103
3835784338,3677539420,1654218535,1654219041,506,2342
3977987504,3043736420,1662270818,1662271192,374,331
3007702341,3900451371,1669051400,1669051944,544,710
3225901381,3891027417,1653807090,1653807702,612,1112
3674059710,3656656446,1666521164,1666521662,498,1774
3156483651,3134793811,1655744504,1655745474,970,2154
3030641135,3894690935,1643891413,1643891585,172,2048
3602955685,3328854884,1665145378,1665145577,199,742
3795299092,3069675415,1651252096,1651252614,518,1520
3824649355,3375769320,1653170563,1653171413,850,2026
3393606099,3016299339,1661569461,1661569925,464,1176
3977359273,3632283664,1659715576,1659715621,45,680
3215453691,3882879531,1642324794,1642325312,518,2305
3403389913,3371790369,1648914298,1648914738,440,1629
3037577001,3025133604,1654299040,1654299851,811,151
3102753256,3309396992,1658479082,1658479757,675,1876
3945332462,3294984880,1662121241,1662121887,646,766
3105243389,3863448086,1655241276,1655241942,666,2123
3255485773,3300694030,1659346039,1659346377,338,1257
3138638384,3403911906,1659998781,1659999067,286,495
3716137932,3565052722,1660564842,1660565180,338,1694
3314823389,3678404361,1645583531,1645584199,668,1257
3886720244,3824545323,1653149603,1653150408,805,52
3903588940,3813921952,1651201992,1651202683,691,473
3958507465,3850392190,1652150560,1652151049,489,2484
3297949666,3343855888,1668315131,1668315166,35,2034
3460669513,3444174394,1667406923,1667407217,294,872
3177651100,3752442248,1651288108,1651288810,702,1592
3486059916,3321699949,1645311037,1645311283,246,1808
3095834081,3407513744,1643744627,1643745610,983,1797
3050607996,3351216955,1660985442,1660986188,746,1313
3875008839,3841314189,1657564266,1657564886,620,1423
3294783182,3990144819,1667297440,1667297964,524,1136
3789727449,3725848338,1647341366,1647341726,360,1719
3508108339,3217173480,1660161813,1660161939,126,1454
3013314607,3303719777,1658740029,1658740985,956,325
3744196402,3141480547,1643139444,1643139921,477,699
3971524060,3264460374,1661232467,1661232555,88,959
3914926954,3077590635,1666518003,1666518561,558,1441
3298879351,3126987673,1655966512,1655967337,825,2041
3113516667,3266867093,1661835582,1661836134,552,1349
3714203425,3342685325,1663769471,1663770247,776,1116
3563967528,3312203382,1652110176,1652111038,862,1903
3431175768,3761556948,1653083277,1653083507,230,1199
3177628377,3977317498,1648102098,1648102178,80,776
3785883615,3261265769,1647885933,1647886810,877,2109
3570955260,3630318253,1662114845,1662115768,923,478
3651847351,3333037570,1658566842,1658566940,98,755
3226092646,3430464852,1663247587,1663248358,771,2236
3569244680,3044226207,1647215518,1647216259,741,1477
3044117851,3664408598,1645579396,1645579475,79,1966
3885893310,3103943430,1661552756,1661553208,452,552
3699183333,3726520685,1659205433,1659205915,482,260
3934199220,3944493334,1654136091,1654136947,856,742
3719744431,3484710507,1664476115,1664476891,776,2347
3493489568,3474402148,1649426279,1649426530,251,1123
3236975783,3715731774,1669294658,1669295652,994,273
3850906711,3288937566,1651336200,1651336333,133,1206
3561254848,3725117905,1654791507,1654792320,813,1332
3040889811,3104164320,1652811307,1652811561,254,472
3524109178,3371767777,1652135843,1652135988,145,1984
3597904540,3980139195,1652165100,1652165940,840,1508
3402155812,3699947490,1646260080,1646260670,590,1998
3437665905,3032465570,1644949879,1644950218,339,1566
3272879760,3748061416,1664361687,1664362586,899,2108
3707199669,3021621189,1666896665,1666896692,27,57
3047402472,3698906761,1655673130,1655673779,649,1341
3972917056,3341890542,1667879328,1667879369,41,2065
3297681098,3442408044,1661213730,1661214449,719,1695
3924583665,3591101388,1651114125,1651114827,702,764
3781580109,3321202962,1669319284,1669319823,539,291
3802614854,3324395012,1666604963,1666605465,502,505
3677574672,3683326795,1662389744,1662390100,356,2324
3189211545,3342685325,1645964548,1645965008,460,526
3475846394,3650199111,1651693198,1651693789,591,1787
3132802864,3287988080,1656721938,1656722915,977,4
3167716044,3651110510,1648309748,1648310390,642,1381
3137891271,3551771231,1665238521,1665238572,51,1050
3594707374,3952663430,1645911908,1645912309,401,1409
3607608267,3131331478,1666693300,1666693854,554,1458
3993580342,3729340640,1657038137,1657038614,477,2157
3141134453,3782941796,1644122880,1644123034,154,121
3886368625,3899618702,1648844053,1648844264,211,2154
3389497658,3733849983,1644672556,1644672768,212,215
3029500930,3316398180,1652268088,1652268577,489,2222
3634492534,3875440466,1646638025,1646638930,905,1544
3336551797,3285243887,1655226918,1655227527,609,760
3421671936,3069318012,1645248696,1645248765,69,1484
3900911220,3439221238,1649096775,1649097352,577,206
3676100322,3535325513,1660459515,1660460002,487,97
3306934792,3866921322,1651230659,1651231020,361,1525
3563407459,3684883542,1645371434,1645372089,655,1392
3274452346,3646596750,1642983633,1642984132,499,2493
3122144249,3740274448,1650076614,1650077288,674,1802
3437705581,3755473771,1665804838,1665804947,109,345
3170036337,3112739600,1667508911,1667509436,525,2020
3603853942,3021338974,1655261676,1655262360,684,249
3428557602,3152554117,1651992962,1651993073,111,779
3139928298,3669744444,1660077397,1660077865,468,2442
3325962611,3375769320,1642257347,1642257449,102,2332
3388814364,3663985085,1658612685,1658613061,376,866
3407409307,3580908290,1658280637,1658281022,385,1890
3861263764,3283211870,1655948576,1655948589,13,2246
3940948395,3216241275,1645207761,1645207788,27,1350
3044226207,3949002357,1648903358,1648904335,977,2454
3253827804,3912916652,1659074822,1659075748,926,2448
3044854518,3306619417,1645767216,1645767534,318,2052
3569443529,3882748527,1653504757,1653505502,745,792
3932077086,3882603510,1654611575,1654611947,372,1221
3355195985,3046738951,1669024346,1669024454,108,1376
3776934270,3432522125,1652233115,1652233997,882,1860
3195148360,3076307729,1663319240,1663319457,217,1339
3889544424,3739048247,1648814173,1648815018,845,1999
3579404607,3817579913,1661136458,1661136794,336,2313
3519375692,3060718787,1650820502,1650820750,248,1704
3432892677,3437309077,1649134430,1649134579,149,1826
3521081470,3598506871,1658141311,1658142149,838,2494
3623092479,3685505113,1663337997,1663338886,889,374
3653850140,3310499607,1657400423,1657401358,935,1747
3896867161,3558848518,1649885291,1649885527,236,2147
3272981808,3125350196,1645123245,1645124158,913,1821
3958508676,3990233750,1661148454,1661149156,702,863
3549703546,3451206797,1652059348,1652059833,485,2325
3272187328,3135405364,1668958374,1668958849,475,1068
3042461816,3949771162,1660214516,1660215236,720,1909
3031560160,3687243333,1650662776,1650663000,224,818
3520344153,3261837009,1666038613,1666039460,847,1359
3339459948,3692345317,1647693730,1647694322,592,122
3436198180,3401677898,1660815242,1660816071,829,1987
3218903379,3775968124,1657783237,1657784130,893,735
3825645806,3362148197,1658296753,1658297075,322,932
3768211591,3758323845,1658136045,1658136953,908,1149
3125818794,3829209875,1664083658,1664084598,940,2440
3219265850,3055710852,1648490825,1648491654,829,1495
3967250644,3449504551,1654542963,1654543508,545,595
3699947490,3508224327,1642347263,1642347810,547,859
3761147252,3821391381,1651859396,1651860386,990,1400
3660998516,3693129961,1665153508,1665153677,169,987
3003723782,3101363863,1645245669,1645246274,605,387
3768311968,3167985603,1658032494,1658033184,690,277
3434010912,3922341165,1647276128,1647276425,297,1599
3897756969,3188588023,1648168694,1648169264,570,2233
3635052101,3063520189,1652189188,1652189552,364,2293
3417248496,3967972556,1666821033,1666821149,116,123
3235825340,3342199267,1656831464,1656831789,325,236
3578616050,3752701792,1653846546,1653846581,35,1355
3598645736,3325334366,1652232659,1652232753,94,250
3827891957,3781368357,1647540257,1647540420,163,257
3590384867,3304499678,1655357800,1655358585,785,803
3611763388,3845522882,1658174913,1658175743,830,2240
3602955685,3953224601,1655795529,1655796349,820,531
3649036403,3868348947,1644180462,1644181154,692,1468
3315650808,3206061644,1643041500,1643042205,705,383
3029468613,3936821313,1654066471,1654066694,223,1330
3769767823,3111080178,1655090988,1655091817,829,1019
3073924620,3829874150,1667013730,1667014355,625,804
3509047408,3962773297,1656335474,1656336230,756,608
3220800349,3761307187,1657894747,1657895045,298,2156
3377528840,3069313994,1665186282,1665186608,326,245
3088571651,3346860393,1642702114,1642702343,229,1740
3307721045,3167058279,1664088243,1664088993,750,1515
3408108471,3569573616,1653196557,1653197488,931,1730
3592519306,3921816397,1648671596,1648671702,106,757
3888469544,3900241568,1648901148,1648901745,597,39
3144175285,3071322324,1654302680,1654303152,472,724
3860432776,3098083694,1647831747,1647832249,502,1302
3550329232,3636001595,1658899911,1658900253,342,454
3055020688,3777820691,1652233769,1652234112,343,928
3424368056,3786322776,1659251319,1659251910,591,1737
3098955230,3980675077,1655296721,1655296953,232,1781
3446547180,3716757245,1642509620,1642510374,754,1081
3935809720,3273379502,1668119962,1668119968,6,1365
3573941843,3807478002,1648042250,1648042449,199,1473
3584660761,3596839317,1652355539,1652356462,923,2318
3443384698,3046526062,1658673964,1658674843,879,29
3989563375,3420266147,1663303952,1663304024,72,567
3820254686,3527201198,1668209293,1668209935,642,757
3460678842,3352759849,1663944441,1663944809,368,1015
3058290794,3802790977,1668467890,1668467984,94,18
3161063958,3670291498,1666267449,1666268306,857,1650
3035946381,3473170336,1650062841,1650063285,444,2396
3506187447,3135579253,1662601968,1662602867,899,545
3494746675,3565781990,1646828948,1646829008,60,1830
3142923526,3820885067,1649286065,1649286950,885,2145
3014798893,3442209140,1660566450,1660566861,411,675
3628583147,3201968141,1663548265,1663548313,48,508
3930118877,3103743198,1653669414,1653669878,464,243
3513925385,3997397652,1664174381,1664175166,785,2474
3680139573,3671971306,1664497516,1664498354,838,2039
3476728930,3620395885,1661260358,1661261343,985,1180
3894036055,3549549632,1667698516,1667698937,421,1465
3778228977,3228319450,1648046348,1648047133,785,34
3914166761,3031299470,1654389412,1654389576,164,198
3503489321,3133319209,1666796144,1666796490,346,567
3406042920,3650041115,1650625960,1650626176,216,723
3742220718,3828761401,1668182112,1668182680,568,761
3739595528,3119752328,1669084802,1669085467,665,254
3636621583,3100572176,1652579587,1652580294,707,2235
3247047829,3602891052,1647426784,1647427601,817,473
3520511256,3557734825,1651951335,1651951424,89,1026
3533414032,3000383745,1659427836,1659428238,402,1283
3035476619,3303986609,1662671671,1662672320,649,1400
3339911597,3166521010,1645001778,1645001928,150,2296
3061461510,3882619512,1669532445,1669532822,377,2351
3584925664,3349724698,1656799892,1656800429,537,163
3843078363,3754706912,1658100689,1658101592,903,824
3365676412,3370966526,1668060319,1668060972,653,298
3553436680,3657101592,1644822748,1644823172,424,1348
3077238667,3075313832,1651003402,1651003446,44,295
3380928920,3828322397,1666873938,1666874014,76,1351
3184178717,3044483301,1652338796,1652338855,59,1810
3806570797,3598223917,1647115158,1647115680,522,1864
3921229994,3422046745,1656275849,1656276640,791,194
3581083030,3524508110,1656540662,1656541661,999,984
3865781327,3664273227,1654562058,1654562365,307,1609
3481881323,3798447157,1664079676,1664079702,26,689
3741978263,3783723078,1652291175,1652291553,378,93
3317382420,3043656500,1654882368,1654883034,666,945
3090103866,3748085058,1643161296,1643161981,685,1491
3192375486,3080734335,1664453707,1664454507,800,1576
3763453899,3747621620,1647614113,1647614823,710,1092
3947521897,3123795999,1644655910,1644656739,829,917
3298436959,3297314002,1663626247,1663626886,639,1155
3971926686,3380053573,1641396073,1641396288,215,1817
3978330638,3848272906,1655498295,1655499028,733,2222
3160938941,3661976391,1660753832,1660754345,513,480
3379285136,3623876940,1661035871,1661036401,530,2451
3687689210,3729034883,1650320826,1650321660,834,1085
3289684726,3145389444,1667310154,1667310206,52,43
3972294801,3077683954,1664572903,1664572973,70,334
3025215569,3210078490,1644517607,1644518142,535,551
3173809486,3454851350,1654149352,1654150200,848,1467
3127142463,3333223237,1660207745,1660207778,33,863
3327145204,3086444841,1661379140,1661379246,106,13
3940115951,3915772795,1664045974,1664046177,203,1705
3063566522,3254496907,1643447288,1643447456,168,2079
3315544584,3636930993,1659639532,1659640489,957,1119
3955307397,3292782964,1643412214,1643412856,642,1648
3702178313,3298676228,1656785178,1656785489,311,408
3972195042,3935379393,1652798756,1652799668,912,997
3108998670,3600334566,1650965555,1650965820,265,874
3518620219,3708101315,1648945882,1648946295,413,1684
3481006313,3816240060,1647199519,1647199612,93,880
3223374226,3097834756,1659607635,1659607732,97,1520
3826573375,3541942422,1662301087,1662301243,156,2451
3314823389,3895422097,1653255506,1653256284,778,327
3889537515,3408944120,1651285964,1651286401,437,520
3309106486,3972441567,1646410727,1646410758,31,2188
3784646522,3029807207,1661444216,1661445163,947,1569
3575816255,3127447356,1654775102,1654775773,671,995
3201587444,3552494506,1649036427,1649036830,403,2236
3809312897,3878831823,1650182813,1650183434,621,562
3568614629,3988466264,1642210599,1642211532,933,224
3176941664,3948577391,1656253276,1656253817,541,304
3174639274,3043180716,1650556554,1650557002,448,2150
3328737379,3441383531,1648086571,1648086798,227,185
3988935369,3436636953,1648580694,1648581587,893,1408
3185373368,3281753784,1656682542,1656682786,244,2406
3200646968,3032851657,1660617901,1660618804,903,2121
3683038464,3513925385,1666326092,1666326510,418,455
3444809495,3613021322,1668242558,1668242731,173,637
3251808759,3462410204,1661477200,1661477242,42,1946
3538159241,3359901981,1649347638,1649348051,413,1102
3957411858,3071023164,1656380371,1656380761,390,690
3457895283,3738887934,1642371446,1642371490,44,979
3282587673,3883057669,1652935464,1652936310,846,1852
3040136606,3485526833,1659782638,1659783144,506,680
3215257603,3474558723,1646146590,1646146758,168,1797
3125900419,3126038266,1669242695,1669243258,563,1856
3866431229,3041792624,1665052505,1665053076,571,1404
3342054027,3927284839,1666961979,1666962045,66,326
3030192990,3825824228,1666221209,1666222042,833,2151
3713455058,3191460519,1654976709,1654976735,26,1544
3938337743,3670266153,1666114973,1666115643,670,1816
3349301564,3363279084,1648075151,1648075367,216,1028
3651055879,3062464540,1644655347,1644655931,584,305
3557734825,3524831718,1649250903,1649251691,788,833
3232128014,3880139481,1665919986,1665920152,166,1557
3772337054,3893170545,1666564912,1666565738,826,222
3184178717,3224960669,1650256224,1650257174,950,2203
3761556948,3988790434,1669378452,1669379382,930,1782
3615419444,3105250340,1667135137,1667136076,939,1733
3242897765,3063659192,1663966841,1663966937,96,1369
3609029368,3852834619,1645956032,1645956347,315,2451
3344394548,3500152600,1641605674,1641606637,963,302
3279773317,3361514629,1663219456,1663220118,662,804
3945358150,3823650698,1648984099,1648984806,707,575
3287600901,3727981782,1643285572,1643286474,902,655
3412053580,3256873642,1663449889,1663450326,437,1189
3422745115,3202161567,1641934051,1641934855,804,874
3285030317,3407735827,1648381182,1648381318,136,326
3382856674,3869495480,1668548089,1668548182,93,615
3415584739,3163058578,1653801447,1653802356,909,1554
3984570592,3562456307,1641455947,1641456914,967,140
3023880168,3718909055,1653015384,1653015866,482,2020
3578298884,3310715907,1657545225,1657545487,262,1204
3561037966,3895277580,1649616309,1649617024,715,162
3381313507,3849701361,1662032015,1662032859,844,2431
3458645622,3868215944,1667008386,1667009284,898,2107
3420733881,3094940809,1668372445,1668373025,580,1399
3125314664,3656829277,1661048980,1661049356,376,7
3449125023,3565392717,1648361757,1648362162,405,1239
3248167631,3987735792,1661267402,1661268024,622,223
3721571243,3315854812,1649430193,1649430566,373,565
3284433811,3485926280,1649668249,1649668502,253,286
3678778706,3686025670,1669360020,1669360281,261,2444
3802545642,3546954605,1648413723,1648414210,487,1696
3112313754,3584704567,1644058704,1644058765,61,1008
3467810757,3642339062,1654654322,1654655067,745,7
3943413233,3787048351,1643712758,1643713467,709,562
3339349217,3730337290,1667585350,1667586141,791,1887
3859164696,3779331078,1647788787,1647788860,73,1816
3947369111,3372438676,1667261946,1667262501,555,312
3776334300,3384307655,1643598938,1643599005,67,2240
3730337290,3968412854,1643596693,1643597298,605,2053
3037984397,3674005769,1664472500,1664473300,800,990
3428763205,3031560160,1649221237,1649221989,752,1204
3668421848,3882030333,1644656793,1644657007,214,898
3248324593,3123677020,1654985124,1654986009,885,1139
3053991932,3915336029,1648886948,1648887155,207,1685
3896922629,3143226144,1650059669,1650060024,355,974
3896019652,3508340066,1656549534,1656550464,930,1830
3660983068,3579642249,1648206585,1648207098,513,1016
3858052316,3746229411,1646289914,1646290798,884,289
3684919510,3603214777,1644752558,1644753461,903,30
3446490643,3048386186,1647031019,1647031939,920,501
3592043925,3776419392,1667426559,1667426600,41,2064
3436888201,3781537659,1653582946,1653583222,276,422
3689032543,3262845808,1656538155,1656538574,419,1306
3074044425,3784105182,1651800881,1651801469,588,2161
3413369567,3145045320,1658870487,1658871465,978,2247
3567520646,3670267009,1648074478,1648074531,53,2244
3283171763,3839688715,1644997091,1644997934,843,1009
3300694030,3760304580,1658180179,1658180541,362,1369
3184669033,3805928545,1644118869,1644119019,150,714
3974318707,3094418033,1668562807,1668563535,728,1590
3311280180,3739490721,1661683289,1661683620,331,163
3967147343,3494544431,1662660728,1662661268,540,1582
3605316405,3321699949,1655078896,1655078980,84,235
3802545642,3003005378,1644424205,1644424498,293,1775
3938776287,3834401696,1653434336,1653434965,629,278
3674271275,3207210781,1655530906,1655531194,288,2098
3771588829,3451370887,1659589887,1659590600,713,2299
3578075354,3625684557,1653637188,1653637623,435,2333
3670622586,3507363672,1656330273,1656330450,177,900
3776398060,3590361712,1651339735,1651340467,732,732
3580310329,3023576817,1641725639,1641725756,117,1552
3069431080,3481293963,1652063410,1652063906,496,748
3152537793,3356689959,1666290776,1666291386,610,2184
3589984222,3200646968,1657200636,1657201394,758,1445
3980050310,3615595663,1669666893,1669667097,204,56
3499994307,3883497013,1657829150,1657829357,207,1271
3923523643,3472052544,1654879910,1654880773,863,400
3262864867,3293615945,1651360832,1651361247,415,925
3319422840,3178728299,1664472144,1664472293,149,69
3243231806,3825824228,1648952369,1648952911,542,2296
3880835949,3386961417,1661296949,1661297618,669,506
3011686027,3058846696,1668383186,1668384018,832,2293
3040136606,3303719777,1653206073,1653206585,512,281
3767912489,3322801895,1661287366,1661287762,396,452
3899301205,3072347750,1645245944,1645246806,862,444
3617958907,3375966339,1642247599,1642248244,645,13
3312124839,3196704660,1647882088,1647882175,87,1312
3366845170,3389812297,1653035076,1653035538,462,2276
3898012654,3964636806,1649522039,1649522915,876,192
3300159475,3595560993,1663351145,1663351530,385,472
3582478882,3063791472,1661268020,1661268440,420,1085
3662023903,3641983006,1653887907,1653887959,52,2118
3721977473,3921930806,1645981999,1645982186,187,713
3898495918,3225909236,1656101912,1656102112,200,942
3976858724,3740090157,1645021978,1645022626,648,815
3335040022,3780368492,1645669630,1645670405,775,1427
3131820605,3132611388,1664201087,1664201499,412,1551
3388490960,3626118668,1643613000,1643613515,515,878
3341211432,3250312962,1653816999,1653817802,803,1672
3022283384,3091817310,1657928589,1657929455,866,1902
3727020814,3265895976,1642956967,1642957478,511,1840
3217923322,3883497013,1662256513,1662256736,223,168
3398735443,3872493238,1653960594,1653961262,668,2099
3251409316,3326881805,1664951795,1664952681,886,2119
3032851657,3166517941,1665692714,1665693025,311,1230
3506937925,3841174974,1653343296,1653343578,282,1039
3659752387,3062464540,1653179420,1653180158,738,1702
3809698347,3003858315,1659013609,1659014345,736,2476
3223290764,3999180921,1664719506,1664719574,68,2366
3764318951,3831542177,1647828592,1647828780,188,992
3749811473,3916290714,1657607397,1657607562,165,1423
3648593799,3343260379,1647252710,1647252981,271,809
3965164080,3713834683,1647635097,1647635301,204,846
3617746688,3327681313,1652827289,1652828046,757,161
3459830291,3413319616,1642336140,1642336834,694,664
3006508919,3511192827,1662442196,1662442981,785,576
3336525489,3013314607,1663919494,1663920190,696,128
3442725932,3057922933,1658642667,1658642683,16,1670
3393458100,3050229164,1642410835,1642411136,301,168
3317411967,3724770746,1652479010,1652479915,905,75
3206197726,3218964640,1656687895,1656688579,684,1966
3071410684,3674271275,1657360791,1657361324,533,2307
3445743049,3925754107,1661113047,1661113774,727,2283
3644951156,3921816397,1662366154,1662366821,667,436
3939725219,3292667822,1660833129,1660833525,396,213
3687243333,3886720244,1655611344,1655611925,581,513
3799249782,3791510494,1648533089,1648533729,640,78
3069353793,3868397809,1669599737,1669600032,295,81
3804914454,3907872554,1661815430,1661815739,309,1309
3113427537,3407579711,1641778912,1641779286,374,851
3242235161,3631660076,1658941606,1658942324,718,1320
3405955824,3885493402,1658447846,1658448462,616,1904
3260571568,3032431944,1663727323,1663728008,685,2442
3319365305,3197362399,1669507244,1669507698,454,1702
3704305860,3067985831,1661825464,1661826111,647,425
3461938856,3868474839,1645658855,1645658900,45,1097
3677965553,3668078009,1651890759,1651891318,559,1597
3517631415,3151896132,1651677950,1651678859,909,1331
3184168205,3906024837,1657913815,1657914183,368,627
3454392909,3533898881,1659927361,1659928097,736,1930
3691021918,3151938386,1652646877,1652647680,803,1720
3487740667,3816026938,1649433119,1649433603,484,1993
3408396410,3185512282,1652660739,1652661012,273,2111
3284550954,3877049401,1651368716,1651369567,851,2326
3870035420,3354579861,1648895784,1648896640,856,1201
3051654064,3664898256,1648299296,1648299765,469,1717
3876888791,3296478783,1666941316,1666941412,96,1446
3740728884,3065350513,1643517192,1643517733,541,59
3198149459,3383110959,1650917187,1650917801,614,631
3663814997,3660575608,1660585634,1660586162,528,2000
3892850406,3773789419,1661546998,1661547666,668,81
3993994586,3304559201,1665960594,1665960727,133,672
3619929187,3820885067,1658737983,1658738123,140,2203
3098276544,3012929490,1664832087,1664832810,723,2306
3019750416,3679519826,1653449203,1653449501,298,2090
3542153652,3024447668,1663943207,1663943542,335,609
3987162833,3347434027,1655048271,1655048785,514,2384
3130899709,3777929700,1646243327,1646243731,404,2392
3653770219,3290481654,1650266267,1650266625,358,264
3606994517,3237987905,1643551769,1643551884,115,628
3229975544,3938776287,1654369671,1654369798,127,412
3306378570,3988935369,1646986512,1646987485,973,2051
3377855107,3280818938,1652463248,1652463287,39,393
3099984232,3784948704,1653403746,1653404070,324,1139
3021289375,3028886204,1647066860,1647067357,497,842
3832995595,3837062335,1659052243,1659052503,260,1200
3859221152,3973853235,1650597054,1650597393,339,292
3189085834,3650563043,1658861325,1658861600,275,879
3695478448,3716977635,1655943966,1655944401,435,1488
3283037458,3769391036,1641029049,1641029337,288,2499
3921490578,3328993418,1657823110,1657823220,110,2249
3412675211,3329848036,1652306639,1652306646,7,2080
3548799053,3283211870,1662696287,1662696558,271,670
3487756836,3974804920,1654644567,1654645503,936,143
3388814754,3766345791,1647251585,1647252559,974,1191
3705247337,3939181696,1666812706,1666813477,771,1842
3823206701,3911960681,1662051524,1662052083,559,941
3210337290,3711847265,1658371709,1658372692,983,920
3994130271,3981273706,1657105704,1657106257,553,2393
3104271824,3049147900,1649050246,1649050498,252,763
3742145726,3195138141,1652558234,1652559142,908,1856
3740438273,3612460883,1657795548,1657796201,653,1277
3565781990,3082255761,1656496079,1656496766,687,1640
3642339062,3556729365,1652491337,1652491578,241,783
3300694030,3584139105,1662904241,1662905053,812,717
3757189761,3299362427,1662835018,1662835709,691,1393
3228366627,3442799166,1653211823,1653212510,687,108
3287784262,3985491144,1642349942,1642350822,880,1957
3534218813,3905167655,1646893913,1646894422,509,909
3085851145,3791055136,1643458455,1643459382,927,1997
3041001828,3841904297,1643699337,1643699926,589,2297
3639695113,3740102481,1651811554,1651811697,143,2154
3234064286,3103740757,1641266257,1641266926,669,1385
3817667121,3039081980,1657930712,1657931488,776,648
3551810435,3257187145,1641445812,1641446265,453,2129
3645560004,3392271707,1644779217,1644780058,841,990
3382396122,3944476586,1654970111,1654970792,681,2257
3304973317,3039544352,1662766911,1662767732,821,1540
3787465946,3320767438,1651132202,1651132657,455,1145
3570429285,3793772897,1645037838,1645038549,711,1378
3733821292,3129594470,1668890923,1668891051,128,941
3959504618,3207258694,1652486939,1652487383,444,1560
3760142759,3402259490,1642585648,1642586612,964,1920
3439940608,3894667761,1646750074,1646750465,391,780
3276617814,3675703241,1665172107,1665172466,359,1670
3424553049,3413592003,1650629051,1650629741,690,626
3730920499,3375404573,1653295292,1653295791,499,1529
3094361527,3641041716,1663005928,1663006503,575,1512
3547672806,3249252169,1658466869,1658467075,206,772
3810798932,3929497543,1664588337,1664589253,916,719
3634999231,3690043318,1659114990,1659115970,980,1961
3623115966,3229368997,1650740175,1650740655,480,280
3369049258,3615359439,1669089277,1669089286,9,2338
3076767349,3667718430,1656056770,1656057543,773,2031
3091008161,3250023388,1647193747,1647194203,456,20
3243018622,3992571464,1644206812,1644206819,7,1600
3757189761,3895277580,1656297838,1656298442,604,2017
3057574793,3360342048,1668321184,1668321798,614,76
3005200951,3892336923,1653975798,1653976097,299,725
3274588728,3143909362,1645049583,1645049969,386,448
3079905449,3562456307,1665843285,1665843548,263,2410
3291394293,3690657404,1661886342,1661887051,709,676
3883497013,3968564476,1662126471,1662127051,580,1695
3106371588,3134380066,1669298254,1669298955,701,1621
3834166808,3753391012,1667240989,1667241391,402,1608
3110733657,3028841213,1648951455,1648952301,846,1452
3097609387,3141137322,1650191494,1650192099,605,2306
3423043196,3957695947,1647458703,1647459343,640,381
3475779347,3272663489,1668372255,1668372644,389,1505
3286065477,3728160519,1668903130,1668903744,614,2097
3004890840,3696432858,1647731036,1647731681,645,1447
3115303809,3668456327,1650427734,1650428464,730,1933
3364855872,3645666563,1666970990,1666971725,735,592
3010173509,3971093415,1668556974,1668557212,238,414
3335455607,3722483331,1647992128,1647992334,206,329
3295316821,3253589940,1658686482,1658686624,142,1019
3300203056,3018651462,1654516362,1654516593,231,1965
3334743610,3161784330,1660487892,1660488064,172,67
3245906837,3938025728,1643396051,1643396472,421,489
3351182329,3354330082,1653367085,1653367146,61,2223
3500216283,3382983805,1654569923,1654569994,71,1897
3268826534,3321818923,1656677717,1656678472,755,578
3265181921,3377901268,1648260244,1648260814,570,1559
3506733308,3105733809,1651653620,1651654013,393,650
3180728306,3404200815,1660088780,1660089390,610,48
3261195333,3041385548,1650463746,1650464264,518,699
3611100286,3128287586,1644392217,1644392907,690,539
3570955260,3356302136,1658652860,1658653312,452,1429
3780678233,3314528450,1664586217,1664586789,572,1887
3883812439,3423306122,1653018802,1653018863,61,1424
3204912218,3348006171,1668866710,1668866875,165,672
3755962729,3959795133,1641601255,1641601605,350,1991
3066362135,3197201691,1661010029,1661010821,792,670
3644272268,3303561746,1662891470,1662891505,35,2392
3980050310,3928257298,1660569512,1660569797,285,667
3840416991,3835049098,1654220751,1654221486,735,1450
3492638245,3534752391,1666201494,1666201524,30,548
3481811999,3141198072,1646946430,1646947132,702,832
3322663101,3459188746,1666839136,1666839551,415,2086
3995412026,3821180393,1645425028,1645425913,885,1862
3071667890,3583591867,1654978434,1654978559,125,2444
3329496705,3429887771,1642438305,1642438306,1,1143
3577990920,3921560605,1665003465,1665003699,234,375
3692441467,3599568023,1657070377,1657071192,815,1970
3814577253,3661369487,1668577882,1668578590,708,116
3128613298,3257732454,1645984753,1645984773,20,219
3982736205,3573961768,1648048586,1648048996,410,1819
3617757019,3935125903,1658638751,1658639477,726,523
3143318519,3838250910,1659321014,1659321331,317,170
3228073924,3534752391,1664604410,1664605401,991,1450
3041792624,3601604629,1646384444,1646384532,88,1456
3266121254,3073967597,1652795262,1652795311,49,1372
3624872846,3433237569,1650936198,1650936835,637,1690
3320488617,3290794282,1644532135,1644532887,752,1506
3592453741,3549033213,1649877964,1649878870,906,2081
3950428741,3581083030,1665955592,1665956269,677,2486
3220690215,3143452523,1652207186,1652207814,628,997
3974092782,3011863548,1645155652,1645156051,399,1514
3151554851,3236522609,1660005292,1660005394,102,2405
3442927979,3539303536,1647309188,1647309290,102,12
3711016575,3445647826,1657142284,1657143029,745,175
3225857817,3240340462,1661833709,1661834437,728,1317
3605278552,3707676798,1661806568,1661807312,744,1411
3730106432,3453839667,1660659458,1660660366,908,1540
3793503160,3641911946,1644906701,1644907669,968,2154
3323936820,3947879014,1659785325,1659786180,855,773
3084940745,3782266220,1644077832,1644077905,73,557
3883497013,3779319466,1650448760,1650449697,937,450
3439221238,3462412055,1659161162,1659161711,549,571
3054606477,3802694367,1658998967,1658999244,277,452
3831426674,3564599618,1667837254,1667837768,514,2114
3631587282,3128318593,1665627402,1665627693,291,213
3031292798,3722078855,1654718547,1654719230,683,2096
3408604990,3980501547,1650569170,1650569880,710,594
3126940487,3208106743,1663144585,1663145474,889,2354
3660732427,3929887239,1649126500,1649126646,146,2222
3705755036,3308454699,1649737309,1649738175,866,1516
3119718471,3417248496,1655309721,1655310588,867,1866
3830541998,3629984199,1669558040,1669558786,746,828
3804768140,3643730317,1664058863,1664059392,529,1851
3641983006,3389443435,1664057805,1664058744,939,240
3807549475,3860883669,1645027293,1645027368,75,2471
3291512173,3323198594,1643475590,1643475980,390,845
3825849470,3272563093,1665145568,1665146487,919,254
3471085694,3616901816,1643485553,1643485924,371,974
3643412582,3133788020,1667733556,1667733711,155,326
3744726408,3112313754,1657237075,1657238002,927,994
3207389119,3261013545,1653524787,1653525060,273,1959
3128514837,3918552618,1665357871,1665358387,516,1624
3045879019,3769391036,1644175596,1644175746,150,681
3444809495,3693691265,1662546822,1662546949,127,360
3529381895,3365663032,1660276976,1660277874,898,163
3320742371,3402349073,1648601239,1648601904,665,307
3249642950,3159638305,1659592818,1659593516,698,2461
3791510494,3675683512,1646584307,1646584577,270,1455
3676100322,3723957807,1642493575,1642494285,710,2248
3887305908,3549671217,1650629742,1650629904,162,1924
3456948150,3403024728,1648668186,1648668418,232,2080
3748850384,3302992244,1652940154,1652940169,15,555
3096662890,3243840165,1641289210,1641290057,847,662
3164122941,3801579775,1653475602,1653476554,952,1679
3737772457,3142899759,1661314681,1661315588,907,591
3258854274,3993504996,1659044260,1659044605,345,827
3553241769,3067897101,1665700586,1665701395,809,1942
3266042074,3253395374,1652071150,1652071939,789,583
3395670756,3623374020,1665848790,1665849047,257,1369
3922697372,3106705860,1661238383,1661238692,309,1089
3908895548,3027651085,1659590901,1659590992,91,1114
3855563284,3098907787,1669383832,1669384340,508,1353
3217923322,3924141950,1660493484,1660494338,854,1698
3617715231,3749811473,1652141245,1652141381,136,1515
3247758952,3686298420,1661590591,1661590665,74,278
3168329235,3945055663,1661436821,1661436984,163,2487
3037279735,3923683467,1668231573,1668232495,922,2176
3993995217,3618683738,1668284800,1668285428,628,1076
3357247840,3502484697,1647868667,1647869594,927,1767
3741413739,3290912062,1654172143,1654172461,318,635
3424562136,3157155319,1648205770,1648206556,786,1465
3517541359,3448952875,1658558953,1658558974,21,1135
3348234563,3703825153,1653352397,1653353330,933,2178
3186569725,3658428855,1649898282,1649898698,416,1679
3254367735,3735547050,1663987126,1663987436,310,2418
3198195956,3456603950,1665277702,1665278005,303,1069
3297123407,3358571434,1650636037,1650637029,992,825
3583585259,3780014272,1667257990,1667258470,480,131
3517992014,3258577325,1665904240,1665904606,366,2291
3017740025,3655981198,1653219309,1653219418,109,137
3261169929,3887586447,1664074764,1664074887,123,1556
3876344592,3176753600,1645094177,1645094452,275,261
3242064640,3362249024,1669726587,1669726613,26,41
3507338655,3202225412,1642266942,1642267487,545,673
3890875667,3914275771,1646372231,1646372801,570,1497
3601519220,3594066575,1653344439,1653345294,855,307
3434575449,3670835955,1668983084,1668983200,116,1459
3184539687,3355418256,1661948387,1661948410,23,1291
3752133167,3086530794,1663522032,1663522782,750,1098
3120705176,3594269515,1649502232,1649503007,775,1128
3892023630,3019512245,1667493182,1667493316,134,1620
3884704204,3802790977,1666774548,1666775005,457,318
3980803977,3530157274,1650733623,1650733650,27,1979
3329825462,3207757416,1648290188,1648290910,722,2
3233040662,3220750989,1668378880,1668378989,109,1533
3269889273,3985825297,1659963590,1659963811,221,2222
3287116319,3929988329,1649814147,1649815084,937,1471
3675429073,3744234480,1650713115,1650713743,628,2353
3787817814,3660247870,1658781240,1658781908,668,2358
3863080370,3383348505,1667958158,1667958786,628,617
3070186247,3365615023,1666727882,1666728095,213,949
3851747907,3887409378,1662626687,1662626918,231,367
3235086334,3941642636,1645002538,1645003048,510,432
3674349184,3738624659,1648348791,1648349400,609,217
3958539607,3682028611,1647238259,1647239110,851,729
3080703553,3030117347,1664883178,1664884112,934,1361
3104719783,3198731476,1643807746,1643808601,855,2033
3752522830,3129955835,1658836411,1658837360,949,1669
3215870665,3025108334,1660339063,1660339851,788,1541
3974917779,3485644295,1661777378,1661777715,337,864
3021129414,3586734200,1668906280,1668906402,122,818
3167985603,3143293050,1647197132,1647198130,998,2039
3242064640,3343162937,1668271752,1668272137,385,1527
3817548425,3038630181,1656040054,1656040103,49,116
3744726408,3085931016,1646635380,1646635761,381,2468
3948710872,3190035679,1657210935,1657211553,618,168
3914348680,3323198594,1658541626,1658542616,990,156
3599160097,3608201278,1654590174,1654590930,756,682
3022403169,3416719967,1658299871,1658300198,327,1045
3069818047,3952425376,1667867119,1667867602,483,1011
3807473345,3395782360,1651092165,1651092801,636,2328
3718652649,3432722823,1650997928,1650998688,760,2355
3842362489,3889112055,1659708242,1659708248,6,1070
3252981510,3878274883,1645469116,1645469876,760,1791
3875892624,3903108572,1652070847,1652071782,935,215
3554862003,3486802233,1658358172,1658358644,472,666
3759165741,3155294057,1643422853,1643423700,847,1900
3182502852,3820885067,1661538390,1661539215,825,773
3225466850,3328015314,1655676261,1655677146,885,221
3487972666,3870877628,1648571428,1648571635,207,1993
3906024837,3131156982,1650289645,1650290301,656,185
3916776869,3069989068,1650596918,1650597338,420,2246
3757370089,3611269407,1660737610,1660738005,395,2017
3928290954,3429004715,1654154118,1654154931,813,2254
3766186320,3870243569,1661876141,1661876521,380,697
3766062750,3542153652,1668244010,1668244973,963,1457
3830408109,3918602291,1650063667,1650063930,263,569
3997215508,3097501233,1660980310,1660980898,588,637
3815779833,3503510962,1641319917,1641320328,411,574
3972886254,3209462413,1660675447,1660676137,690,2095
3361670451,3930994715,1651198819,1651199604,785,170
3401582775,3898959510,1643168042,1643168228,186,1
3947921257,3668174777,1662272368,1662272989,621,1681
3908796611,3326882521,1657867228,1657867844,616,2491
3999788546,3192940759,1658253411,1658253606,195,536
3920028342,3767724034,1662961354,1662962013,659,308
3353388722,3056252574,1659340075,1659340905,830,1165
3486793392,3742159503,1652757415,1652758216,801,135
3463121212,3434363944,1649468167,1649469062,895,1544
3256736613,3771758356,1656352785,1656353503,718,581
3282261851,3786194675,1667548836,1667549395,559,1915
3041563987,3473170336,1669193772,1669194609,837,344
3293504206,3554753273,1652545500,1652546248,748,591
3686530724,3276118203,1664812388,1664812420,32,2221
3774823325,3399503261,1658743084,1658743807,723,2121
3800861252,3233040662,1665377160,1665377572,412,1730
3163326257,3562579840,1650203131,1650203968,837,531
3930347129,3706178319,1643487667,1643488430,763,2118
3625684557,3328699609,1652653594,1652653976,382,591
3994168332,3850392190,1654537311,1654537814,503,2468
3029849131,3774102998,1667516945,1667517898,953,142
3532021354,3015593061,1659830482,1659831185,703,909
3906244265,3936135558,1652806810,1652807168,358,2495
3184168205,3956058747,1668668758,1668668820,62,468
3999180921,3997038651,1643036384,1643037365,981,2399
3298505096,3136172164,1643223289,1643223597,308,1698
3218136112,3333872407,1648659920,1648660053,133,1503
3830243698,3490435539,1646101180,1646101513,333,2389
3887337385,3274208430,1662906619,1662906621,2,154
3463734539,3864436164,1665290479,1665290903,424,498
3545188902,3912183552,1655597247,1655597314,67,2000
3304087986,3021683395,1651599836,1651600220,384,1070
3122127756,3069431080,1642609309,1642610309,1000,941
3909292537,3806251232,1656496590,1656497240,650,1176
3002669219,3280558341,1642359621,1642360183,562,1636
3241584825,3620006027,1656241488,1656241924,436,565
3371767777,3691062084,1647768171,1647768770,599,1383
3786480807,3684411297,1662446498,1662446776,278,986
3663228098,3404432145,1647499667,1647500485,818,1069
3091062283,3356690610,1661756546,1661756826,280,215
3507644528,3518932161,1659278304,1659279229,925,379
3395479272,3291819950,1643975091,1643975959,868,2359
3552101140,3463875425,1641476820,1641477419,599,1890
3984461468,3831346903,1665030669,1665031070,401,1827
3656846834,3639090741,1658490013,1658490711,698,559
3678482446,3278854404,1664240154,1664240165,11,1893
3550516008,3025223556,1666721331,1666721379,48,1621
3771528397,3137803904,1649207641,1649207987,346,1346
3957689713,3909997437,1643672944,1643673768,824,2252
3041652512,3672560021,1661713967,1661714742,775,1783
3415020400,3044345094,1646910972,1646911165,193,2380
3482509515,3953483372,1641169609,1641170608,999,243
3443190053,3791547480,1665596645,1665597507,862,646
3615359439,3736118442,1646695314,1646695858,544,1834
3339459948,3620006027,1650031311,1650031323,12,1653
3775753518,3243883781,1659938392,1659938782,390,253
3676634608,3301093931,1647570108,1647571041,933,488
3637861848,3875750764,1667104453,1667104718,265,2135
3018760022,3018612279,1664518078,1664518613,535,2115
3421344639,3502316165,1647954596,1647955546,950,451
3205864966,3999180921,1650674874,1650674988,114,859
3114128222,3160938941,1649231292,1649231756,464,1346
3815102601,3165845148,1642380986,1642381655,669,2128
3306252501,3035895563,1656386603,1656387555,952,571
3896308173,3224952698,1645919013,1645919515,502,1394
3690657404,3243883781,1662202786,1662203410,624,1000
3565278029,3664381582,1665544240,1665544904,664,383
3726367604,3624644696,1662182485,1662183194,709,1177
3200827648,3622848449,1663429598,1663429923,325,79
3098276544,3474081200,1655841657,1655842583,926,1682
3058725687,3005231138,1660476241,1660476912,671,869
3693475435,3386846556,1663722417,1663723403,986,622
3081028310,3356545594,1658560898,1658560933,35,692
3444174394,3198520645,1641941653,1641941815,162,364
3173642675,3846628868,1644942765,1644943716,951,513
3958539607,3858459394,1645736041,1645736254,213,926
3556000533,3604426149,1661494615,1661495527,912,1671
3564667780,3522861132,1666094787,1666095508,721,1562
3175498635,3112259657,1667208996,1667209731,735,2259
3319224567,3565805050,1647022260,1647022538,278,1931
3028063669,3956547336,1642405517,1642406143,626,1500
3138662322,3957051129,1643461539,1643462485,946,652
3677001111,3777609973,1651629975,1651630881,906,1923
3776148003,3417176290,1668513132,1668513247,115,1270
3596661503,3601690466,1668145519,1668146372,853,545
3139928298,3886651871,1652233695,1652233730,35,1455
3470482542,3295402408,1652084607,1652084623,16,2418
3895277580,3783622486,1665031751,1665032449,698,1903
3061299464,3393712145,1648945229,1648945807,578,625
3321752938,3574773588,1660638193,1660638455,262,584
3972917056,3673735088,1647288386,1647288737,351,1529
3172310061,3745420516,1656525251,1656525504,253,1687
3690539115,3994388981,1660124103,1660124341,238,31
3284829365,3809059026,1650678193,1650678396,203,332
3375782922,3333347852,1655459707,1655460529,822,919
3548252436,3478404891,1656220944,1656221659,715,447
3662578193,3804748811,1651896031,1651896698,667,1971
3605699054,3069225011,1666763200,1666763702,502,2496
3513399148,3384460816,1650893522,1650893747,225,505
3458815526,3400211756,1664196672,1664197441,769,1896
3104210284,3642318884,1658041689,1658042447,758,2200
3180728306,3513193858,1647002799,1647003745,946,1648
3865463499,3777091595,1643007922,1643008681,759,823
3324069408,3001509229,1662469648,1662470548,900,1150
3039081980,3172524712,1650633400,1650633536,136,854
3877299439,3135707503,1652249613,1652250124,511,2071
3904007370,3885555985,1646226549,1646227507,958,1668
3100716894,3064644311,1653132122,1653132402,280,1491
3184404815,3138801114,1653357740,1653358318,578,1863
3577798894,3424944206,1661236924,1661237704,780,159
3423909447,3556456137,1646156195,1646157068,873,1864
3289330422,3537443088,1663882914,1663883766,852,865
3603214777,3092292487,1667340213,1667340839,626,315
3091579646,3422728078,1661567983,1661568169,186,1630
3793967785,3203128336,1651020471,1651020908,437,611
3457191473,3969728585,1665210781,1665211414,633,2281
3827431944,3084385255,1650582051,1650582173,122,1553
3658477943,3830330372,1646436690,1646436941,251,1281
3052438592,3170740142,1667612051,1667612242,191,462
3451479071,3902705203,1669592194,1669592900,706,428
3272535116,3671869525,1646592702,1646593382,680,1434
3184916120,3234851871,1652892085,1652892185,100,28
3795934256,3095594016,1662071690,1662071963,273,748
3282166903,3800460824,1652933714,1652934269,555,884
3649036884,3681498352,1652657247,1652657601,354,858
3536128186,3354055639,1641740593,1641740657,64,421
3852212988,3473055855,1666069825,1666070047,222,16
3395316132,3406868680,1656293164,1656293932,768,985
3068723030,3768253081,1645425972,1645426952,980,305
3812239613,3939477257,1655435029,1655435532,503,700
3939755962,3689464410,1659224584,1659225565,981,1142
3253827804,3135211724,1650467368,1650467796,428,1189
3714909437,3602829591,1646075864,1646076024,160,999
3177491349,3564440153,1653774929,1653774940,11,1921
3262711330,3973853235,1663528646,1663529467,821,13
3533414032,3095849365,1657457712,1657457762,50,1816
3104793032,3195032074,1642375610,1642376164,554,112
3480115115,3986955632,1646359184,1646360159,975,567
3209462413,3079516653,1661196202,1661197139,937,1536
3485801867,3706206403,1647527190,1647527733,543,1785
3737420070,3979845809,1656269318,1656269557,239,1995
3102089102,3422106507,1668405245,1668405430,185,552
3347854994,3562859716,1667202446,1667202653,207,734
3643173963,3518079213,1645599099,1645600081,982,732
3671869525,3494746675,1656703586,1656704414,828,1538
3398257086,3332012161,1641172035,1641172207,172,1166
3074886612,3592561930,1649696804,1649697502,698,1990
3597251704,3989208740,1666130263,1666130608,345,614
3301994647,3711701083,1668043942,1668044818,876,1142
3659701814,3629797745,1666183012,1666183719,707,2153
3933940005,3962722941,1647513922,1647514894,972,963
3335976452,3306619417,1663096458,1663097093,635,496
3547358965,3292365668,1669571966,1669572796,830,1923
3565781990,3583918364,1652929408,1652929840,432,1112
3945370501,3003422357,1654381419,1654382372,953,926
3860432776,3655135775,1654999990,1655000223,233,1481
3494613087,3489858368,1669391340,1669392281,941,1546
3432899117,3034147055,1659393926,1659394431,505,830
3616651934,3768846820,1668055967,1668056078,111,233
3011466658,3688345244,1668000937,1668001343,406,1575
3857841054,3892686083,1648400532,1648400536,4,1378
3319506258,3440372055,1649226701,1649227096,395,264
3086530794,3887791096,1641460005,1641460317,312,2046
3352389016,3248733503,1645308487,1645309317,830,1976
3385264040,3336535934,1659093666,1659094289,623,541
3044064258,3194070207,1663703329,1663703598,269,1507
3382693942,3728797277,1663996309,1663996669,360,2092
3153902371,3566257032,1654812317,1654812652,335,442
3860432776,3321105707,1644856513,1644857046,533,1139
3513180024,3957053810,1642824519,1642825364,845,1187
3942520090,3307636200,1654813025,1654813541,516,1393
3680060067,3483666747,1657815688,1657815830,142,2257
3272187328,3213376352,1653717715,1653718074,359,1482
3677300151,3201479561,1669685418,1669686379,961,1940
3206512870,3556425071,1656301742,1656302624,882,938
3285019414,3899932297,1656499770,1656500050,280,295
3204963755,3505480563,1647000739,1647000845,106,2344
3880620233,3975864053,1649904928,1649905412,484,2330
3550889203,3554089401,1644708633,1644709378,745,470
3521271030,3915817603,1662905937,1662906931,994,2046
3887743057,3197693984,1645619814,1645620069,255,1929
3356317749,3816015403,1645375192,1645375370,178,736
3692368068,3411921561,1641577456,1641577824,368,340
3696947299,3381060534,1653742845,1653743480,635,1908
3983610735,3401568650,1665712037,1665712925,888,817
3884100790,3724455974,1659013046,1659013365,319,2487
3553146922,3127142463,1655765791,1655766672,881,2413
3377457710,3008062664,1669704357,1669705215,858,1853
3565278029,3973050834,1669129073,1669129824,751,2210
3675366639,3071023164,1653309247,1653309282,35,1181
3945881377,3025581381,1643480817,1643480963,146,2477
3594269515,3928354041,1662478834,1662478950,116,1710
3892206642,3719884534,1642335314,1642335520,206,653
3498989393,3187523092,1653511867,1653512198,331,454
3748850384,3881578299,1643137916,1643138673,757,708
3772788087,3423971586,1661775024,1661775960,936,2437
3744293001,3407579711,1669558474,1669559213,739,2139
3175595669,3811785839,1648067870,1648068440,570,1386
3447257561,3796954140,1665975003,1665975696,693,2427
3933460964,3854351732,1660232713,1660233317,604,2162
3658910038,3015593061,1658315332,1658316001,669,1794
3585100772,3800337461,1648394349,1648394854,505,1760
3666494756,3825930964,1653561493,1653562181,688,2469
3364586923,3802614854,1657397190,1657397520,330,1495
3728797277,3911185524,1648814257,1648814464,207,907
3565278029,3225857817,1658029379,1658029381,2,490
3341694529,3056252574,1669412930,1669413175,245,408
3683198772,3328373210,1651198855,1651199048,193,483
3040897601,3842362489,1659349071,1659349638,567,728
3210080881,3278297907,1666998638,1666999219,581,1730
3415761431,3103421893,1656927141,1656927964,823,2426
3110482626,3990379463,1666793202,1666793764,562,777
3931624174,3981191978,1658578238,1658578512,274,1348
3777846262,3149046961,1656780669,1656781350,681,1522
3433374325,3958710935,1664460558,1664460905,347,1480
3737809844,3415917688,1649489156,1649489308,152,2473
3959093613,3536080615,1641266614,1641267218,604,1093
3537457982,3011225738,1662903496,1662903855,359,639
3673597203,3199395221,1653900422,1653900466,44,935
3696149430,3064461314,1661306672,1661307399,727,2077
3184680353,3528146911,1643234575,1643234894,319,787
3213169891,3117234289,1652582010,1652582574,564,1703
3540029077,3541920859,1667960030,1667960923,893,65
3601851578,3046006152,1668841784,1668842034,250,1280
3290800332,3612460883,1642508050,1642508337,287,1548
3192375486,3118959727,1652843724,1652844514,790,1804
3989991456,3747697794,1657515379,1657515801,422,1333
3397779824,3926699428,1649696232,1649696358,126,1705
3302700303,3846628868,1662093285,1662093802,517,1806
3184344401,3687278591,1651146447,1651146534,87,2115
3012822525,3385413048,1641275210,1641275694,484,975
3534224607,3375021204,1659967230,1659967633,403,1767
3050607996,3153858233,1661558120,1661558728,608,543
3151539194,3869692733,1658601820,1658602451,631,1892
3822126164,3324113509,1652399660,1652399935,275,150
3601519220,3630621507,1645287611,1645287922,311,1975
3131683456,3426753006,1660938762,1660938823,61,766
3082885404,3830408109,1656794512,1656795295,783,304
3437705581,3309684706,1643323914,1643323915,1,968
3351786927,3081589831,1646214404,1646215157,753,2288
3089126812,3824227701,1645058261,1645059142,881,2278
3590672346,3925344243,1649151690,1649151821,131,2174
3855563284,3455808094,1669397488,1669398486,998,43
3592043925,3611685224,1644559194,1644559618,424,1138
3604593541,3342260000,1641853149,1641853607,458,500
3599795440,3209288149,1669102054,1669102405,351,586
3605492251,3103740757,1642512380,1642512732,352,232
3194140038,3462825977,1643288035,1643288284,249,1592
3260861147,3734779425,1647478133,1647478904,771,2484
3824860461,3128287586,1650167222,1650167990,768,916
3800566657,3446652020,1646252015,1646252163,148,469
3184455755,3240324089,1645494659,1645495401,742,261
3926088173,3672194570,1653931957,1653932742,785,384
3906236028,3061619114,1661150557,1661151441,884,201
3131930167,3389114774,1659162376,1659163163,787,1162
3704980935,3398840886,1664746632,1664747455,823,2290
3886368625,3178837482,1646281773,1646282543,770,1896
3323809275,3825332100,1652026676,1652027671,995,1019
3776862606,3687293094,1642219054,1642219816,762,1427
3988976739,3836535079,1650677319,1650677402,83,2153
3883812439,3885026939,1658677670,1658678285,615,140
3095124554,3751300388,1663619884,1663619914,30,2062
3329117199,3911671645,1660530546,1660531503,957,1624
3879605776,3993572792,1641432088,1641432783,695,2116
3612649935,3637518238,1643321331,1643321434,103,50
3660998516,3806167216,1665496549,1665496919,370,77
3877811036,3549033213,1641936114,1641937109,995,1472
3031299470,3080853733,1645380410,1645381337,927,2012
3486582851,3191460519,1653433169,1653434029,860,1405
3894247542,3393314546,1665857687,1665857908,221,634
3545067538,3811672443,1660941490,1660942083,593,2021
3639121807,3388257945,1665215109,1665215689,580,347
3818823702,3007446724,1656079583,1656079924,341,324
3607354151,3414488975,1651043871,1651044787,916,1522
3848272906,3698706740,1660940045,1660940373,328,921
3249145163,3837157118,1650986909,1650987308,399,1949
3175295329,3198520645,1651412460,1651412868,408,1507
3412673526,3248892530,1650855147,1650855907,760,1669
3875434702,3912511626,1665187887,1665188229,342,719
3485695895,3879766152,1665752600,1665753574,974,1507
3095849365,3585526520,1668484623,1668484648,25,2325
3310262408,3699533383,1642344982,1642345835,853,146
3344787204,3832585790,1664087997,1664088790,793,2226
3042836639,3680453323,1668105776,1668105830,54,1993
3624947127,3352759849,1665436714,1665437617,903,2108
3499541432,3118406319,1651376978,1651377299,321,1966
3493489568,3912511626,1664887411,1664888128,717,1798
3152554117,3103871966,1657593344,1657593639,295,327
3038849431,3649649514,1650894609,1650895048,439,63
3277284318,3160061122,1654209702,1654209971,269,534
3220690215,3994783794,1666845990,1666846460,470,710
3511194169,3708032127,1667076238,1667076327,89,574
3492376573,3028841213,1657957789,1657958298,509,1039
3392293203,3616094004,1650962705,1650963622,917,435
3600067650,3608048838,1658142077,1658142397,320,23
3085001659,3546824914,1658575629,1658575708,79,701
3321818923,3205554156,1664298731,1664299281,550,1537
3786811867,3577718759,1648933723,1648934182,459,1306
3313615371,3301994647,1662039077,1662039174,97,932
3178837482,3533898881,1643229787,1643230373,586,2081
3792143103,3468963532,1649891429,1649892088,659,1863
3498441448,3686826205,1660770389,1660771081,692,958
3633498077,3168625610,1652167301,1652167392,91,1848
3184720975,3499481975,1650104143,1650104261,118,1590
3421772590,3322226292,1669129628,1669130181,553,1620
3131938458,3497911447,1644828665,1644829449,784,2453
3551344746,3872306673,1648576298,1648576440,142,1192
3018325807,3855476133,1642687873,1642688781,908,2095
3194069746,3726883867,1641876362,1641876412,50,1616
3102588374,3476450845,1650936832,1650936913,81,1306
3439280560,3562365612,1645510354,1645510540,186,1420
3626015702,3975379893,1660909161,1660909383,222,1999
3637269987,3130594039,1666080762,1666081334,572,50
3724770746,3934911409,1658311262,1658311757,495,994
3907705988,3959086145,1663443855,1663443933,78,577
3430916751,3675093452,1660043889,1660044811,922,67
3110395191,3348770994,1649894603,1649894708,105,1795
3816567987,3265571367,1643137702,1643138397,695,1894
3243840165,3811308890,1649959976,1649960299,323,522
3665599335,3982268438,1654640878,1654641127,249,1534
3050867171,3122127756,1665492583,1665493055,472,1558
3439303987,3277810331,1650080933,1650081269,336,621
3408903285,3867640062,1668421130,1668421434,304,597
3468455079,3891477592,1661310337,1661310945,608,224
3690001044,3042943074,1655964792,1655965122,330,1685
3611139716,3444149733,1651625569,1651626336,767,354
3885696227,3894431064,1660286201,1660286976,775,1147
3680694926,3125008218,1641216785,1641217696,911,178
3799014776,3263372197,1650680572,1650681050,478,503
3497990894,3645073300,1652429853,1652430074,221,758
3817667121,3496040749,1666826790,1666827672,882,2412
3195813968,3940115951,1651510218,1651510639,421,1286
3949201468,3654381548,1649582840,1649583361,521,1031
3346484497,3255149739,1650413466,1650414065,599,1706
3084783158,3923635120,1652546087,1652546386,299,1299
3986825518,3672371563,1646341852,1646342319,467,2203
3142747577,3958050741,1643429430,1643429876,446,2115
3268670465,3019761756,1668181149,1668181869,720,717
3474558723,3157600969,1641845831,1641846362,531,597
3295316821,3879898101,1667130035,1667130686,651,521
3642314622,3609043475,1659162018,1659162612,594,1805
3013073909,3424476490,1654381695,1654382584,889,1794
3041386590,3195504067,1656700704,1656701224,520,417
3138755786,3165973608,1657529621,1657530205,584,2154
3180836532,3883874845,1662067461,1662068405,944,1326
3005771350,3958375464,1643298266,1643299048,782,1992
3878512967,3119802700,1658391667,1658392436,769,960
3877299439,3181047536,1647622406,1647622854,448,1391
3193657080,3351218513,1650646671,1650646779,108,449
3474216203,3735081666,1662273462,1662273951,489,1364
3143226144,3536903033,1647028528,1647029070,542,2329
3573975424,3389097842,1659183345,1659183976,631,1782
3868348947,3975380491,1646669745,1646670418,673,1264
3359189419,3984050382,1660468045,1660468958,913,2198
3454276568,3366155048,1666390490,1666390995,505,1189
3500201376,3346860393,1648292188,1648292901,713,2440
3602340127,3038244365,1655695081,1655695749,668,775
3759230876,3828921434,1654745997,1654746840,843,610
3557835284,3637092038,1649321730,1649322037,307,856
3060121211,3068661794,1650241419,1650242317,898,1238
3009801123,3721136961,1649352874,1649353053,179,938
3711847265,3533290388,1664228424,1664229418,994,889
3641185549,3147376468,1653503813,1653504689,876,1678
3904517073,3317241023,1652311984,1652312477,493,1674
3392271707,3109702081,1658227485,1658227787,302,515
3309922968,3236308141,1655043162,1655043501,339,2312
3049424358,3948695100,1655952403,1655952864,461,2475
3379548317,3124222667,1653665211,1653665617,406,1515
3731116644,3616651934,1661638795,1661639568,773,1038
3819812955,3632335400,1665638589,1665638792,203,170
3157965235,3776783076,1651674846,1651675014,168,418
3371063992,3991299369,1657080154,1657080773,619,1820
3713455058,3491272857,1644148531,1644149220,689,1949
3974326867,3671748544,1666703444,1666704262,818,2080
3066360181,3778625091,1644359455,1644360402,947,2472
3421671936,3196616254,1665057619,1665057891,272,1680
3432321849,3014517714,1649257222,1649257556,334,2227
3097145374,3463800741,1654427508,1654428320,812,789
3105630699,3562104036,1647822873,1647822880,7,1860
3474742534,3954073874,1642971658,1642972270,612,513
3240249176,3170296955,1660467636,1660468529,893,1652
3791510494,3271864656,1660514808,1660514991,183,1901
3715994986,3768558350,1656525652,1656525706,54,341
3722726470,3310294122,1641259305,1641259582,277,1116
3127783768,3934953223,1666386795,1666387116,321,2411
3550889203,3790298140,1668278755,1668278871,116,2132
3229368997,3204359619,1655115746,1655116051,305,1592
3739320901,3969744786,1665271737,1665272009,272,1409
3048497124,3840846518,1655275503,1655276244,741,164
3481922555,3884412861,1647403395,1647404176,781,245
3548145086,3055644463,1658452175,1658452220,45,927
3417820101,3550516008,1660156073,1660156211,138,1342
3876696308,3945607460,1643095469,1643096198,729,1678
3020729502,3097834756,1655656814,1655657304,490,406
3756806050,3044161404,1655439617,1655440227,610,26
3952552328,3406509436,1666186026,1666186113,87,2162
3320039544,3112742999,1663962287,1663963197,910,903
3820466728,3994651874,1641312247,1641312827,580,758
3012032774,3815779833,1665202438,1665202493,55,945
3988976739,3084138267,1658279196,1658279310,114,342
3066429600,3175498635,1652289282,1652289577,295,324
3377179024,3425613329,1644775271,1644775934,663,1876
3462072699,3697322167,1650329735,1650330205,470,1361
3407770585,3108427765,1649293210,1649294161,951,628
3601690466,3186367687,1660787666,1660787876,210,1886
3710202750,3756722426,1667492880,1667493591,711,1928
3219637680,3012892515,1664463627,1664463640,13,1705
3481090623,3196302340,1667022579,1667023563,984,931
3491022991,3342189600,1655169885,1655169976,91,949
3041897048,3942520090,1646214577,1646215164,587,96
3889544424,3592235229,1666918556,1666919090,534,793
3937077335,3637292465,1667361186,1667361971,785,1383
3125818794,3969563324,1661351742,1661352490,748,1883
3163708045,3384536407,1652525575,1652526093,518,1333
3167290048,3986081370,1657018687,1657018738,51,17
3406215034,3104009859,1657885732,1657885925,193,1117
3567637602,3177851224,1664287699,1664288569,870,2203
3288347905,3463734539,1666417725,1666418036,311,67
3221885729,3342190885,1661172951,1661173597,646,2351
3471288672,3542293606,1654480882,1654481425,543,361
3512935575,3979550486,1668679101,1668679170,69,1365
3329117199,3288834634,1666182079,1666182596,517,2327
3894247542,3734367959,1642439482,1642440121,639,2263
3819405521,3306669471,1667239039,1667239204,165,248
3736260750,3075780193,1653850860,1653851382,522,771
3093024844,3536421569,1667624817,1667624963,146,1700
3897739549,3890492731,1648839163,1648840140,977,1678
3543239972,3996381336,1658354323,1658354713,390,578
3939768853,3131938458,1651349927,1651350581,654,2372
3793738776,3907713562,1651938612,1651939357,745,1063
3211795832,3633479779,1658892531,1658892630,99,850
3933460964,3608200385,1663632282,1663632346,64,1946
3841174974,3013064040,1653233999,1653234690,691,29
3382983805,3639090741,1660110797,1660110968,171,578
3507939773,3922827209,1663793975,1663794294,319,511
3165423009,3473037406,1646658821,1646659073,252,93
3457361080,3771758356,1659619237,1659619973,736,1687
3752347758,3796587240,1661232623,1661232717,94,377
3372197177,3397779824,1651026192,1651026842,650,1512
3797270025,3404563689,1668567834,1668568151,317,23
3348006171,3993637202,1643881434,1643882289,855,2178
3088587729,3270111894,1653546471,1653547076,605,1229
3905167655,3766193314,1656389787,1656390514,727,627
3964637208,3351610798,1648661657,1648661752,95,1029
3322083266,3462744716,1666757889,1666758451,562,2238
3391118279,3033029762,1664994874,1664995622,748,753
3957051129,3346604377,1654586413,1654586509,96,2327
3278854404,3114863942,1648993584,1648994442,858,1090
3674037967,3143909362,1658391273,1658391559,286,1357
3191811632,3386961417,1658381492,1658382287,795,2487
3863080370,3561573044,1661300338,1661300787,449,105
3999314182,3744955044,1660852207,1660852907,700,1659
3028841213,3043310672,1656029139,1656029225,86,1810
3696448766,3844499309,1641856581,1641857089,508,1331
3072834944,3616173127,1665380555,1665380588,33,476
3240502673,3032465570,1641130094,1641130942,848,295
3878573707,3702755503,1668202133,1668202609,476,142
3958375464,3898118371,1654715366,1654716323,957,37
3878943307,3102089102,1652803142,1652803310,168,1356
3197323395,3702302181,1666292860,1666293165,305,885
3562110382,3739338939,1649584410,1649584479,69,575
3985734621,3014185506,1650294243,1650294490,247,1851
3411181030,3894030912,1648674609,1648674667,58,1594
3491022991,3356765270,1655169008,1655169429,421,1139
3952874218,3678336055,1642840988,1642841206,218,2335
3993866389,3165807050,1652509650,1652509819,169,860
3594269515,3120737114,1644756535,1644756915,380,1492
3704871253,3157546931,1647933015,1647933455,440,1112
3508108339,3070404759,1653430054,1653430425,371,2365
3206198477,3546432752,1667459078,1667459284,206,2194
3132210207,3319877479,1667335273,1667335862,589,1911
3263350346,3701979416,1668938135,1668938509,374,2032
3662289637,3241500636,1655619442,1655619509,67,2492
3087326516,3621969167,1649355404,1649356222,818,1458
3145328663,3194342775,1646684832,1646685382,550,1514
3243502165,3626672801,1666319182,1666319361,179,24
3473505436,3427860415,1642509971,1642510288,317,2137
3910846571,3740438273,1662637655,1662637670,15,1011
3870032753,3467650879,1668704431,1668705310,879,315
3755243698,3320381981,1663469207,1663469656,449,46
3197201691,3213039478,1644847033,1644847331,298,898
3521258004,3645314586,1662066992,1662067086,94,1068
3710782213,3116281998,1665803402,1665804124,722,89
3620013325,3029943531,1643266129,1643266312,183,1328
3515480973,3820885067,1650743097,1650744040,943,263
3490942401,3489466063,1658516443,1658516588,145,950
3517541359,3022252567,1642606870,1642607113,243,1409
3550261012,3361290885,1649791842,1649792468,626,2466
3333339972,3073332785,1652790569,1652790700,131,1360
3419809319,3402349073,1650056055,1650057052,997,1986
3840558415,3754706912,1650086165,1650086809,644,2493
3256807270,3125818794,1667856629,1667856782,153,794
3453511353,3659701814,1641713339,1641713903,564,189
3926088173,3023530031,1668741219,1668741383,164,1432
3946015739,3457998128,1648916467,1648916680,213,2449
3847104925,3134337442,1655413895,1655414221,326,1152
3567906153,3727995134,1648573562,1648574301,739,1492
3825645806,3167058279,1660308855,1660309003,148,1567
3792012199,3070395663,1644350343,1644350479,136,2118
3673524018,3015715378,1643773982,1643774666,684,753
3168818004,3745513680,1654207892,1654208607,715,1992
3849028830,3660732427,1663343113,1663343847,734,1660
3793232281,3032851657,1647440591,1647440736,145,1030
3679519826,3865511945,1669301921,1669301973,52,1256
3019631963,3537457982,1648551964,1648552472,508,1101
3307636200,3590228003,1653921752,1653921893,141,2466
3620013325,3662763316,1663408817,1663409217,400,1664
3878005127,3084066396,1668484516,1668485267,751,1599
3393458100,3694127985,1662049861,1662050341,480,1280
3582859001,3288490513,1652017354,1652017496,142,701
3683198772,3651753987,1667868546,1667868734,188,1129
3570955260,3587633750,1663328363,1663329135,772,1316
3939098308,3768013956,1644387475,1644388044,569,967
3729600228,3327427782,1652784820,1652785550,730,1588
3105630699,3688405055,1655841345,1655841400,55,213
3606954305,3112742999,1642430605,1642431548,943,2312
3113214024,3424453686,1645346716,1645346855,139,843
3479401831,3210136888,1649538434,1649539054,620,1500
3800451074,3110591514,1655765732,1655766593,861,97
3593244627,3965585706,1642061966,1642062046,80,1195
3283922234,3020526331,1652636358,1652637210,852,1245
3858225831,3806629780,1646710643,1646711102,459,150
3197323395,3348102929,1667601946,1667602361,415,954
3687293094,3488484971,1648880410,1648880592,182,2192
3114277786,3542832965,1658853119,1658853282,163,443
3098538909,3368654717,1654612840,1654612969,129,604
3191970772,3089844622,1646635723,1646636542,819,2497
3995868243,3237563954,1655710838,1655711724,886,1690
3172352127,3276763839,1649266234,1649266898,664,1981
3818039978,3249916829,1649246306,1649246369,63,1450
3316287541,3571972204,1662823259,1662823520,261,618
3807323401,3368387959,1649464551,1649465264,713,1063
3350891476,3374940485,1645070652,1645071547,895,1382
3844416504,3572896327,1641343014,1641343527,513,363
3157496248,3369330833,1654509865,1654509892,27,89
3902970032,3048781539,1661838215,1661839085,870,1355
3408460871,3870475008,1653999669,1654000481,812,724
3944247629,3586489382,1665402850,1665403529,679,1635
3178981589,3747697794,1643555903,1643556606,703,239
3093523046,3021129414,1667837436,1667838335,899,149
3565700391,3661507330,1657362603,1657363323,720,965
3521023027,3181181141,1641521948,1641522396,448,531
3897976617,3526315797,1660057115,1660057164,49,2080
3276771725,3197176680,1664632398,1664633121,723,428
3835112188,3720381616,1661614709,1661615571,862,73
3675353745,3688345244,1648597647,1648598271,624,1001
3818713435,3048386186,1659191015,1659191137,122,730
3287988080,3400434269,1649859852,1649860191,339,166
3451106027,3649036403,1655433173,1655433222,49,73
3178490239,3532270724,1659083732,1659083939,207,826
3329498574,3032779815,1641309071,1641309680,609,830
3370701718,3635616513,1661043973,1661044171,198,715
3388814754,3523546928,1665723183,1665723219,36,788
3624090791,3822869749,1642860712,1642861681,969,1873
3145948160,3436582780,1667565790,1667565850,60,889
3066439887,3340933137,1661942280,1661942720,440,2347
3618313240,3143324065,1648779656,1648780354,698,1915
3914946558,3286463125,1661739937,1661740246,309,1129
3086084685,3928894030,1665815492,1665816240,748,1477
3755413351,3250484759,1647904111,1647904337,226,2385
3476450845,3887397856,1658109743,1658110386,643,940
3023980378,3358241145,1665778539,1665778776,237,643
3672164838,3067403592,1649717765,1649718621,856,347
3537457982,3055918856,1641743441,1641744366,925,2469
3216171635,3513368682,1643699337,1643700105,768,1033
3691032308,3725117905,1641769965,1641770896,931,179
3143189190,3338715388,1659217926,1659218837,911,1022
3854390772,3094125203,1662113537,1662114137,600,1194
3554089401,3881942272,1667948911,1667949582,671,701
3728976822,3184178717,1663921928,1663922183,255,401
3615848654,3260861147,1658102179,1658102628,449,1263
3885893310,3090103866,1661632180,1661632681,501,2011
3393458100,3049869003,1668130703,1668130880,177,936
3643412582,3952282084,1645737304,1645737369,65,1476
3957798687,3798708209,1665469822,1665470536,714,908
3769647112,3129792187,1667911251,1667911977,726,546
3113516667,3276617814,1650413276,1650413519,243,528
3359724083,3393552322,1658078136,1658078515,379,230
3606270024,3391037775,1663301901,1663302405,504,2227
3037577001,3152438109,1659975246,1659975271,25,1520
3058290794,3845511281,1653689533,1653690506,973,1506
3767249449,3162524259,1663934204,1663935080,876,246
3954185607,3959228076,1653880491,1653880909,418,1667
3414488975,3127940283,1655607040,1655607281,241,628
3975462879,3660247870,1646783766,1646784274,508,433
3265895976,3600955732,1642007237,1642007261,24,1904
3941489594,3161805415,1654711893,1654711958,65,1875
3577990920,3310512172,1641752446,1641752518,72,91
3002438521,3727801252,1651911208,1651912127,919,2322
3680677416,3297684978,1642087289,1642087741,452,2198
3120949338,3955307397,1653860877,1653861095,218,231
3804978604,3209288149,1652681924,1652682291,367,180
3945266221,3369792484,1645666318,1645666847,529,981
3845131231,3877299439,1647226472,1647226938,466,2083
3242064640,3184615246,1644747105,1644747467,362,413
3335040022,3210536820,1653470414,1653470845,431,1540
3304497399,3228497776,1646849239,1646849603,364,790
3052822229,3060674509,1652836041,1652836572,531,1816
3086534991,3085412399,1666710699,1666711610,911,2336
3737603669,3825995272,1656797273,1656797760,487,1826
3771504908,3228574805,1657860327,1657861138,811,1127
3240340462,3714188043,1650338852,1650339111,259,266
3979696807,3575375841,1644371073,1644371850,777,2064
3560967248,3252593307,1648583364,1648584271,907,1697
3435340439,3773532257,1644632743,1644632924,181,1621
3349301564,3923523643,1663636035,1663636812,777,218
3130093617,3587633750,1669370086,1669370175,89,196
3446914685,3075088680,1656978588,1656979138,550,159
3185360566,3996963058,1654859500,1654860153,653,2397
3644272268,3319782337,1656038415,1656038898,483,355
3939725219,3275494433,1658721714,1658722687,973,1168
3228319450,3619800237,1652005893,1652006297,404,2143
3736118442,3250108907,1661920950,1661920997,47,381
3481090623,3624060457,1646406376,1646406876,500,178
3513169935,3763455710,1668560247,1668560378,131,1698
3804948415,3287082352,1657122687,1657122997,310,2166
3751588241,3059151355,1644210262,1644210992,730,728
3180600647,3659732080,1651912265,1651912793,528,1946
3091072272,3866534454,1657259406,1657259509,103,1449
3713126710,3760930897,1660384652,1660384681,29,276
3593967802,3114348300,1663468136,1663468346,210,2021
3744196402,3414224162,1641928142,1641928291,149,547
3477827867,3941783209,1650500925,1650501428,503,1951
3766818968,3589441972,1663163640,1663164462,822,661
3471703914,3041001828,1649384109,1649384334,225,2028
3091062283,3520523282,1653218094,1653218600,506,700
3027870588,3340511048,1653870744,1653871694,950,416
3427127427,3626020948,1651201367,1651201696,329,2125
3917500425,3453070428,1663400723,1663401326,603,2033
3985734621,3184000585,1649728965,1649729295,330,2284
3506307976,3012339110,1662042858,1662043857,999,800
3605278552,3151539194,1653275487,1653276284,797,318
3855762650,3868827867,1656729867,1656730420,553,2397
3368294774,3124200545,1647508595,1647508773,178,1611
3398412701,3945397961,1669492775,1669492915,140,2434
3005283650,3071667890,1656470784,1656471316,532,1522
3898229065,3659732080,1660269605,1660270262,657,270
3038067120,3346860393,1664264909,1664265748,839,150
3107530825,3997397652,1662458543,1662459364,821,2034
3159669419,3183435456,1656980892,1656981550,658,706
3506273643,3050817805,1648242982,1648243281,299,1641
3088604045,3158962971,1647757170,1647757730,560,1246
3265324040,3710202750,1645055380,1645056333,953,1914
3154079557,3735946925,1659328570,1659329141,571,167
3181388502,3224130773,1668873015,1668873071,56,1974
3465842758,3998200859,1666279417,1666280277,860,1754
3815102601,3521217476,1642157001,1642157434,433,1276
3380930960,3400542216,1641903886,1641904257,371,178
3085429140,3505295000,1666092794,1666092946,152,413
3572224210,3689020840,1666116711,1666116838,127,1467
3395307809,3606545393,1653178254,1653178480,226,1521
3084138267,3088571651,1655009684,1655009796,112,569
3371063992,3201968141,1668630239,1668631040,801,462
3071971535,3177370273,1641350842,1641351003,161,465
3177879837,3852205498,1642631900,1642632688,788,1901
3314528450,3412989654,1644472625,1644472732,107,567
3824625919,3834268660,1663756483,1663757023,540,116
3471587065,3382974723,1654989576,1654990301,725,228
3273827707,3312344118,1657030754,1657031251,497,483
3736104902,3217857851,1653877854,1653878793,939,1809
3351361711,3774991953,1652144818,1652145605,787,1542
3572689902,3151704655,1645856023,1645856299,276,1458
3435292986,3094852425,1669059755,1669060478,723,2127
3959783422,3291819950,1653068981,1653069396,415,2027
3439799907,3580901513,1642620316,1642620781,465,89
3773789419,3657699213,1650088310,1650088312,2,631
3368987950,3159950284,1650322957,1650323078,121,1029
3551771231,3495691991,1653338701,1653339652,951,1266
3149818961,3477522732,1651922379,1651923168,789,1198
3976757440,3018325807,1667285878,1667286263,385,1089
3561113748,3487756836,1654077548,1654077707,159,1370
3459599732,3512215996,1643875866,1643876178,312,710
3979203926,3723780339,1645108229,1645108423,194,510
3210331889,3540735539,1666019083,1666019802,719,1563
3120490643,3924838447,1663705620,1663706445,825,668
3120490643,3814809809,1642786763,1642787558,795,1146
3342315965,3292797747,1660113345,1660113432,87,105
3771788181,3011686027,1649245879,1649246819,940,835
3834843479,3355429456,1654281023,1654281580,557,1904
3346484497,3907665331,1654382991,1654383142,151,123
3615359458,3474975781,1654341945,1654342182,237,824
3693920541,3408115806,1655340512,1655341075,563,1361
3885194706,3368420871,1667687395,1667687824,429,2442
3234064286,3055044716,1653761210,1653761967,757,2087
3966130885,3811930283,1648805937,1648806352,415,2172
3098934820,3264401846,1656124934,1656125237,303,1329
3383754736,3841459327,1668579207,1668580080,873,2303
3630963449,3162844882,1655949677,1655949924,247,610
3989563375,3206386504,1656412151,1656412437,286,1005
3165423009,3126455934,1657700034,1657700875,841,979
3609029368,3653739025,1644442784,1644443596,812,28
3377911201,3729787496,1645459574,1645460502,928,587
3592887882,3785728567,1652018054,1652018990,936,215
3688056726,3184270447,1666353460,1666354217,757,2451
3807924634,3886521075,1656793357,1656793406,49,1667
3066439887,3261174036,1665421187,1665422020,833,2472
3994348053,3909330778,1663824201,1663824885,684,2427
3875908590,3342929537,1645422558,1645422901,343,313
3166521010,3333665805,1652555350,1652555942,592,2166
3847771650,3793966136,1644586616,1644587167,551,1433
3365676412,3357699960,1668180581,1668181292,711,1484
3262978596,3967972556,1661846617,1661846753,136,316
3179280029,3184344401,1659580068,1659580202,134,393
3349247221,3290800332,1641544515,1641544779,264,663
3556197400,3041652512,1654793792,1654794240,448,2108
3402354750,3044161404,1647031880,1647031976,96,1216
3811482837,3920437320,1649938727,1649939221,494,1495
3745737102,3911632634,1653393767,1653393875,108,2308
3277577090,3295316821,1641794755,1641794906,151,957
3156522255,3441680015,1659311766,1659311920,154,489
3916928531,3252843201,1655838364,1655838832,468,1778
3447946570,3530491537,1657120711,1657121556,845,2280
3079137127,3128009914,1664685288,1664686246,958,621
3315185864,3793344397,1661443222,1661443908,686,1955
3162641272,3903112291,1661237396,1661237402,6,1671
3425613329,3748061416,1657958821,1657959238,417,746
3581399447,3836331716,1646799006,1646799880,874,475
3114277786,3851780195,1644243058,1644243637,579,1572
3476566118,3433261355,1658978564,1658978901,337,2146
3406042920,3846866111,1658269082,1658269369,287,1976
3001912243,3541942422,1656642495,1656643013,518,2461
3006953744,3426022733,1666884203,1666884293,90,1921
3613730980,3899117968,1662632862,1662633819,957,2195
3524589150,3467650879,1655939485,1655939839,354,482
3246159564,3829729960,1664589462,1664589805,343,1854
3595144575,3576411084,1645692623,1645693414,791,1694
3170036337,3039001408,1664075104,1664075475,371,937
3245354614,3853178623,1664869216,1664869377,161,695
3703056224,3375125376,1666325019,1666325148,129,481
3099976032,3570423127,1648638996,1648639782,786,1884
3949445116,3182502852,1650232945,1650233851,906,1519
3904825547,3296895937,1659062339,1659062687,348,827
3192505750,3751346675,1653882034,1653882835,801,752
3089574886,3540029077,1652642962,1652642988,26,1341
3617715231,3135579253,1658921420,1658921643,223,826
3336965818,3784046500,1656650577,1656651405,828,725
3043256301,3942575505,1666054935,1666055546,611,698
3776334300,3776918350,1655813801,1655814139,338,2136
3619399873,3214969929,1653964216,1653964962,746,98
3098538909,3198149459,1651919244,1651919698,454,448
3298748343,3755413351,1659935949,1659936917,968,1396
3428889808,3956054666,1666466720,1666467663,943,596
3500053511,3207283619,1662544608,1662544963,355,1223
3510416134,3008609242,1653084614,1653085256,642,975
3828713812,3843953645,1658856774,1658857002,228,2410
3953465037,3542285714,1657895735,1657895851,116,236
3820302319,3995299995,1661944185,1661945166,981,89
3495147813,3051654064,1654208043,1654208304,261,787
3657333207,3516410980,1656841412,1656841561,149,938
3066093153,3647994845,1660440031,1660440588,557,1526
3198022110,3060674509,1649738211,1649739000,789,764
3218798966,3883846613,1643049284,1643049740,456,2120
3734893217,3309053474,1649778277,1649778978,701,561
3271314900,3417298701,1651239661,1651239941,280,2439
3596839317,3802018450,1646336026,1646336358,332,1902
3741692259,3419415544,1650597581,1650597877,296,257
3339185857,3118128782,1668094454,1668094472,18,365
3137891271,3346778916,1660950865,1660951356,491,1018
3350872529,3359601528,1656187386,1656187411,25,209
3283155844,3872170030,1641395527,1641396144,617,1087
3343752753,3115236500,1646425999,1646426866,867,2241
3154680228,3376287193,1641830032,1641830326,294,2468
3710786724,3126455934,1664442765,1664443302,537,43
3104459009,3547672806,1651132065,1651132128,63,424
3114733025,3509999399,1650653425,1650654130,705,843
3472052544,3473314396,1664217692,1664217697,5,1906
3151982756,3289684726,1650180841,1650181436,595,2415
3400000869,3118807144,1660641514,1660642091,577,2123
3445689630,3410737355,1653053382,1653054366,984,476
3310169810,3661494924,1656640102,1656640586,484,602
3800201060,3095221133,1658243554,1658243681,127,1306
3478288963,3176317370,1658113769,1658113987,218,407
3136396999,3716861274,1649092829,1649093724,895,1933
3900309643,3986825518,1653581887,1653582140,253,550
3984215552,3199892178,1666930297,1666931148,851,1217
3619175296,3193403424,1644015638,1644016305,667,695
3744147238,3296531648,1643086055,1643086607,552,1892
3110121278,3212095735,1668189828,1668190244,416,1583
3318848700,3336494171,1642485019,1642485813,794,2072
3751694809,3704818655,1658178120,1658178764,644,2476
3749208805,3947788644,1660649195,1660650119,924,994
3761576790,3612642563,1658676157,1658676809,652,1444
3801410751,3451771672,1669388991,1669389971,980,654
3973440480,3488506620,1667906103,1667906210,107,2138
3360051725,3407460146,1658902399,1658902941,542,1535
3345458354,3063659192,1664437121,1664437923,802,852
3903947013,3073474496,1656113852,1656114496,644,354
3925754107,3566919425,1655963737,1655964091,354,237
3384222838,3829149174,1661701834,1661702754,920,353
3101886383,3693888320,1663215103,1663215870,767,1206
3924167113,3977139394,1660537473,1660538014,541,2319
3335383594,3995299995,1650396375,1650397056,681,2033
3945332462,3448459810,1667569455,1667569935,480,90
3932212405,3955825968,1650078199,1650079086,887,1167
3445647826,3806728629,1645561208,1645561830,622,1727
3306934792,3862122399,1657718347,1657719196,849,59
3306669471,3763317740,1660416151,1660417033,882,448
3785638958,3801410751,1658002261,1658002922,661,316
3019657030,3927920093,1659234094,1659234903,809,408
3546486600,3123458167,1669535058,1669535949,891,594
3243883781,3019761756,1651406048,1651406341,293,830
3658099781,3021218084,1661843855,1661844087,232,1009
3046380642,3205359825,1646202149,1646203099,950,448
3835708711,3986016860,1658304666,1658305049,383,250
3804824307,3228737899,1653244650,1653244781,131,2461
3040521946,3435319506,1651544374,1651544833,459,845
3319877479,3156189187,1658243990,1658244087,97,119
3451771672,3863427189,1668515593,1668515660,67,187
3636141899,3283671920,1645310040,1645310649,609,1439
3745420516,3432892677,1641738418,1641738886,468,2368
3191414403,3674059710,1659878546,1659879489,943,2425
3659771853,3966056341,1667359084,1667359715,631,394
3678720106,3041652512,1657811256,1657811722,466,834
3352262794,3588936901,1666824733,1666825133,400,33
3699258770,3580310329,1642535047,1642535478,431,871
3248724095,3162641272,1662254630,1662255438,808,1796
3422046745,3505480563,1648470311,1648470985,674,1757
3884346810,3647210250,1655505216,1655506105,889,232
3259367927,3715731774,1650144980,1650145041,61,737
3417798594,3324611610,1647876701,1647877362,661,1390
3454554705,3349301564,1649621521,1649621993,472,22
3456435173,3758622438,1667388371,1667389127,756,2093
3088602459,3431283022,1655736776,1655737565,789,1166
3168871510,3948946969,1659634268,1659635136,868,360
3461017113,3134890095,1656511420,1656512178,758,309
3068296722,3435252882,1653526902,1653526964,62,2317
3432522125,3821049069,1669298794,1669299705,911,372
3988546259,3522814184,1666163157,1666164043,886,1560
3287508774,3565381166,1646804211,1646804761,550,2111
3859249968,3051876837,1644776317,1644776619,302,1863
3834166808,3570906118,1649587130,1649587430,300,2131
3520324090,3487778655,1663525047,1663525062,15,75
3474543664,3927864902,1651515108,1651516070,962,1070
3253827804,3274159957,1649011374,1649012156,782,364
3721870717,3697085492,1667747396,1667748085,689,8
3593704176,3153750267,1659646236,1659646339,103,178
3403389913,3043611684,1655596279,1655596371,92,2210
3442799166,3355429456,1642607778,1642608121,343,1243
3011567148,3783119155,1657714446,1657714574,128,511
3630966486,3191792012,1649457113,1649457914,801,1868
3104459009,3393032827,1647641390,1647641415,25,2097
3468682335,3397376963,1660813964,1660814086,122,460
3146529279,3562105236,1650518180,1650518576,396,2415
3478280943,3028679133,1665358947,1665359922,975,2004
3957411858,3348735740,1660463057,1660463955,898,1103
3749897140,3390416640,1662887132,1662887293,161,2284
3233282653,3405388298,1644127593,1644127627,34,606
3121128511,3390416640,1664227529,1664228091,562,1444
3846060378,3370350588,1654898628,1654898680,52,2042
3867860336,3736085476,1653896517,1653897053,536,2346
3067179904,3290860752,1665500002,1665500262,260,1549
3451479071,3066168441,1646720764,1646721238,474,634
3031386210,3721110937,1662963109,1662963507,398,1058
3324395012,3416521015,1669080516,1669080883,367,1397
3827810459,3769836039,1649454929,1649455057,128,1705
3199892178,3269198119,1659605503,1659605661,158,879
3883057669,3198195956,1651181257,1651181286,29,2454
3883976824,3534192041,1649919151,1649920037,886,768
3183340735,3977078930,1654993191,1654993561,370,699
3059022884,3824517920,1668890699,1668891178,479,17
3861652282,3289017659,1658112470,1658113017,547,561
3171569619,3327427782,1651089259,1651089492,233,2430
3761269014,3922423821,1648454485,1648455392,907,944
3118358674,3709681519,1642854626,1642855360,734,2135
3696512728,3366321387,1652532500,1652533386,886,292
3413300274,3192940759,1641995892,1641996607,715,656
3396063880,3265434991,1656716012,1656716435,423,196
3413111275,3106705860,1667673645,1667674585,940,1404
3835701186,3583585259,1644476443,1644476515,72,936
3907665331,3057725565,1654293249,1654294200,951,214
3742012582,3118502732,1642353083,1642353867,784,2007
3964434363,3768211591,1641506221,1641506277,56,1934
3398876044,3909278547,1662350766,1662351057,291,658
3752297066,3105299236,1645588499,1645588697,198,1760
3195032074,3595560993,1663778770,1663779563,793,2060
3554741157,3977860015,1644387447,1644388288,841,706
3139882519,3062423981,1659606662,1659607367,705,729
3860422016,3995288261,1653343196,1653343550,354,1813
3014646091,3013073909,1662641166,1662641990,824,689
3792834070,3346778916,1644610363,1644610398,35,1249
3185985712,3595284541,1658150762,1658151348,586,1089
3632335400,3443161524,1661267060,1661267964,904,1476
3316398180,3994348053,1662953150,1662953954,804,289
3112356239,3594009328,1652753531,1652754421,890,256
3183672525,3111167324,1653775190,1653775305,115,2058
3635697777,3504911583,1644346282,1644347003,721,1604
3388490960,3168576951,1642594753,1642595610,857,925
3085001659,3633382140,1665464101,1665464500,399,1369
3169486525,3171734482,1644875295,1644876060,765,332
3852212988,3655135775,1641614475,1641614531,56,208
3234064099,3339633388,1642368899,1642369103,204,9
3905969199,3316978783,1650397703,1650397760,57,966
3129993467,3036527901,1644052785,1644053141,356,197
3617340911,3823206701,1653865120,1653866064,944,436
3489254440,3521258004,1642012158,1642012550,392,2205
3523631626,3309158757,1642196202,1642196843,641,1592
3404959548,3855900879,1644413039,1644413485,446,2466
3386809097,3085936525,1652081379,1652081646,267,1905
3894193367,3900309643,1661901210,1661902096,886,1997
3180984174,3035794185,1661424943,1661425110,167,224
3088132769,3193403424,1657791192,1657791883,691,1198
3544772636,3890821469,1648907106,1648907739,633,367
3248324593,3925504452,1663469576,1663469864,288,1431
3301901497,3307730398,1669481269,1669481702,433,279
3969355995,3525751984,1659345150,1659346150,1000,1655
3480905975,3010819705,1664908708,1664909294,586,222
3913608544,3841174974,1658974442,1658974838,396,520
3926088173,3132258390,1653694953,1653695940,987,2266
3274159957,3021613958,1653592852,1653593533,681,1487
3765617850,3825900664,1666173965,1666173993,28,2406
3711442352,3815537815,1654625778,1654626225,447,412
3445023517,3993756491,1662091885,1662092727,842,524
3593861215,3364911803,1665287068,1665287494,426,1814
3708101315,3373667144,1642277277,1642278154,877,681
3339719117,3287175350,1660516816,1660517753,937,740
3011985525,3895196680,1654307784,1654308010,226,1177
3740807524,3192175476,1643519983,1643520323,340,937
3468914867,3766186320,1648541973,1648542744,771,505
3224491185,3493226566,1641851303,1641852018,715,1036
3149668198,3983490056,1658279702,1658280221,519,642
3890875667,3096076350,1665027736,1665027908,172,736
3335915365,3415917688,1650199164,1650199384,220,1140
3319545220,3516410980,1654006485,1654006934,449,1605
3685715658,3404330776,1651692705,1651693191,486,363
3880298832,3035992910,1658476351,1658476775,424,2461
3480523769,3391282493,1650444585,1650445483,898,1140
3475612329,3406357109,1659837808,1659838595,787,2311
3197545162,3087326516,1667474852,1667475442,590,110
3611062566,3565803867,1664803373,1664804234,861,1713
3659732080,3437707461,1641537248,1641537472,224,1758
3570230022,3965137487,1661077364,1661078321,957,687
3406953156,3938025728,1656354005,1656354795,790,2029
3059848821,3589157304,1643510733,1643511547,814,1586
3895274115,3911671645,1661709842,1661710372,530,1310
3937618865,3823288349,1645192483,1645192994,511,8
3775665997,3914427859,1661563768,1661564386,618,1616
3420137628,3451329310,1650100972,1650101919,947,509
3054828202,3867543887,1668698264,1668699030,766,1528
3154823834,3336423969,1657340103,1657340280,177,2344
3658423327,3464770966,1651552425,1651553296,871,311
3962031345,3854906546,1649708829,1649709761,932,1249
3024431618,3600725106,1641060483,1641061194,711,1563
3365289656,3104793032,1660549589,1660549638,49,878
3436636953,3520341683,1654819376,1654819411,35,1629
3327857419,3927646653,1665722304,1665722695,391,1144
3697338181,3257080734,1647093336,1647093656,320,1118
3776783076,3677965553,1658912297,1658913198,901,222
3889544424,3246044882,1650654406,1650655042,636,1911
3015814199,3125019722,1649328944,1649329442,498,2083
3837062335,3273518390,1668831903,1668832080,177,109
3122085251,3786840082,1653425896,1653426590,694,480
3283947136,3378613925,1656051230,1656051456,226,1285
3003941040,3482235012,1663788258,1663788454,196,1586
3748841094,3656770582,1650384627,1650385046,419,1224
3374470605,3022767670,1641638227,1641638992,765,483
3857931113,3774991953,1669364513,1669365438,925,47
3356154602,3856756422,1643007561,1643008350,789,927
3919792223,3897412947,1643964316,1643964617,301,1911
3906903088,3028886204,1661762141,1661762401,260,866
3346604377,3746229411,1663885458,1663886380,922,379
3671154785,3061594355,1652381383,1652381819,436,1737
3776685300,3606998838,1666066336,1666066353,17,29
3294478149,3607580736,1666936669,1666936999,330,2172
3881216721,3114605564,1653251079,1653251404,325,2363
3168600862,3060633640,1649919652,1649919666,14,1124
3372438676,3628830127,1641950789,1641950905,116,1973
3928354041,3595284541,1656549377,1656549734,357,2024
3082885404,3817252660,1643830107,1643830224,117,2308
3647398701,3098513510,1653509828,1653510569,741,1788
3975462879,3124200545,1652862959,1652863104,145,766
3770771031,3628729475,1645321910,1645321960,50,693
3406332128,3940222685,1643472468,1643472922,454,11
3984533628,3952286494,1648141861,1648142277,416,1707
3958920817,3707867178,1667071058,1667071155,97,1378
3342189600,3605519659,1668843459,1668844050,591,2005
3216657133,3615177362,1651153525,1651154520,995,914
3303986609,3404394014,1642515028,1642515382,354,896
3057085790,3832585790,1655529440,1655529993,553,1492
3795609815,3885786333,1665097288,1665098174,886,552
3232333937,3084855451,1650047769,1650047839,70,1839
3148041041,3704818655,1641354241,1641354576,335,159
3861499264,3747889498,1652399692,1652400650,958,2396
3497171741,3961973688,1667861361,1667861396,35,974
3918234060,3665557228,1663407139,1663408137,998,365
3322226292,3865503383,1669590715,1669591055,340,686
3168820334,3656002043,1664119978,1664120976,998,2183
3034985161,3270453709,1668880321,1668880696,375,263
3725465166,3098369438,1660061434,1660062053,619,962
3012272703,3892800106,1653251550,1653251661,111,1950
3772739629,3794926978,1648489709,1648490456,747,2117
3632156948,3545032372,1647182587,1647183106,519,339
3331866261,3030117347,1662395124,1662395568,444,1517
3703457098,3975198652,1651305657,1651306369,712,2293
3678305236,3536931244,1652680182,1652680241,59,225
3432462167,3329848036,1654371542,1654371573,31,752
3106328456,3963385029,1661103499,1661104381,882,606
3805742408,3648305208,1656291110,1656291306,196,172
3246321113,3602829591,1654462580,1654463000,420,1853
3464754983,3184720975,1663423881,1663424839,958,1406
3730533080,3112357538,1653987357,1653987361,4,837
3553146922,3749308364,1657043529,1657044051,522,1543
3025133604,3240839516,1660730888,1660731228,340,41
3554409625,3571897260,1667852131,1667852795,664,1924
3538972815,3090588645,1643412945,1643413622,677,2272
3660162411,3104870555,1644974093,1644974588,495,2023
3131025611,3095728444,1666505581,1666506567,986,2480
3715118659,3066439887,1665734963,1665735125,162,2379
3894413849,3927284839,1668661050,1668661281,231,1529
3232436630,3514680311,1644582665,1644582956,291,1921
3266042074,3829878263,1667188341,1667189067,726,175
3205383513,3423043196,1667632342,1667633078,736,2091
3682419396,3924559198,1644383519,1644384472,953,922
3031560160,3791302710,1664146413,1664146532,119,1086
3604757184,3658656847,1657027451,1657028192,741,289
3364404145,3009365802,1646723693,1646724294,601,2363
3219292166,3348802129,1643794693,1643795323,630,1345
3280405059,3594231530,1645990669,1645990752,83,2014
3328699609,3084783158,1645646326,1645647290,964,208
3734099449,3825462888,1650037427,1650038379,952,2460
3607608267,3224800126,1664583183,1664583437,254,1622
3316031407,3866582723,1666358712,1666359321,609,2249
3989563375,3866532806,1662502134,1662503040,906,1167
3278980230,3634539557,1651238171,1651238372,201,242
3663985085,3645310975,1658700521,1658700803,282,1338
3575535453,3687829870,1669535787,1669536668,881,424
3717334493,3600472145,1646405560,1646406222,662,1170
3405388298,3563259493,1655887454,1655888273,819,1093
3722726470,3320065223,1644056917,1644057250,333,2492
3924583665,3686144397,1664164898,1664165179,281,444
3159240548,3529898997,1655773261,1655773864,603,1632
3151982756,3340427847,1665795463,1665796292,829,1388
3344282962,3004890840,1651450057,1651450114,57,1096
3061619114,3130594039,1668905380,1668906149,769,924
3604881190,3809312897,1658718397,1658719036,639,758
3448203668,3794715398,1651516181,1651517027,846,34
3653577731,3877299439,1642312843,1642312943,100,2498
3311113773,3607622692,1645761315,1645761570,255,2274
3219637680,3644531526,1646367760,1646368454,694,2091
3528146911,3232781077,1643638087,1643638286,199,134
3267600229,3850392190,1659162358,1659162860,502,2120
3601690466,3583307819,1648877653,1648878454,801,398
3948969420,3754631129,1667258679,1667258767,88,569
3569200063,3329117199,1661393915,1661393937,22,2437
3073966897,3493424957,1667773815,1667774135,320,1319
3079516653,3624090791,1655168631,1655169463,832,2083
3920028342,3698133773,1641971222,1641971470,248,2062
3109500957,3011981503,1653689851,1653690194,343,581
3255248380,3143189190,1647055235,1647055254,19,317
3501520918,3367685887,1666808206,1666809103,897,395
3896789438,3317748904,1658815910,1658816112,202,1694
3603068932,3717406689,1642128355,1642128566,211,2412
3785657136,3402426323,1643741682,1643742026,344,2154
3216582576,3186483050,1668552387,1668553022,635,359
3916290714,3112356239,1648645205,1648645430,225,343
3980501547,3605706184,1644638652,1644639301,649,1470
3831683294,3196407951,1649538102,1649538415,313,1077
3915686266,3880353584,1662792325,1662792515,190,402
3207757416,3313252249,1659694932,1659695678,746,1632
3363125076,3178090646,1659112957,1659113086,129,332
3417248496,3579642249,1666956908,1666957319,411,123
3034601276,3899788381,1664635220,1664635539,319,1348
3764175850,3976367014,1657371703,1657372586,883,60
3759967696,3510318605,1667424582,1667425323,741,1363
3311244386,3843917747,1647853347,1647854204,857,1335
3774806676,3284832227,1666933151,1666933397,246,1431
3434608050,3597485446,1644800722,1644801354,632,23
3036046331,3453227348,1662265796,1662266354,558,1931
3911960681,3269763687,1650858293,1650859003,710,905
3361422449,3949522552,1647857171,1647857208,37,129
3139434250,3351087116,1667363825,1667364006,181,414
3567328601,3061299464,1646616876,1646617171,295,2306
3590243603,3696437293,1653016467,1653016911,444,424
3086084685,3428889808,1649694124,1649694948,824,513
3584668339,3909173527,1641577320,1641577867,547,689
3475897333,3172018366,1646731800,1646731957,157,615
3578075354,3467650879,1644645625,1644646149,524,1432
3771504908,3003087336,1643868644,1643868832,188,536
3197371652,3660046291,1641176523,1641177479,956,586
3821275122,3101460702,1654530249,1654531109,860,208
3535414109,3605195406,1648197512,1648197903,391,2207
3974481828,3151323388,1644308858,1644309037,179,1005
3658423327,3151697582,1641173899,1641174880,981,2381
3079031370,3611100286,1646416420,1646417068,648,25
3765472006,3991686619,1668733603,1668733844,241,760
3577216621,3268349855,1665906713,1665907571,858,2278
3287600901,3049969877,1655416775,1655416832,57,2370
3250108907,3861263764,1666083223,1666084089,866,92
3424368056,3267089074,1645873936,1645874479,543,81
3537915144,3481466662,1661473313,1661473778,465,1984
3864485247,3840962989,1659814047,1659814715,668,282
3277298737,3623092479,1655975084,1655975801,717,1298
3333665805,3767912489,1664976500,1664977487,987,2212
3393712145,3327166880,1652963320,1652964032,712,1274
3142747577,3683507812,1667265093,1667265588,495,250
3401138486,3667718430,1665899847,1665900501,654,2145
3237987905,3150485567,1646524302,1646524396,94,783
3385806632,3480516042,1646355125,1646355351,226,839
3463121212,3344891111,1658326682,1658327401,719,1016
3742647803,3458478056,1642755926,1642756462,536,1950
3029016525,3236975783,1642987158,1642987356,198,1397
3154435614,3913366963,1646005235,1646005282,47,694
3382693942,3831380073,1658750391,1658750547,156,2073
3683507812,3475779347,1665299454,1665299560,106,1532
3489811088,3343941091,1661990690,1661991404,714,2266
3402511144,3634282428,1646593188,1646593399,211,1738
3057348673,3367865740,1656042034,1656042902,868,1110
3940914301,3324473595,1653291642,1653292397,755,817
3097489594,3902739418,1654860243,1654860997,754,1985
3675703241,3768013956,1645557981,1645558670,689,773
3985734621,3137412000,1651287984,1651288583,599,2067
3451206797,3922972838,1658529030,1658529712,682,576
3790039057,3885087517,1665674045,1665674983,938,907
3293007803,3766062750,1663991263,1663991665,402,2272
3880599649,3329618048,1658837679,1658838483,804,460
3972886254,3246701704,1643587696,1643587730,34,486
3910837040,3944398168,1669027981,1669028653,672,1357
3057300178,3338749992,1662795638,1662796115,477,2147
3610577318,3664337365,1667217539,1667218108,569,2467
3538039823,3280328195,1663760570,1663761525,955,954
3120419076,3672059189,1641342307,1641343115,808,1861
3879299283,3048497124,1668389608,1668389664,56,1968
3014392598,3865511945,1645679326,1645680121,795,2401
3299389436,3704871253,1656974915,1656975755,840,1552
3824517920,3188162412,1656921555,1656921889,334,1437
3028267408,3036448305,1645006459,1645007179,720,659
3594173372,3038067120,1666828190,1666828400,210,1932
3076767349,3181048786,1659834957,1659835018,61,130
3297949666,3723110330,1650056416,1650057088,672,603
3053100790,3521408145,1646496962,1646497133,171,2321
3582076532,3171413650,1663698039,1663698526,487,1908
3556450605,3827810459,1645118171,1645118371,200,732
3027287663,3050800748,1659674577,1659674861,284,1868
3061979919,3553096192,1663040042,1663040947,905,1503
3359895223,3201142543,1644536969,1644537070,101,231
3128514837,3334102064,1641538635,1641538643,8,884
3599874732,3200897172,1665916168,1665916615,447,1292
3526687041,3392121294,1662916532,1662917369,837,254
3740438273,3972955608,1654404156,1654404362,206,2488
3772910484,3188643066,1666688285,1666688702,417,2100
3536903033,3250528764,1648813034,1648813567,533,1291
3743136976,3194140038,1667594160,1667594859,699,1568
3392293203,3196407951,1644310958,1644311954,996,2172
3356034290,3276763839,1656779590,1656779933,343,1707
3418988797,3961420550,1659170794,1659171431,637,2118
3390445291,3681631482,1649697473,1649697600,127,549
3121336226,3378325026,1668317532,1668317813,281,2285
3315951327,3982715838,1660599462,1660600449,987,2439
3136707992,3635624917,1655076071,1655076364,293,248
3831426674,3105679045,1650046435,1650047081,646,1347
3780182766,3048788442,1643430064,1643430882,818,1175
3089525434,3337765684,1646827134,1646827678,544,1265
3921189235,3592026567,1665360135,1665361117,982,971
3252535116,3726378645,1646851149,1646851231,82,1847
3254367735,3449622291,1667936782,1667937689,907,670
3823133313,3069818047,1661622462,1661622953,491,787
3379726555,3640605424,1653738424,1653739243,819,1494
3542369467,3325842490,1657032974,1657033662,688,376
3072834944,3662526382,1668562589,1668562998,409,210
3114183830,3275436235,1663888860,1663889133,273,770
3743835099,3582076532,1642898401,1642898611,210,1914
3518179871,3579924256,1663121478,1663121500,22,1609
3060121211,3251409316,1666872550,1666872865,315,397
3749529134,3574460900,1656642308,1656643229,921,1979
3450811740,3943413233,1653598760,1653599265,505,1435
3093773162,3414224162,1669267510,1669268492,982,389
3261913628,3097475982,1645570115,1645570993,878,316
3697338181,3240452269,1652998020,1652998501,481,2424
3887337385,3888895982,1656489111,1656489169,58,1968
3524831718,3286065477,1654223428,1654224333,905,1461
3070199722,3488280503,1641066523,1641067191,668,1882
3225477579,3833345079,1641731971,1641732793,822,1715
3650172161,3190778281,1647021862,1647022751,889,102
3403223215,3658782272,1662666719,1662667188,469,1977
3105903246,3030641135,1668446920,1668447871,951,162
3798343786,3840422094,1651914026,1651914389,363,911
3985879853,3617349707,1662878503,1662879022,519,524
3655498745,3393406422,1656007724,1656008662,938,295
3827810459,3265611656,1663960964,1663961296,332,528
3716415183,3113516667,1650229772,1650230770,998,2001
3828322397,3896308173,1642088013,1642088310,297,1002
3312805786,3883497013,1657836520,1657836810,290,174
3643185661,3516140957,1662001754,1662001926,172,1511
3403389913,3202881162,1656928879,1656928991,112,1363
3965000413,3463540687,1646357301,1646357388,87,1522
3522211010,3203128336,1666401052,1666401225,173,1426
3434224349,3171235556,1664620057,1664620465,408,1413
3917601622,3350566867,1661551828,1661552227,399,1491
3280328195,3119702215,1663124087,1663125036,949,1943
3121762934,3254695387,1649155513,1649155816,303,1531
3937729247,3232141615,1650567442,1650568421,979,644
3796559738,3540104512,1642564859,1642565440,581,164
3400233871,3835049098,1646083650,1646083786,136,2362
3670075164,3816170686,1667142257,1667142288,31,2034
3715994986,3380930960,1663965299,1663966011,712,284
3660548799,3991087724,1657122434,1657123145,711,103
3734367959,3657333207,1658078815,1658079361,546,1996
3650205106,3227951880,1645043775,1645044535,760,1580
3061362091,3836823852,1655740635,1655741063,428,2477
3239517474,3120425371,1641844436,1641845303,867,2444
3310512172,3186584232,1668318977,1668319359,382,219
3428557602,3930205120,1656705858,1656706796,938,302
3065434950,3956194935,1661178522,1661178631,109,1843
3564440153,3985486150,1659162843,1659163000,157,257
3093599187,3310496626,1654438181,1654438378,197,1061
3445226012,3146634302,1655218023,1655218061,38,2333
3891850013,3436234030,1662359592,1662360175,583,1813
3213169891,3722422633,1643026689,1643026851,162,1141
3336302831,3687243333,1642494770,1642495396,626,677
3815537815,3027870588,1654612379,1654613321,942,301
3493489568,3521217476,1646128413,1646128549,136,2238
3513399148,3288555658,1653394785,1653395514,729,1651
3858519840,3280491285,1659315671,1659316401,730,1148
3401611149,3514013878,1660006745,1660007513,768,852
3405168756,3345875910,1661952862,1661953376,514,1309
3679617161,3537107415,1654509597,1654509678,81,587
3639659256,3123999917,1663425540,1663426397,857,1783
3138662322,3189300345,1667672905,1667673865,960,672
3298044531,3014185506,1648767105,1648767969,864,863
3950936299,3539839307,1659532514,1659532564,50,1585
3874626130,3295518987,1667158867,1667159481,614,1479
3275223689,3014646091,1661620138,1661620970,832,1109
3060727793,3906308749,1647121314,1647122133,819,2493
3669324531,3258352640,1641268317,1641268506,189,1135
3474558723,3835049098,1667318495,1667319445,950,1409
3855013110,3490435539,1651696535,1651696790,255,2081
3728924033,3022283384,1642714052,1642714085,33,655
3890781778,3820374377,1657404104,1657405039,935,1652
3368423726,3935656272,1660441047,1660441158,111,2004
3696096099,3002396640,1651388923,1651389415,492,2049
3373729748,3434324683,1666011665,1666011883,218,1309
3272663489,3289332257,1648626360,1648627334,974,66
3428260922,3639618179,1644641086,1644641691,605,1946
3780039563,3598506871,1647281173,1647281492,319,2253
3935656272,3963334554,1664437030,1664437439,409,2167
3317382420,3598506871,1648494142,1648494233,91,360
3656829277,3696184358,1653124647,1653125550,903,1716
3109127825,3113214024,1646980788,1646981191,403,16
3574740304,3710466773,1648263326,1648263892,566,1602
3077145114,3891579335,1641244455,1641245317,862,1389
3713129998,3227462918,1667096269,1667096912,643,1767
3678404361,3847104925,1650258035,1650258583,548,1683
3637981738,3903588940,1659183146,1659183447,301,1092
3099818927,3061299464,1661465096,1661465352,256,269
3091275117,3142313032,1652819921,1652820239,318,1073
3420733881,3060633640,1665252838,1665253800,962,1502
3812800144,3349433488,1643888742,1643889147,405,535
3713520914,3109806852,1650791129,1650791623,494,1079
3909523201,3069313994,1641310637,1641311041,404,1787
3489695411,3264865965,1643867842,1643868760,918,2405
3289696366,3986247608,1657357242,1657358062,820,564
3256566881,3932613929,1650663803,1650664686,883,1322
3172310061,3489811088,1663901389,1663901642,253,734
3890940747,3800312034,1642009562,1642010307,745,1520
3594038673,3364390232,1641579036,1641579599,563,692
3876867156,3218136112,1665722875,1665723189,314,1756
3849816711,3041652512,1659870926,1659871523,597,2127
3515170949,3308454699,1662201766,1662201965,199,455
3016568360,3200827648,1645022681,1645023513,832,640
3350446044,3632911091,1666623019,1666623434,415,2241
3049141347,3190544941,1665350451,1665351322,871,1787
3097489594,3185373368,1665581109,1665581390,281,1537
3727544443,3959795133,1641163725,1641164614,889,2227
3972294801,3594471575,1643355247,1643355635,388,1665
3034643506,3902705203,1662180027,1662180772,745,1463
3278038835,3956054666,1660574918,1660575037,119,528
3600573063,3657597585,1668542868,1668542928,60,278
3230277243,3179280029,1659884777,1659885210,433,1195
3181032246,3884798812,1646087381,1646088200,819,2102
3928572443,3940914301,1653551997,1653552631,634,1771
3990264315,3110339164,1666108349,1666109310,961,1306
3450074680,3882438892,1653701438,1653701596,158,2384
3911588238,3627191763,1654099123,1654099979,856,617
3657464089,3819584735,1655184785,1655185719,934,1520
3246701704,3144175285,1661550023,1661550357,334,351
3195504067,3537862606,1641962717,1641962970,253,170
3881861537,3260515804,1661678466,1661678487,21,2489
3626020948,3710318693,1667410816,1667411165,349,2272
3194871172,3929307105,1657644906,1657645858,952,1535
3060727793,3180973124,1657034472,1657035199,727,1008
3796275634,3099976032,1647987816,1647987872,56,600
3617340911,3294783182,1651684075,1651684798,723,812
3832585790,3527201198,1661734661,1661734739,78,537
3761636372,3543732655,1665978522,1665979083,561,1238
3242785599,3778228977,1664572068,1664572174,106,963
3960897829,3317961564,1652373866,1652374005,139,68
3233536885,3973050834,1654086592,1654087352,760,311
3282561101,3169486525,1663803668,1663804321,653,54
3905356323,3048405710,1668869971,1668870143,172,549
3338020076,3084982671,1641195119,1641195791,672,2326
3164942448,3424768768,1657650301,1657650962,661,123
3335063983,3873840731,1653010074,1653010935,861,461
3341248102,3084882941,1641227756,1641227815,59,1339
3502050886,3272981808,1664405290,1664405347,57,1031
3137092101,3251854206,1662534306,1662534928,622,276
3390134392,3343752753,1666650435,1666650843,408,606
3605278552,3551771231,1657412010,1657412999,989,49
3283922234,3534715157,1646532463,1646532755,292,2071
3195274844,3647480411,1644564465,1644564871,406,161
3125459736,3615595663,1653052677,1653053036,359,797
3986016860,3096662890,1656063912,1656064802,890,2474
3429074631,3706085200,1658782228,1658782681,453,1308
3635624917,3623876940,1658558619,1658558843,224,300
3039544352,3007934266,1643055526,1643056319,793,2136
3816995343,3775660991,1643187315,1643188302,987,2052
3758849561,3384536407,1656344964,1656345205,241,1254
3840846518,3825995272,1650049304,1650049611,307,1068
3096854657,3127783768,1669067119,1669067643,524,252
3003422357,3436768933,1644397974,1644398508,534,2319
3110753111,3956878212,1663375308,1663375576,268,322
3775103844,3041385548,1654824653,1654825123,470,1601
3336657547,3818028118,1666771831,1666771967,136,1695
3383755219,3624298459,1663679256,1663679709,453,2201
3368420871,3014798893,1669549181,1669550007,826,1597
3924838447,3022348535,1644464536,1644465375,839,29
3340331761,3804257503,1667815431,1667816109,678,1855
3285747162,3528278695,1642907467,1642908169,702,2402
3184404815,3894030912,1647049463,1647049714,251,540
3356302136,3488280503,1666937111,1666937934,823,1512
3604881190,3313608055,1645128491,1645129402,911,1304
3529681535,3643637605,1655272180,1655272342,162,7
3433261355,3424994271,1667409037,1667409913,876,85
3810915449,3931229167,1667820951,1667821712,761,604
3939755962,3377781677,1649572937,1649573718,781,1170
3308071201,3319605191,1647878780,1647879353,573,1949
3927329503,3156452001,1650974593,1650975307,714,1955
3685715658,3928685907,1660777894,1660778071,177,1325
3393000047,3346254669,1657653586,1657654013,427,2442
3680453323,3812997079,1643561524,1643561587,63,56
3833594316,3457542537,1645331606,1645332496,890,1591
3233318289,3563134874,1650439294,1650439737,443,2394
3514354263,3434575449,1649890852,1649891478,626,1013
3939244771,3967255191,1641280453,1641281418,965,213
3415686543,3906309759,1667070819,1667071701,882,2148
3121336226,3718905579,1642071163,1642071290,127,1072
3741273371,3413948595,1665738484,1665738892,408,815
3438084709,3221276652,1648991874,1648991899,25,1497
3823288349,3071765048,1647907061,1647907592,531,2406
3791419861,3799036179,1647812869,1647813350,481,1849
3020452542,3090506589,1642734363,1642734410,47,2040
3856882586,3261463305,1653015605,1653016377,772,2197
3795794957,3176410131,1652022158,1652022481,323,576
3908895548,3842362489,1648345101,1648346051,950,1949
3844499309,3071810518,1653742806,1653743070,264,2062
3003861546,3143689256,1647004912,1647005114,202,1874
3787937000,3298748343,1665641745,1665641874,129,1011
3329751201,3333872407,1659716014,1659716970,956,2415
3729325351,3600334566,1664072471,1664073077,606,703
3110339164,3875343154,1664643077,1664643987,910,1400
3599795440,3507564472,1642604300,1642605008,708,1846
3476405785,3332458882,1649116501,1649117444,943,471
3463405011,3948754212,1647156387,1647156657,270,921
3861764050,3036527901,1669694668,1669695089,421,2296
3245723038,3463734539,1648210838,1648211386,548,763
3012119082,3167058279,1665829797,1665830341,544,1947
3662355477,3028705386,1662180715,1662181392,677,1929
3532021354,3304973317,1654368723,1654369139,416,1849
3445281422,3776862606,1654340296,1654340387,91,509
3855476133,3542827244,1644087896,1644088799,903,17
3763188005,3289330422,1655423876,1655423886,10,1793
3069881077,3404043594,1645387181,1645387853,672,7
3977495302,3787590278,1643859440,1643860367,927,1369
3819380768,3866582723,1651342978,1651343644,666,1377
3597904540,3677539420,1651413627,1651414141,514,2474
3805772843,3569478966,1657960041,1657961000,959,564
3204735172,3894616795,1668871578,1668872095,517,590
3688056726,3412307376,1651853499,1651853678,179,2317
3390329949,3947174877,1662619653,1662620250,597,420
3989991456,3823637809,1667158843,1667159710,867,1315
3332458882,3153085443,1659870916,1659871535,619,969
3882879531,3428260922,1666874805,1666875367,562,1776
3164702890,3434182192,1654541841,1654542200,359,887
3141689539,3105648731,1643542523,1643543307,784,1270
3083182515,3683038659,1649029313,1649029737,424,1882
3487406679,3918988651,1650672520,1650673127,607,606
3305480485,3224617784,1660599206,1660600127,921,677
3132802864,3365316758,1652936823,1652936835,12,2256
3991542844,3257034858,1654622886,1654623641,755,1162
3151346211,3349879521,1647413000,1647413191,191,2377
3534133715,3048296949,1656555457,1656555672,215,1411
3312656348,3183640403,1651775866,1651776618,752,1227
3491272857,3227446097,1658711348,1658711519,171,337
3886368625,3752000675,1658461624,1658461798,174,648
3166483466,3689828648,1653280323,1653281122,799,1939
3732456028,3481672220,1642809001,1642809207,206,2103
3682922389,3314872000,1666344639,1666345564,925,2367
3458116043,3257594028,1662388631,1662388801,170,415
3929638122,3590361712,1656679509,1656679605,96,910
3620985435,3364540592,1662652874,1662653558,684,196
3398443861,3727801252,1660976197,1660976497,300,57
3003861546,3990343743,1666237680,1666237712,32,834
3824083602,3792708367,1667662580,1667663211,631,937
3546799061,3424562136,1667695847,1667696325,478,2438
3087612913,3827891957,1651642091,1651642969,878,111
3746243275,3821275122,1653494423,1653494982,559,437
3088571651,3177491349,1654079924,1654080743,819,1055
3472474698,3112314644,1644569650,1644570401,751,97
3232285985,3122246747,1665003672,1665004612,940,810
3745960708,3258098890,1662932505,1662932921,416,896
3154079557,3253589940,1663206236,1663207054,818,2318
3221850819,3175976694,1647331021,1647331173,152,350
3058141936,3727131221,1653926765,1653927288,523,957
3748627476,3555571916,1644177744,1644177983,239,2297
3482576542,3866414868,1646965174,1646965246,72,2428
3002669219,3541597384,1649313278,1649313562,284,779
3497990894,3301620813,1652024018,1652024893,875,1474
3662455665,3617453316,1661874316,1661874353,37,63
3541560120,3470128186,1644004434,1644005045,611,429
3713231806,3619529955,1658136518,1658136857,339,1375
3708922840,3450102071,1651066683,1651067315,632,1218
3444149733,3105636655,1646317254,1646317269,15,1337
3056252574,3118419220,1650518076,1650518975,899,2071
3288555658,3100670764,1665772172,1665773066,894,1961
3623769570,3106395050,1668175259,1668175800,541,1334
3128009914,3699427202,1651957562,1651958378,816,2136
3704437148,3424476490,1666500261,1666500482,221,10
3482763584,3506384176,1644142467,1644143357,890,2186
3584660761,3125378100,1645677631,1645678436,805,1412
3103404280,3996963058,1652657866,1652658118,252,2095
3698025795,3747889498,1649735948,1649736016,68,1914
3988337484,3704568536,1652072534,1652072997,463,671
3855013110,3241444105,1666602891,1666603139,248,1387
3749327438,3907213401,1641707442,1641708187,745,1108
3596883607,3118406319,1643927131,1643927607,476,1227
3950225483,3945397961,1643326224,1643327124,900,1229
3345138946,3189759788,1652189890,1652190671,781,374
3207407283,3827551944,1642749065,1642749814,749,1288
3473355243,3346978275,1654983340,1654984181,841,1352
3080829502,3135134317,1660232753,1660233484,731,1960
3144993263,3942325631,1648846050,1648846570,520,2017
3180101007,3722220404,1669182902,1669183692,790,1298
3360040841,3458243810,1658244730,1658245712,982,424
3300203056,3723780339,1669367746,1669368292,546,699
3925365269,3802325069,1645580213,1645580789,576,776
3447527130,3476566118,1643562895,1643563428,533,711
3048497124,3796559738,1668171828,1668172391,563,1367
3487756836,3262728353,1643678626,1643678729,103,993
3247688800,3595270507,1662659835,1662660771,936,411
3446987671,3351921075,1650146038,1650146304,266,47
3258417294,3911185524,1662134810,1662135474,664,1756
3606331231,3456080836,1651854230,1651854709,479,2298
3786148014,3470586731,1664559550,1664560543,993,1195
3043736420,3643372353,1656933015,1656933548,533,1981
3685049252,3538039823,1665528252,1665528680,428,2028
3416521015,3877049401,1647221580,1647222415,835,1160
3081803809,3053100790,1647765731,1647766431,700,1425
3515845767,3112742999,1667072646,1667073047,401,1897
3899247202,3839967647,1664835730,1664836591,861,2228
3471651838,3636879699,1661950370,1661951040,670,261
3945611603,3349724698,1647522976,1647523572,596,2143
3827851972,3065482463,1667399850,1667400002,152,1231
3366822094,3568289450,1665933282,1665934062,780,1452
3607622692,3938417195,1657189470,1657189636,166,48
3894359262,3836565798,1669566821,1669566965,144,867
3652898768,3829874150,1665186303,1665186582,279,787
3070588700,3022428512,1664163967,1664164497,530,983
3390441234,3460552791,1668154601,1668155487,886,1661
3378522829,3783064521,1661798204,1661798661,457,758
3237807880,3806015172,1667090506,1667090921,415,458
3140971443,3043153412,1655120576,1655121566,990,2371
3025333750,3184168205,1654862425,1654863267,842,1744
3132349279,3565128218,1650145571,1650146068,497,1058
3957824946,3217047921,1647333485,1647333846,361,176
3612061421,3261376049,1666223028,1666223701,673,2372
3457361080,3794408677,1649737680,1649738213,533,1234
3816538946,3466204914,1651413870,1651414326,456,526
3050867171,3599795440,1662415815,1662416463,648,874
3122246747,3340464785,1647904275,1647905103,828,330
3828833040,3726892870,1662927527,1662928479,952,241
3482763584,3125818794,1652125566,1652126007,441,2470
3309684706,3359278409,1652260054,1652260843,789,2023
3243831128,3871321308,1641457480,1641457617,137,759
3206512870,3941586762,1651126101,1651126579,478,846
3780039563,3169688960,1658420246,1658420319,73,222
3904183865,3046085814,1642462819,1642463706,887,583
3600977488,3639804787,1669438891,1669439440,549,885
3616429615,3647539125,1664337893,1664338632,739,1929
3993923271,3425856728,1658628140,1658628402,262,2011
3617958907,3799078288,1662950914,1662951887,973,264
3697085492,3878274883,1666146845,1666147541,696,1631
3878005127,3007480776,1658750334,1658751224,890,1097
3432059238,3946911182,1656390641,1656391381,740,627
3204346356,3507431231,1651763683,1651763991,308,1100
3864485247,3332144974,1646703082,1646703158,76,592
3506384176,3990233750,1654704531,1654705344,813,1416
3473314396,3759008568,1648861833,1648862248,415,1899
3789999187,3702064029,1664040598,1664041242,644,883
3426017820,3683793217,1666298654,1666299431,777,373
3522465860,3712443558,1655785198,1655785781,583,2456
3206061644,3341211432,1645471589,1645472515,926,2040
3241847877,3153858233,1659829164,1659829896,732,1125
3868902207,3214068022,1641878297,1641878502,205,542
3760817382,3514680311,1662397082,1662397093,11,1170
3901459563,3290794282,1665425584,1665426313,729,1037
3845363108,3749211785,1664744478,1664745105,627,257
3153902371,3632156948,1663256530,1663257131,601,1251
3652029135,3108123256,1651809538,1651810026,488,1570
3799078288,3519269683,1645440075,1645440099,24,889
3406509436,3880580622,1657848641,1657848831,190,868
3576425783,3083182515,1658898882,1658899180,298,697
3788769219,3210036729,1652686131,1652686608,477,2195
3817073865,3860519596,1648808663,1648809480,817,790
3359212197,3351863157,1650143595,1650143994,399,2461
3525442421,3610270492,1659677361,1659678076,715,1181
3967517584,3918383192,1649279747,1649279848,101,1303
3005101248,3090731052,1641512422,1641512460,38,3
3967250644,3946833004,1665711682,1665712552,870,1342
3564599618,3841314189,1644574391,1644574551,160,230
3298436959,3571576669,1656028631,1656028777,146,221
3608450611,3968682824,1644485362,1644485728,366,1066
3883846613,3474115926,1668943288,1668943428,140,2053
3347942747,3119802700,1648303625,1648303940,315,945
3293416862,3963841091,1666913261,1666913493,232,1399
3776944992,3264317816,1658002112,1658002864,752,1669
3706215600,3889840253,1650471674,1650472056,382,1790
3869930031,3197201691,1648512672,1648512918,246,1178
3703615574,3404330776,1654678989,1654679911,922,1280
3682006274,3231701470,1663822513,1663822680,167,2471
3886709661,3332012161,1645522517,1645522853,336,463
3649298405,3531898771,1645415182,1645415839,657,1081
3218798966,3297681098,1666277579,1666277918,339,1073
3042836639,3887032656,1651588050,1651588259,209,414
3093300732,3012822525,1660749877,1660750438,561,1474
3769269484,3157212376,1655000184,1655000414,230,1376
3074269946,3545652885,1661859903,1661859970,67,115
3852344377,3825036404,1649840476,1649840973,497,194
3244198823,3645666563,1647679013,1647679696,683,2422
3151436331,3040867771,1665270867,1665271814,947,1186
3718882981,3577651077,1647667918,1647668160,242,1488
3271318708,3500595056,1651445720,1651446527,807,657
3439280560,3824517920,1667083454,1667083711,257,2160
3892686083,3387938632,1653012889,1653013764,875,660
3189038779,3078628091,1663152784,1663153198,414,1471
3466642935,3572792752,1645290540,1645291175,635,522
3076767349,3472375572,1664622278,1664622394,116,1024
3506585658,3454448670,1652055527,1652055859,332,2204
3256807270,3947229430,1642954007,1642954514,507,667
3734035375,3302917137,1657002223,1657002767,544,745
3105558193,3398443861,1650251063,1650251991,928,505
3022388087,3425720812,1647678280,1647679277,997,2442
3261128926,3428763205,1643253580,1643253719,139,54
3527164294,3723780339,1649306238,1649306755,517,286
3069313994,3573826666,1661136731,1661137290,559,319
3217173480,3057308926,1669164177,1669164713,536,1810
3772035177,3527269010,1661291767,1661291772,5,55
3537151295,3933558253,1659622347,1659623115,768,2368
3046132590,3934199220,1650101950,1650102930,980,713
3324069408,3758323845,1669099002,1669099884,882,1034
3113321914,3652177742,1654461615,1654461717,102,1438
3708777992,3074460772,1645604676,1645605002,326,1833
3952663430,3007308564,1669540123,1669540333,210,316
3930591160,3002415281,1653272110,1653272662,552,319
3495919793,3554409625,1652886990,1652887494,504,1745
3751826055,3404330776,1643721796,1643722234,438,1651
3406332128,3343941091,1667063150,1667063434,284,803
3985159412,3246900158,1644137717,1644138617,900,1325
3481085072,3771826410,1644218939,1644218962,23,1293
3143689256,3006388757,1662102191,1662102465,274,726
3384794661,3389161785,1650886684,1650887236,552,1047
3625979408,3513576000,1667863746,1667864004,258,890
3184615246,3564592902,1669219109,1669219851,742,444
3741494242,3130093617,1658251064,1658251953,889,1133
3078216798,3160061122,1649240566,1649240606,40,1504
3409568191,3679578513,1641749040,1641749185,145,941
3833333678,3463540687,1667333582,1667333846,264,1916
3334298803,3098316380,1659269350,1659270090,740,2469
3471587065,3620748135,1648129751,1648130143,392,1743
3970049421,3467613173,1653814746,1653815120,374,1825
3754706912,3700896206,1662233778,1662234537,759,2309
3706178319,3295278768,1649870171,1649871059,888,2123
3916290714,3052789625,1659308887,1659309874,987,151
3161243271,3579486534,1666352386,1666353128,742,408
3080853733,3921560605,1661181324,1661181984,660,1779
3105243389,3232285985,1650664797,1650665258,461,963
3378168172,3914613880,1667016483,1667017165,682,2192
3550820934,3396524452,1645729600,1645729684,84,2388
3039255124,3032888380,1654546480,1654546673,193,1256
3351245855,3057725565,1644125982,1644126939,957,479
3917721165,3246900158,1647515096,1647515972,876,2440
3274452346,3635502276,1667987207,1667987520,313,523
3155320608,3356690610,1644116887,1644117407,520,319
3672123230,3973226891,1650210345,1650210746,401,1357
3111817334,3621966073,1642707470,1642708387,917,1077
3997312356,3806875541,1667484482,1667485262,780,251
3798512184,3760972512,1649835570,1649836511,941,2124
3299817472,3564198089,1654752986,1654753684,698,2287
3927646653,3957053810,1653301556,1653302295,739,1689
3425815854,3487387362,1654023620,1654024135,515,1076
3180252962,3057756725,1664165612,1664166482,870,46
3458389447,3921877328,1646577734,1646577913,179,860
3187779586,3311118815,1643421300,1643422216,916,1681
3181578884,3114277786,1664316700,1664317292,592,2438
3986631065,3243840165,1643535204,1643535771,567,2486
3405799068,3699947490,1652171445,1652172316,871,581
3499026312,3052789625,1654772689,1654773153,464,560
3641911946,3464235741,1641850969,1641851302,333,2327
3041809783,3221685249,1651040500,1651040714,214,2164
3771588829,3759415017,1662608106,1662608551,445,1516
3867860336,3463135439,1663505434,1663505900,466,527
3078216798,3914166761,1640994875,1640995027,152,373
3924583665,3559489793,1652792831,1652793762,931,1444
3809965750,3060450258,1654221038,1654221990,952,2156
3419465829,3438550737,1644507687,1644508265,578,2238
3280717680,3139455252,1653409802,1653410340,538,1249
3261128374,3339649448,1645608161,1645608225,64,2295
3166805288,3453431236,1650907660,1650908414,754,1621
3195214383,3805826972,1659408364,1659408876,512,348
3173369021,3529898997,1660513449,1660514383,934,1738
3188468802,3277875103,1649456999,1649457540,541,165
3296957627,3252021647,1661225432,1661226350,918,1908
3706560099,3958920817,1644708130,1644708939,809,1899
3773770885,3945299482,1664372830,1664373428,598,2181
3455040603,3021287506,1663796364,1663796795,431,1622
3174676733,3698633384,1645976619,1645976933,314,347
3488001885,3550908209,1660053890,1660054673,783,1360
3800014504,3356034290,1656506050,1656506970,920,2122
3218738751,3310523513,1646319490,1646319832,342,2187
3261419893,3481620613,1662533820,1662534567,747,1338
3879157400,3477363517,1645810482,1645811402,920,2142
3311303975,3960633649,1641263481,1641263922,441,1970
3244946730,3563738755,1656344174,1656344436,262,1230
3272981808,3899788381,1661432272,1661433062,790,1692
3585989542,3645943439,1663771962,1663772776,814,1393
3594009328,3086551217,1651412420,1651412524,104,2408
3160071792,3499182342,1645193958,1645194863,905,806
3240249176,3085412399,1650303889,1650304322,433,1952
3973959874,3297477157,1646223292,1646223391,99,1445
3851864688,3251372174,1667847800,1667847929,129,1639
3977539783,3035794185,1661880234,1661880621,387,1821
3793772897,3257821708,1667283817,1667284388,571,433
3572276937,3191414403,1653371128,1653371902,774,2219
3499182342,3115777637,1652667397,1652667450,53,205
3114036217,3434363944,1648804263,1648804333,70,221
3824649355,3816538905,1653731608,1653732456,848,2038
3617746688,3751560053,1668338238,1668338297,59,1290
3986979175,3968412854,1666864569,1666864669,100,2036
3698521503,3297290662,1659884066,1659884634,568,2370
3117234289,3485815053,1642513693,1642514373,680,998
3911364139,3887337385,1660251169,1660251586,417,1628
3215870665,3264434341,1657141125,1657141473,348,338
3885084129,3370120843,1668997134,1668997538,404,1914
3687919265,3108342285,1664821891,1664822455,564,1864
3815537815,3720248207,1645026431,1645026607,176,1169
3472375572,3168535205,1646378197,1646378923,726,1520
3049727234,3044064258,1643957343,1643957633,290,2324
3814608487,3694006679,1655738243,1655739001,758,697
3549145976,3414370730,1646395876,1646396354,478,134
3832640445,3257080734,1645697403,1645698210,807,744
3029956642,3310037244,1657864206,1657864281,75,1137
3105931624,3016068435,1664106122,1664106904,782,2405
3677539420,3029807207,1657953217,1657953392,175,1756
3829597039,3585042042,1653945942,1653946298,356,496
3410865372,3037048394,1650084409,1650084536,127,2401
3154309446,3452773006,1641551919,1641552158,239,1710
3109127825,3033438220,1642323960,1642324186,226,1276
3604759141,3621571402,1663570753,1663571495,742,1692
3549038219,3244599174,1643279708,1643280086,378,2353
3657464089,3625504025,1658720026,1658720369,343,1511
3373684030,3952286494,1658100535,1658101011,476,777
3289437738,3631568439,1667894040,1667894285,245,1825
3227368879,3042432058,1659904226,1659904332,106,109
3433237569,3936029875,1653676220,1653676890,670,131
3395479272,3290912062,1649509263,1649510206,943,1303
3043354217,3991046503,1654169812,1654170433,621,1236
3621452884,3231517158,1658645158,1658645829,671,719
3571972204,3310882037,1649507264,1649507484,220,12
3271689881,3939768853,1656647492,1656648390,898,1146
3235825340,3952620083,1665232122,1665232197,75,610
3391037775,3855769157,1668914672,1668915170,498,2305
3818319301,3832265812,1645231240,1645231827,587,245
3344957789,3232141615,1647557539,1647558321,782,1206
3327061038,3224800126,1650393891,1650394284,393,871
3207258694,3368654717,1650093237,1650093796,559,1204
3225901381,3385806632,1646319598,1646320525,927,2405
3243873593,3005200951,1645417173,1645418157,984,1530
3155756336,3191632331,1657804523,1657805512,989,1467
3230248695,3198731476,1664734293,1664734478,185,1196
3672274616,3978987003,1661996938,1661997466,528,848
3820225206,3314028925,1652629244,1652629532,288,2411
3772749656,3108818977,1665311505,1665311886,381,419
3939469152,3790748869,1651860709,1651861049,340,1623
3957430800,3678152024,1665444167,1665444259,92,1379
3846866111,3957824946,1645219466,1645219782,316,219
3275027460,3936135558,1655342576,1655343277,701,784
3380303288,3793232281,1649591406,1649592201,795,1167
3998763119,3475352970,1661854158,1661855029,871,840
3789999187,3368571252,1662824569,1662824966,397,2246
3268182022,3516140957,1645527253,1645527844,591,1043
3894149054,3776148003,1652299118,1652299122,4,2449
3971524060,3114036217,1664317742,1664318509,767,1043
3403323839,3787673872,1651212824,1651212906,82,803
3894844173,3554862003,1652613016,1652613985,969,1725
3194140038,3200875282,1651401761,1651402495,734,2263
3139087074,3839947308,1653514429,1653514616,187,2403
3623974243,3431595099,1655322125,1655322747,622,35
3992924141,3361422449,1663291780,1663291884,104,702
3956491451,3437707461,1669259401,1669259520,119,1909
3608597242,3679867888,1643138071,1643138991,920,1845
3411636309,3796198742,1665791437,1665792260,823,589
3278038835,3002415281,1646866649,1646866691,42,1587
3006603067,3322083266,1650191940,1650192680,740,788
3042176960,3804458349,1652599234,1652599935,701,2081
3581207584,3310523513,1645801357,1645801713,356,127
3461630480,3026727334,1645577541,1645578133,592,547
3214711870,3398257086,1642995034,1642995959,925,1549
3378168172,3417049317,1646342033,1646342855,822,422
3898188404,3068400634,1649053264,1649054245,981,636
3847638658,3488878461,1662799280,1662799329,49,1222
3722945080,3999551936,1663217429,1663217496,67,1202
3563246157,3551810435,1663439361,1663439744,383,2139
3696716300,3714535860,1665919328,1665919580,252,1963
3129677855,3362395200,1648813490,1648813815,325,1712
3780885377,3871345895,1642918803,1642919695,892,1128
3508340066,3249071020,1641561367,1641562017,650,2299
3353878603,3653850140,1656825838,1656826186,348,2400
3965000413,3835976086,1664821270,1664821562,292,2207
3154729703,3730368703,1662400304,1662401001,697,2151
3488280503,3094418033,1660330278,1660330783,505,1953
3158029379,3022453107,1652310975,1652311754,779,1420
3779590261,3803051709,1664390156,1664391064,908,1075
3989563375,3548511640,1667690517,1667690771,254,1368
3365676412,3176818286,1647557594,1647558183,589,1836
3103871966,3303973335,1643387535,1643387860,325,1861
3451299629,3911316683,1648514193,1648514648,455,141
3104944123,3241584825,1664385194,1664385210,16,1060
3876097800,3315569726,1646676871,1646677219,348,2006
3557087358,3537151295,1666721482,1666721909,427,266
3446946900,3086950119,1647428317,1647429054,737,605
3262645455,3945611603,1668000296,1668000919,623,725
3302992244,3365340586,1660338790,1660338933,143,1332
3782457642,3530462613,1664665222,1664666138,916,1357
3294446147,3653757569,1647433262,1647433962,700,1565
3559267449,3185360566,1656608809,1656609070,261,336
3844006658,3818823702,1642244966,1642245411,445,851
3388726341,3680453323,1652471001,1652471828,827,1723
3287399418,3243502165,1649008928,1649009364,436,1893
3672350582,3964830238,1668580337,1668581301,964,385
3869991101,3184539687,1654133229,1654133685,456,1696
3714897535,3506384176,1654978973,1654979181,208,1070
3929638122,3360436723,1643247130,1643247204,74,1533
3853163109,3431175768,1662826074,1662826476,402,404
3969563324,3834401696,1657442517,1657443371,854,2071
3515845767,3570955260,1659657260,1659657624,364,2039
3898603481,3393458100,1658273695,1658273896,201,177
3251409316,3143324065,1652808393,1652808955,562,457
3653770219,3480424657,1654541550,1654541773,223,1329
3760535935,3664989774,1648689746,1648690498,752,1926
3592235229,3772762015,1661462107,1661462634,527,545
3594269515,3440372055,1647738672,1647739169,497,87
3195214383,3199255829,1660931256,1660931596,340,2292
3514218549,3415761431,1645757868,1645758270,402,967
3880353584,3542078032,1643520645,1643521479,834,2305
3254473094,3791107997,1662515588,1662516177,589,2440
3669744444,3782708820,1647664609,1647665231,622,21
3802040767,3431883681,1653014809,1653015295,486,1095
3034255613,3653285237,1642056937,1642057646,709,1584
3959795133,3838160976,1663146409,1663146934,525,311
3103228367,3994577207,1649527411,1649527642,231,1805
3017075122,3146072606,1649035980,1649036226,246,91
3973666003,3316031407,1645762839,1645763567,728,1478
3728974462,3961183307,1650776965,1650777660,695,878
3846323092,3308015697,1665162886,1665162936,50,507
3589984222,3955663201,1653737675,1653737881,206,1729
3317614106,3885393767,1659301991,1659302827,836,436
3177851224,3254952204,1665108870,1665109037,167,402
3075088680,3163012662,1655819390,1655819679,289,83
3675703241,3358968371,1663744469,1663744537,68,1995
3174722772,3142869544,1643130850,1643130908,58,1307
3325313312,3878005127,1659586829,1659587498,669,1644
3869505474,3530930024,1654082621,1654083451,830,351
3804914454,3681399132,1652261929,1652262775,846,2169
3862829462,3499272388,1666217040,1666217770,730,797
3482166014,3550702679,1656324540,1656324685,145,2207
3634044438,3743569811,1648721587,1648722123,536,1371
3417820101,3289437738,1664821736,1664821958,222,919
3407409307,3433374325,1669677183,1669677874,691,1542
3107482740,3088562105,1642773627,1642773685,58,2084
3035895563,3160963185,1652958489,1652958543,54,737
3621938271,3538863873,1649770576,1649770858,282,1446
3939722468,3144551332,1648377583,1648377850,267,1911
3413111275,3528271389,1660077930,1660078470,540,890
3887743057,3433937560,1658677415,1658678261,846,1833
3319365305,3311329069,1656424709,1656424896,187,1998
3985159412,3486286893,1646689161,1646689771,610,2165
3643939596,3217857851,1647433359,1647434354,995,2035
3475846394,3805314214,1664729802,1664730314,512,1468
3996963058,3752817676,1644918947,1644919857,910,832
3063674428,3852633699,1666140229,1666140993,764,2324
3790406016,3890492731,1664072791,1664072997,206,1659
3022767670,3967754963,1644593366,1644593431,65,101
3114863942,3561254848,1668269234,1668269679,445,709
3370263528,3054828202,1658893878,1658894040,162,1847
3656770582,3460669513,1665810906,1665811598,692,1427
3024813851,3900951859,1642697097,1642697129,32,735
3032834107,3106781266,1658849168,1658849819,651,968
3641460659,3298748343,1642398637,1642399539,902,1963
3888670009,3505196729,1651358496,1651358914,418,14
3643382802,3545150522,1647211465,1647211645,180,295
3569478966,3069881077,1651804223,1651804369,146,1770
3754706912,3612460883,1650192047,1650192390,343,379
3856386170,3829606187,1655923436,1655923909,473,1021
3204333859,3876377964,1648216854,1648216916,62,866
3338082003,3604461797,1657656902,1657657490,588,2364
3498441448,3721136961,1657066500,1657066925,425,877
3421728246,3094125203,1647307958,1647308436,478,1998
3888392286,3200059644,1657113030,1657113447,417,969
3548145086,3899301205,1642854220,1642854636,416,996
3686240080,3170167097,1647255968,1647256138,170,978
3934125569,3250528764,1666758879,1666759519,640,1914
3691474413,3339856407,1651019301,1651019625,324,1700
3202063550,3162284444,1646823010,1646823304,294,209
3510281371,3539303536,1651657907,1651657922,15,885
3160938941,3568614629,1668163478,1668163646,168,2000
3086894794,3481922555,1651730447,1651730466,19,1882
3271689881,3180728306,1665527721,1665528346,625,949
3479608671,3551884757,1641533121,1641533440,319,389
3456386287,3744147238,1646887965,1646888408,443,1513
3496470143,3171235556,1664808043,1664808277,234,1463
3741344192,3711576021,1644134751,1644135669,918,1131
3526815452,3885235661,1652216928,1652217921,993,570
3063715610,3487778655,1662045547,1662046486,939,2010
3401677898,3584037261,1650398070,1650398436,366,1232
3266498789,3033692011,1664847758,1664848195,437,1524
3232285985,3253589940,1654904377,1654905014,637,1594
3754631129,3038067120,1667537145,1667537959,814,1949
3963547295,3046351455,1651415866,1651415898,32,2059
3209064637,3085412399,1653558605,1653559361,756,219
3781537659,3487740667,1645191802,1645192450,648,627
3678624517,3328737379,1662429205,1662429756,551,389
3878683407,3534133715,1661731015,1661731243,228,654
3662578193,3729914869,1660460428,1660460938,510,2411
3660939542,3637412110,1664310720,1664311403,683,1449
3787058440,3335818403,1654977050,1654977330,280,1853
3669324531,3552091513,1655346756,1655347209,453,628
3242235161,3169898520,1651797844,1651798523,679,316
3813811121,3707403309,1654073718,1654073823,105,2129
3404200815,3415041326,1669358974,1669359374,400,901
3477692188,3636808827,1643530998,1643531031,33,2496
3915111520,3636948225,1651394653,1651395636,983,532
3721060604,3593988999,1647375118,1647375782,664,449
3219656369,3692691710,1658515241,1658515477,236,1183
3679065090,3614741796,1669320359,1669321316,957,1908
3692861248,3956796805,1652188439,1652189338,899,44
3932077086,3562547940,1647633594,1647634410,816,1927
3231496949,3614399988,1659082963,1659083551,588,2456
3280558341,3677965553,1656115087,1656115103,16,172
3674729672,3471703914,1649081587,1649081660,73,1024
3377911201,3614179985,1661748597,1661748694,97,1086
3481881323,3744955044,1662183911,1662184045,134,2262
3142848483,3751975877,1646568605,1646569069,464,246
3067150549,3620395885,1651794017,1651794205,188,461
3904546701,3158209281,1655123503,1655124431,928,1456
3700896206,3669520344,1655261921,1655262474,553,1342
3649298405,3642498039,1669052179,1669052402,223,237
3271039091,3003330774,1667842676,1667843163,487,2460
3792708367,3272217633,1666302201,1666302791,590,1407
3859680527,3267151775,1665832514,1665832767,253,1465
3858911279,3070186247,1666320892,1666321455,563,264
3577817989,3450689808,1659452152,1659452273,121,2367
3656656446,3968683220,1659898415,1659898573,158,2379
3912410470,3474666564,1660271122,1660272077,955,72
3066990756,3869505474,1659994170,1659994684,514,2320
3768558350,3710331536,1664381196,1664381692,496,2430
3548252436,3586770678,1648891216,1648892168,952,756
3706304663,3472458500,1648934733,1648935350,617,794
3025611145,3347776562,1653909299,1653910003,704,1179
3816567987,3376960491,1650240412,1650241391,979,865
3343249545,3862918742,1668560850,1668560946,96,1146
3246159564,3292782964,1651546047,1651546296,249,857
3499026312,3584704567,1643965564,1643965897,333,1443
3424562136,3401382792,1646185938,1646185986,48,532
3198240429,3894454988,1662647244,1662647866,622,1537
3788769219,3973050834,1650485822,1650486522,700,2041
3421600026,3002971802,1667096187,1667097047,860,1828
3889288487,3977860015,1663808155,1663808248,93,879
3676132016,3424584896,1648618639,1648619170,531,85
3817579913,3165208023,1652610099,1652610142,43,204
3689453273,3231537700,1647853629,1647854598,969,1768
3120419076,3680453323,1653097809,1653098119,310,1282
3554676369,3917709571,1654460574,1654461490,916,2184
3949522552,3103856643,1647214374,1647214697,323,1072
3395307809,3289437738,1669517789,1669518277,488,2358
3271039091,3331335383,1642383740,1642384311,571,1985
3673950693,3425282516,1660728545,1660729181,636,112
3657587705,3406595083,1652009979,1652010939,960,1332
3199635800,3053134032,1645868821,1645869637,816,99
3329463543,3030290445,1644863611,1644863736,125,1940
3761218329,3911632634,1661821016,1661821205,189,2389
3725480364,3101265323,1661404070,1661404111,41,1176
3474558723,3738624659,1658040803,1658040925,122,1552
3346530861,3894431064,1649310825,1649311768,943,942
3733102461,3915154684,1646586211,1646586758,547,48
3522103750,3154991935,1659727320,1659727496,176,486
3339349217,3181912863,1654571330,1654572016,686,2086
3154729703,3728160519,1659188939,1659189662,723,1190
3063714742,3470228949,1643678986,1643679103,117,500
3162641272,3447946570,1649242342,1649243089,747,1262
3865422787,3528271389,1669410664,1669410765,101,1773
3044345094,3097033729,1650781348,1650781441,93,1968
3462410204,3979552361,1655373190,1655373421,231,1279
3413320652,3791510494,1664329020,1664329284,264,951
3165423009,3952282084,1641828638,1641829428,790,1633
3790996735,3123677020,1641464746,1641464830,84,1214
3520106918,3333336166,1658627630,1658628148,518,1715
3195148360,3059602794,1641215489,1641216090,601,1988
3157600969,3555187890,1660130122,1660130939,817,2149
3924838447,3382453510,1646591820,1646591823,3,736
3532756620,3043256301,1665624811,1665625618,807,2409
3995412026,3074477991,1641068536,1641068942,406,1478
3139268488,3107482740,1660494031,1660494511,480,1822
3606643671,3912014286,1653412272,1653412760,488,1299
3805653360,3948219301,1659139390,1659139468,78,123
3242064640,3471651838,1652112139,1652112891,752,2111
3189038779,3833342718,1644572384,1644572552,168,2171
3258399411,3424944206,1654116707,1654117007,300,1216
3673950693,3293339453,1650966326,1650966334,8,370
3383093669,3527164294,1653861624,1653862279,655,2195
3196704660,3478921948,1659462523,1659463150,627,2161
3389926670,3690586350,1665647597,1665647616,19,703
3609043475,3765023649,1667776282,1667776355,73,627
3711576021,3358578228,1661492139,1661492873,734,808
3469359731,3343153937,1646537610,1646537871,261,1662
3836823852,3143452523,1645312991,1645313148,157,930
3448135160,3111080178,1660897999,1660898098,99,1012
3423298470,3095661578,1655279671,1655280647,976,1645
3614399988,3653925331,1652194598,1652194941,343,676
3235155985,3399334455,1649158871,1649159133,262,1159
3385430413,3345650412,1646193629,1646194004,375,1071
3697118662,3307306078,1644572288,1644572948,660,1889
3629984961,3965585706,1668820882,1668821776,894,918
3904825547,3553712893,1668985978,1668986260,282,1051
3207407283,3413056504,1658011862,1658012495,633,885
3182703869,3254503569,1641348609,1641349131,522,444
3246571420,3327795374,1661784351,1661784747,396,1086
3300063136,3793086361,1648393088,1648393740,652,1943
3559615011,3880948714,1667403285,1667403697,412,44
3691830908,3814355412,1652963105,1652963884,779,1336
3005125326,3776027879,1650489421,1650489423,2,1517
3118057575,3636960130,1655401296,1655402273,977,121
3705752007,3904881288,1645243712,1645244137,425,1660
3445095607,3084060274,1656374990,1656375622,632,2465
3733004020,3506345760,1648388853,1648389550,697,2296
3797295915,3896777982,1648282155,1648282795,640,1712
3944247629,3655786063,1660913601,1660913676,75,347
3569738818,3009366895,1649591581,1649592231,650,2368
3943927246,3279773317,1659578265,1659578656,391,1969
3767724034,3892206642,1655341905,1655342413,508,1600
3145378445,3565052722,1662098544,1662098759,215,2154
3402690548,3434817228,1658899250,1658899450,200,938
3833333678,3721340009,1660258467,1660259328,861,1072
3428889808,3502074085,1664198288,1664198601,313,1054
3509619062,3831683294,1666529282,1666529707,425,1970
3248395971,3202460554,1661852055,1661852854,799,1196
3295146156,3130166522,1669507263,1669507312,49,430
3486208738,3986016860,1661776020,1661776347,327,90
3561881366,3278703976,1667699372,1667700171,799,333
3508809990,3364893066,1644235386,1644235620,234,2137
3285225403,3248167631,1647800612,1647800922,310,1535
3032465570,3111965011,1652616555,1652617254,699,1777
3859221152,3246260241,1655852787,1655852957,170,276
3678452420,3574205549,1659816904,1659817803,899,241
3176536531,3351182329,1641020344,1641021051,707,1562
3481293963,3853644964,1666122144,1666122245,101,275
3497171741,3695292102,1642671177,1642671764,587,1564
3871845792,3105460297,1647065666,1647066524,858,1754
3301119536,3505197900,1667207420,1667207950,530,288
3420520626,3845743542,1652118308,1652118771,463,1411
3624911947,3177851224,1647781858,1647781956,98,1975
3543926712,3289850617,1647363567,1647363841,274,1979
3448952875,3606368289,1653583818,1653584086,268,426
3311303975,3098422570,1661898923,1661899032,109,36
3201213219,3100239217,1662255556,1662256225,669,1448
3291512173,3133647753,1658586461,1658587009,548,234
3994721189,3730984573,1661650003,1661650891,888,1901
3990643900,3037301537,1652828942,1652829123,181,1141
3377457710,3471587065,1653319805,1653320428,623,343
3816170686,3880373505,1662474252,1662475226,974,566
3845122668,3044483301,1642471696,1642472433,737,848
3857590396,3559023463,1664012280,1664013053,773,731
3141688992,3168625610,1641605477,1641605688,211,1109
3948695100,3944493334,1653218329,1653218666,337,1536
3540279517,3072219388,1666400590,1666401204,614,722
3851879278,3828485006,1660504875,1660505080,205,1468
3310715907,3555912894,1651370757,1651371009,252,2170
3981379416,3047126246,1666321360,1666321940,580,2274
3596247005,3349718189,1658587525,1658587682,157,984
3489466063,3437665905,1648418598,1648418794,196,1500
3744759130,3551771231,1664024430,1664025214,784,1609
3759967696,3426899836,1648968964,1648969009,45,1449
3464235741,3661507330,1658320208,1658320838,630,728
3431117217,3641618845,1669182065,1669182354,289,1281
3092360885,3892850406,1641454923,1641455740,817,830
3762816561,3420180743,1662064938,1662065875,937,2119
3692247556,3784046500,1665792154,1665793002,848,723
3371063992,3288441459,1643996012,1643996787,775,2009
3413948595,3654841867,1659267795,1659268288,493,930
3037301537,3470446722,1661020446,1661021419,973,512
3287600901,3660998516,1652229817,1652230451,634,321
3948515015,3362091170,1656320367,1656320602,235,967
3251744109,3596951808,1648459865,1648460446,581,272
3608535655,3256787088,1662307089,1662307286,197,660
3879967963,3725611236,1653029921,1653030556,635,1279
3478404891,3590361712,1644126980,1644127415,435,1175
3773770885,3119802700,1665628133,1665629024,891,2068
3667684695,3614206353,1652676542,1652677196,654,2406
3023980378,3598409790,1666896069,1666896841,772,501
3361529884,3634624974,1664755376,1664756207,831,2268
3428062841,3026209549,1645197333,1645197686,353,1689
3784959270,3893170545,1664108008,1664108958,950,2126
3181912863,3662455665,1654069275,1654069704,429,1720
3791107997,3619490574,1667652946,1667653801,855,1633
3474242977,3875908590,1651043667,1651043736,69,742
3697322167,3502690432,1647357590,1647358472,882,1764
3603853942,3219637680,1654269771,1654270765,994,1460
3113608489,3117262222,1664302864,1664303653,789,1294
3523508617,3729340640,1657683431,1657683578,147,81
3392469094,3487992433,1664304421,1664305280,859,2153
3930347129,3115343467,1649368402,1649368593,191,1958
3935822380,3269726483,1642396629,1642397142,513,559
3046085814,3551344746,1642987654,1642988025,371,496
3261195333,3858459394,1642048631,1642048934,303,2259
3576100130,3194379247,1669078483,1669079128,645,367
3306439333,3285333536,1664314516,1664315000,484,2401
3790883274,3706178319,1650830710,1650831131,421,1334
3190859932,3099424302,1644120917,1644121821,904,1033
3404468022,3504398546,1651957856,1651958842,986,1318
3573975780,3302113605,1664753242,1664754106,864,2275
3407139317,3013484024,1650744009,1650744093,84,1650
3796504737,3227462918,1663573528,1663573754,226,2050
3864239870,3942393978,1658885472,1658885626,154,2001
3182131313,3398865388,1656776778,1656776815,37,1974
3753391012,3842445140,1644377745,1644378619,874,1147
3429328367,3869692733,1650965528,1650965567,39,423
3563750578,3972687424,1646775692,1646776556,864,681
3168084964,3014552263,1650067262,1650068223,961,1130
3692247556,3719455699,1660757833,1660758000,167,795
3447743170,3066067288,1653678133,1653678728,595,1097
3354330082,3744386868,1655986604,1655987415,811,2259
3107713394,3094147044,1663822321,1663822382,61,2397
3818508802,3041001828,1643427583,1643428544,961,1310
3193830008,3922728266,1643309442,1643309863,421,201
3890218641,3360115986,1645439844,1645440555,711,731
3676592387,3039972849,1661321871,1661321997,126,2367
3102760949,3528278695,1665787916,1665788050,134,1366
3727618645,3110339164,1664686996,1664687808,812,2417
3634328779,3772406671,1649545380,1649545495,115,377
3379366812,3482148686,1644970875,1644971175,300,28
3270273033,3604593541,1642379482,1642379912,430,1669
3666486477,3103497887,1667625807,1667626004,197,2428
3415351222,3294526671,1645653448,1645653934,486,1564
3819415032,3600977488,1653030137,1653030848,711,575
3766160943,3953002004,1656430700,1656431486,786,1558
3318717113,3139551539,1658592948,1658593836,888,2370
3016283694,3526365568,1647078002,1647078348,346,330
3257594028,3658099781,1658701663,1658702441,778,671
3651798658,3163551629,1664435003,1664435010,7,115
3653850140,3371785046,1647313770,1647314481,711,1575
3423782681,3019773309,1663819560,1663819665,105,677
3415892236,3554676369,1647939821,1647940497,676,2024
3894508827,3825971737,1664415039,1664415487,448,153
3429660049,3456811507,1666326342,1666326537,195,496
3257492375,3811308890,1651361842,1651362566,724,176
3695692085,3306753571,1644855578,1644856025,447,603
3964613907,3011158212,1652174002,1652174330,328,1252
3498314038,3482406705,1644917509,1644917511,2,785
3767453896,3367457506,1653217454,1653217594,140,1213
3391857064,3457542537,1643041221,1643041390,169,2172
3189435516,3029451399,1641266985,1641267096,111,2237
3053991932,3262379384,1645429983,1645430659,676,1681
3381769309,3276350975,1642628747,1642628794,47,1938
3106804099,3393199571,1668775647,1668776571,924,2231
3121336226,3518322544,1664558668,1664559562,894,1925
3273752842,3625611440,1667086924,1667087718,794,1241
3764173171,3483670734,1653024641,1653025227,586,1422
3903321481,3307775998,1661399127,1661399520,393,623
3768211591,3220903356,1642186399,1642186836,437,1761
3823942349,3519233850,1644147354,1644148334,980,61
3110016926,3100440036,1658608985,1658609174,189,962
3242897765,3102760949,1666324478,1666324867,389,286
3424944206,3192142540,1648524098,1648524256,158,1840
3988957478,3054865222,1641333057,1641333349,292,324
3960450011,3987860424,1655689503,1655689569,66,1924
3740009683,3707892765,1663295593,1663296426,833,1758
3280668606,3111205819,1664022614,1664023310,696,186
3490415118,3949970421,1642985377,1642985949,572,259
3566534974,3499281518,1663713464,1663713511,47,1900
3674729672,3585526520,1652850117,1652850539,422,1568
3126995401,3557835284,1649382343,1649383189,846,782
3849028830,3418338710,1662173223,1662173384,161,577
3444149733,3556033785,1644312757,1644313419,662,2466
3424453686,3385413048,1643573554,1643574476,922,2079
3549122378,3591290407,1643549726,1643550487,761,422
3381313507,3768311968,1649231780,1649232557,777,166
3647480411,3157965235,1648237064,1648237308,244,2185
3003728684,3648118736,1644395755,1644396632,877,1671
3732472752,3772910484,1651564728,1651564921,193,186
3011158212,3398876044,1649622075,1649622159,84,820
3316625530,3832336338,1662061508,1662062011,503,1346
3582859001,3856474495,1656063177,1656063831,654,1617
3665798527,3639035607,1641726198,1641727115,917,143
3154653229,3456239535,1669128472,1669129101,629,1926
3072741474,3087700946,1651903434,1651903498,64,744
3739233756,3544133682,1648332405,1648332787,382,173
3332797032,3722247979,1665327554,1665327632,78,1910
3145344208,3424211722,1646434841,1646435351,510,773
3976367014,3882748527,1654578691,1654578920,229,1345
3081369661,3043180716,1662044014,1662044886,872,51
3722301598,3887519119,1661601742,1661602559,817,113
3140407144,3202783831,1665981469,1665981962,493,508
3354055639,3501962027,1660280376,1660280825,449,394
3031827531,3235245267,1645459088,1645460000,912,2250
3173791920,3555731884,1644619777,1644619965,188,445
3787333178,3816567987,1666178048,1666178755,707,498
3063969367,3182703869,1658047226,1658047842,616,1610
3714105777,3985585282,1667392432,1667393408,976,534
3550261012,3469879706,1646321548,1646322423,875,1544
3089844622,3516488694,1668959665,1668959810,145,1521
3179405209,3291394293,1665340414,1665340534,120,1672
3056267922,3831346903,1656289736,1656289919,183,1141
3929282989,3052499026,1665570242,1665570637,395,740
3571991159,3165973608,1656521996,1656522075,79,2153
3733440098,3285331142,1660450340,1660450953,613,1011
3626552836,3487972666,1663475551,1663475664,113,722
3773488272,3470128186,1643462414,1643462876,462,1730
3285333536,3067179904,1643501746,1643501933,187,1140
3686530724,3664898256,1662273130,1662273162,32,2287
3637981738,3643382802,1667777582,1667778449,867,2426
3956194935,3240839516,1642955750,1642955964,214,210
3626824650,3852555743,1667888666,1667889054,388,2222
3283922234,3388490960,1656863657,1656864136,479,606
3668645457,3577651077,1651621142,1651621367,225,1287
3788688228,3686743575,1652430324,1652431253,929,2300
3198527442,3675429073,1667470894,1667471538,644,439
3130462571,3525261242,1658036437,1658036717,280,1034
3995654203,3790829012,1642136894,1642137196,302,533
3807576323,3244071979,1648084329,1648084344,15,1664
3140486428,3861153303,1657837904,1657838702,798,1213
3442927979,3620303845,1660379410,1660380221,811,962
3829084330,3941689381,1642966639,1642967515,876,1536
3094852425,3562116841,1659372869,1659373838,969,2391
3086564112,3001803326,1644639593,1644639862,269,672
3201068600,3816194055,1664735393,1664735459,66,1736
3575816255,3277298737,1648950387,1648950869,482,561
3768087701,3196302340,1663148772,1663149761,989,1014
3825023321,3980851662,1668720806,1668721288,482,589
3904183865,3819467184,1665291701,1665292042,341,6
3242406857,3837366084,1646416884,1646417465,581,1995
3230277243,3363279084,1669242118,1669242416,298,1915
3287210562,3454276568,1664895222,1664895493,271,2330
3164391025,3967425379,1657426153,1657426724,571,116
3513169935,3077143208,1642661983,1642662073,90,1513
3828810890,3773627036,1647888903,1647889670,767,375
3431283022,3472112661,1669738105,1669738992,887,364
3642691052,3256615260,1651660441,1651660616,175,762
3265655534,3620616287,1660919113,1660919417,304,1105
3783051630,3195214383,1653838368,1653838448,80,1684
3375782922,3625950355,1646677948,1646678079,131,1917
3855537172,3826956383,1653944222,1653944285,63,8
3699730203,3563259493,1645068426,1645069359,933,639
3845522882,3702439685,1644638345,1644639098,753,2488
3899117968,3269726483,1662031473,1662032114,641,87
3252187190,3027558279,1660893152,1660893902,750,291
3077683954,3825900664,1660291007,1660291087,80,1841
3807323401,3859680527,1665729381,1665729748,367,2428
3242406857,3860430252,1664347202,1664347884,682,227
3852500776,3813854723,1652141215,1652141431,216,1147
3026025743,3358374850,1666783692,1666783778,86,469
3952283751,3943221472,1653777558,1653778469,911,1453
3764078507,3657380279,1668322281,1668322785,504,2294
3278827891,3287399418,1658461755,1658462198,443,1108
3378864156,3204575281,1655178555,1655178608,53,1317
3672371563,3451263201,1645753658,1645754140,482,1344
3031649001,3307721045,1655602233,1655602588,355,990
3203153576,3320272612,1646440620,1646440636,16,665
3054828202,3038014403,1641621957,1641622527,570,1702
3208757755,3380928920,1647608935,1647609140,205,57
3214698363,3615177362,1649844572,1649844932,360,1261
3591348696,3156452001,1665283122,1665283303,181,200
3201933010,3750083020,1658018325,1658019018,693,2332
3523465225,3034325039,1660048767,1660049209,442,1916
3995358434,3439442608,1650694013,1650694857,844,1300
3976095218,3324473595,1649843881,1649844710,829,1682
3847237978,3507376482,1669291288,1669291779,491,1507
3882134877,3407735827,1642035278,1642036050,772,2304
3685977300,3974481828,1667327594,1667327709,115,1311
3551243497,3713404433,1651873127,1651873366,239,2390
3127940283,3370120843,1657494907,1657495197,290,942
3889079063,3450353368,1665904555,1665904902,347,627
3887054161,3504457520,1646588887,1646589793,906,2307
3639515059,3658017612,1651318841,1651319173,332,1382
3855113371,3104210284,1660323853,1660324422,569,604
3026701207,3929901413,1645104582,1645105137,555,911
3739406554,3981778568,1662801524,1662801743,219,743
3337108824,3081369661,1668012027,1668012189,162,2338
3336657547,3073762858,1663106554,1663107092,538,2155
3108818977,3473314396,1648115446,1648115730,284,1542
3436975295,3205282165,1669548222,1669548466,244,1874
3297681098,3905744284,1657484475,1657484617,142,718
3478921948,3470128186,1643622773,1643623686,913,195
3118502732,3356144129,1664155169,1664155663,494,524
3287082352,3456386287,1650962137,1650962878,741,2084
3210279328,3277343126,1659129444,1659130093,649,84
3804648275,3439510951,1663756998,1663757788,790,33
3345186165,3118128782,1645166841,1645167145,304,1309
3508340066,3765962960,1669268339,1669269177,838,2069
3821768923,3794447092,1661843094,1661843550,456,2301
3597403559,3065810858,1657888098,1657888102,4,2238
3413334821,3161586578,1661922949,1661923029,80,1341
3002971802,3963385029,1666977956,1666978858,902,634
3645560004,3517912492,1648223303,1648224021,718,1316
3647951580,3224128562,1660382759,1660383291,532,1266
3418635865,3218738751,1644650662,1644651515,853,705
3577530061,3714122939,1645810360,1645810542,182,2249
3391324219,3993122275,1664838861,1664838869,8,1936
3954434825,3022707615,1662384835,1662385690,855,1231
3089699104,3811389743,1647278496,1647279009,513,1995
3154551351,3534450842,1657003681,1657003847,166,1653
3255248380,3180728306,1648179264,1648180194,930,1486
3128043317,3055402951,1665022925,1665023359,434,2155
3610270492,3336551797,1645366689,1645367253,564,744
3757693725,3959383415,1669418716,1669419171,455,1767
3915637706,3695161514,1662753154,1662753767,613,864
3244918124,3260867614,1649659873,1649660687,814,946
3447946570,3184539687,1652293638,1652294430,792,280
3832995595,3463032893,1650880842,1650881656,814,1106
3598576303,3532756620,1661261073,1661262033,960,895
3100201926,3487526777,1654116044,1654116529,485,734
3483666747,3393000047,1643018394,1643018569,175,815
3569401888,3721060604,1642521302,1642521439,137,1113
3228497776,3152518339,1651507018,1651507998,980,2295
3938370016,3994967281,1666051251,1666051833,582,2374
3646797040,3522861132,1665069636,1665070503,867,2125
3102526783,3548799053,1648840665,1648840851,186,965
3019750416,3950225483,1651769940,1651770288,348,2156
3831380073,3937077335,1648553297,1648553932,635,2413
3690667222,3706027798,1657836952,1657837075,123,1757
3169559952,3125008218,1654111303,1654111793,490,401
3093534312,3342189600,1662942255,1662942479,224,620
3062704523,3871971681,1653667573,1653667651,78,2237
3963303057,3997312859,1662500971,1662501533,562,714
3872626198,3050867171,1652377859,1652378108,249,752
3343279177,3215815915,1646782517,1646782661,144,707
3099546139,3912111332,1642996375,1642997038,663,1715
3237339326,3074477991,1651390386,1651391099,713,1034
3295806447,3253589940,1644744927,1644745716,789,1795
3056252574,3357034260,1657915617,1657916479,862,948
3516624109,3991686619,1658383936,1658384040,104,2268
3615359458,3930124385,1654112931,1654113852,921,426
3629984199,3467233007,1664434491,1664435280,789,1613
3112298724,3585832857,1668253836,1668253976,140,1000
3117732598,3361482296,1658483553,1658484493,940,1952
3422374987,3111167324,1660855897,1660856837,940,88
3592043925,3115669693,1649483036,1649483738,702,2200
3074385503,3763991129,1652579559,1652579940,381,865
3588684575,3112389617,1648470170,1648470482,312,299
3096740365,3922251351,1645418074,1645418279,205,1716
3690171214,3922927380,1649161384,1649161514,130,537
3018756378,3808191596,1661973714,1661973731,17,1463
3664408598,3548670552,1651247607,1651248446,839,1489
3975864053,3410737355,1664333212,1664333344,132,1709
3801107936,3924167113,1668077108,1668077626,518,2406
3124321462,3904007370,1665367811,1665368431,620,2362
3752522830,3705943924,1658035173,1658035559,386,305
3257947713,3127812666,1653934691,1653935181,490,1170
3156962564,3234064286,1667040120,1667040414,294,2027
3202460554,3556000533,1644244265,1644244438,173,730
3171734482,3311382844,1647978148,1647978903,755,2124
3489254440,3479322514,1664708546,1664708809,263,1094
3834720743,3559267449,1656870160,1656870751,591,694
3046707177,3068400634,1654426269,1654427018,749,2459
3339649448,3342190885,1658343253,1658343376,123,2138
3739555068,3514354263,1665721374,1665721376,2,1258
3451106027,3110121278,1644976244,1644976704,460,1051
3973713516,3955825968,1669329716,1669330553,837,1326
3339911597,3470404771,1645935975,1645936775,800,664
3888851378,3453884967,1652982607,1652983174,567,763
3981515277,3191792012,1645841249,1645841951,702,1612
3958449916,3414834461,1668855607,1668855903,296,1422
3615362859,3348282881,1666845055,1666845814,759,1745
3043256301,3585919417,1648052283,1648052493,210,1375
3563103144,3962034507,1662623550,1662624228,678,1923
3916456426,3044564753,1653000929,1653001499,570,874
3205383513,3315182095,1653274199,1653274890,691,609
3303986609,3903978752,1663477959,1663478399,440,807
3007934266,3497045946,1662733863,1662734783,920,1773
3815718297,3389497658,1659825087,1659825557,470,1620
3181032246,3154833958,1661802126,1661802945,819,956
3954799831,3014993252,1643670654,1643671165,511,1772
3370350588,3264460374,1648983105,1648983328,223,285
3435340439,3082026010,1647208809,1647209516,707,2429
3977860015,3265434991,1661642676,1661643672,996,1347
3544772636,3545150522,1654639724,1654640495,771,1490
3249705811,3294703062,1641144902,1641145613,711,1598
3811337280,3826827617,1657190166,1657190657,491,2054
3249554278,3256566881,1669408210,1669409081,871,544
3415535285,3591088164,1641207738,1641208631,893,295
3040037607,3000650426,1645277251,1645277385,134,2160
3634735892,3935656272,1658451115,1658451601,486,2278
3635487786,3551243497,1647837461,1647837720,259,918
3150551034,3637981738,1652512321,1652512452,131,1372
3672123230,3678404361,1653782626,1653782773,147,1
3228110844,3442854678,1657495924,1657496593,669,874
3752701792,3449693686,1658187037,1658187471,434,706
3872691076,3075001202,1647721246,1647721338,92,1416
3641752896,3467383586,1647540902,1647541124,222,2017
3413592003,3380930960,1651792285,1651792482,197,1417
3479608671,3498989393,1660824286,1660824496,210,2286
3840026910,3672694122,1666030695,1666030841,146,2186
3190267458,3105299236,1655213035,1655213413,378,2483
3833683293,3344177563,1667101966,1667102389,423,1806
3815774397,3210986714,1659371581,1659372368,787,779
3956194935,3739490721,1650355701,1650356144,443,2460
3587633750,3730337290,1654150376,1654151291,915,1202
3847297747,3403323839,1645661702,1645662573,871,957
3343260379,3355135607,1659805655,1659806441,786,1762
3948180125,3404034127,1656149937,1656150757,820,1696
3773789419,3334298803,1667013561,1667013830,269,1949
3153902371,3502815865,1648441950,1648442316,366,2213
3249916829,3309922968,1666023118,1666023769,651,1755
3002013720,3586101932,1649566203,1649566620,417,17
3119802700,3418276734,1659924418,1659925415,997,2056
3164702890,3068129646,1663476662,1663476942,280,2210
3364600039,3210337290,1653208876,1653209594,718,794
3706178319,3378864156,1659746202,1659746872,670,2405
3906236028,3707947874,1663461844,1663462262,418,1230
3675703241,3966056341,1654999006,1654999218,212,983
3487030175,3120762596,1648247669,1648248088,419,86
3513576000,3117749198,1646205322,1646205341,19,1556
3852633699,3166805288,1655973504,1655973950,446,1972
3145772897,3488280503,1642876982,1642877762,780,2411
3223154180,3086530794,1661765266,1661766011,745,1544
3791547480,3807576323,1664315087,1664315974,887,1240
3587440298,3956058747,1657824076,1657825009,933,582
3879787945,3794251958,1652942569,1652943151,582,2092
3969650128,3036194601,1656809922,1656810828,906,1449
3603853942,3419809319,1654169568,1654170204,636,980
3781368357,3194379247,1643829927,1643830155,228,429
3009635817,3256374123,1649225059,1649225625,566,437
3965434074,3365289656,1658127249,1658127674,425,6
3955055535,3188643066,1661015869,1661016510,641,750
3315056551,3626020948,1664381751,1664382660,909,174
3877811036,3991477345,1661901444,1661901980,536,1305
3157965235,3606643671,1655198012,1655198031,19,1778
3643939596,3661559275,1663898572,1663899220,648,2337
3990870728,3793117012,1654006526,1654006526,0,2454
3252187190,3282561101,1668177496,1668177560,64,1226
3035158102,3321105707,1646197024,1646197721,697,1886
3080889735,3080214168,1644262755,1644263612,857,634
3021218084,3693183129,1651511180,1651511767,587,1475
3562110382,3284616898,1643141776,1643141863,87,2084
3016482005,3008576449,1658650888,1658651430,542,1927
3201630796,3962261300,1652394108,1652395065,957,1363
3831770571,3666072303,1647260950,1647260953,3,2327
3231899706,3924960579,1645588671,1645588854,183,1040
3344553610,3714909437,1660471208,1660471740,532,890
3826956383,3814577253,1666215132,1666215594,462,2123
3567906153,3936360658,1659988128,1659988796,668,1111
3750698244,3582076532,1653415838,1653416535,697,482
3609003771,3417143667,1644974173,1644974816,643,916
3028311577,3659158165,1649456565,1649456714,149,2382
3191811632,3097917804,1641157117,1641157357,240,621
3144993263,3426004964,1662221567,1662221810,243,682
3313192018,3408604990,1648526937,1648527779,842,1163
3070395663,3094414065,1667776668,1667777275,607,1575
3142869544,3727618645,1657286719,1657287139,420,1486
3771616536,3258399411,1641402298,1641403115,817,461
3178728299,3802749978,1668884539,1668884708,169,597
3695419353,3880835949,1659199256,1659200252,996,1512
3720615918,3582859001,1662782901,1662783367,466,1560
3233932115,3748360490,1659888707,1659889323,616,596
3042943074,3835612256,1656511642,1656512528,886,253
3366385571,3012032774,1667761946,1667762273,327,897
3710189327,3868460834,1658356093,1658357062,969,1244
3673935826,3974630210,1662100539,1662100608,69,1092
3708426776,3174705393,1661542909,1661543222,313,2112
3241847877,3969503443,1646908180,1646909070,890,78
3759393612,3976055046,1661735487,1661736438,951,2054
3449395269,3139035952,1649660164,1649660448,284,2071
3224800126,3334483625,1663726660,1663727115,455,829
3315583401,3144068102,1665800273,1665800491,218,268
3190267458,3014462663,1643921621,1643922006,385,103
3038529026,3526797183,1644511396,1644511563,167,2436
3739490721,3205418435,1667478161,1667478336,175,1197
3952663430,3747907269,1653874364,1653874728,364,2113
3034040451,3355418256,1652066719,1652066803,84,1876
3192940759,3923692475,1657982141,1657982501,360,1438
3409962434,3941512307,1643292165,1643292637,472,715
3920436432,3206512870,1659442609,1659442815,206,1155
3566693010,3714065380,1644549357,1644549850,493,981
3395782360,3249705811,1666096471,1666097114,643,1251
3240347468,3410150990,1657262696,1657263582,886,664
3864133914,3334965309,1654974042,1654974914,872,1125
3251382188,3902329320,1662125700,1662125997,297,2292
3307305290,3863665550,1667328386,1667328905,519,406
3781537659,3174712961,1641627795,1641628697,902,1501
3742159503,3442753076,1653558616,1653559515,899,722
3287175350,3634624974,1641332786,1641333386,600,1112
3309767670,3004951157,1665984480,1665985343,863,1182
3844939526,3741692259,1667560824,1667561416,592,923
3399479391,3261195333,1645897159,1645897637,478,662
3232333937,3325735480,1655336876,1655337688,812,2318
3828219822,3120105783,1644794484,1644795041,557,249
3041385548,3937618865,1666203477,1666204215,738,2202
3148284665,3553939893,1656287487,1656287872,385,677
3221885729,3183435456,1655865284,1655865759,475,21
3248167631,3122002940,1652371488,1652372302,814,1835
3476728930,3049592624,1657666103,1657666413,310,515
3482509515,3620522583,1646490915,1646491140,225,1892
3554977739,3728950700,1655691923,1655691962,39,1271
3029849131,3438130685,1652575370,1652575836,466,1928
3395609056,3712727713,1644889278,1644889440,162,906
3903588940,3405319002,1653575666,1653576599,933,1374
3489453670,3550329232,1656864274,1656864388,114,682
3849379963,3270923168,1651898350,1651898803,453,2148
3659752387,3315583401,1669089019,1669089471,452,1958
3069225011,3943184820,1659517046,1659517615,569,1789
3578974875,3184680353,1647070166,1647070616,450,1569
3796255141,3045070182,1652468898,1652469621,723,87
3547358965,3009169806,1669737045,1669737097,52,1830
3350017208,3448409263,1642785021,1642785870,849,2240
3199395221,3922972838,1661865537,1661866226,689,1530
3263488499,3792012199,1655453202,1655453423,221,2465
3437122732,3036801405,1642809354,1642809952,598,1225
3342189600,3959783422,1668832544,1668832716,172,1080
3809312897,3852673624,1655113967,1655114692,725,2335
3622848449,3075765827,1653312808,1653313143,335,1058
3378522829,3977872515,1649451983,1649452752,769,1108
3036194601,3380822514,1668194830,1668195154,324,1317
3926612159,3621456276,1654716616,1654716906,290,1425
3687938178,3039932020,1642277287,1642278154,867,694
3832243899,3980207883,1649373558,1649374496,938,900
3676352528,3757305418,1651889463,1651890389,926,724
3961903747,3714122939,1661180164,1661181010,846,112
3071929787,3761307187,1656496632,1656497424,792,830
3242948145,3130594039,1647472055,1647472256,201,404
3127467065,3353388722,1667490399,1667491258,859,580
3790039057,3847297747,1647973928,1647974844,916,660
3692095366,3114277786,1656506277,1656506914,637,1339
3485459472,3065405448,1649353604,1649354156,552,484
3756028002,3832995595,1654469735,1654470598,863,629
3350783192,3361694981,1662176843,1662177688,845,2012
3023265778,3049592624,1652220727,1652220802,75,177
3507431231,3697291064,1656608186,1656608783,597,714
3382777450,3341042744,1668155263,1668156044,781,400
3030551637,3540029077,1657936147,1657936620,473,2336
3642771281,3895370398,1661826267,1661827102,835,1344
3800392649,3016508907,1653681323,1653682219,896,2294
3300983140,3344285047,1654953043,1654953329,286,2419
3854351732,3772749656,1654117422,1654118228,806,1135
3665148560,3912183552,1651640246,1651641229,983,2410
3769647112,3058725687,1655081096,1655081178,82,1761
3101609490,3901902653,1651485362,1651485865,503,378
3984467207,3465406980,1650272023,1650272519,496,364
3870779720,3728224229,1643232958,1643233459,501,1894
3774725066,3026244912,1666049012,1666049032,20,540
3824860461,3660489961,1645667922,1645668252,330,793
3340125949,3656002043,1663240478,1663241456,978,180
3319365305,3948862720,1658446501,1658447490,989,1698
3992909356,3240249176,1660956264,1660956265,1,1593
3657391976,3194617168,1653931726,1653932400,674,1179
3129138715,3376266236,1653114047,1653114667,620,438
3206197726,3960908616,1669704674,1669705587,913,2419
3361016803,3902437090,1655587585,1655587993,408,1014
3513368682,3024447668,1644306124,1644306852,728,708
3895855296,3045302814,1651531539,1651531690,151,1740
3365134626,3080325374,1648377809,1648378128,319,704
3576422890,3907299052,1666523015,1666523250,235,1721
3761218329,3818467247,1663015344,1663015983,639,1573
3022348535,3468963532,1665974655,1665975258,603,1317
3913608544,3879157400,1667645950,1667646203,253,2075
3957803611,3613188168,1648273259,1648273756,497,1187
3855013110,3656878544,1663875140,1663875367,227,1804
3125730442,3458209928,1644282929,1644283896,967,1280
3258460512,3343729897,1643601110,1643601199,89,2097
3059602794,3571576669,1666755228,1666756186,958,1056
3153335208,3650471605,1664973518,1664974271,753,458
3261913628,3767983934,1661966940,1661967005,65,1342
3175298013,3549635553,1668555850,1668556549,699,1806
3844822083,3679617161,1668770408,1668770438,30,2233
3070117232,3059447105,1661054105,1661055073,968,2224
3784912315,3020285623,1644455608,1644455927,319,298
3172429422,3810823450,1650596762,1650597355,593,1838
3745513680,3441383531,1664635073,1664635843,770,873
3879898101,3180294141,1647324416,1647325203,787,1058
3151938386,3982538753,1664779926,1664780249,323,580
3552101140,3295850908,1647843667,1647844123,456,2264
3970654045,3718182841,1659417666,1659418079,413,1593
3906903088,3526793212,1665990202,1665990406,204,1578
3574285791,3914601322,1646652190,1646652951,761,2237
3714259747,3118425000,1642276733,1642277660,927,134
3591724433,3184455727,1665952596,1665952695,99,2219
3032465570,3909292537,1661366066,1661366658,592,2237
3194721041,3013314607,1643459268,1643460256,988,2246
3216171635,3328015314,1652590786,1652591108,322,1814
3316952075,3658516535,1667196052,1667196947,895,31
3623020544,3402878567,1662482989,1662482999,10,2078
3963793916,3656846834,1661685666,1661685763,97,2286
3699293407,3045587450,1660180160,1660181125,965,1921
3765962960,3407409307,1648733527,1648734206,679,860
3734004050,3957798687,1662137926,1662138114,188,132
3649298405,3222438717,1663920928,1663921023,95,572
3114863942,3052233179,1650370435,1650371325,890,1551
3424721457,3721395445,1644427880,1644428409,529,1941
3617453316,3276142713,1667954845,1667955735,890,803
3564395523,3350017208,1646482650,1646482914,264,1240
3855548589,3206512870,1667004197,1667005141,944,2068
3174676733,3252790120,1642045158,1642045340,182,1493
3055044716,3414502284,1669725629,1669726145,516,461
3650902153,3685977300,1656853684,1656854606,922,1789
3722578408,3773742235,1668486527,1668486776,249,2374
3582046255,3081188307,1654794286,1654795245,959,602
3999551936,3428026242,1667435451,1667435905,454,2087
3083020614,3286078112,1658536445,1658536804,359,34
3149181988,3028886204,1663613055,1663613248,193,1088
3993756491,3737809844,1650163825,1650164408,583,2213
3375879417,3379726555,1665052884,1665053622,738,1610
3456386287,3017504746,1641111813,1641112521,708,318
3028705386,3410150990,1657874296,1657874508,212,24
3080195715,3800392649,1648820538,1648821479,941,1501
3643173963,3359724083,1660454623,1660455187,564,671
3268349855,3685977300,1649732953,1649733010,57,1113
3131629372,3552305242,1668257320,1668257682,362,1978
3753659944,3409352040,1663012264,1663012489,225,72
3879898101,3407409307,1666726985,1666727812,827,548
3417143667,3954490536,1647765515,1647766182,667,1648
3530376538,3585100772,1652981373,1652981446,73,811
3525088003,3246783185,1643933835,1643934052,217,1161
3719084637,3028535162,1643887544,1643887885,341,646
3276350975,3465229825,1668488092,1668488166,74,1355
3455941777,3309286736,1643987148,1643987342,194,730
3729600228,3326881805,1662315334,1662316131,797,1438
3782941796,3533290388,1652996476,1652997356,880,2385
3708896596,3670112572,1646376330,1646376916,586,286
3506384176,3615595663,1659659278,1659660068,790,2345
3561881366,3483254795,1653193370,1653193583,213,2309
3313782821,3181578884,1651739942,1651740789,847,1137
3475612329,3099785418,1644948530,1644949469,939,365
3216171635,3885849262,1657061722,1657062010,288,1880
3467215587,3634624974,1669568484,1669569140,656,1413
3237841242,3461505923,1662467331,1662468029,698,81
3105815944,3774945806,1665487890,1665487975,85,677
3944914500,3752817676,1648103207,1648104009,802,1707
3691607111,3734035973,1651160568,1651161319,751,2197
3808541027,3377179024,1653321421,1653322153,732,1183
3725989619,3758323845,1668833701,1668834361,660,1832
3153040217,3025014828,1656199446,1656199728,282,316
3609274729,3680100111,1648661332,1648661881,549,873
3030174879,3231496949,1659345651,1659346146,495,644
3800451074,3365939940,1666738271,1666738667,396,1439
3231938844,3344549344,1647454497,1647455317,820,635
3366321387,3295262122,1653515756,1653516145,389,1439
3872493238,3162836777,1648563271,1648563446,175,1046
3398785571,3319601888,1664882505,1664883095,590,1188
3938417195,3037375725,1652382897,1652383448,551,1918
3929887239,3014438377,1668362672,1668362772,100,1836
3291512173,3332458882,1660922174,1660922373,199,994
3662745240,3975065378,1666185274,1666186124,850,84
3037048394,3154991935,1642172598,1642172788,190,369
3825900664,3822816987,1660594400,1660595268,868,30
3389448374,3431892611,1664369520,1664370438,918,1935
3359403467,3074886612,1644588458,1644589122,664,369
3584660761,3478959759,1669107989,1669108578,589,1661
3190544941,3408300554,1653071660,1653071938,278,2333
3211401798,3880139481,1660141559,1660142424,865,1035
3461630480,3331882759,1647125134,1647125324,190,375
3536903033,3755473771,1659365350,1659365908,558,2143
3307067721,3273348089,1650445932,1650446883,951,1707
3680682585,3675429073,1665381679,1665381730,51,1134
3976970303,3434650074,1657436869,1657437127,258,591
3141688992,3488878461,1643897990,1643898559,569,120
3684537058,3368571252,1650345807,1650346145,338,355
3639819433,3052889118,1644870730,1644871279,549,1635
3805826972,3495858842,1643147248,1643147289,41,163
3642318884,3071602516,1642726925,1642727618,693,547
3422046745,3295518987,1655112115,1655112122,7,887
3095772004,3033523546,1669467202,1669467521,319,625
3381821132,3231938844,1664593635,1664593736,101,2387
3933196862,3894175918,1651164464,1651164818,354,516
3841314189,3632284739,1664559722,1664559958,236,1461
3310262408,3458209928,1666623823,1666624796,973,2269
3404034127,3114361358,1669086222,1669086769,547,93
3962031345,3647938021,1664988886,1664989596,710,0
3419415544,3949841652,1658790358,1658791241,883,595
3367977353,3656467120,1656268834,1656269798,964,1148
3740376361,3153518026,1665434505,1665435259,754,2278
3109959336,3235825340,1662789537,1662789741,204,1798
3127549843,3636930993,1662925082,1662925999,917,1693
3451370887,3520324090,1656924840,1656925549,709,933
3186483050,3641911946,1659492459,1659492585,126,1800
3509864353,3863827466,1663614566,1663615056,490,1296
3931677547,3153858233,1655912417,1655912797,380,375
3650675743,3063674428,1665139180,1665139514,334,808
3977699882,3465500045,1659259222,1659259375,153,1936
3421730413,3366609475,1649067251,1649067304,53,2128
3100201926,3962440297,1648111723,1648111741,18,358
3010488834,3841287368,1668485298,1668486151,853,2380
3107865208,3180534430,1668821655,1668822562,907,751
3219440900,3114097031,1647763076,1647763870,794,235
3957210150,3646908383,1657637271,1657637667,396,1570
3701103798,3462072699,1668283804,1668284726,922,670
3573975780,3164122941,1647335529,1647335637,108,905
3659158165,3053005521,1656482069,1656482254,185,1233
3376266236,3104459009,1652755106,1652756086,980,1606
3697066162,3719965258,1643222107,1643222765,658,2293
3516547882,3734576015,1644738818,1644739157,339,989
3785361012,3678452420,1654808195,1654808799,604,1205
3020452542,3365829981,1654315340,1654316140,800,1329
3442799166,3022916032,1643439159,1643439172,13,811
3828921434,3929774793,1668410036,1668410075,39,2165
3972294801,3194125043,1668015857,1668016521,664,444
3754631129,3354055639,1652253487,1652253595,108,554
3805653360,3517992014,1647848326,1647848835,509,2398
3939755962,3448459810,1668170789,1668171510,721,1775
3060674509,3759668586,1649159008,1649159437,429,2345
3257973966,3224864814,1667386307,1667387022,715,572
3437705581,3780546851,1664106727,1664107092,365,870
3298857826,3886521997,1649227063,1649227866,803,1190
3389926670,3605195406,1642689549,1642690350,801,1389
3137967669,3630318253,1669496097,1669496136,39,1216
3094361527,3807549475,1659834615,1659835111,496,1323
3887290680,3325313312,1642667231,1642667232,1,1745
3555538922,3006603067,1650888607,1650888717,110,224
3984414020,3670112572,1641409230,1641410067,837,2211
3710844932,3969744786,1648904514,1648905427,913,2279
3501786397,3462744404,1651206032,1651206495,463,1186
3481006313,3951158399,1656349784,1656350449,665,2368
3169486525,3846628868,1651975699,1651976587,888,1747
3459018363,3324073911,1641525630,1641525995,365,1735
3052499026,3436975295,1667976991,1667977505,514,407
3315321131,3008760173,1663037748,1663038360,612,1986
3550299952,3710888381,1648856495,1648856940,445,2002
3543732655,3514354263,1662193440,1662193627,187,887
3432608968,3158962971,1647881141,1647881643,502,1130
3109465057,3851879278,1664103672,1664104017,345,1899
3790829012,3719229760,1657383380,1657383985,605,370
3921317746,3123999917,1647769675,1647770379,704,469
3979522310,3188588023,1643395261,1643395782,521,1629
3536954029,3176941664,1647959416,1647959833,417,1616
3132863382,3046006152,1667388333,1667388947,614,1168
3880849800,3463509445,1665827858,1665828472,614,896
3834174227,3127419046,1663776795,1663776916,121,1958
3733051386,3759656646,1641138744,1641138981,237,72
3176818286,3166274990,1660396800,1660397170,370,266
3395782360,3181237998,1651636316,1651636742,426,2297
3875045889,3160071792,1664045552,1664045866,314,2493
3850178015,3361508949,1660400676,1660400996,320,426
3521408145,3407746149,1644238548,1644238690,142,1496
3630448266,3984467207,1661347818,1661348474,656,917
3456435173,3775665997,1665439019,1665439850,831,1694
3678482446,3007308564,1654022007,1654022469,462,1437
3672699331,3112960048,1665320775,1665320966,191,1572
3664627036,3479308343,1650077187,1650077881,694,785
3804257503,3878657197,1641915344,1641916037,693,213
3604596822,3874569616,1665653844,1665653952,108,1316
3533274758,3097834756,1659843831,1659844776,945,1051
3364938815,3889730114,1663859661,1663859988,327,287
3927657297,3984818292,1654932249,1654932638,389,82
3702302181,3346832945,1664170786,1664170987,201,1502
3794074656,3556803718,1652546871,1652547590,719,1303
3344077337,3689032543,1653024585,1653024585,0,2144
3575457804,3308001923,1653996627,1653997323,696,2366
3752347758,3002727939,1647033957,1647034509,552,994
3610930903,3787880772,1664048571,1664049448,877,1997
3211047702,3262711330,1660625398,1660625669,271,1714
3019576854,3658113721,1660669533,1660669603,70,1694
3862102577,3424650360,1657384189,1657385092,903,1483
3364600825,3951845301,1645126170,1645126804,634,248
3499481975,3793344397,1652002874,1652003838,964,1385
3844666457,3072276713,1654701707,1654702010,303,2414
3598665921,3625586912,1661738595,1661738832,237,1318
3398242179,3638233110,1654018970,1654019029,59,2312
3136174856,3675359399,1647807982,1647808639,657,227
3021289375,3321818923,1663702364,1663703138,774,2084
3477243904,3377826578,1654263733,1654264551,818,914
3878512967,3070640991,1668143878,1668144445,567,1798
3650205106,3676228617,1642415396,1642415570,174,73
3664408598,3105299236,1665010239,1665010867,628,1123
3281923852,3976147939,1648228480,1648229418,938,638
3632335400,3854737938,1664001743,1664002668,925,1983
3716977635,3415768719,1654458644,1654458813,169,1606
3059848821,3408529019,1668942382,1668942770,388,1111
3986970365,3085921604,1646960487,1646960782,295,2322
3229318915,3239158180,1646505328,1646505571,243,700
3177427428,3936659399,1657227767,1657228279,512,1682
3016482005,3764318951,1650931152,1650931679,527,2395
3994927164,3470102638,1660331274,1660332096,822,930
3210422873,3624872846,1644544245,1644544461,216,2243
3786724835,3693925345,1663433718,1663433958,240,2397
3695237310,3034159032,1659937916,1659938310,394,538
3463965663,3828503026,1669672930,1669673546,616,445
3978691513,3011458038,1654627203,1654627350,147,1127
3398257086,3032123620,1654139404,1654139723,319,308
3276840933,3260695363,1651275842,1651276042,200,574
3358959910,3072219388,1654656645,1654656719,74,389
3824649355,3686826205,1641459015,1641459979,964,359
3956194935,3757693725,1650308786,1650309598,812,2042
3122293667,3313292041,1668577331,1668577759,428,1427
3517631415,3901616267,1662102186,1662102802,616,1367
3027478849,3451249074,1653859543,1653860235,692,1499
3671971306,3306838717,1652540503,1652541206,703,1619
3724977571,3997353499,1659077397,1659077935,538,1900
3348113823,3639659256,1664366168,1664366967,799,912
3498441448,3149191705,1649480781,1649481090,309,1194
3937729247,3676132016,1653426414,1653427103,689,332
3418007140,3195504067,1656352792,1656353062,270,878
3514013878,3379598529,1654709446,1654709893,447,1491
3457895283,3696607958,1662728507,1662729414,907,2045
3211514286,3156483651,1654004434,1654005297,863,732
3152176779,3609601814,1668130802,1668130812,10,2415
3156261740,3707070213,1663253427,1663254191,764,774
3710422072,3457317780,1644705573,1644705739,166,1352
3480314503,3626156541,1654319346,1654319803,457,1225
3696607958,3154139372,1662861905,1662862004,99,2103
3882038749,3054171550,1668858347,1668859240,893,1966
3735943539,3158209281,1649599705,1649600159,454,1800
3963303057,3929887239,1648368613,1648368798,185,1779
3878810894,3686207600,1652571891,1652572715,824,154
3261477798,3594471575,1653425179,1653425247,68,1079
3064758483,3036527901,1649574388,1649575273,885,1956
3928685907,3306460846,1666623062,1666623496,434,2454
3763188005,3445647826,1667147172,1667147653,481,1670
3407322181,3128248749,1646358416,1646359362,946,1989
3735547050,3362249024,1663443510,1663444489,979,769
3339385127,3700412611,1641872584,1641873158,574,2083
3133601374,3498989393,1655331947,1655332821,874,1524
3403911906,3935057012,1647177657,1647178376,719,1622
3026701207,3536832504,1652870602,1652870684,82,38
3205418435,3170058626,1655574418,1655574729,311,1844
3648257100,3088562105,1642828329,1642829229,900,709
3237674968,3404317985,1652174791,1652175564,773,128
3906903088,3600879855,1659481269,1659482159,890,238
3658659669,3701537998,1668365213,1668365504,291,2312
3525377731,3309196902,1668837750,1668838662,912,843
3549209951,3897421758,1647932413,1647932586,173,2088
3844006658,3185745995,1656556657,1656557465,808,1550
3315185864,3389448374,1651791450,1651792240,790,806
3889730114,3248892530,1666197334,1666197794,460,1421
3978720869,3033373685,1663085508,1663086043,535,199
3975462879,3949133704,1661444678,1661445382,704,836
3569051470,3688076815,1667237238,1667237842,604,2492
3945943527,3514335388,1660044939,1660045677,738,1844
3835069955,3172293659,1665603386,1665604345,959,81
3047643464,3547429967,1667112214,1667112591,377,1793
3268745445,3048386186,1654010109,1654011019,910,611
3845980646,3628729475,1660105290,1660106261,971,638
3924607271,3487475790,1650772235,1650772881,646,1919
3561037966,3088854267,1647198331,1647198700,369,130
3060728062,3316496524,1667137733,1667138011,278,889
3469507401,3506952427,1654455624,1654456358,734,1019
3912111332,3021253966,1666429274,1666429706,432,2287
3475129802,3722329316,1641737883,1641738270,387,2221
3371026826,3237224664,1643940326,1643940686,360,32
3972052329,3867026366,1645970884,1645971157,273,466
3203319376,3346631744,1641105450,1641106058,608,587
3587171844,3590627159,1669344564,1669345325,761,385
3025333750,3100440036,1660450651,1660451211,560,638
3117230173,3968682824,1645004557,1645004959,402,2342
3866222795,3831951487,1668513317,1668513869,552,489
3884878006,3760047951,1646198661,1646198925,264,1408
3019204329,3128449335,1666116070,1666116528,458,902
3298436959,3915344164,1667100994,1667101103,109,782
3454851350,3457284809,1661954713,1661955177,464,894
3624484272,3804768140,1643180505,1643180611,106,1695
3004160380,3158894896,1652478305,1652478851,546,210
3704980935,3750765878,1656873867,1656874598,731,696
3024651290,3201068600,1660361853,1660362519,666,1510
3526793212,3328471090,1660289639,1660289757,118,2030
3023075779,3881216721,1642064326,1642065324,998,1465
3046043182,3707767360,1646745656,1646745948,292,1255
3022283384,3181388502,1646576892,1646576983,91,1442
3590361712,3680694926,1643242752,1643242936,184,1659
3308454699,3102588374,1641309815,1641310160,345,1061
3595469152,3063566522,1664390979,1664390985,6,2230
3806664868,3398412701,1655646820,1655646924,104,2088
3314028925,3625691221,1650419777,1650420563,786,2130
3145948160,3516838480,1661959792,1661959845,53,2420
3734579045,3348568561,1642413847,1642414383,536,1455
3541579882,3189358030,1649104012,1649104116,104,1807
3356728242,3879967963,1654687909,1654688615,706,1778
3372471333,3468654589,1668210001,1668210791,790,101
3628583147,3571991159,1659090470,1659090917,447,2278
3562547940,3687552718,1643618402,1643619012,610,2188
3673597203,3515138485,1662457388,1662457598,210,2259
3064961160,3108288045,1641388243,1641388314,71,1218
3586734200,3715766296,1660168448,1660168770,322,723
3623351962,3744293001,1664720748,1664720801,53,1758
3446572964,3749327438,1653918452,1653918702,250,928
3855563284,3269690639,1647085854,1647085940,86,2150
3120105783,3188726102,1666957927,1666958409,482,1946
3271479070,3936360658,1663763941,1663764377,436,263
3139604406,3941528766,1646476929,1646477911,982,2425
3055169776,3503011690,1645968828,1645969032,204,1416
3159873313,3704568536,1660365922,1660365990,68,2063
3768846820,3569244680,1664478113,1664478877,764,1633
3022916032,3179354869,1653860926,1653861169,243,1316
3306871271,3073762858,1669481686,1669482581,895,502
3154250720,3283447626,1641684893,1641685582,689,538
3749188570,3750756562,1664106512,1664107356,844,976
3231938844,3277521554,1658297062,1658297977,915,1536
3131753608,3553436680,1666055708,1666055874,166,8
3388159268,3354574342,1649162690,1649163235,545,1570
3960908616,3821157240,1659082209,1659083138,929,414
3392213771,3087876190,1646052162,1646052662,500,1958
3524282034,3122288373,1660470182,1660470457,275,2326
3321971009,3882619512,1644325085,1644325903,818,649
3970288014,3157600969,1648441752,1648441868,116,1752
3178742688,3586770678,1657737187,1657737277,90,401
3353500391,3659158165,1666788723,1666789115,392,127
3044390847,3949668592,1646143002,1646143738,736,210
3084855451,3451749535,1647364998,1647365340,342,357
3905067771,3775501779,1661101335,1661102310,975,1852
3867026366,3530491537,1649097717,1649098254,537,1232
3942273552,3395316132,1641615092,1641615258,166,148
3430375744,3997810649,1642617024,1642617728,704,793
3091595739,3446547180,1648253619,1648254117,498,115
3949480596,3208831400,1660336310,1660337244,934,1976
3760535935,3257375975,1662957475,1662958344,869,999
3198731476,3837904800,1643869867,1643870070,203,1597
3990520153,3175929512,1655660593,1655661244,651,2004
3023421632,3243059921,1654731562,1654732416,854,458
3749811473,3400163448,1653394934,1653395063,129,410
3577627752,3581083030,1642301883,1642302306,423,2096
3143741876,3106490071,1664425161,1664425750,589,296
3735691730,3590627159,1649327408,1649328099,691,236
3124574350,3334102064,1650902225,1650903027,802,1258
3306669471,3807473345,1651268178,1651268509,331,1595
3948862720,3803000258,1660320504,1660320527,23,1790
3381313507,3108998670,1658071673,1658071703,30,626
3317431311,3445558523,1647590985,1647591032,47,2201
3748850384,3655498745,1651440127,1651441098,971,2202
3930205120,3488001885,1656216814,1656217383,569,622
3661037098,3922341165,1658600324,1658600987,663,1932
3492376573,3319546209,1660580262,1660580383,121,1810
3963615140,3157765022,1657672369,1657673358,989,465
3894247542,3515367610,1644861819,1644861983,164,2176
3862918742,3382777450,1649474790,1649474947,157,1033
3375759020,3222282745,1664992290,1664992895,605,2338
3889537515,3617545187,1650115126,1650115516,390,1769
3552457707,3378221943,1647819669,1647820417,748,248
3409662195,3985326073,1652128592,1652128992,400,1585
3073540574,3708809295,1644032956,1644033573,617,1218
3541881881,3110691442,1658718535,1658718964,429,174
3067539427,3799459873,1644190785,1644191761,976,1447
3799036179,3133902865,1657449480,1657450066,586,1375
3408104715,3086653619,1645982289,1645983003,714,2365
3928354041,3914601322,1646198161,1646198694,533,1960
3178749877,3961973688,1658967999,1658968475,476,1387
3858225831,3640915578,1652866502,1652867409,907,1689
3141635102,3162641272,1650764963,1650765015,52,315
3375585327,3058855369,1652744476,1652744788,312,1932
3671355250,3329190028,1657775608,1657776256,648,50
3282425868,3480308437,1659283904,1659284061,157,918
3654381548,3282275875,1668981747,1668982036,289,1705
3403223215,3084882941,1650021366,1650021886,520,2261
3303815040,3494179125,1657960537,1657961240,703,47
3778068384,3048504189,1666416530,1666417126,596,145
3213836945,3390723607,1659673366,1659673736,370,58
3145948160,3747697794,1667909195,1667909738,543,241
3329253794,3960204629,1661669443,1661670439,996,701
3206549691,3360575138,1656913737,1656914569,832,2030
3928354041,3832072924,1643721752,1643721983,231,1881
3858052316,3804773972,1669462081,1669462965,884,1942
3857081560,3012272703,1660527652,1660528550,898,1058
3334030228,3318735194,1661929704,1661929773,69,1330
3504641910,3919562972,1645224458,1645224821,363,1978
3005809519,3502599631,1665366572,1665367295,723,785
3818549518,3688056726,1658393160,1658393179,19,2463
3604376955,3110691442,1666789470,1666789677,207,1630
3445226012,3058725687,1667639745,1667640056,311,1457
3536128186,3518179871,1647825320,1647825646,326,2323
3114097031,3350783192,1652190983,1652191616,633,2387
3319128889,3687829870,1645350834,1645351620,786,705
3085182687,3756806050,1649444535,1649444573,38,2473
3805928545,3911290843,1647998709,1647999039,330,560
3404008086,3614399988,1662563007,1662563889,882,1651
3949133704,3100201926,1644646442,1644647360,918,1138
3071850041,3117821060,1644484241,1644485201,960,1770
3957798687,3920875021,1652564187,1652565154,967,2290
3438474821,3521160717,1658619920,1658619938,18,1294
3772749656,3371785046,1655823875,1655824864,989,1255
3104271824,3831039944,1648145518,1648145798,280,745
3344394548,3785432995,1651492777,1651493227,450,1623
3154309446,3145948160,1647931051,1647931732,681,2267
3908209550,3567520646,1646240620,1646241025,405,1355
3339480960,3069989068,1641501733,1641502174,441,2412
3617453316,3048409719,1655482753,1655483076,323,1514
3428501033,3210078490,1667004804,1667005557,753,1408
3530278315,3887791096,1665074839,1665074993,154,691
3844416504,3904881288,1668030807,1668031632,825,1847
3515933745,3215423327,1651655270,1651655979,709,262
3039864595,3443490373,1643370844,1643371200,356,2077
3256374123,3988264152,1643315312,1643315690,378,1299
3319965397,3858150562,1643402132,1643402180,48,1906
3932077086,3773789419,1651509230,1651509985,755,753
3949522552,3556848299,1665810815,1665811288,473,2427
3773789419,3479580096,1648416840,1648417298,458,361
3941903445,3925690262,1666243083,1666243408,325,741
3781394729,3064323869,1654654627,1654655293,666,61
3058846696,3400233871,1665658925,1665659152,227,12
3420298161,3550218169,1666042133,1666042700,567,2360
3316031407,3821049069,1660051544,1660051787,243,2184
3752522830,3138638384,1641145953,1641146721,768,109
3488878461,3922851964,1660882154,1660882843,689,83
3851747907,3423522480,1659773074,1659773560,486,2004
3405373154,3841660750,1658085225,1658085901,676,1471
3488878461,3156189187,1658530288,1658530461,173,1739
3865387894,3883497013,1664718575,1664719062,487,626
3012892515,3271876104,1657083654,1657084253,599,1886
3866836302,3549752945,1641907954,1641908104,150,1278
3446699030,3137200123,1663118600,1663118929,329,1031
3234861737,3435915872,1660093247,1660094066,819,1876
3159240548,3544353013,1650958353,1650958589,236,1810
3272623699,3629933310,1666070844,1666071649,805,93
3416230781,3200827648,1650004018,1650005007,989,2492
3692095366,3129860388,1641467065,1641467957,892,702
3127447356,3301202561,1644611854,1644612479,625,2018
3486286893,3115669693,1649901142,1649901361,219,1721
3430145466,3010373186,1655787201,1655788088,887,1550
3841106350,3289696366,1665154080,1665154309,229,2112
3003723782,3785426867,1656228429,1656229086,657,146
3351277781,3462026511,1644430062,1644430389,327,2041
3756020689,3787230225,1661304328,1661304467,139,2052
3149545838,3862890852,1664219569,1664219809,240,1084
3319365305,3022082086,1653566252,1653567070,818,1777
3066168441,3254503569,1661748887,1661749740,853,204
3611982999,3414488975,1647074844,1647074977,133,240
3200978578,3909002163,1644821924,1644822001,77,1858
3204336699,3766274699,1668923390,1668923554,164,1771
3644128961,3810891199,1645636424,1645637130,706,900
3586734200,3648263372,1660865819,1660866799,980,2192
3434351368,3518932161,1667547491,1667547706,215,606
3886521997,3471703914,1666183902,1666184869,967,522
3894175918,3375782922,1642668028,1642668418,390,890
3385007362,3846628868,1655662581,1655663328,747,927
3806875541,3100440036,1645003991,1645004843,852,548
3003022656,3159525512,1659327196,1659327288,92,1559
3715106063,3124415148,1647909368,1647909565,197,1786
3654922401,3003145369,1647163852,1647164064,212,1641
3699258770,3724455974,1661850827,1661850964,137,1835
3199892178,3025133604,1652945443,1652945987,544,1786
3698989053,3142106289,1668561938,1668561952,14,1156
3417138981,3411347712,1669058611,1669059305,694,1757
3168820334,3811337280,1666166521,1666166564,43,777
3888764578,3649660430,1666563002,1666563985,983,2295
3533898881,3675341264,1656680983,1656681369,386,1772
3656000543,3842362489,1663364024,1663364439,415,2463
3683507812,3654344198,1666281181,1666281575,394,315
3396524452,3727995134,1662966919,1662967465,546,2407
3463509445,3022082086,1654956880,1654957868,988,189
3108427765,3534581934,1654842531,1654843479,948,1379
3568097363,3918812791,1656145446,1656146123,677,855
3217384934,3057090135,1665039054,1665039806,752,2232
3412109130,3265078616,1648286009,1648286969,960,2289
3205809646,3261527870,1660523890,1660524181,291,1395
3648118736,3304958701,1669301919,1669302079,160,223
3481482238,3910029798,1651269650,1651269763,113,2127
3347832946,3810823450,1647839476,1647840303,827,2412
3086564112,3516624109,1643372704,1643372917,213,979
3287399418,3051395031,1669224415,1669224920,505,1155
3935936621,3947105207,1651538881,1651539459,578,2422
3791406454,3605706184,1667870988,1667871707,719,43
3795609815,3121391240,1656678034,1656678559,525,2303
3960494982,3945607460,1642120850,1642121011,161,1289
3385760763,3547334414,1649561160,1649561354,194,1520
3276482511,3249705811,1656569704,1656569832,128,1411
3681719344,3117234289,1658390873,1658391302,429,346
3538692457,3796559738,1646242356,1646242614,258,1880
3581207584,3507431231,1649619856,1649620281,425,120
3375759020,3829986472,1657833719,1657834077,358,1771
3267600229,3873554599,1641641074,1641642002,928,1519
3576411084,3804948415,1652655578,1652656203,625,2032
3290860752,3418276734,1647871396,1647872168,772,498
3583864167,3331977197,1667041439,1667041864,425,2039
3131156982,3118554894,1655667099,1655667943,844,484
3740090157,3895976556,1652865104,1652865642,538,1151
3940222685,3034750166,1644109208,1644109357,149,2297
3859634422,3415584739,1649195698,1649196198,500,2449
3620700244,3609058442,1653544272,1653544328,56,638
3863827466,3625772064,1647528019,1647528683,664,574
3060989519,3411340387,1656196909,1656197394,485,365
3057028614,3301471485,1661423298,1661423765,467,500
3273258651,3457468984,1654313066,1654313835,769,814
3112419355,3122624322,1650763622,1650764499,877,1636
3678624517,3704305860,1650697073,1650697073,0,2212
3173642675,3382974723,1669276270,1669276393,123,1227
3442927979,3826433692,1650854505,1650855505,1000,91
3586489382,3069318012,1650353022,1650353430,408,2439
3933450798,3518620219,1665931913,1665932871,958,1773
3652513122,3375655129,1652216740,1652216964,224,2354
3670291498,3506750759,1658939692,1658939737,45,1232
3005926074,3194342775,1662782729,1662783541,812,1198
3700419429,3125730442,1642589005,1642589924,919,1156
3076431464,3084940745,1662746971,1662747022,51,1110
3478959759,3141689539,1652492167,1652492590,423,1416
3276576100,3030286864,1661506722,1661507314,592,81
3338154846,3200933791,1643010263,1643011073,810,857
3382396122,3569743064,1659234786,1659234894,108,1272
3091072272,3787071341,1663322051,1663322595,544,1603
3349566530,3587903968,1644007105,1644008093,988,1745
3099013723,3389497658,1655261802,1655261898,96,2131
3718182841,3688076815,1658063030,1658063552,522,82
3469887287,3619660501,1641467267,1641467510,243,220
3428260922,3163986082,1658281933,1658282203,270,1415
3637092038,3894359262,1649762126,1649762981,855,1758
3033438220,3401463703,1642496097,1642496157,60,2258
3595670942,3054979282,1654996280,1654997140,860,1219
3254473094,3161412125,1665064694,1665064911,217,724
3271759672,3170985187,1643706263,1643706827,564,1834
3750069283,3880290667,1649160633,1649161199,566,174
3064758483,3088465843,1663088008,1663088731,723,1602
3054803754,3943836795,1669401618,1669402357,739,2048
3327166880,3565001530,1651566989,1651567716,727,1754
3021968850,3134436515,1661313489,1661314443,954,2241
3244398882,3991673197,1656351122,1656351530,408,1550
3179180919,3029468613,1649327684,1649327806,122,1903
3658428855,3675366639,1652546132,1652546504,372,1024
3664267954,3451131159,1668039342,1668039802,460,475
3204912218,3325944344,1645411847,1645412032,185,292
3714322007,3488813245,1643686294,1643686842,548,1762
3526166184,3128805218,1667290149,1667290415,266,2364
3706560099,3773177927,1643784391,1643784594,203,1228
3028780744,3032431944,1658039882,1658040036,154,947
3098422570,3556456137,1652606901,1652607287,386,828
3036346251,3219869001,1664826139,1664826808,669,1436
3566919425,3091595739,1650445724,1650446340,616,2270
3387568587,3133601374,1654603074,1654603484,410,1331
3970753504,3657758228,1654026444,1654026585,141,1180
3003617799,3890159677,1650690169,1650691096,927,368
3558139345,3957824946,1642874851,1642875004,153,1333
3423640116,3389097842,1649036731,1649036836,105,41
3761609140,3615359458,1645362134,1645362748,614,172
3213169891,3270395343,1646896203,1646897075,872,569
3224792502,3365129722,1646329146,1646329154,8,741
3593437920,3161784330,1650041306,1650042151,845,2121
3035794185,3925364546,1655585550,1655585727,177,825
3502815865,3126455934,1663438671,1663439489,818,2173
3819172879,3958733956,1648978709,1648979039,330,1873
3296419150,3508398331,1644611122,1644611527,405,1971
3048788442,3405373154,1668990935,1668991010,75,1487
3831542177,3771623134,1668310793,1668311734,941,220
3087394554,3983536056,1659701069,1659701199,130,821
3247590827,3934890046,1646844625,1646845283,658,84
3421078448,3297290662,1662117284,1662117808,524,240
3174722772,3882903150,1663601325,1663601706,381,1796
3351145248,3529056509,1654558648,1654558713,65,1106
3636132038,3488151008,1665290871,1665291330,459,521
3413984037,3523546928,1651992111,1651992864,753,1147
3549549632,3603965318,1665341221,1665342077,856,2156
3123522446,3284943687,1660816558,1660817136,578,573
3726892870,3894690935,1645107164,1645107706,542,599
3132210207,3462483679,1652448268,1652448815,547,769
3329887381,3331554085,1650294346,1650295282,936,1107
3162947685,3835049098,1666632843,1666633642,799,1594
3479778946,3793298032,1660385068,1660385346,278,1858
3193403424,3468654589,1650178708,1650179025,317,721
3990949387,3315951327,1664987505,1664987794,289,873
3030641135,3770388331,1652628580,1652629310,730,2360
3378791519,3295850908,1667134582,1667135484,902,325
3052279761,3867603056,1652431188,1652431633,445,735
3049447132,3938025728,1666966896,1666967687,791,199
3621462507,3295850908,1665269067,1665269398,331,2478
3294319716,3010819705,1649461307,1649461651,344,559
3784105182,3566693010,1643136204,1643137049,845,27
3987813210,3015814199,1641594658,1641595655,997,1513
3450535254,3399180008,1641811395,1641811829,434,1426
3309405529,3811337280,1661611414,1661611853,439,2040
3341890542,3348802129,1660718060,1660718763,703,1353
3044345094,3141689539,1653915390,1653915836,446,1331
3027129249,3188680599,1643695341,1643695947,606,1171
3515367610,3176252124,1656356026,1656356908,882,1706
3567491118,3833572466,1660922625,1660922721,96,2030
3627730665,3597459911,1667477881,1667478393,512,1863
3187982526,3673597203,1664195023,1664195291,268,2315
3106276005,3689303525,1644175847,1644175868,21,470
3705996677,3880295026,1667009149,1667009262,113,1902
3323797477,3610101662,1652519508,1652519805,297,2418
3724861653,3456799118,1646468591,1646468622,31,2304
3469783180,3110482626,1648193026,1648193958,932,314
3513925385,3473728186,1650097825,1650098079,254,622
3912803496,3130166522,1659484788,1659485536,748,1367
3314823389,3680429293,1667724433,1667724856,423,2137
3537443088,3227462918,1645902370,1645902894,524,582
3321819030,3443773400,1660789396,1660789876,480,1308
3072985971,3934773931,1655539012,1655539137,125,433
3827431944,3665086817,1644819758,1644820617,859,425
3458645622,3359189419,1643804847,1643805530,683,266
3174722772,3266620552,1657207868,1657208235,367,2069
3686247296,3959497834,1661721338,1661721960,622,2074
3572164547,3556577780,1648091236,1648091807,571,305
3487166896,3542129823,1663112970,1663113764,794,1206
3741344192,3409662195,1653214159,1653215089,930,1990
3534450842,3750083020,1661431172,1661432071,899,1835
3605316405,3556197400,1648791609,1648792091,482,2425
3759737476,3144551332,1647478906,1647479726,820,1881
3942965206,3596179079,1643023383,1643023400,17,757
3371970996,3486802233,1641565857,1641566027,170,1283
3510805998,3722199706,1648480716,1648481069,353,2056
3634936481,3994007098,1656455926,1656456693,767,2187
3753659944,3787071341,1654979841,1654979889,48,1278
3085936525,3042739113,1647142427,1647142941,514,2439
3066093153,3833722302,1649436906,1649437298,392,2447
3736260750,3925365269,1660586656,1660587326,670,1106
3014462663,3837062335,1644394330,1644395064,734,594
3747889498,3703548595,1662515783,1662516462,679,2074
3110733657,3029468613,1667433305,1667433460,155,344
3579404607,3399631396,1645448191,1645448800,609,143
3619399873,3060728062,1663390154,1663390968,814,1898
3007328261,3292797747,1657069673,1657070611,938,2026
3249252169,3023259214,1654090870,1654091171,301,1693
3215423327,3439364410,1666738937,1666739784,847,2289
3844006658,3590627159,1646888592,1646889028,436,355
3256859026,3765962960,1663949469,1663950097,628,404
3803959008,3973226891,1669574216,1669574984,768,1747
3093589416,3142230569,1642275431,1642275479,48,2316
3234030791,3091418450,1655919724,1655919969,245,1954
3220432369,3056501932,1660276174,1660276203,29,1706
3021338974,3970286228,1653093378,1653094331,953,2014
3836597583,3630744377,1644772654,1644773164,510,190
3809010705,3492034029,1659193533,1659193720,187,250
3217060058,3059602794,1663926306,1663926671,365,2402
3622259711,3261003235,1648323770,1648324551,781,1282
3055545326,3505100409,1649150535,1649151115,580,1254
3181047536,3415185806,1646176876,1646177494,618,2107
3232333937,3370779634,1648188319,1648188847,528,2424
3740404190,3899585675,1666950405,1666950641,236,394
3608485872,3456546904,1655083719,1655083942,223,456
3208757755,3518932161,1665007156,1665007686,530,1089
3356545594,3463121212,1659933820,1659933864,44,1036
3386490201,3156962564,1665770813,1665771435,622,120
3022594569,3828531030,1643242692,1643242851,159,1266
3517556603,3537214664,1658645199,1658645494,295,1068
3934489625,3035476619,1653912090,1653912166,76,108
3564839908,3744347272,1668506996,1668507537,541,1462
3302455172,3766186320,1654611050,1654611141,91,546
3801358344,3025611145,1654664314,1654664412,98,1632
3880580622,3612642897,1660568448,1660568639,191,1240
3906244265,3594707374,1645447375,1645448253,878,340
3716415183,3686530724,1647472147,1647473114,967,791
3452683650,3970654045,1647378905,1647379302,397,1330
3916261675,3105449263,1650660873,1650661100,227,1521
3940948395,3594682644,1655508223,1655508881,658,305
3014552263,3479322514,1646078299,1646078869,570,2170
3697692313,3791107997,1646704993,1646705437,444,692
3883976824,3246796194,1647210327,1647211039,712,912
3824860461,3162844882,1668703434,1668704345,911,221
3947174877,3975663862,1649335462,1649336450,988,1595
3563246157,3878512967,1646782486,1646783061,575,247
3583029647,3151386327,1667967474,1667967778,304,275
3564089463,3074385503,1655066833,1655066920,87,466
3351802314,3101363863,1664910633,1664911211,578,854
3234656999,3091817310,1666410916,1666411369,453,462
3625869317,3099785418,1668981829,1668982815,986,1289
3895422097,3384536407,1642136029,1642136479,450,373
3549122378,3820225206,1652819903,1652820897,994,127
3481672220,3277926691,1669021926,1669022349,423,46
3457468984,3900309643,1653417406,1653418207,801,1603
3183079019,3630982131,1660038024,1660038345,321,1956
3643637605,3357699960,1668709279,1668710005,726,2086
3375359100,3384536407,1643277716,1643277945,229,1000
3291324812,3451299629,1663010576,1663010606,30,1511
3870485916,3779192515,1643543835,1643543948,113,171
3556033785,3099818927,1650900553,1650900607,54,507
3444809495,3474315750,1659455065,1659455443,378,519
3185512282,3267089074,1645560979,1645561826,847,322
3306910493,3023421632,1649891910,1649892808,898,1390
3173642675,3509864353,1664499793,1664500499,706,1595
3310520005,3697692313,1642457184,1642458111,927,478
3099934862,3589972665,1653119581,1653120227,646,1564
3973666003,3900535275,1660124088,1660124454,366,121
3252535116,3174639274,1644200851,1644200871,20,424
3347679085,3778587500,1643763067,1643763186,119,409
3240369434,3714575918,1641966711,1641967074,363,1102
3935656272,3914166761,1642565165,1642565291,126,970
3808191596,3319583055,1646306436,1646306778,342,386
3591088164,3043753185,1652474466,1652475253,787,1546
3285243887,3054171550,1658085400,1658086037,637,2497
3508202949,3021006721,1660816934,1660817598,664,872
3162844882,3041155430,1663147578,1663148111,533,141
3237563954,3314528450,1667591135,1667591579,444,1613
3130166522,3482576542,1653916214,1653917155,941,2373
3542824458,3310496626,1667177395,1667177892,497,661
3034216304,3770393539,1644767618,1644767701,83,367
3114348300,3222870125,1645978711,1645979240,529,962
3861160074,3449395269,1657170462,1657171072,610,2342
3247980767,3157546931,1650282695,1650283376,681,64
3887108152,3297477157,1668620402,1668620483,81,1786
3547429967,3620817271,1666492333,1666493181,848,1882
3462033895,3994168332,1643976633,1643977113,480,467
3364409507,3124574350,1665638359,1665638736,377,1113
3164702890,3147896698,1662394171,1662394346,175,2338
3187779586,3039962870,1651300283,1651300841,558,2050
3070395663,3157308488,1641221286,1641222282,996,1939
3583985803,3827195774,1649502216,1649502681,465,617
3109941959,3714122939,1668575989,1668576577,588,1283
3892336923,3550516008,1668406662,1668407199,537,148
3358968371,3039035602,1661854650,1661855031,381,1151
3361223822,3327857419,1668460444,1668460560,116,1930
3297314002,3298993308,1649272618,1649272930,312,2189
3882603510,3119802700,1662768780,1662768823,43,130
3722114463,3894690935,1656513812,1656514725,913,1816
3135579253,3966056341,1668590775,1668590986,211,2149
3039035602,3835842311,1648213567,1648213712,145,2215
3777835723,3645537857,1660685578,1660686314,736,1653
3436582780,3330048607,1651582119,1651582671,552,625
3201142543,3915963591,1654369233,1654369677,444,683
3976147939,3231537700,1644960729,1644961138,409,1971
3153552268,3907713562,1665037962,1665038669,707,624
3641618845,3818713435,1664590216,1664590225,9,929
3232469999,3441206388,1644079256,1644079913,657,2409
3765962960,3194342775,1664406185,1664406707,522,907
3822307865,3368884196,1642535665,1642535925,260,418
3898494020,3639659256,1661932587,1661932799,212,1682
3117262222,3005773066,1648190031,1648190946,915,1169
3886736668,3268349855,1643696044,1643696163,119,120
3645341350,3404563689,1656106007,1656106330,323,1373
3545658442,3796275634,1664199538,1664200263,725,1708
3243502165,3336494171,1651792503,1651792571,68,313
3367768003,3785721693,1657515262,1657515825,563,832
3325575004,3035402024,1652769120,1652769237,117,2097
3161805415,3674037967,1653315627,1653316156,529,1216
3538039823,3437705581,1667773671,1667774596,925,2401
3224364206,3308015697,1656925439,1656925786,347,1707
3833553454,3300994471,1665744458,1665745355,897,2434
3128529900,3098422570,1647035427,1647035456,29,1481
3097145374,3090090794,1643506191,1643506539,348,1343
3133647753,3636948225,1664780576,1664780579,3,1516
3264148498,3838774657,1650282538,1650283131,593,645
3189673990,3494009953,1666837336,1666837690,354,1177
3410972917,3732256987,1669707506,1669708164,658,1516
3347397074,3459115924,1667982098,1667982568,470,1952
3316237227,3935057012,1658214074,1658214976,902,2246
3850089310,3799624292,1641506894,1641507383,489,862
3861173090,3926699428,1655126256,1655126990,734,1535
3469471892,3692498377,1656072763,1656073437,674,2378
3688910009,3155807587,1667414925,1667415173,248,2235
3784828021,3468516508,1661061848,1661062680,832,2026
3539797487,3015956370,1669215307,1669216143,836,2256
3884346810,3667414511,1641504342,1641505288,946,619
3611100286,3185985712,1659399557,1659400509,952,2129
3533740602,3663554395,1647689993,1647690502,509,1110
3843953645,3314932010,1662470124,1662470421,297,3
3623115966,3161805415,1664424337,1664425147,810,569
3990144819,3387774254,1663392759,1663393560,801,1154
3259344210,3356689959,1663220839,1663221663,824,33
3790751649,3719929552,1666082513,1666082751,238,2130
3540550798,3585919417,1667808759,1667809733,974,855
3098891437,3329751201,1654942943,1654943112,169,1411
3671054235,3829377486,1645404388,1645404968,580,1914
3699625300,3365676412,1651161128,1651161440,312,625
3957430800,3501520918,1664217744,1664218567,823,495
3747929255,3015156809,1665456238,1665456275,37,1064
3489909547,3923647484,1642317393,1642318262,869,872
3957586219,3205423909,1652771620,1652772304,684,2099
3734381035,3341300979,1656347620,1656348009,389,358
3472052544,3295262122,1660433817,1660434678,861,1590
3845743542,3379296882,1666220767,1666221594,827,1201
3909558934,3514498367,1650010059,1650010423,364,1326
3485298583,3072741474,1668891809,1668892025,216,490
3888015355,3801768919,1657802743,1657803056,313,1520
3910502945,3635324805,1646581879,1646582547,668,1340
3097789994,3407331091,1656368910,1656369138,228,508
3893227652,3686530724,1661640570,1661641446,876,1978
3445095607,3663884600,1657362769,1657363411,642,1117
3637980358,3081213963,1641444862,1641445631,769,880
3755413351,3409034003,1649508910,1649509023,113,383
3960727376,3934433729,1652265884,1652266314,430,998
3849379963,3835864517,1655286118,1655286685,567,1901
3143689256,3771504908,1666559698,1666560010,312,965
3423306122,3264993323,1646410348,1646410885,537,2472
3141503682,3822404633,1663871189,1663871996,807,1804
3734331528,3796587240,1648818571,1648819463,892,127
3154653229,3682116874,1652585400,1652585825,425,850
3680100111,3985620157,1647323234,1647324186,952,989
3948862720,3095170532,1661311649,1661311990,341,1736
3617795950,3586025172,1650043058,1650043803,745,190
3647398701,3717899735,1647962542,1647962677,135,654
3845363108,3480115115,1653820076,1653820980,904,38
3955055535,3261376049,1643134481,1643134537,56,1538
3222082052,3772980352,1666583517,1666583617,100,1532
3795494127,3021515419,1649875887,1649876491,604,1458
3196975901,3417298701,1654084703,1654085669,966,1750
3153446106,3283171763,1648773985,1648774245,260,1885
3041897048,3599604382,1651429477,1651429676,199,607
3952185527,3498740809,1659841232,1659841399,167,1875
3084969131,3928572443,1667424603,1667424617,14,1573
3646596750,3287988080,1651308976,1651309887,911,411
3637518238,3641983006,1660382686,1660382950,264,347
3866158221,3084430345,1658637372,1658637603,231,845
3023259214,3245354614,1646735742,1646736534,792,1498
3173909495,3021515419,1663072046,1663072170,124,1492
3739439527,3342538148,1643888418,1643888709,291,2139
3125019722,3993122275,1649179458,1649179751,293,887
3462862340,3979845809,1666841633,1666841692,59,1684
3629984199,3077145114,1667183975,1667184474,499,119
3961183307,3507431231,1649647820,1649648792,972,562
3115245083,3413948595,1643203751,1643204296,545,1265
3107530825,3922766043,1655782258,1655782944,686,1661
3976730264,3272879760,1660896548,1660897065,517,142
3723438987,3139376524,1655092376,1655093346,970,1883
3615359439,3160061122,1658957494,1658958247,753,623
3985901910,3493393225,1662974285,1662974543,258,1128
3972955608,3702439685,1652385823,1652386664,841,420
3642771281,3277926691,1651313986,1651314038,52,427
3392293203,3490155787,1646688081,1646688510,429,1143
3408903285,3231701470,1646606273,1646607157,884,970
3650205106,3340511048,1663658019,1663658720,701,2231
3502599631,3267045921,1653545687,1653546254,567,2112
3224952698,3267089074,1642001075,1642001520,445,1766
3690633750,3439462043,1656229379,1656229476,97,435
3825462888,3124562368,1659774498,1659775302,804,849
3371138351,3370834194,1653421882,1653422811,929,641
3181086026,3134166826,1656070804,1656071597,793,1187
3458645622,3813403697,1646578136,1646578409,273,2060
3257375975,3953118937,1647737933,1647738717,784,355
3485995293,3450228800,1668833804,1668834548,744,1088
3229321048,3896910823,1648056428,1648057147,719,1325
3758695244,3258926142,1642775993,1642776477,484,1828
3690539115,3684537058,1645276148,1645276197,49,980
3352316809,3569738818,1650234299,1650234612,313,646
3692095366,3028267408,1644129770,1644130479,709,378
3646797040,3802040767,1650469657,1650469995,338,2370
3096386556,3840502377,1645253904,1645254601,697,483
3333223237,3351182329,1665368595,1665368787,192,2281
3843157491,3141480547,1646073191,1646074077,886,698
3475352970,3126940487,1651424448,1651425198,750,1471
3592043925,3760365434,1668410826,1668411741,915,1431
3441206388,3976267689,1667430557,1667431422,865,1099
3038849431,3510634049,1661105053,1661105139,86,779
3773196864,3098820434,1646592480,1646592496,16,989
3852704822,3197739962,1657776982,1657777616,634,1021
3002396640,3014798893,1644931124,1644931693,569,2181
3222749852,3306515955,1646279625,1646279892,267,710
3997810649,3133030435,1647311290,1647311883,593,1633
3075088680,3832773624,1659106666,1659107261,595,1756
3169486525,3275827194,1642122238,1642123035,797,1202
3899618702,3994927164,1650781378,1650782338,960,1573
3456285013,3476971345,1648104863,1648105116,253,920
3950433378,3318594125,1646014444,1646014817,373,792
3753863307,3364586923,1664498524,1664499099,575,475
3433374325,3392569339,1663399169,1663399237,68,1825
3083791573,3796504737,1659820299,1659820741,442,715
3138755786,3574834673,1652364726,1652364966,240,662
3429887771,3639515059,1659762695,1659763370,675,211
3393724727,3386490201,1662360337,1662360769,432,1395
3653218860,3227584428,1651024459,1651025163,704,523
3623092479,3838136289,1663653789,1663653818,29,2237
3066854514,3156210736,1661118785,1661119636,851,1458
3678149544,3759421049,1663363196,1663363929,733,2450
3138755786,3343752753,1651821801,1651822312,511,91
3700813458,3075519908,1666459971,1666460178,207,67
3346530861,3112298724,1652345458,1652346426,968,2454
3449504551,3067403592,1644479509,1644479708,199,76
3084385255,3123532931,1643703346,1643703835,489,1844
3073798415,3526815452,1659298701,1659299387,686,2151
3515044837,3359078190,1652942642,1652943186,544,2407
3112960048,3303358502,1651523853,1651524754,901,2102
3799459873,3824478322,1658074245,1658075139,894,735
3894431064,3133319209,1662072512,1662073328,816,2216
3170036337,3189435516,1650715496,1650715777,281,741
3260174905,3364600825,1656593217,1656593373,156,983
3387568587,3282168599,1664802431,1664802488,57,906
3906026429,3564592902,1652704718,1652705279,561,2119
3195813968,3100535469,1643059144,1643060000,856,2049
3875908590,3896867161,1657837993,1657838308,315,2458
3136174856,3439462043,1642520696,1642521516,820,1190
3025133604,3520872962,1666972135,1666972686,551,398
3526491245,3222254600,1641355503,1641355664,161,2004
3428325312,3406332128,1643824069,1643824610,541,2053
3307393195,3447946570,1668806314,1668807271,957,1150
3095503795,3048504189,1668117571,1668118253,682,712
3258417294,3470586731,1661583991,1661584572,581,1408
3529764378,3849977339,1666414272,1666415259,987,756
3425490548,3130181848,1661088746,1661088966,220,947
3757719267,3885084129,1644432851,1644433132,281,596
3289330422,3581470040,1647929426,1647930376,950,582
3759608318,3811235183,1651519849,1651520758,909,479
3447051833,3411272565,1654590066,1654590585,519,1450
3545188902,3490044613,1644658153,1644658492,339,59
3838082378,3734754514,1657978724,1657979380,656,1979
3198527442,3052861028,1666667170,1666668148,978,1434
3630330540,3099102864,1662130974,1662131387,413,2259
3127783768,3625651694,1662428406,1662428609,203,59
3969103555,3973948700,1641722330,1641722360,30,1299
3312336013,3673950693,1658237819,1658238304,485,515
3365134626,3023530031,1641710761,1641710990,229,1411
3602497998,3181074947,1647814884,1647815125,241,2054
3970970054,3292111100,1655956388,1655957101,713,993
3123441689,3541423460,1645296899,1645297862,963,750
3104472516,3351441481,1664316186,1664316423,237,1127
3462825977,3739233756,1642032308,1642033045,737,635
3625611440,3206512870,1662358489,1662359447,958,2393
3000780515,3581011004,1664396420,1664396898,478,2451
3377847710,3636948225,1662850076,1662850571,495,1614
3146555014,3627886263,1665212008,1665212594,586,1500
3514335388,3854859043,1655519987,1655520917,930,1765
3698633384,3118502732,1641129991,1641130922,931,1851
3106788261,3813697780,1645239695,1645240183,488,2158
3923259150,3108805085,1659195133,1659195410,277,1924
3273379502,3120105783,1651733528,1651734034,506,341
3918383192,3921451192,1657867544,1657868183,639,1566
3135134317,3424897066,1651964873,1651964997,124,1378
3832463052,3870463011,1657259603,1657260059,456,2311
3529681535,3242897248,1656522261,1656522407,146,520
3748492935,3655923753,1656698060,1656698407,347,1306
3353257973,3985037610,1669462833,1669463286,453,493
3966881800,3363802434,1665936592,1665936686,94,1193
3937445570,3375879417,1655348187,1655348818,631,1111
3332797032,3388971461,1650350918,1650351361,443,387
3260174905,3307306078,1644769302,1644769697,395,2357
3979552361,3988466264,1651313870,1651314112,242,2024
3060883368,3115494713,1667586459,1667586994,535,391
3945199219,3730428171,1643810700,1643811368,668,1743
3409055122,3470049551,1665645784,1665646297,513,1027
3753483202,3419117613,1647482575,1647483439,864,511
3628830127,3740438273,1661806675,1661807054,379,2232
3221885729,3156261740,1666716956,1666717178,222,535
3183740417,3823637809,1659574697,1659575225,528,549
3430165544,3567520646,1653542642,1653543078,436,2485
3186371475,3163326257,1664563153,1664563584,431,306
3085311533,3389443435,1644874799,1644875160,361,2464
3569244680,3085429140,1666141981,1666142659,678,151
3670075164,3481030779,1656402088,1656402420,332,2397
3840533238,3098342545,1662334337,1662334872,535,1984
3784948704,3024551635,1650951459,1650951693,234,34
3889544424,3540799427,1663860879,1663861698,819,2111
3910837040,3332056702,1647526002,1647526460,458,1884
3880837935,3716257088,1664501204,1664501950,746,183
3063955055,3937728696,1649439630,1649440072,442,247
3541423460,3672276184,1665877548,1665877560,12,193
3547072063,3029403229,1663766533,1663766801,268,1090
3336211604,3226298244,1667969979,1667970760,781,1853
3696448766,3321818923,1665455485,1665455543,58,2167
3223518905,3747621620,1653122834,1653123230,396,841
3463875425,3709736172,1652749003,1652749869,866,1662
3570872297,3935936621,1658729666,1658730337,671,1242
3446914685,3067403592,1655209355,1655209379,24,699
3898495918,3730428171,1645312875,1645313816,941,1933
3848995096,3273219526,1647164354,1647164404,50,804
3806466784,3323797477,1644961438,1644962415,977,1482
3763300182,3391540103,1646231771,1646232163,392,1212
3076431464,3439221238,1663240398,1663241051,653,2436
3070557341,3612460883,1646196120,1646196395,275,1580
3900588986,3233920789,1646807937,1646808412,475,2372
3962031345,3193657080,1645071982,1645072091,109,2381
3285516363,3775501779,1659596692,1659597625,933,1325
3806520351,3002727939,1669409247,1669409626,379,739
3771841105,3885696227,1650995944,1650996126,182,2284
3375847073,3613700451,1654950857,1654951427,570,1518
3967015655,3143962586,1644074984,1644075262,278,111
3989550849,3148203422,1649178536,1649179507,971,131
3601240692,3479322514,1666709439,1666709808,369,462
3649649514,3136172164,1665922715,1665923158,443,1278
3176818286,3760975208,1652770387,1652770488,101,1253
3681843847,3269680998,1660093666,1660094614,948,2051
3732349114,3002013720,1658808485,1658809414,929,303
3823962241,3139268488,1664918452,1664918699,247,2026
3197661010,3841314189,1654305316,1654305658,342,1929
3269865212,3474723005,1661733421,1661733981,560,932
3880439495,3132210207,1652009725,1652010529,804,1727
3294446147,3431000503,1658438289,1658439060,771,1124
3513193858,3882619512,1664007398,1664007847,449,2201
3959783422,3259039915,1656732403,1656733281,878,8
3388814754,3982058383,1651578329,1651578789,460,1695
3486059916,3314190424,1661131129,1661132066,937,1016
3133601374,3505322684,1649046187,1649047174,987,2264
3816538905,3369175849,1665115709,1665116208,499,2063
3663554395,3415041326,1646476506,1646476647,141,887
3118518203,3587440298,1650193662,1650193952,290,467
3337673105,3715894883,1645582019,1645582233,214,2156
3325360523,3089699104,1647796714,1647797072,358,930
3567926021,3777316167,1650117593,1650117910,317,1288
3830866959,3461674303,1651625436,1651625670,234,350
3878512967,3246028948,1645140588,1645141060,472,2007
3341694529,3673561332,1661619677,1661620259,582,1003
3032431944,3463009951,1667473021,1667473580,559,1079
3798223043,3335242048,1658176757,1658177200,443,1532
3939281989,3777820691,1648084884,1648085830,946,1881
3971588399,3859221152,1655858127,1655858686,559,1216
3842413213,3105903246,1668823107,1668823924,817,952
3054171550,3568162481,1664393591,1664393669,78,2343
3564089463,3043598133,1660556037,1660556145,108,1254
3923907099,3419783275,1642555987,1642556146,159,1598
3196304056,3562021711,1667542881,1667543847,966,694
3119014132,3870349696,1650395286,1650396144,858,1485
3773658133,3515332061,1669063991,1669064590,599,840
3905744284,3726378645,1641701712,1641702101,389,1085
3977139394,3545544203,1669675203,1669675504,301,1859
3529898997,3710466773,1669343209,1669343226,17,987
3336211604,3262596597,1652391873,1652391930,57,563
3241033604,3243502165,1655087545,1655088347,802,1570
3132674107,3036527901,1658299793,1658300019,226,1460
3790549304,3082828436,1659586293,1659587272,979,1540
3199315199,3080325374,1643506327,1643506829,502,1779
3385273825,3998850502,1649868611,1649869540,929,1422
3165835560,3542078032,1641914740,1641915740,1000,2304
3647539125,3160242179,1653998448,1653998857,409,436
3766196716,3700287335,1646732543,1646732762,219,333
3206197726,3786840082,1645389770,1645390102,332,748
3388814754,3042836639,1644802497,1644802938,441,2386
3243502165,3391622565,1646439660,1646440219,559,98
3334102064,3899315309,1669577761,1669578161,400,1077
3693000511,3199472785,1667001887,1667002754,867,1871
3888015355,3057574793,1665550228,1665550672,444,2210
3141134453,3005480994,1645991496,1645992195,699,2115
3534581934,3911364139,1658234306,1658235181,875,728
3170036337,3362148197,1645098202,1645098469,267,870
3917684798,3043310672,1648226056,1648226228,172,1055
3549431178,3976858724,1654879039,1654879798,759,2139
3447051833,3492749874,1655394568,1655395016,448,378
3648447244,3494990710,1666691623,1666691678,55,422
3084066396,3733102461,1648003958,1648004432,474,232
3692441467,3779611783,1669551827,1669552709,882,1823
3700896206,3917715509,1646213031,1646213567,536,459
3410655469,3698358344,1646426333,1646427332,999,1011
3581026789,3322083266,1652938065,1652939063,998,2466
3005283650,3471288672,1646744926,1646745270,344,1903
3917984429,3978925529,1647099192,1647099953,761,547
3696716300,3657391976,1661044847,1661045522,675,2318
3132802864,3976984063,1644460163,1644460505,342,877
3159240548,3920437320,1645206587,1645207253,666,1355
3996963058,3501729913,1659772833,1659773831,998,2168
3230277243,3600692380,1644792952,1644793834,882,1011
3888851378,3078216798,1644491501,1644491798,297,81
3659563225,3806520351,1660015095,1660015805,710,214
3036470049,3476405785,1665817268,1665818122,854,1883
3932212405,3811648493,1661494314,1661495184,870,108
3319545220,3513193858,1665987328,1665988014,686,1049
3653069495,3479401102,1660441231,1660441566,335,505
3257203631,3115177011,1651398301,1651398701,400,318
3353500391,3952389962,1643486277,1643486918,641,475
3269966376,3753391012,1668899185,1668899564,379,1666
3773207612,3097563397,1663596653,1663597256,603,1384
3436768933,3622978712,1657552393,1657552934,541,2018
3447743170,3760432849,1657587692,1657588122,430,817
3734004050,3930347129,1659060779,1659060872,93,1775
3136172164,3316951862,1656049774,1656050445,671,647
3120092137,3011225738,1647058010,1647058547,537,1223
3348568561,3718905579,1661237138,1661237741,603,544
3650471605,3802325069,1643609269,1643610150,881,2479
3943947223,3433374325,1653773284,1653773993,709,2377
3021126829,3125900419,1666968791,1666969748,957,258
3419783275,3624060457,1645859071,1645859535,464,866
3612973191,3824625919,1651761431,1651762238,807,1823
3916680089,3102820806,1658888280,1658888451,171,1641
3311118815,3562463361,1659678597,1659678912,315,565
3595284541,3939480099,1666031424,1666031556,132,1504
3973948700,3748556962,1659138839,1659139448,609,361
3310953839,3383754736,1649758518,1649759506,988,942
3122246747,3973226891,1643530148,1643530667,519,1949
3325360523,3784594026,1650568961,1650569710,749,2003
3383755219,3414277030,1644886309,1644887271,962,1311
3734893217,3117575075,1641687254,1641687694,440,1685
3266620552,3321293262,1654033029,1654033287,258,1176
3962676436,3256807270,1650685353,1650685602,249,1432
3879967963,3689518345,1656884492,1656884724,232,1701
3434729931,3212095735,1662681340,1662681505,165,2359
3800566657,3314823389,1646653428,1646653429,1,402
3509047408,3339649448,1643723587,1643724399,812,130
3126499590,3282950540,1669493996,1669494762,766,1333
3805928545,3551884757,1668177223,1668178040,817,1211
3601519220,3046351455,1643252318,1643252910,592,2163
3687239883,3778228977,1656821767,1656822140,373,603
3637408266,3569390971,1669578432,1669578834,402,488
3206197726,3449114289,1659953909,1659954725,816,882
3867603056,3217173480,1661914125,1661914377,252,606
3821768923,3792117640,1658204964,1658205034,70,1905
3714105777,3749161560,1651443397,1651443431,34,755
3267089074,3383751042,1650474277,1650475056,779,2463
3877902487,3207875764,1659300966,1659301683,717,1542
3699152541,3944398168,1652616494,1652616856,362,2082
3843331100,3036194601,1657473227,1657473577,350,1093
3147376468,3225068874,1644812574,1644812778,204,166
3494544431,3328245802,1662742396,1662742504,108,223
3164391025,3506090868,1661817385,1661818290,905,339
3941266037,3751418832,1658769227,1658769910,683,13
3256615260,3216092524,1645145500,1645145653,153,1664
3011981503,3476826459,1648492181,1648493086,905,1481
3640957872,3397397223,1654489402,1654489492,90,2020
3027129249,3739338939,1644842203,1644843001,798,159
3000986440,3934890046,1663699077,1663699092,15,1752
3585100772,3800239896,1643144836,1643145316,480,713
3434729931,3249642950,1654984353,1654984767,414,1254
3280657282,3933742178,1666549329,1666549763,434,2382
3770061469,3820070209,1659653560,1659653953,393,1100
3611777140,3103004217,1658247766,1658247812,46,2473
3191462400,3523631626,1644986306,1644986550,244,1141
3229979386,3361694981,1656007294,1656008185,891,1541
3798512184,3984215552,1653791318,1653791968,650,466
3863948017,3398116898,1669421211,1669421346,135,2056
3515170949,3857687791,1646627972,1646627972,0,2344
3251372174,3375927053,1649519476,1649519956,480,204
3335462055,3956055955,1648643726,1648644632,906,930
3857434991,3414581321,1647285459,1647285902,443,2372
3331977197,3043354217,1654787536,1654788242,706,2406
3543150979,3795299092,1645407634,1645408348,714,2407
3856160688,3520106918,1653699716,1653700430,714,37
3364059276,3115367011,1658519639,1658520599,960,2418
3100670764,3398785571,1669153841,1669153880,39,2136
3031299470,3786811867,1655908128,1655908878,750,19
3764078507,3680810431,1665290496,1665290990,494,1913
3003087336,3108230028,1661185340,1661185385,45,312
3838851134,3807538433,1658840063,1658840093,30,782
3780368492,3883812439,1667492888,1667493780,892,807
3182502852,3153413554,1657590325,1657590885,560,2110
3003330774,3368860003,1652338348,1652338790,442,1135
3914166761,3474572698,1664428195,1664428985,790,1247
3569563212,3902705203,1649510073,1649510453,380,1458
3930662723,3869618249,1641633633,1641634382,749,1076
3825930964,3201276259,1663720674,1663721488,814,1367
3007339106,3802267458,1659585137,1659585751,614,1937
3879157400,3863697907,1641658380,1641658415,35,2450
3562456307,3152555864,1643993123,1643993533,410,1395
3621969167,3807323401,1658787215,1658787288,73,2213
3858150562,3661507330,1656585766,1656586575,809,496
3184344401,3559615011,1669558364,1669559033,669,1007
3280491285,3066451739,1656469644,1656470339,695,2273
3250627439,3522444883,1643330975,1643331753,778,1141
3100239217,3635921511,1665769157,1665769447,290,321
3292111100,3093254727,1669291498,1669292302,804,1893
3565001530,3844964880,1652474143,1652474382,239,2041
3241847877,3173788210,1650739351,1650740272,921,614
3430464852,3240435560,1669443284,1669443294,10,481
3721340009,3899782287,1665976658,1665977478,820,34
3638281686,3736118442,1659180231,1659180370,139,198
3536633962,3447743170,1647681535,1647681746,211,1662
3962062858,3534224607,1641423063,1641423347,284,1356
3665086817,3168600862,1643822759,1643823639,880,982
3557087358,3194664110,1656841046,1656841631,585,333
3035464149,3657464089,1664407146,1664407444,298,1180
3719455699,3815605229,1655133202,1655133873,671,469
3181388502,3610930903,1660058415,1660059410,995,183
3316485303,3909173527,1667656076,1667656248,172,677
3599795440,3389097842,1648799125,1648799639,514,1254
3997050001,3636879699,1662063621,1662064431,810,489
3906026429,3796784054,1657925846,1657926790,944,1772
3828713812,3432899117,1643693692,1643694396,704,235
3623876940,3379829698,1662220009,1662220326,317,1132
3524942512,3035976552,1668262979,1668263572,593,1225
3540799664,3084060274,1643940585,1643941385,800,346
3410737355,3512353520,1658607118,1658607272,154,2117
3361482296,3391658891,1658182753,1658183294,541,1999
3029460549,3206512870,1660362800,1660363387,587,1686
3598572594,3471587065,1646384975,1646385931,956,797
3128287586,3025133604,1660889823,1660890084,261,116
3649036884,3191398794,1665055849,1665056389,540,1627
3361167735,3388844626,1656640144,1656640310,166,1984
3118419220,3815692931,1651728689,1651729151,462,1492
3722859316,3180728306,1660423543,1660423593,50,1177
3748061416,3143293050,1663749513,1663750267,754,1196
3526365568,3732256987,1650041283,1650041855,572,1274
3300694030,3955055535,1661925005,1661925733,728,637
3172773924,3231517158,1644729498,1644729914,416,1231
3647479988,3995299995,1656718769,1656718798,29,2255
3973010524,3025310934,1644095517,1644096470,953,2160
3936135558,3928951547,1654868660,1654869515,855,1461
3438247915,3869794122,1662503629,1662504583,954,2380
3457417743,3734035973,1658475282,1658475346,64,566
3277550058,3855218155,1665641380,1665642324,944,1701
3233932115,3041652512,1651274307,1651274522,215,1633
3323783108,3928685907,1642587844,1642588229,385,167
3060893703,3710318693,1661822996,1661823210,214,1582
3847957207,3446156273,1647555191,1647555607,416,1374
3021320868,3701979416,1645027561,1645027677,116,1025
3127549843,3097426944,1642587979,1642588090,111,1669
3861160074,3292298549,1654454479,1654455273,794,207
3023025075,3994130271,1654857890,1654858107,217,270
3945266221,3710844932,1650611836,1650612729,893,1561
3992226673,3705601482,1662002432,1662002730,298,995
3838250910,3096386556,1648186256,1648186413,157,2294
3459090367,3780652187,1656555895,1656556425,530,1031
3264460374,3549475344,1655516145,1655516600,455,1857
3105607346,3651058536,1658206272,1658206706,434,1025
3938097708,3251106195,1649031328,1649031775,447,1315
3786478382,3947083981,1643654144,1643654566,422,837
3586778995,3133788020,1645368321,1645368965,644,1964
3287714636,3802816973,1652536110,1652536859,749,996
3413056504,3038630181,1655045424,1655045670,246,226
3307393195,3776419392,1668402329,1668403226,897,404
3532355049,3556425071,1666499143,1666499903,760,1458
3630982131,3890054358,1641792597,1641793435,838,561
3673950693,3468455079,1647903238,1647903497,259,1282
3379935974,3811648493,1641866280,1641867012,732,1777
3132376039,3797778150,1647970986,1647971336,350,2224
3879299283,3310294122,1658573402,1658573602,200,2498
3965000413,3090304189,1643792133,1643792522,389,1539
3418635865,3461938856,1656943217,1656944127,910,1917
3612269633,3348568561,1668350774,1668351290,516,1841
3183299670,3868873330,1664784752,1664785194,442,728
3623294630,3604514331,1660294166,1660294544,378,1625
3543872563,3693920541,1659305767,1659306426,659,828
3814588354,3490044613,1644958895,1644959352,457,2011
3235245267,3943413233,1666414637,1666415243,606,774
3689518345,3842413213,1662832988,1662833229,241,2100
3683793217,3252070101,1668730734,1668731563,829,1169
3486286893,3537592483,1658289891,1658290876,985,1588
3423909447,3136810446,1669293443,1669294442,999,2067
3670835955,3211047702,1665113467,1665113479,12,1801
3605316405,3934953223,1659851530,1659851968,438,1126
3037741311,3999390272,1668908510,1668909414,904,2353
3768099353,3881554146,1642730217,1642730236,19,311
3021289375,3112217806,1641561971,1641562108,137,1982
3955055535,3198022110,1651631013,1651631607,594,1752
3386724007,3721060604,1650738299,1650738387,88,1833
3624683080,3805060036,1657180374,1657180781,407,349
3646908383,3951592432,1649679316,1649679344,28,455
3913905115,3532307372,1656204287,1656205182,895,331
3809010705,3681399132,1649663958,1649664219,261,2105
3347990376,3140407144,1650038681,1650038741,60,1407
3224130773,3328589697,1646608777,1646609621,844,952
3870320323,3977139394,1662271235,1662271686,451,2299
3878943307,3819235768,1667641406,1667642393,987,2007
3936042616,3990849115,1662239010,1662239227,217,400
3125717667,3183640403,1658392927,1658393598,671,2457
3567637602,3827937024,1662949118,1662949818,700,712
3987860424,3330058679,1667611439,1667611745,306,885
3175676853,3617715231,1664345353,1664346316,963,1083
3473102313,3857211245,1667984660,1667984894,234,1894
3785728567,3349724698,1655856165,1655856947,782,1162
3998221237,3829347049,1644125330,1644125887,557,831
3865387894,3657597585,1654508206,1654508756,550,116
3527291464,3117141664,1648647269,1648647406,137,2354
3340427847,3844006658,1665119512,1665119604,92,2331
3674335911,3199375921,1655493261,1655494183,922,1385
3762829533,3577651077,1652938941,1652939606,665,2334
3922927380,3068161140,1649420425,1649420574,149,477
3079530021,3846477373,1645127271,1645127301,30,573
3442354739,3045570288,1642547073,1642547183,110,281
3003872692,3730845439,1649031576,1649031820,244,188
3492103801,3166521010,1641935645,1641936642,997,465
3158338043,3562859716,1645192163,1645193044,881,222
3526439962,3008470758,1654309373,1654309553,180,772
3620223775,3796255141,1663099507,1663100468,961,1744
3968297784,3868902207,1653226696,1653227647,951,156
3503510962,3448459810,1669032223,1669032257,34,1816
3269573550,3950982431,1661214763,1661215360,597,390
3800014504,3918234060,1647270347,1647270690,343,1089
3118425000,3194618871,1661413486,1661414379,893,2162
3794926978,3919478201,1647325700,1647326443,743,2379
3889967886,3354200745,1650733468,1650734452,984,1668
3638847705,3560132016,1646779778,1646780325,547,1083
3740438273,3707892765,1655830934,1655831513,579,1524
3202625372,3147298514,1659176659,1659177203,544,2179
3814045699,3990849115,1650238623,1650239081,458,1477
3065298582,3522963106,1660501964,1660502314,350,671
3963546042,3518620219,1658334535,1658334725,190,117
3745737102,3377911201,1645325679,1645325756,77,2447
3139376524,3382983805,1645722739,1645723631,892,1424
3672276184,3745419810,1666952131,1666952163,32,1941
3694006679,3332144974,1668782892,1668783281,389,2320
3184720975,3787048351,1665108840,1665109097,257,1659
3178742688,3865463499,1662961541,1662961895,354,1110
3269726483,3117749198,1647987574,1647988098,524,1942
3100440036,3250786481,1660502373,1660503291,918,1539
3778228977,3641752896,1646919068,1646920024,956,246
3149181988,3442354739,1655552044,1655552797,753,1253
3020108220,3717781013,1669372979,1669373591,612,744
3334207071,3622259711,1649670352,1649671269,917,588
3600501749,3273857586,1666312547,1666312888,341,1729
3320272612,3004951157,1642081558,1642081861,303,479
3169601604,3318654389,1663103921,1663104088,167,1225
3019572992,3911632634,1648630513,1648630618,105,203
3848860153,3565278029,1652334612,1652335044,432,871
3863652254,3380930960,1658253104,1658253990,886,1243
3154288650,3255248380,1664988774,1664989758,984,2424
3347462301,3827867076,1659111624,1659111884,260,2284
3383791217,3968682824,1660327209,1660328083,874,461
3985037610,3477522732,1663017720,1663018130,410,2032
3981348782,3862829462,1642483595,1642484292,697,1466
3131156982,3631152825,1667573450,1667573702,252,817
3744955044,3269502320,1667794129,1667794574,445,1081
3856138813,3664273227,1669742276,1669742361,85,327
3458478056,3241847877,1642189385,1642189522,137,1073
3217137285,3276840933,1663041006,1663041383,377,970
3095124554,3029016525,1665940872,1665940892,20,581
3192142540,3809965750,1652140166,1652140783,617,345
3545730764,3512575951,1650127383,1650128221,838,2015
3001803326,3349879521,1655687014,1655687640,626,449
3056053831,3681795615,1648604045,1648604633,588,1756
3621966073,3839688715,1642771076,1642771084,8,1372
3052233179,3778894897,1658528513,1658528980,467,1849
3082255761,3156942626,1660695043,1660695946,903,768
3581302872,3907705988,1647544266,1647545046,780,783
3220405755,3234620335,1652534930,1652535749,819,952
3405955824,3231988469,1658253486,1658253553,67,734
3710782213,3213397142,1662025242,1662025556,314,794
3618380884,3945370501,1664124576,1664124645,69,201
3163986082,3325360523,1667496958,1667497082,124,229
3729787496,3545730764,1660477621,1660477926,305,1810
3802890793,3280657282,1657346105,1657347035,930,947
3806936803,3788819111,1669630008,1669630543,535,215
3034256232,3060522981,1660397550,1660397613,63,913
3798728420,3736260750,1659863012,1659863051,39,2151
3024651290,3313192018,1661655791,1661656354,563,173
3700167321,3129500635,1647873459,1647874279,820,1832
3259260257,3332506866,1653862104,1653862378,274,1588
3257732454,3072317138,1654388238,1654389152,914,484
3072080605,3549105154,1648321520,1648322239,719,2057
3809059026,3219656369,1643027708,1643027810,102,805
3768482482,3309767670,1657953884,1657954243,359,975
3181778467,3549038219,1661560110,1661560848,738,1182
3991390314,3386724007,1665770737,1665771265,528,116
3241584825,3623736661,1658804688,1658804836,148,1350
3099013723,3037984793,1657532078,1657532500,422,1184
3098891437,3739731580,1655108704,1655109674,970,1691
3761142574,3319334426,1659626281,1659626370,89,1240
3929312426,3687243333,1658707172,1658707944,772,123
3712443558,3789380087,1655044207,1655044827,620,672
3427860415,3874569616,1645339906,1645340005,99,726
3564883937,3328471090,1642693605,1642694107,502,1826
3269865212,3781368357,1657874566,1657875027,461,890
3556648442,3364409507,1653434701,1653434985,284,1398
3695419353,3117230173,1648752468,1648752882,414,781
3887519119,3033373685,1646695348,1646695972,624,964
3645537857,3309799085,1643379852,1643380666,814,1810
3395457102,3629090721,1654528198,1654528535,337,87
3053991932,3964830238,1648456297,1648457245,948,37
3347152834,3680677416,1663909932,1663910442,510,73
3691830908,3836565798,1642262198,1642262638,440,1348
3080200257,3582168015,1650631996,1650632645,649,768
3099785790,3930474522,1668242577,1668242603,26,111
3185985712,3257375975,1668207869,1668208022,153,124
3289684726,3208770010,1667540570,1667540842,272,93
3433937560,3311252249,1646712007,1646712028,21,1226
3329825235,3662289637,1663480617,1663481260,643,1799
3771623134,3005356433,1669216395,1669217006,611,1991
3993513856,3407156969,1663437273,1663437400,127,1289
3446490643,3905067771,1648014457,1648014994,537,1335
3500455630,3888834059,1662517849,1662518830,981,583
3037090215,3375879417,1645760828,1645761444,616,2234
3737153063,3282587673,1654183699,1654183878,179,1270
3366192341,3910502945,1646281519,1646281668,149,1834
3324395012,3423782681,1649170393,1649171391,998,913
3115177011,3137412000,1648183845,1648184489,644,2291
3388971461,3880638655,1667771907,1667772584,677,262
3600247537,3861153303,1645022191,1645022225,34,1736
3959408689,3980087695,1643366227,1643366227,0,2264
3781394729,3078791988,1652106974,1652107577,603,1103
3367685887,3022401876,1646077088,1646077852,764,1723
3176317370,3060718787,1652481739,1652482236,497,1397
3121932256,3816240060,1652637879,1652638458,579,866
3689453273,3574834673,1655261140,1655262073,933,98
3521410258,3320381981,1642136580,1642136997,417,303
3790783685,3617795950,1663475249,1663475974,725,994
3581470040,3948833001,1649327704,1649328115,411,635
3245723038,3810798932,1664975659,1664976340,681,1824
3606994517,3188588023,1649274342,1649274709,367,403
3816935536,3035135381,1647626219,1647626595,376,1566
3050800748,3730702889,1655585242,1655585630,388,38
3962617141,3577627752,1661841800,1661842164,364,2423
3771841105,3854737938,1644109772,1644109816,44,1079
3236132865,3605195406,1654544847,1654544954,107,747
3069746677,3546034581,1644770295,1644770554,259,1022
3475846394,3101669976,1650351369,1650351587,218,619
3069989068,3938615588,1646843474,1646843976,502,1496
3273857586,3730266625,1649104258,1649104765,507,221
3884802599,3874913687,1659300921,1659301768,847,655
3414857456,3197371652,1657536108,1657536712,604,95
3814851615,3968635893,1642795849,1642796042,193,133
3021613958,3042461816,1660203981,1660204145,164,1173
3097609387,3753596469,1662498801,1662498907,106,2448
3021683395,3586600196,1644259124,1644259705,581,1251
3935210171,3167142908,1656102979,1656103538,559,63
3585218766,3409568191,1648678811,1648679261,450,374
3945358150,3714259747,1661672206,1661672334,128,2043
3657115450,3881554146,1661548868,1661549433,565,2028
3753998489,3984414020,1655470397,1655471276,879,2044
3729389785,3292507015,1645149860,1645150792,932,2142
3678452420,3991542844,1664576725,1664577366,641,1415
3226092646,3252070101,1667853328,1667853665,337,367
3100113266,3513368682,1656018974,1656019271,297,1525
3068659940,3740376361,1666788437,1666789259,822,799
3564089463,3723700913,1663299634,1663300261,627,759
3421178618,3282839568,1657167551,1657167668,117,2035
3743886187,3698965715,1651486517,1651487270,753,330
3806936803,3972052329,1651792851,1651793478,627,1395
3957824946,3759608318,1651193904,1651194890,986,1179
3520699413,3478771172,1646806435,1646806677,242,2344
3825900664,3795609815,1654311838,1654312415,577,1837
3929305160,3222871111,1643237092,1643237468,376,55
3055044716,3440322150,1662836391,1662836577,186,476
3574240169,3480115115,1656749768,1656750098,330,1754
3183165788,3651271289,1656797065,1656797801,736,2294
3021289375,3817579913,1647809924,1647810541,617,1845
3832880789,3657699213,1665908609,1665909395,786,715
3993365296,3328993418,1643174389,1643174535,146,2315
3955685340,3520385284,1663676564,1663677325,761,262
3793840002,3163986082,1642948638,1642948833,195,570
3487547990,3451227417,1654527172,1654527220,48,2260
3518932161,3493040979,1664513449,1664514070,621,1883
3112356239,3896789438,1656796331,1656797218,887,1394
3993866389,3831683294,1653978778,1653979343,565,418
3771826410,3699258770,1658188512,1658189469,957,1642
3959408689,3349718189,1656366216,1656367004,788,289
3018651462,3292812509,1656349485,1656350023,538,2392
3661243199,3567980215,1667034302,1667034687,385,529
3061299464,3379076226,1649767612,1649768099,487,1787
3207757416,3567614002,1667761355,1667762005,650,349
3070640991,3868215944,1654247610,1654247693,83,2479
3547758342,3792004796,1666511664,1666512549,885,1194
3166483466,3192375486,1647139010,1647139436,426,2205
3963547295,3021129414,1650675865,1650676076,211,1379
3734035973,3274208430,1654423701,1654424459,758,1119
3948260526,3069746677,1654247937,1654248530,593,1207
3391540103,3242406857,1645421748,1645422097,349,579
3602497998,3208220195,1649952856,1649953060,204,2242
3671539226,3981657344,1649663774,1649664596,822,2131
3841106350,3808604912,1653827181,1653827626,445,1853
3702541874,3820254686,1663623279,1663623501,222,1934
3742220718,3031241695,1666455232,1666455932,700,415
3831009076,3135707503,1649900828,1649901364,536,1589
3888392286,3330817237,1662036716,1662036973,257,2046
3967747142,3816921514,1651245302,1651245473,171,1169
3298879351,3630744377,1663336949,1663337117,168,2035
3021968850,3013814400,1661879784,1661879950,166,431
3012155922,3402543059,1657360504,1657361126,622,1400
3447812768,3116751960,1644498765,1644499125,360,799
3478404891,3826257607,1653951283,1653952031,748,2423
3292869706,3896922629,1658218436,1658219398,962,90
3853163109,3211514286,1648850913,1648851232,319,891
3996993457,3735098036,1645120268,1645121020,752,1577
3534910343,3637923107,1645715132,1645715599,467,2295
3656158144,3893170545,1653660168,1653660499,331,2446
3447926518,3928685907,1655937631,1655937803,172,2436
3478921948,3759668586,1665324481,1665325213,732,516
3960633649,3858911279,1666324381,1666325090,709,376
3105733809,3271864656,1665007224,1665007438,214,1233
3564667780,3090304189,1666355704,1666356078,374,2425
3879299283,3636141899,1650938548,1650939162,614,1615
3194617168,3545067538,1668891338,1668892194,856,314
3889854774,3983158937,1662005104,1662005829,725,2103
3443161524,3074385503,1658009079,1658009249,170,1883
3761584126,3061299464,1668359891,1668359917,26,1032
3181032246,3360158658,1642147165,1642147788,623,1819
3038014403,3246260241,1648591848,1648592047,199,1421
3577276558,3211641180,1651515757,1651516603,846,910
3821312248,3356499294,1642066442,1642066459,17,938
3451167153,3336535934,1645298985,1645299893,908,2159
3840026910,3372544937,1650252143,1650252657,514,1331
3949771162,3586405616,1643081910,1643082218,308,569
3551810435,3060718787,1663007190,1663007895,705,516
3442593383,3819380768,1658219687,1658219794,107,1952
3686530724,3678624517,1649229044,1649229470,426,1926
3411495833,3761147252,1653852156,1653852791,635,682
3955663201,3722726470,1654116157,1654117025,868,677
3132584801,3869355507,1646047137,1646047630,493,2204
3266127117,3848963466,1667517381,1667518291,910,1278
3575766470,3070237620,1657196070,1657196135,65,450
3451285207,3469887287,1642999524,1643000184,660,1620
3734533600,3709665583,1664494247,1664495058,811,817
3232141615,3521258004,1644132935,1644133767,832,2084
3663884600,3649265606,1655304352,1655304488,136,2178
3972195042,3840502377,1654414155,1654414905,750,624
3195214383,3124723265,1644765974,1644766814,840,1968
3531256735,3333665805,1643430211,1643430776,565,1094
3669324531,3136396999,1658949454,1658949461,7,370
3453552267,3095661205,1666701818,1666702762,944,1212
3842738399,3664898256,1652878671,1652879321,650,1515
3307305290,3432722823,1641483759,1641483869,110,2288
3804948415,3396154732,1663658133,1663659126,993,1890
3803799575,3959081575,1649186897,1649187599,702,2005
3563972468,3240369434,1641355852,1641356652,800,2149
3204735172,3951845301,1652860567,1652861262,695,1642
3850089310,3943927246,1663997141,1663997458,317,1374
3081369661,3371707067,1649441425,1649441683,258,2101
3978691513,3086444841,1661573677,1661574491,814,690
3625691221,3310953839,1660191886,1660192859,973,2339
3959497834,3562814356,1643081746,1643082037,291,958
3008283469,3114277786,1651439008,1651439208,200,2238
3751346675,3205988899,1650601775,1650602670,895,1867
3595726436,3652480299,1645994234,1645994733,499,1241
3550889203,3969960450,1644187238,1644187594,356,408
3490942401,3188162412,1648525894,1648526439,545,1205
3439280560,3052499026,1669071489,1669071538,49,1866
3792143103,3359722926,1651322468,1651323299,831,413
3446946900,3910712536,1656658538,1656659032,494,1101
3773196864,3697650296,1649087523,1649088383,860,10
3199472785,3263328793,1647547916,1647547969,53,2143
3177628377,3049869003,1660660634,1660661316,682,1253
3629090721,3987431029,1649747396,1649748088,692,377
3185373368,3994348053,1645044024,1645044269,245,2479
3900755896,3292368988,1665494966,1665495304,338,1735
3244502667,3805742408,1662566385,1662566425,40,2471
3204081712,3413300274,1667385631,1667385776,145,1465
3523546928,3817668840,1654396217,1654397053,836,384
3961973688,3722114463,1649142127,1649142415,288,1434
3623869570,3887108152,1658820361,1658820788,427,2303
3639804787,3697692313,1645357044,1645357059,15,661
3967439884,3087612913,1664181704,1664182419,715,1055
3722114463,3125459736,1656191695,1656191970,275,2138
3566257032,3164410972,1668065980,1668066359,379,1349
3180051747,3801847517,1662468833,1662468851,18,1909
3747630644,3046085814,1668399219,1668399636,417,887
3019576854,3288309878,1652892675,1652893017,342,2073
3046132590,3641682706,1654785835,1654786241,406,2200
3551104975,3952663430,1666365593,1666366003,410,1602
3843953645,3272187328,1654394359,1654395177,818,77
3627503494,3334792271,1669575195,1669575658,463,55
3226451761,3139035952,1666021733,1666022711,978,2486
3807922855,3778068384,1649956161,1649956194,33,2274
3411128747,3999390272,1652085573,1652085884,311,329
3472112661,3015715378,1660809717,1660810370,653,1076
3540104512,3127412666,1654694266,1654695119,853,2218
3864930473,3818823702,1668809570,1668809620,50,2347
3888260346,3882329817,1668001619,1668001818,199,1580
3250926786,3973853235,1645992922,1645993870,948,1527
3166274990,3097475982,1644944961,1644945080,119,1101
3957210150,3249916829,1641218708,1641219393,685,1462
3576315042,3393000047,1654466439,1654466487,48,1240
3208770010,3159897010,1651652268,1651652616,348,1512
3098907787,3271876104,1647293464,1647293536,72,1252
3595984663,3585100772,1641485866,1641485974,108,1607
3242088486,3217250826,1646492865,1646492927,62,2044
3971020365,3026293367,1665756665,1665757066,401,157
3654861844,3780368492,1650651418,1650651650,232,2377
3261477798,3074837048,1644982637,1644983242,605,1960
3401738714,3478280943,1661514513,1661515316,803,133
3372334548,3430102174,1664909554,1664910426,872,820
3313687025,3593487418,1666069945,1666070398,453,601
3647222339,3080195715,1669644887,1669645496,609,1959
3878698797,3537735224,1651259468,1651259526,58,673
3850906711,3438553592,1661770130,1661771083,953,1531
3022348535,3720248207,1669374871,1669375048,177,246
3317318302,3778405053,1659859997,1659860920,923,1227
3270273033,3702345362,1663630067,1663630561,494,476
3406357109,3863080370,1664600290,1664601216,926,707
3660129917,3541413511,1644472032,1644472996,964,1443
3996381336,3482576542,1655388280,1655389121,841,667
3518607253,3170167097,1669426648,1669427202,554,912
3361051044,3094562402,1649343029,1649343445,416,2442
3184720975,3039198774,1651787833,1651788650,817,1069
3013073909,3022428512,1652592252,1652592584,332,164
3139551539,3199117399,1664919687,1664920159,472,1993
3985486150,3408944120,1642277413,1642278129,716,2184
3379076226,3707940691,1646450614,1646450934,320,2375
3898946519,3030551637,1669125997,1669126145,148,2092
3046351455,3602340127,1662602786,1662602853,67,2299
3003705867,3346261120,1651185512,1651185949,437,2324
3677965553,3221885729,1663289749,1663289956,207,2453
3910029798,3848740333,1662435065,1662435985,920,2161
3690633750,3449395269,1669638805,1669639529,724,2297
3963547295,3920437320,1668354578,1668355053,475,1351
3469507401,3463540687,1665221640,1665222632,992,2152
3617795950,3675481622,1661365698,1661366429,731,2175
3741273371,3601590462,1663775792,1663776654,862,1104
3447887397,3064961160,1647121908,1647121932,24,1910
3070676307,3596839317,1661107754,1661108706,952,890
3702965571,3895274115,1643200023,1643200528,505,826
3562116841,3194140038,1668714843,1668715141,298,1621
3076570841,3716415183,1668661748,1668661986,238,429
3023254734,3977359273,1668723237,1668723903,666,1263
3178742688,3156098708,1651894000,1651894332,332,1668
3260695363,3086444841,1645113497,1645113503,6,1230
3276576100,3535575355,1650366257,1650366986,729,1575
3916680089,3158554223,1664192435,1664193415,980,1208
3202460554,3323783108,1666832921,1666833287,366,1992
3926815435,3260157601,1654159029,1654159172,143,25
3759409777,3751780241,1669382489,1669383043,554,411
3295352365,3239158180,1651859238,1651859354,116,796
3816533759,3110395191,1668484467,1668484647,180,659
3805888209,3261195333,1661667759,1661668354,595,1258
3085429140,3582531330,1659401251,1659401258,7,827
3291324812,3967250644,1646121761,1646122632,871,1805
3178742688,3211541773,1654891909,1654892004,95,811
3598841094,3038529026,1667883384,1667883913,529,1237
3204735172,3506090868,1647490959,1647491024,65,2391
3825332100,3338715388,1662434476,1662434837,361,623
3066362135,3623115966,1660079213,1660079902,689,1061
3706215600,3877638741,1648599933,1648600733,800,2494
3916290714,3678541527,1654173296,1654173550,254,1724
3947521897,3518246885,1646762462,1646763324,862,2044
3691474413,3273752842,1642777009,1642777103,94,21
3272623699,3395316132,1655705057,1655705101,44,1188
3771504908,3866532806,1644445985,1644446963,978,1250
3046127876,3388490960,1661228120,1661228725,605,2279
3962676436,3607580736,1656986998,1656987802,804,533
3398257086,3136200575,1669426024,1669426830,806,370
3192612662,3068161140,1665323270,1665323788,518,1406
3007357837,3936360658,1649993343,1649993681,338,1479
3574394407,3544965463,1642312627,1642312636,9,1031
3927920093,3306871271,1655207765,1655207966,201,1019
3335818403,3755228064,1642177866,1642177969,103,882
3545214789,3829593597,1665279164,1665279334,170,1060
3124277484,3767581542,1664547440,1664547622,182,489
3693000511,3275027460,1664037237,1664037291,54,1834
3780991625,3098165935,1654603233,1654604154,921,695
3776148003,3156261740,1648023302,1648023723,421,166
3578974875,3391282493,1641641457,1641641551,94,597
3842431875,3419430775,1652649843,1652650453,610,1959
3255149739,3170292789,1659827004,1659827680,676,223
3192940759,3604514331,1660516327,1660516984,657,696
3336947163,3211541773,1651847765,1651847949,184,1780
3196009998,3512935575,1665756307,1665757008,701,932
3922972838,3181181141,1641150884,1641151467,583,361
3049869003,3536421569,1659971681,1659972065,384,420
3847297747,3518322544,1654241277,1654241542,265,142
3124562368,3865282317,1659430103,1659430768,665,1780
3656846834,3870485916,1660994928,1660995645,717,1025
3975663862,3397169008,1643599979,1643600941,962,1780
3690518174,3748988849,1656087801,1656087937,136,2334
3430638959,3566825897,1642861558,1642862410,852,1009
3672694122,3234064286,1652390449,1652390853,404,627
3481482238,3043258601,1667533000,1667533120,120,1760
3757518149,3277521554,1641575369,1641575912,543,255
3604769442,3887002610,1662097929,1662098061,132,1294
3973226891,3429887771,1648684240,1648684902,662,823
3452275962,3142848483,1641488778,1641489574,796,950
3872928406,3884018587,1667756383,1667756591,208,2200
3848740333,3805665502,1644295705,1644296186,481,1489
3857013729,3888438556,1651507919,1651508419,500,2241
3739439527,3135406478,1662387992,1662388315,323,2467
3652304615,3239527114,1653400045,1653401020,975,2181
3589972665,3415351222,1658216298,1658216313,15,533
3375799029,3658516535,1648613095,1648613188,93,2053
3965863452,3536832504,1658498886,1658499363,477,1593
3857400676,3388159268,1644607784,1644607987,203,1223
3693453006,3191462400,1652761293,1652761536,243,737
3641493201,3087700946,1649546687,1649547122,435,1434
3447470600,3181047536,1651727900,1651728400,500,151
3115245083,3052875832,1663424884,1663425723,839,1911
3545067538,3668174777,1669066200,1669066435,235,426
3137412000,3593861215,1663603012,1663603992,980,1177
3966525848,3375655129,1645524085,1645524654,569,365
3406595083,3014983064,1653680608,1653681428,820,1951
3004890840,3128839608,1647777920,1647778446,526,44
3423043196,3824545323,1656301172,1656302163,991,262
3663155034,3622984488,1664488311,1664489089,778,185
3578655079,3312656348,1647960122,1647960134,12,609
3432321849,3183672525,1652988551,1652989320,769,2497
3118976994,3073967597,1668756171,1668756604,433,1878
3042461816,3900951859,1665617708,1665618355,647,2328
3283171763,3481881323,1648903484,1648903543,59,998
3830975217,3532307372,1654159471,1654159487,16,2117
3492247995,3949713678,1655910635,1655911613,978,1756
3275436235,3310523513,1641549895,1641550303,408,770
3503510962,3141503682,1647227979,1647228759,780,1347
3672070606,3824860461,1653015252,1653016217,965,621
3878059612,3061594355,1643254247,1643254444,197,457
3547278175,3748812993,1661023697,1661024108,411,728
3710331536,3836331716,1651105744,1651105912,168,1262
3262596597,3779236518,1646937741,1646937832,91,2303
3336494171,3776954666,1647118531,1647118760,229,355
3829347049,3232497890,1669000055,1669000853,798,163
3483553551,3989208740,1651998569,1651999198,629,2139
3447407380,3887791096,1646940399,1646941385,986,1712
3735547050,3093589416,1652438720,1652439600,880,230
3564440153,3352595765,1663666222,1663666430,208,1254
3409962434,3904352989,1651085073,1651085281,208,215
3752652141,3084385255,1648819937,1648820445,508,1823
3261128374,3639352352,1643917467,1643918285,818,2349
3552457707,3426491499,1654873608,1654873901,293,1613
3342189600,3794575914,1659182101,1659182252,151,772
3724861653,3917601622,1667633969,1667634039,70,747
3741494242,3225466850,1645678119,1645678465,346,1724
3224644594,3208757755,1659025385,1659025923,538,1359
3735167946,3748556962,1663114111,1663114482,371,1264
3215040043,3203904444,1644651930,1644651946,16,1490
3547334414,3343232841,1664097423,1664097432,9,306
3364855872,3240340462,1643950963,1643951570,607,435
3243649022,3863448086,1655242849,1655242956,107,1986
3512575951,3204735172,1668708574,1668709438,864,2079
3712549911,3082075242,1647101698,1647101855,157,1075
3108998670,3264345880,1644350451,1644350643,192,893
3482826953,3887791096,1669240486,1669240808,322,960
3760224151,3247269367,1651885278,1651886039,761,2442
3645341350,3359403467,1666869327,1666870050,723,1539
3828531030,3059176048,1643526386,1643526422,36,6
3128043317,3852633699,1664326779,1664327364,585,57
3298527612,3088132769,1656134189,1656134622,433,441
3774413169,3252790120,1645730218,1645731158,940,1253
3059491889,3057085790,1644043923,1644044879,956,1314
3310499607,3036801405,1661941172,1661941950,778,2222
3356590035,3707578213,1659134214,1659134339,125,1529
3265655534,3160349110,1668283768,1668284022,254,616
3090304189,3365381632,1646881151,1646881176,25,185
3476566118,3569557301,1645573124,1645573547,423,1537
3952425376,3103625074,1661634382,1661634924,542,276
3677379196,3445666899,1642252283,1642253188,905,935
3359296227,3731206373,1645555944,1645556483,539,1721
3736911154,3377086230,1641353073,1641353534,461,510
3375279811,3616803531,1649009049,1649009710,661,899
3047402472,3785361012,1651987065,1651987249,184,1515
3547358965,3809041613,1660508388,1660508573,185,1432
3928989640,3370889279,1662192939,1662193126,187,1354
3051863550,3985308319,1667583070,1667583945,875,940
3971934050,3153851884,1653815883,1653816486,603,2484
3586101932,3005356433,1649589904,1649590247,343,349
3488506620,3915817603,1663585719,1663586063,344,1162
3005283650,3080195715,1656277228,1656277882,654,1122
3984414020,3892800106,1653088996,1653089871,875,1793
3442354739,3776934270,1663773788,1663774586,798,1152
3297681098,3956058747,1661252519,1661253411,892,591
3000383745,3979352608,1649480700,1649481252,552,1027
3883497013,3976453338,1646377757,1646377765,8,2064
3700968228,3195274844,1652449631,1652450109,478,451
3364661787,3609043475,1665851543,1665851730,187,1094
3912672075,3035158102,1650437882,1650438641,759,1280
3678404361,3011690678,1649530670,1649530841,171,1354
3797778150,3896357807,1666224665,1666224877,212,1869
3585495750,3882559155,1652990051,1652990599,548,701
3818039978,3666079547,1654811903,1654812732,829,2158
3630750697,3393199571,1662047865,1662047933,68,1483
3477522732,3079415495,1659029235,1659029837,602,2399
3295278768,3313265862,1644786684,1644787157,473,1598
3347317107,3392918310,1654806462,1654806926,464,219
3240839516,3832719894,1644020004,1644020450,446,346
3828531030,3887743057,1650886840,1650887611,771,182
3247269367,3879182220,1660122243,1660122543,300,1648
3270935026,3603096470,1649978743,1649979145,402,131
3733619028,3751411767,1657857698,1657858003,305,724
3525377731,3412673526,1653744290,1653745215,925,1615
3495919793,3790180006,1641907126,1641907539,413,1942
3091062283,3533172784,1655261432,1655262131,699,1198
3240588695,3521023027,1641456776,1641457406,630,1957
3933045461,3876696308,1657387869,1657388482,613,720
3795269127,3504258562,1660159429,1660159584,155,1769
3083388257,3451299629,1663206354,1663207079,725,419
3836565798,3371536214,1643943243,1643943387,144,907
3253568318,3266828046,1650388265,1650389160,895,357
3406979800,3277926691,1666991347,1666991463,116,1547
3692772256,3286065477,1655272308,1655272833,525,1165
3131735006,3603786519,1665374037,1665374419,382,545
3417532235,3851747907,1649535570,1649536230,660,839
3607608267,3887032656,1653351555,1653351631,76,1253
3851879278,3198240429,1643920071,1643920718,647,775
3479308343,3994967281,1648121566,1648121791,225,2449
3386868280,3267319115,1664238868,1664239221,353,952
3569200063,3683038464,1660285730,1660285886,156,2261
3420180743,3415584739,1668160758,1668160886,128,591
3173642675,3562105236,1656427892,1656428859,967,2
3377847710,3266962342,1642410042,1642410672,630,396
3177943874,3273147497,1642510203,1642510721,518,372
3910979746,3406868680,1644117711,1644118542,831,451
3232546504,3415584739,1642950660,1642951515,855,70
3770561730,3994383813,1666481135,1666481918,783,2342
3069992620,3055044716,1645118732,1645119458,726,766
3161774382,3391658891,1661682795,1661683262,467,1456
3872170030,3733975709,1660003437,1660004175,738,677
3468654589,3982210988,1650262169,1650262483,314,2302
3309468510,3926426459,1643501340,1643502157,817,1105
3649649514,3135707503,1652409938,1652410841,903,679
3553712893,3393314546,1643559274,1643559913,639,1818
3620939715,3215453691,1660235624,1660236115,491,44
3288441459,3438553592,1646807819,1646808434,615,675
3746969288,3500595056,1646153481,1646154382,901,1331
3902329320,3089962675,1668011054,1668011877,823,965
3140055258,3229881750,1653368991,1653369040,49,338
3283056652,3020683788,1644621801,1644622258,457,979
3132034706,3242752835,1648994190,1648995009,819,1157
3967727550,3503453854,1648181210,1648181831,621,362
3823942349,3553530817,1642757752,1642758253,501,2375
3624662198,3915111520,1642483427,1642483643,216,360
3398814666,3271409183,1658014486,1658015338,852,2473
3757693725,3269699819,1643069809,1643070034,225,726
3498685499,3148284665,1647639006,1647639259,253,1670
3916244157,3824517920,1652560668,1652561570,902,1217
3042120123,3495798110,1666461797,1666461864,67,911
3302113605,3855165548,1666405870,1666405871,1,1602
3506345760,3702965571,1654786118,1654786877,759,612
3648447244,3665931760,1656872265,1656872680,415,216
3413305965,3774806676,1659256341,1659257334,993,349
3581570568,3940520472,1652507101,1652507951,850,817
3656467120,3880011397,1661104159,1661104629,470,717
3729820423,3474242977,1653429441,1653430379,938,1017
3321441782,3350387055,1657804571,1657805208,637,1981
3310169810,3454276568,1659680137,1659680361,224,2007
3547358965,3629797745,1641228593,1641229185,592,234
3012032774,3343033950,1651578910,1651579688,778,1188
3752653418,3268826534,1668783484,1668783708,224,1193
3773830646,3324073911,1655570253,1655570483,230,579
3804064265,3439280560,1662629958,1662630139,181,2367
3664426298,3594009328,1660152110,1660152306,196,392
3376287193,3122144249,1648985043,1648985705,662,1839
3869692733,3527164294,1653158769,1653159617,848,555
3988976739,3269680998,1668677083,1668677823,740,909
3793967785,3367510444,1669491602,1669491949,347,1914
3154991935,3990849115,1648647251,1648647511,260,2483
3755294305,3324618357,1645639799,1645639888,89,1138
3915637706,3636001595,1648451307,1648451792,485,1044
3090057747,3223694966,1645234547,1645235142,595,2423
3110360947,3795817960,1664183364,1664183591,227,1704
3543105564,3638847705,1658085457,1658085562,105,776
3724523438,3214068022,1662743068,1662743654,586,1733
3671355250,3620748135,1662727719,1662728299,580,530
3009688248,3270273033,1645055688,1645056313,625,1858
3702345362,3050271924,1644803438,1644803905,467,950
3652480299,3307306078,1653156596,1653156763,167,215
3989550849,3471638565,1667029350,1667030185,835,1994
3115245083,3275810322,1645129471,1645129903,432,298
3746351822,3449504551,1644333903,1644334868,965,836
3430165544,3103943430,1658883982,1658884558,576,2234
3516838480,3834166808,1656361347,1656362132,785,1600
3691021918,3638527581,1654739217,1654739763,546,4
3573961768,3178749877,1664891094,1664892001,907,1509
3732472752,3369469616,1666129742,1666130173,431,2361
3992817916,3173586762,1653849657,1653849813,156,1453
3737400101,3325565610,1645197721,1645198344,623,63
3595984663,3955776304,1645538167,1645538882,715,601
3134436515,3021727735,1662493771,1662494420,649,1763
3542827244,3176608983,1667083674,1667084353,679,624
3295402408,3395316132,1665460362,1665460917,555,2499
3751300388,3505322684,1667233240,1667234011,771,730
3144551332,3061982327,1661073483,1661074398,915,2245
3565781990,3698156103,1641896009,1641896885,876,877
3718182841,3183640403,1645210766,1645210847,81,2197
3067641822,3291819950,1645968075,1645968973,898,1698
3725117905,3671539226,1644437591,1644437637,46,1932
3316951862,3428176980,1652315889,1652316754,865,477
3026209549,3885458258,1642244705,1642244930,225,419
3813666053,3718026583,1665712755,1665713333,578,2492
3510166785,3793344397,1659594930,1659595025,95,435
3214068022,3393199571,1650840365,1650841078,713,629
3229448014,3921451192,1662828279,1662828390,111,1034
3399631396,3412109130,1644199648,1644199733,85,629
3926467866,3615359458,1669075743,1669076291,548,1847
3529946433,3018325807,1668644956,1668645941,985,1424
3170985187,3258057377,1663657274,1663658229,955,843
3324069408,3297290662,1667394100,1667394695,595,839
3048409719,3468914867,1653798619,1653799411,792,1051
3451106027,3622334419,1655732434,1655733071,637,639
3316287541,3404020970,1649192264,1649192933,669,689
3518620219,3899247202,1645426434,1645427002,568,2124
3688345244,3319334426,1653428989,1653429531,542,230
3816538946,3518079213,1661336708,1661336985,277,1442
3798563042,3347776562,1647309288,1647310256,968,885
3247688800,3184539687,1664038392,1664039361,969,1822
3986970365,3634624974,1644095853,1644096087,234,1746
3265611656,3851982179,1644412742,1644413308,566,278
3816538905,3687689210,1662294993,1662295379,386,639
3510660628,3526815452,1657060635,1657061334,699,818
3228366627,3705733070,1641314313,1641314547,234,1022
3911316683,3934848520,1644135993,1644136877,884,1042
3851540721,3233222399,1648390807,1648391078,271,2019
3321819030,3248324593,1656431569,1656432465,896,677
3036470049,3035158102,1657681590,1657682182,592,407
3573915559,3091817310,1668994794,1668995731,937,2465
3097145374,3865422787,1659425497,1659425776,279,1097
3986081370,3130993420,1660307843,1660308242,399,52
3102776006,3194796707,1669078363,1669079296,933,780
3215514672,3945611603,1662894418,1662895380,962,1229
3268570857,3295806447,1645434724,1645435478,754,1161
3925239812,3295385873,1665574113,1665574369,256,1102
3039544352,3331604266,1643617780,1643618262,482,2375
3859164696,3699263886,1655340725,1655341112,387,599
3663871563,3580178697,1668663042,1668663716,674,1175
3683134571,3771931468,1654670920,1654671875,955,523
3007934266,3779998740,1646803534,1646804192,658,1702
3466473464,3105903246,1648276523,1648276796,273,1517
3467933841,3974804920,1649588344,1649588864,520,1826
3473102313,3046006152,1651287432,1651288151,719,1396
3815605229,3190969092,1660430068,1660430916,848,1046
3375759020,3556425071,1651022093,1651022521,428,441
3437705581,3697028347,1654919103,1654919733,630,237
3449352254,3840026910,1656145142,1656145536,394,269
3161999632,3909523201,1658421685,1658422272,587,1742
3200059644,3062789212,1666705565,1666706242,677,2236
3060633640,3756028002,1668455862,1668455946,84,543
3053134032,3935822380,1649227987,1649228011,24,524
3557409187,3907764491,1641881247,1641881266,19,1611
3244398882,3292739128,1643899814,1643899919,105,757
3718652649,3094852425,1655056665,1655057152,487,866
3048361071,3199288675,1666793258,1666793292,34,127
3398840886,3325565610,1647452788,1647452796,8,915
3241021396,3131025611,1658166929,1658167099,170,893
3972441567,3546943801,1658378720,1658378859,139,363
3734579045,3199717052,1650311487,1650311964,477,2126
3047628685,3755473771,1659108086,1659108551,465,2380
3878177076,3118358674,1655108376,1655108710,334,270
3828810890,3890161181,1655077812,1655077823,11,1204
3816561204,3577817989,1658664040,1658664982,942,1168
3261128374,3814278185,1641899043,1641899963,920,83
3217375075,3830330372,1644020133,1644020148,15,1508
3680060067,3997397652,1654818978,1654819975,997,1874
3292797747,3138638384,1644737031,1644737772,741,455
3631587282,3998641184,1641874345,1641874579,234,895
3218738751,3646159351,1653286191,1653286380,189,2204
3299821745,3798563042,1650384776,1650385442,666,440
3037130270,3611286809,1656395020,1656395764,744,328
3265434991,3772739629,1663122681,1663122985,304,436
3130993420,3096541903,1668320414,1668321243,829,476
3276350975,3202161567,1656220954,1656221941,987,1836
3260157601,3948193261,1668436419,1668436674,255,1426
3887108152,3177943874,1659048671,1659049271,600,1385
3719929552,3286696325,1641993698,1641993873,175,2027
3011863548,3646596750,1647843959,1647844463,504,582
3255904598,3913608544,1663439774,1663439800,26,1618
3248733503,3651900802,1654042638,1654043502,864,42
3119752328,3736260750,1643720242,1643721179,937,1659
3680682585,3735538229,1647848351,1647849052,701,1790
3685665978,3834954155,1648217879,1648218308,429,830
3620006027,3820225206,1649137539,1649138060,521,977
3867543887,3256787088,1648953879,1648954388,509,1881
3992927391,3749593178,1663862564,1663863292,728,2199
3772762015,3939711103,1664736109,1664736926,817,2092
3287171733,3192194263,1646265477,1646266384,907,1977
3329498574,3797484306,1655799657,1655799956,299,2484
3247688800,3662040060,1658352386,1658352891,505,2383
3060970440,3243231806,1648236864,1648237291,427,314
3604954681,3643132014,1663810553,1663810645,92,1269
3598665921,3178732875,1649556023,1649556207,184,1544
3709075485,3154551351,1651953375,1651953647,272,603
3749208805,3671869525,1650246190,1650246752,562,396
3778068384,3421875747,1647314197,1647314706,509,12
3156098708,3303719777,1662450626,1662450638,12,1353
3154991935,3967727550,1648096913,1648097092,179,531
3988466264,3900843323,1653264142,1653264515,373,491
3490286406,3743687544,1661316385,1661317189,804,2107
3384452997,3105259495,1659372583,1659373002,419,678
3108342285,3944914500,1663079864,1663080636,772,2228
3958507465,3804328787,1658599094,1658600058,964,533
3334483625,3962138330,1649414272,1649414276,4,1232
3946569604,3116684420,1646405217,1646405451,234,998
3997581459,3630963449,1652822813,1652822817,4,1676
3829149174,3015814199,1653630774,1653631187,413,684
3644531526,3828761401,1645114047,1645114321,274,1555
3041652512,3148259657,1660522247,1660522258,11,638
3445023517,3760142759,1655049794,1655049811,17,175
3318594125,3637408266,1653344245,1653344565,320,788
3784828021,3064323869,1661864869,1661865159,290,1870
3435578430,3864045087,1652485841,1652486707,866,1312
3192142540,3885162740,1645132709,1645133073,364,438
3008576449,3034142016,1653270925,1653271278,353,619
3215402575,3823133313,1655158116,1655158221,105,10
3508060901,3558492617,1658821567,1658822166,599,173
3088553332,3961140276,1646919112,1646919654,542,2415
3971934050,3467401235,1659427398,1659427690,292,647
3234064286,3516019563,1663192720,1663193205,485,461
3471463543,3439940608,1645474199,1645474421,222,1640
3857931113,3605706184,1647202444,1647202830,386,114
3936980618,3751411767,1647779195,1647779645,450,467
3309305862,3364842162,1647652856,1647653099,243,1301
3434662490,3323936820,1646240444,1646241427,983,782
3339611423,3351843519,1660184238,1660184942,704,396
3406042920,3199797181,1641749257,1641750007,750,700
3817960208,3202225412,1664297122,1664297939,817,1081
3486059916,3408978529,1649075231,1649075483,252,1683
3783723078,3450628929,1653596108,1653596434,326,269
3055402951,3583345509,1645566165,1645566740,575,531
3280251149,3498466937,1647266168,1647267103,935,920
3471744546,3948577391,1644504876,1644505646,770,2273
3984370468,3592906293,1662364721,1662365247,526,2430
3040136606,3150067482,1647318898,1647319036,138,752
3430638959,3265324040,1653068792,1653069735,943,2033
3332012161,3146555014,1649795641,1649796347,706,773
3351490739,3884247169,1643300198,1643300620,422,1952
3298676228,3495420849,1641601925,1641602389,464,1084
3797270025,3865463499,1654171114,1654171747,633,2077
3330623875,3582471153,1654186400,1654187209,809,2109
3620522583,3535575355,1644022025,1644023017,992,1249
3662409391,3606545393,1642315282,1642315417,135,1412
3087709771,3042120123,1641328578,1641329348,770,16
3420137628,3990233750,1655812099,1655813051,952,651
3750698244,3412927884,1645472242,1645473064,822,1676
3804914454,3744871116,1659056292,1659056320,28,1095
3303561746,3443297756,1647909067,1647909797,730,828
3857013729,3128514837,1650911567,1650912416,849,2437
3236325866,3716977635,1656916229,1656916804,575,716
3289850617,3248096339,1655581412,1655582397,985,937
3672482112,3079013365,1656072569,1656072737,168,1376
3522715448,3194618871,1643187244,1643188233,989,1513
3098276544,3272912522,1642207827,1642208613,786,817
3241500636,3702345362,1652640907,1652641298,391,1060
3089962675,3977078930,1656771600,1656771986,386,2337
3617453316,3641959079,1659105315,1659106093,778,1127
3214817416,3361016803,1655445979,1655445996,17,1013
3336376139,3044390847,1667202716,1667203701,985,651
3314583046,3468703620,1663035746,1663036533,787,868
3610480358,3833679984,1644085163,1644085826,663,2109
3593988999,3351182329,1650461158,1650461171,13,1019
3175418311,3800337461,1651469664,1651470045,381,1049
3783064521,3389546736,1657505495,1657506087,592,921
3109702081,3295146156,1655366741,1655367170,429,1789
3563972468,3344077337,1645843318,1645843773,455,1217
3427127427,3115177011,1648846873,1648847516,643,2369
3531118058,3665599335,1667680885,1667681170,285,1067
3824227701,3715731774,1667349752,1667350213,461,129
3654861844,3656000543,1643884107,1643884761,654,1273
3946068928,3320272612,1644690093,1644690991,898,1215
3217137285,3296957627,1656713219,1656713588,369,685
3702755503,3824478322,1657270080,1657270654,574,1454
3877638741,3631455637,1642106597,1642106646,49,1047
3025223556,3841672169,1662841599,1662841742,143,2010
3580398545,3247787797,1643331451,1643331672,221,2227
3884949094,3185250646,1661993828,1661993853,25,1587
3499994307,3185611253,1666469990,1666470047,57,2322
3566919425,3571719140,1660898372,1660898632,260,1076
3679045431,3404317985,1644048234,1644049191,957,1382
3759986276,3907713562,1644088058,1644088483,425,2235
3270111894,3093364150,1657622691,1657623677,986,1583
3728976822,3639059199,1644306588,1644307367,779,1592
3042432058,3798714576,1657521545,1657521814,269,1535
3556456137,3103215750,1645114089,1645115060,971,2400
3094277549,3499091436,1666354052,1666354692,640,729
3538686599,3712332461,1657865309,1657865505,196,23
3120490643,3417820101,1642678596,1642679488,892,1646
3957051129,3594009328,1654689323,1654689374,51,545
3126778118,3910581173,1658816021,1658816484,463,526
3998641184,3885084129,1660766406,1660767174,768,753
3442854678,3150884811,1656075199,1656075370,171,2350
3579514433,3354200745,1649266119,1649266330,211,1308
3697118662,3179354869,1647571043,1647571795,752,697
3468455079,3473355243,1647797134,1647797839,705,310
3794575914,3220424979,1669053002,1669053185,183,2169
3939977057,3623374020,1650057578,1650058502,924,1816
3582544512,3826956383,1667215499,1667215734,235,461
3834174227,3464734783,1665660388,1665660486,98,2331
3489915638,3632283664,1642868054,1642868684,630,2094
3993066194,3469783180,1668524257,1668525048,791,691
3134793811,3626552836,1645661711,1645662662,951,1356
3546866871,3849379963,1653082372,1653083372,1000,755
3949713678,3378542130,1651976704,1651977055,351,584
3650041115,3168576951,1643431281,1643431644,363,1452
3882415224,3215815915,1657842719,1657843254,535,2051
3556968717,3846323092,1641507934,1641508870,936,2454
3015246686,3319506258,1641869858,1641870635,777,871
3349566530,3961830711,1651184080,1651184646,566,2215
3057102903,3702302181,1654740766,1654741133,367,2013
3160515169,3019669727,1662291183,1662291896,713,1017
3897211381,3625034951,1650577566,1650578367,801,372
3472855930,3014552263,1649342528,1649342970,442,1583
3666174374,3957586219,1658701927,1658702157,230,2182
3201446016,3451167153,1649848017,1649848539,522,1064
3922251351,3751022139,1646602302,1646603237,935,1688
3895334140,3052233179,1648834253,1648834618,365,1784
3701726268,3708134798,1659664587,1659665075,488,1925
3469600523,3569761806,1655713025,1655713246,221,2456
3542293606,3235586138,1647952545,1647952565,20,469
3819468348,3915154684,1665426857,1665427254,397,1735
3669520344,3524217572,1667745064,1667745916,852,611
3899772312,3051776472,1650707888,1650708827,939,2083
3146653168,3628830127,1642499279,1642499794,515,952
3617746688,3421671936,1649263405,1649264281,876,1903
3862829462,3814017798,1666784738,1666785046,308,916
3073944007,3329987086,1650021441,1650022411,970,2484
3754706912,3821979869,1665459083,1665459318,235,1871
3476882609,3558493130,1643017002,1643017245,243,1569
3466642935,3422728078,1669035189,1669035297,108,1746
3715540162,3763317740,1669486525,1669487180,655,2469
3197497279,3015956370,1648128353,1648128376,23,1234
3583591867,3651058536,1654636339,1654636715,376,439
3044345094,3775645582,1645191370,1645191520,150,260
3918234060,3352729606,1657455581,1657455931,350,1654
3827954829,3424994271,1650787350,1650787944,594,1474
3198319752,3283211870,1650521460,1650522053,593,2467
3696437293,3371063992,1653908401,1653908916,515,581
3955750752,3938370016,1651427464,1651427935,471,2139
3441541439,3366192341,1661656758,1661656784,26,2407
3014185506,3985418000,1660715772,1660716284,512,1349
3029053911,3776685300,1663427545,1663427993,448,1182
3120186347,3038067120,1663433515,1663433571,56,837
3017758671,3828322397,1668322607,1668322887,280,2459
3356317749,3429010148,1658092306,1658092576,270,560
3130899709,3628554134,1656092105,1656092728,623,874
3461451325,3028780744,1644769040,1644769957,917,2210
3367849829,3828342380,1655240446,1655240718,272,2173
3209150433,3094277549,1667776354,1667777257,903,618
3289255457,3659224437,1667655874,1667656274,400,1172
3437603547,3165492854,1665191918,1665192841,923,1556
3095170532,3818028118,1641869264,1641869898,634,2269
3137803904,3005771350,1661009725,1661010095,370,2368
3043598133,3235155985,1664510728,1664510981,253,635
3946919028,3512935575,1666141270,1666141968,698,2293
3353295219,3103421893,1658054270,1658055248,978,582
3866993832,3057574793,1648691497,1648691841,344,1570
3636960130,3625504025,1664401442,1664401900,458,1939
3401738714,3542615732,1666568180,1666568248,68,2032
3115928790,3623092479,1660323612,1660324090,478,1360
3548028995,3639618179,1645371498,1645371776,278,479
3971180079,3851864688,1647840866,1647841835,969,2117
3547358965,3620616287,1641722190,1641722464,274,1702
3338154846,3799036179,1652243926,1652244200,274,29
3462543040,3148256129,1651712097,1651712471,374,445
3102760949,3522814184,1662246828,1662247709,881,1415
3246024635,3338082003,1661248766,1661249556,790,1057
3316031407,3672560021,1643276752,1643277169,417,600
3672699331,3512100935,1652851953,1652852558,605,1750
3662788693,3157765022,1647396482,1647397409,927,1452
3504641910,3118959727,1645064249,1645064626,377,1329
3808604912,3119345995,1662599505,1662600471,966,1306
3754292816,3270111894,1668307795,1668308630,835,1285
3651753987,3014552263,1649681593,1649682003,410,1814
3888392286,3034040451,1655247250,1655247721,471,330
3240588695,3528439013,1649092310,1649092972,662,2231
3354912831,3112622637,1647750823,1647751299,476,787
3042045098,3527221438,1660645022,1660645379,357,2358
3542832965,3757020498,1668142836,1668143759,923,1450
3254503569,3717406689,1659151816,1659152097,281,630
3205554156,3565287194,1665883727,1665883900,173,2309
3017883382,3595500034,1666331331,1666332314,983,1797
3200059644,3223313152,1643830963,1643831173,210,1051
3185611253,3408978529,1663606641,1663607579,938,1806
3151436331,3824845857,1668434471,1668435031,560,865
3922851964,3157496248,1664969677,1664970509,832,2324
3445863766,3603702697,1654083438,1654083617,179,474
3054758455,3347434027,1650717845,1650718684,839,1703
3176941664,3112419355,1662477391,1662477520,129,1663
3324113509,3003723782,1668548206,1668548747,541,1482
3838082378,3527221438,1652510937,1652511262,325,2479
3202984277,3660575608,1645321885,1645321942,57,2260
3273147497,3774102998,1649387946,1649388709,763,1865
3324113509,3909281743,1661931465,1661931892,427,597
3636001595,3592520398,1643429732,1643430049,317,938
3266121254,3524315738,1643507380,1643507869,489,633
3400542216,3358959910,1654502901,1654503427,526,668
3191792012,3908848133,1664816135,1664816907,772,581
3093599187,3747363730,1650747546,1650748205,659,687
3879564460,3457390239,1662968416,1662969152,736,1938
3961672171,3155320608,1667413942,1667414925,983,1347
3438892275,3542293606,1657678110,1657678219,109,356
3342054027,3237987905,1645459799,1645460455,656,1937
3620311248,3537457982,1666833416,1666833717,301,678
3671971306,3392395230,1652196446,1652196893,447,1862
3310935085,3244763805,1661332889,1661333701,812,2359
3389773271,3225901381,1650826788,1650827216,428,1009
3249627758,3413810353,1647231215,1647231842,627,2162
3821312248,3091008161,1647815873,1647816554,681,2222
3066990756,3171413650,1660806324,1660806994,670,1737
3795508879,3995288261,1655382345,1655382621,276,21
3197661010,3617340911,1648045044,1648045782,738,1487
3236522609,3514218549,1653919925,1653920785,860,417
3605699054,3232781077,1658460607,1658461366,759,390
3981846169,3294635633,1648155336,1648156293,957,38
3810320285,3816690173,1656236030,1656236450,420,760
3294984880,3233318289,1643641800,1643642037,237,227
3095621927,3238443990,1642715923,1642716446,523,1073
3998329857,3408604990,1669635212,1669636006,794,279
3269726483,3128287586,1662531042,1662531934,892,2100
3110016926,3441206388,1668893762,1668893763,1,1790
3303418943,3636808827,1665546551,1665546639,88,83
3318577605,3520571883,1668418041,1668418575,534,1917
3407770585,3724806243,1651136772,1651136826,54,1256
3021727735,3543668840,1650485543,1650485648,105,1452
3024813851,3553096192,1649336522,1649336786,264,194
3423782681,3573826666,1644607215,1644608050,835,2236
3080876844,3724523438,1661618998,1661619225,227,1738
3219509030,3452248216,1652940263,1652941086,823,1921
3727131221,3666579485,1653041023,1653041565,542,2340
3216912897,3451823359,1658135622,1658136191,569,567
3068242755,3788018778,1645313592,1645314557,965,2205
3963334554,3689303525,1667533799,1667534293,494,1632
3406042920,3901468403,1642510328,1642510756,428,1058
3799014776,3427225872,1649056165,1649056972,807,1981
3691834770,3470570814,1650588673,1650589540,867,982
3465796988,3662040060,1657275060,1657275869,809,1477
3010531134,3348770994,1669707430,1669708430,1000,1269
3695411154,3773789419,1643585181,1643585491,310,1050
3878876305,3615387566,1664819460,1664820256,796,1098
3788911315,3533403208,1659301279,1659301537,258,496
3546782886,3036194601,1657729354,1657729782,428,404
3035976552,3322287315,1642230517,1642230640,123,1041
3371138351,3689518345,1648100122,1648100508,386,1282
3982916950,3530157274,1660502190,1660502388,198,2474
3199635800,3793901427,1646043447,1646044415,968,1569
3106437492,3571897260,1666390148,1666391076,928,300
3799480079,3888015355,1656553164,1656553979,815,2166
3109234948,3102588374,1655853132,1655853533,401,1457
3585832857,3007339106,1644176145,1644176194,49,2186
3249305465,3496921526,1642871326,1642872190,864,2044
3547334414,3082359035,1648882014,1648882890,876,2361
3404317985,3123795999,1653340729,1653341091,362,374
3019694538,3976346769,1653088375,1653088749,374,1244
3900101700,3450806791,1641353232,1641353769,537,1485
3904625406,3101161243,1651732594,1651732664,70,168
3120208739,3940222685,1644920495,1644920789,294,838
3714698686,3102588374,1643753260,1643753691,431,436
3250253670,3059151355,1659661771,1659662106,335,2278
3143962586,3617324068,1655889630,1655890367,737,1381
3776783076,3312930717,1647935858,1647935918,60,110
3358156140,3861160074,1661208020,1661208459,439,956
3316398180,3255751346,1669245749,1669246579,830,690
3304596274,3499091436,1666925394,1666926332,938,1014
3470102638,3403024728,1650144792,1650145618,826,2497
3409962434,3086551217,1654172300,1654172665,365,1174
3293615945,3388328160,1655337246,1655337314,68,22
3546432752,3320841904,1663602300,1663602479,179,1815
3787230225,3962453693,1667068091,1667068584,493,1729
3167864948,3049567508,1659748524,1659749336,812,118
3873002836,3215819425,1668966022,1668966846,824,1301
3254473094,3009366895,1658718996,1658719775,779,1436
3897712112,3079038995,1646200485,1646201073,588,411
3677001111,3272981808,1649208116,1649208773,657,1595
3284838720,3852253700,1668684934,1668685371,437,590
3973401658,3838850701,1655924292,1655924293,1,1977
3245919207,3896997211,1663309344,1663309918,574,1143
3879001343,3748837929,1650792764,1650793726,962,2053
3162844882,3564839908,1664788399,1664788593,194,412
3576661425,3139434250,1643022593,1643023219,626,966
3366385571,3831039944,1653662307,1653663278,971,2091
3087603397,3085311533,1650816995,1650817807,812,502
3368420871,3456660113,1642185010,1642185925,915,486
3222060578,3660754603,1666993184,1666993208,24,1339
3597794683,3899618702,1654358681,1654359565,884,261
3641542734,3403911906,1644865146,1644865437,291,80
3869618249,3856160688,1655604583,1655605395,812,2391
3509568211,3008760173,1643951352,1643951953,601,2460
3894036055,3524589150,1653541922,1653542447,525,1822
3736118442,3208464348,1643769424,1643770155,731,2434
3002876565,3335818403,1665270920,1665271287,367,1595
3972441567,3885393767,1641469871,1641470300,429,719
3359278409,3194618871,1642510099,1642510424,325,684
3725611236,3738835445,1659248702,1659249533,831,256
3766160943,3180252962,1650782314,1650782682,368,982
3177943874,3948180125,1648346075,1648346395,320,1905
3320039544,3706215600,1660671212,1660671798,586,671
3097834756,3780808964,1651567726,1651568208,482,719
3569686431,3411128747,1654356029,1654356486,457,325
3576425783,3349879521,1641071848,1641072691,843,1899
3629412022,3329848036,1657163953,1657163977,24,1127
3564592902,3105648731,1663645715,1663645756,41,826
3088587729,3340464785,1655782895,1655783102,207,513
3472817347,3917601622,1668217943,1668218707,764,2165
3398865388,3254866960,1647046902,1647047711,809,2018
3217494787,3306515955,1651553149,1651553708,559,121
3211015636,3257821708,1646915449,1646916225,776,1566
3269283315,3228794031,1657677995,1657678049,54,717
3226052631,3139882519,1661782141,1661782740,599,761
3939973483,3447407380,1645176549,1645176853,304,1407
3296478783,3714698686,1643932614,1643932712,98,618
3787937000,3791419861,1657470976,1657471150,174,358
3351182329,3648447244,1641315694,1641316022,328,36
3387774254,3740090157,1667241320,1667242087,767,1416
3521112560,3707604534,1659058617,1659059007,390,772
3444067052,3797270025,1655398148,1655398527,379,1214
3273147497,3238443990,1648190657,1648191652,995,1258
3819467184,3134117241,1663766294,1663766531,237,531
3636930993,3962138330,1656907920,1656908571,651,756
3645868952,3855476133,1654919829,1654920588,759,234
3264673951,3275494433,1665064749,1665065365,616,425
3340427847,3073967597,1644689693,1644690243,550,613
3314823389,3192375486,1655657794,1655657820,26,134
3845980646,3201479561,1666069379,1666070314,935,40
3851780195,3199375921,1651235452,1651235823,371,1016
3722329316,3347646218,1647822705,1647823384,679,1657
3100716894,3828219822,1655274875,1655275835,960,756
3624171160,3896960517,1658587501,1658588113,612,588
3236325866,3739731580,1668348537,1668349206,669,1976
3329117199,3994577207,1652743278,1652743762,484,985
3356332328,3734621671,1644931584,1644932158,574,1881
3094906195,3397169008,1667140852,1667141630,778,944
3128043317,3707552735,1658229949,1658230038,89,2075
3164550059,3935656272,1665012922,1665013799,877,1557
3133655192,3508858140,1667496407,1667496996,589,2420
3608512295,3680841490,1659827021,1659827905,884,2308
3331604266,3645560004,1641233975,1641234127,152,455
3154567629,3329825235,1645496269,1645497262,993,368
3498707377,3866601790,1641949302,1641949590,288,139
3620939715,3481090623,1647230969,1647231898,929,1098
3163395401,3127940283,1667671380,1667671637,257,1469
3800566657,3317382420,1658127987,1658128429,442,394
3834268660,3488484971,1667202808,1667203562,754,380
3828890005,3010173509,1649286027,1649286953,926,434
3918891410,3109980927,1646215464,1646215699,235,366
3735538229,3872574112,1644838210,1644838529,319,1213
3021338974,3443384698,1668560167,1668560512,345,2148
3729356619,3371026826,1659330460,1659331183,723,2264
3085001659,3084982671,1668762244,1668762844,600,389
3753659944,3931230284,1658636076,1658637028,952,842
3209064637,3203128336,1646568151,1646568775,624,700
3114764410,3707258240,1650435977,1650436367,390,1813
3175979112,3583585259,1647993495,1647994411,916,588
3159562411,3963370859,1656889605,1656890012,407,2121
3003641311,3942393978,1660685938,1660686873,935,435
3156331863,3271039091,1641224708,1641225527,819,461
3180101007,3296519089,1655469254,1655469712,458,187
3761775611,3049447132,1658594778,1658595433,655,222
3967255191,3179280029,1652726097,1652726365,268,2364
3919162177,3183340735,1667940000,1667940122,122,2391
3503510962,3261685435,1666018027,1666018590,563,889
3940310287,3012152244,1654642252,1654642532,280,783
3623374020,3755269138,1659048055,1659048942,887,628
3867158050,3016616906,1668320274,1668320581,307,169
3495858842,3797484306,1653694401,1653694534,133,1434
3734331528,3818713435,1659113211,1659114145,934,884
3742012582,3858876644,1667979097,1667979491,394,62
3790329301,3200646968,1658896705,1658897596,891,180
3828890005,3362388538,1657129798,1657130358,560,1607
3492749874,3924879744,1651462188,1651462795,607,289
3639376136,3196302340,1645423754,1645424398,644,1717
3276846453,3857687791,1667302282,1667302622,340,63
3793232281,3467233007,1658584066,1658584641,575,497
3680453323,3293504206,1652420351,1652420663,312,1610
3580594125,3178529360,1661942289,1661942435,146,1992
3262728353,3041632417,1659495809,1659496808,999,2257
3541881881,3618441418,1661593458,1661594315,857,2002
3443384698,3200827648,1655637478,1655638466,988,2361
3816538946,3189211545,1655683678,1655684581,903,2135
3149534519,3023518914,1653518738,1653519731,993,1398
3873002836,3930051071,1662030105,1662030885,780,1828
3961140276,3923635120,1667521061,1667521605,544,614
3316485303,3152933136,1667099607,1667100133,526,2317
3691317999,3082026010,1651719125,1651719128,3,1925
3741134467,3207801201,1649327735,1649327841,106,119
3617453316,3204735172,1669578834,1669579130,296,343
3648257100,3151923668,1653030581,1653031030,449,2045
3419751912,3678482446,1668710506,1668710971,465,544
3596839317,3709736172,1647901979,1647902177,198,413
3506187447,3337108824,1659992718,1659992852,134,642
3463009951,3501866086,1643065849,1643066735,886,2158
3587903968,3594009328,1642601634,1642602162,528,901
3104793032,3555571916,1658384140,1658384840,700,700
3907872554,3048788442,1653876376,1653876831,455,48
3024979152,3465433147,1652974218,1652974923,705,1464
3698156103,3940115951,1668957321,1668958089,768,1495
3962211697,3017484229,1663694859,1663695464,605,554
3447926518,3448409263,1645431193,1645431474,281,691
3137324029,3552282443,1652870526,1652871327,801,2171
3217250826,3961973688,1659676373,1659676459,86,2331
3315650808,3592379849,1646102660,1646102709,49,1054
3595984663,3908007955,1656305391,1656305394,3,1012
3328479258,3750756562,1647428653,1647429239,586,2098
3379296882,3142160799,1669209851,1669210216,365,2116
3087326516,3568645029,1648278928,1648279745,817,1192
3752297066,3140486428,1666535555,1666535847,292,2347
3179651539,3335355155,1649901097,1649902021,924,1557
3145669202,3501770020,1646772769,1646773495,726,319
3510166785,3622997863,1664697469,1664697937,468,2270
3257973966,3763093748,1648047149,1648047510,361,2049
3302344507,3084982671,1649166238,1649166730,492,1763
3805953085,3795326002,1653394530,1653395157,627,2066
3786840082,3056267922,1658806577,1658806651,74,1191
3110691442,3973440480,1645465988,1645466186,198,1937
3152933136,3372442199,1652840271,1652840709,438,1298
3620985435,3059151355,1658262895,1658263030,135,54
3790157838,3319601888,1657325888,1657325962,74,2439
3457108498,3662455665,1641724121,1641724712,591,2445
3111205819,3299472791,1651998683,1651999253,570,819
3753180150,3536156667,1658074456,1658075354,898,1916
3554261399,3125289160,1654919593,1654920197,604,2205
3269283315,3028910693,1663942229,1663942880,651,2102
3279454391,3856386170,1664387460,1664388272,812,1076
3339633388,3034643506,1645989885,1645990767,882,1767
3361514629,3203153576,1648032418,1648032759,341,1444
3887586447,3445469609,1662441947,1662442399,452,688
3895196680,3526088150,1664229838,1664230663,825,2362
3828738126,3488878461,1661383822,1661384477,655,1116
3160938941,3212043381,1649920304,1649920869,565,685
3364893066,3795940241,1643372841,1643372946,105,292
3744575844,3241021396,1652310018,1652310234,216,572
3755294305,3074795505,1656688787,1656689362,575,2120
3692247556,3710756423,1657496839,1657497552,713,1577
3122127756,3776783076,1650086251,1650086393,142,2023
3050867171,3086653619,1667940587,1667941122,535,1175
3729389785,3287116319,1668652586,1668652704,118,355
3006738164,3227951880,1646776560,1646776658,98,867
3154309446,3780182766,1654783939,1654784266,327,2349
3122246747,3795990774,1647579270,1647579337,67,1424
3461628724,3691021918,1643447701,1643447799,98,1667
3606270024,3842431875,1669012258,1669012612,354,2106
3535467955,3608485872,1665682154,1665682807,653,2411
3856882586,3217029107,1663357704,1663358018,314,1587
3719146348,3486096604,1657690158,1657690904,746,1261
3028910693,3787298788,1664476320,1664476961,641,638
3666148943,3967754963,1661769131,1661769237,106,1506
3421645346,3212038287,1662349235,1662349921,686,509
3338812942,3862102577,1667387902,1667388075,173,1841
3730920499,3346978275,1651703954,1651704354,400,1910
3606270024,3913398460,1666610207,1666610684,477,1288
3692441467,3813318946,1645242246,1645242598,352,2143
3625179175,3808900684,1645376015,1645376330,315,593
3906903088,3489380093,1651969689,1651970065,376,475
3686247296,3194456422,1668899556,1668900103,547,1750
3301093931,3580280923,1642021429,1642021633,204,2011
3315593278,3670387440,1647141013,1647141651,638,1030
3158554223,3421344639,1666364890,1666365143,253,45
3298505096,3863080370,1645137230,1645137244,14,1794
3124200545,3195032074,1659504738,1659504943,205,1686
3985854594,3351277781,1653647276,1653648085,809,436
3398840886,3962031345,1650930315,1650930960,645,1724
3976346769,3620522583,1668947704,1668948033,329,194
3472458500,3453839667,1662080739,1662081093,354,2167
3854535872,3265434991,1649220176,1649221170,994,1585
3228805720,3766062750,1663262457,1663262652,195,139
3691834770,3838136289,1662551148,1662551272,124,686
3825036404,3910979746,1644761251,1644761440,189,81
3106328456,3112739600,1641400319,1641400866,547,1544
3974630210,3335355155,1654044415,1654045297,882,1368
3164391025,3221850819,1653538800,1653539107,307,1915
3747907269,3181181141,1655201261,1655201862,601,812
3100176230,3167058279,1658938109,1658938471,362,2429
3306439333,3637412110,1666159847,1666160149,302,26
3567906153,3174373725,1657042396,1657042668,272,2398
3775103844,3134425396,1643491899,1643492815,916,107
3749756110,3058725687,1660996193,1660996514,321,1762
3968000691,3400211756,1668204021,1668204360,339,370
3928212115,3189435516,1663498427,1663499075,648,1076
3281445213,3567614002,1665549574,1665550277,703,2390
3094414065,3095932716,1651631788,1651632685,897,2438
3694210631,3915206176,1660755824,1660756358,534,2473
3511192827,3079905449,1662584260,1662584787,527,2002
3978728021,3645625556,1644585800,1644585822,22,1004
3084783158,3758695244,1669310411,1669310615,204,1411
3910581173,3000254515,1651374698,1651375692,994,1104
3749308364,3281597338,1656704552,1656704595,43,95
3784046500,3843157491,1656301020,1656301523,503,232
3344077337,3239620599,1658757075,1658757628,553,2424
3218964640,3035287101,1642685103,1642685931,828,720
3719507293,3261195333,1644364106,1644364649,543,1370
3331539245,3641666820,1643117720,1643118117,397,1279
3793966136,3554275173,1669473159,1669473280,121,2384
3788034142,3541423460,1657452253,1657453016,763,197
3968412854,3740438273,1668351252,1668352033,781,199
3818549518,3697822889,1662422083,1662422886,803,2044
3797294746,3270923168,1650895557,1650895867,310,287
3606643671,3174499556,1661629830,1661630308,478,740
3733190374,3057725565,1658255436,1658255940,504,2100
3241007838,3335455607,1642801794,1642802264,470,1771
3504641910,3947712728,1645969737,1645969957,220,2191
3711016575,3941689381,1660856265,1660856930,665,1371
3359278409,3534200501,1657630950,1657631575,625,1065
3137891271,3952874218,1650052472,1650053348,876,887
3083479870,3614399988,1667601506,1667602379,873,473
3538823780,3828219822,1664052258,1664052519,261,1527
3155320608,3762571799,1657880987,1657881596,609,57
3960450011,3671974600,1668099168,1668099884,716,1812
3066645531,3478219461,1656808609,1656809414,805,2056
3495858842,3382453510,1657419457,1657419724,267,998
3885235661,3686704798,1650957858,1650958298,440,1050
3820466728,3401463703,1651547294,1651547813,519,1401
3113214024,3473170336,1645032944,1645033399,455,1446
3653031568,3159525512,1650533277,1650533951,674,2154
3649447383,3998221237,1663960907,1663960934,27,896
3538466951,3570050230,1645104021,1645104936,915,521
3980675077,3495919793,1642075022,1642075610,588,2225
3579486534,3115344578,1664577318,1664578096,778,770
3357029840,3007357837,1663586234,1663586713,479,1580
3377774902,3219440900,1668929399,1668929967,568,1106
3827937024,3481308282,1660339701,1660340132,431,1761
3235476099,3337108824,1642078315,1642078854,539,1551
3281923852,3366262960,1666272503,1666273088,585,1779
3174544371,3687874431,1661095812,1661095897,85,66
3128449335,3183299670,1663397116,1663397171,55,1567
3656002043,3050434345,1664874101,1664874682,581,1578
3740854424,3512575951,1662992436,1662992654,218,949
3553328177,3595984663,1666464469,1666464801,332,2306
3701726268,3315185864,1666339451,1666340004,553,2010
3433576059,3545544203,1645720973,1645721959,986,162
3138539283,3627191763,1645679890,1645680846,956,928
3087394554,3702345362,1655189484,1655189691,207,1621
3859360549,3145312014,1651343814,1651344118,304,2321
3774823325,3722817789,1655392263,1655392884,621,1452
3419117613,3024813851,1658901622,1658902258,636,182
3074412412,3681993008,1653534922,1653535567,645,1151
3316951862,3094852425,1653544518,1653545332,814,450
3553950534,3117234289,1649277789,1649277947,158,1858
3647295073,3287714636,1655117272,1655117522,250,1015
3070237620,3269198119,1646420242,1646420445,203,216
3180984174,3562110382,1668197226,1668197283,57,2099
3477889008,3747046698,1656522102,1656522523,421,1176
3486802233,3896239645,1649560718,1649561071,353,639
3160061122,3979558738,1655378598,1655378622,24,15
3823637809,3492258334,1641573942,1641574143,201,1743
3169072505,3679617161,1660830091,1660830859,768,1780
3640508439,3361694981,1663171111,1663172104,993,1897
3835378465,3734035375,1664936323,1664936463,140,1580
3097426944,3626345917,1641062744,1641062754,10,2095
3195629628,3537294800,1642528577,1642529448,871,303
3677300151,3666174374,1665418977,1665419682,705,1667
3156683897,3945055663,1668408776,1668409051,275,1135
3708309303,3392469094,1660855665,1660856652,987,381
3485046222,3241944871,1667581941,1667582351,410,2338
3831338864,3983727854,1642724027,1642724061,34,1273
3437221963,3063478155,1648343806,1648344165,359,824
3379935974,3564026629,1664525551,1664526071,520,997
3268182022,3930242126,1665031310,1665032039,729,344
3241425701,3711059561,1663857066,1663858065,999,2020
3376552382,3325944344,1665719613,1665720227,614,2289
3913398460,3507644528,1663720088,1663720425,337,2286
3015876104,3139035952,1652140941,1652141314,373,1328
3035158102,3202922076,1648356707,1648356783,76,2254
3177628377,3435518470,1660468481,1660468732,251,1807
3309242036,3074477991,1647384102,1647384539,437,343
3105460297,3379548317,1647761832,1647761922,90,897
3308435698,3828857457,1647824320,1647825298,978,1667
3761636372,3952316985,1654582907,1654583453,546,1732
3716757245,3806728629,1666509500,1666510267,767,1603
3182396653,3492909923,1653706534,1653707487,953,810
3666486477,3757507821,1669192428,1669192652,224,1003
3262645455,3542369467,1660570972,1660571168,196,1519
3362388538,3235672444,1666609042,1666609682,640,282
3442330693,3919162177,1661485325,1661486106,781,710
3834401696,3544772636,1657816567,1657817202,635,174
3182097979,3087278716,1665564222,1665565153,931,2214
3400154631,3361652898,1666697705,1666698522,817,685
3909997437,3633239646,1659961180,1659961458,278,783
3800014504,3559615011,1643411363,1643411897,534,835
3232546504,3993923271,1656675363,1656675734,371,731
3210071519,3676132016,1663027877,1663028548,671,1890
3215453691,3335383594,1665338827,1665338975,148,2006
3715118659,3242897248,1658132181,1658132976,795,2456
3645778086,3377868003,1661290180,1661290430,250,1380
3154158203,3891579335,1651309088,1651309503,415,55
3455808094,3372442199,1655030050,1655030539,489,443
3163012662,3776954666,1659782170,1659782204,34,1803
3427860415,3293435801,1652107524,1652107721,197,864
3543696190,3298505096,1669760468,1669760581,113,784
3832072924,3356144129,1649273011,1649273832,821,333
3531256735,3617958907,1662670661,1662670940,279,405
3226298244,3016568360,1669035215,1669035579,364,511
3028643875,3437707461,1649558942,1649559718,776,875
3714122939,3188588023,1650965122,1650965340,218,1483
3057300178,3658659669,1669683781,1669684123,342,1874
3657115450,3935978133,1656338130,1656338906,776,1927
3546486600,3569525429,1655710075,1655710566,491,834
3739439527,3721340009,1669154333,1669154617,284,2479
3946833004,3779590261,1656771016,1656771690,674,1633
3791462728,3733975709,1660079883,1660080518,635,1379
3958050741,3176432386,1641308429,1641308935,506,2203
3803959008,3486061006,1659242177,1659243068,891,1699
3208831400,3558493130,1667765382,1667765429,47,657
3537943189,3606545393,1669227285,1669227981,696,1689
3855762650,3286555687,1665842353,1665843194,841,2181
3280717680,3900101700,1656720675,1656721000,325,2000
3230775095,3064032505,1647964123,1647965042,919,1434
3708034201,3432563578,1661498473,1661498491,18,531
3508224327,3321818923,1649852712,1649853251,539,1045
3415686543,3037984397,1667352292,1667352790,498,2092
3919792223,3579684205,1643330992,1643331933,941,2482
3840155828,3040627958,1652431912,1652432692,780,1197
3415788314,3950047958,1662697516,1662697960,444,621
3620311248,3962746969,1667063369,1667064028,659,1331
3119523311,3025333750,1643596301,1643596908,607,2366
3682116874,3127783768,1644830681,1644831478,797,1818
3343059553,3254930364,1654416342,1654416841,499,585
3944914500,3022102664,1644242445,1644243432,987,1285
3792924517,3592235229,1652089111,1652089969,858,2226
3481689842,3291667893,1665943073,1665943463,390,711
3129993467,3963385029,1649822929,1649823088,159,1403
3281803406,3613188168,1660621233,1660621334,101,2331
3964711138,3339027368,1661656227,1661656655,428,2052
3757370089,3953118937,1664328887,1664328923,36,2369
3111167324,3424584896,1654295718,1654296613,895,602
3068661794,3734035375,1659167392,1659168085,693,2375
3395679954,3462862340,1663352817,1663353663,846,1660
3798631691,3887342054,1661251685,1661251746,61,2023
3640571571,3810798932,1643815610,1643815758,148,80
3462088604,3361167735,1657638706,1657638825,119,1633
3592561930,3628789282,1662161048,1662161317,269,579
3934125569,3029956642,1649569045,1649569051,6,129
3811930283,3621462507,1666910205,1666910796,591,1539
3132258390,3709075485,1647824973,1647825704,731,162
3567614002,3058606856,1656292980,1656293500,520,1937
3260695363,3624103484,1653496802,1653497280,478,602
3906396830,3392105056,1657318887,1657319400,513,1407
3927329503,3647539125,1645432974,1645433553,579,1900
3278612503,3024268753,1644251020,1644251604,584,554
3564026629,3725283025,1668684790,1668685462,672,389
3104944123,3581302872,1649569569,1649569754,185,399
3710394011,3309242036,1667406143,1667406285,142,887
3273243249,3910760009,1654476362,1654477219,857,2015
3007357837,3154704216,1655848392,1655849299,907,1536
3349716508,3408978529,1664453006,1664453634,628,1952
3656829277,3766062750,1659310343,1659310483,140,83
3583864167,3726520685,1647642545,1647642993,448,1185
3864436164,3344957789,1646871754,1646872732,978,1108
3612061421,3838160976,1658213666,1658214477,811,1540
3771931468,3090383487,1653911288,1653911492,204,2356
3424584896,3896357807,1663827850,1663828483,633,813
3909585382,3832265812,1650341808,1650341963,155,2292
3452181736,3862583365,1663687199,1663687554,355,2172
3102669962,3373239702,1666391236,1666391293,57,1919
3137092101,3562875112,1666554838,1666555231,393,1342
3773627036,3483254795,1658115629,1658115761,132,2051
3834720743,3070557341,1664910739,1664911646,907,1741
3155797946,3070984953,1641772782,1641773037,255,1011
3566825897,3266270844,1642226784,1642226951,167,533
3522861132,3678340379,1648794510,1648795275,765,1975
3827867076,3507564472,1647053930,1647054836,906,1486
3180294141,3199255829,1654432015,1654432068,53,2043
3787590278,3620939715,1644857127,1644857993,866,761
3492657889,3076767349,1643272283,1643272472,189,812
3419807636,3867640062,1668701525,1668702487,962,1289
3043256301,3490381305,1654312367,1654312384,17,2062
3886780901,3382453510,1666239951,1666240488,537,2208
3870779720,3315854812,1645060944,1645061468,524,482
3070241461,3633498077,1649391808,1649392064,256,283
3565052722,3650041115,1648404693,1648405450,757,2350
3579093901,3644164788,1656343032,1656343244,212,888
3045925838,3557734825,1653689816,1653690546,730,1746
3600856738,3480314503,1654187873,1654188737,864,1000
3067930449,3293924278,1653026023,1653026841,818,1188
3122288373,3054758455,1665345198,1665345475,277,1541
3292739128,3725465166,1648475429,1648475476,47,313
3878683407,3311118815,1661973591,1661974533,942,2107
3179855785,3534224607,1650713242,1650713795,553,2273
3985513037,3870359885,1651382285,1651382935,650,1773
3043656500,3373656201,1667351507,1667352313,806,1642
3170924487,3667718430,1649526684,1649526775,91,2175
3776334300,3919489244,1649768677,1649768723,46,2198
3364938815,3196704660,1666105876,1666106440,564,2327
3029374380,3054573274,1654220787,1654221397,610,1263
3240347468,3343729897,1645843172,1645843277,105,2080
3808397193,3526315797,1667240702,1667241332,630,2187
3457317780,3487387362,1652184571,1652184659,88,1450
3626015702,3112742999,1650462441,1650462778,337,593
3142230569,3671437138,1661856156,1661856157,1,2299
3201142543,3034985161,1666328138,1666328871,733,1341
3215423327,3565287194,1667650242,1667651154,912,225
3429010148,3194796707,1667342077,1667342807,730,432
3500948971,3604376955,1653424485,1653425307,822,1159
3040136606,3732256987,1666689613,1666689627,14,1797
3484710507,3644128961,1661421331,1661422093,762,1508
3146653168,3962658092,1654588141,1654588573,432,1106
3225500469,3453552267,1656651263,1656652162,899,2463
3248395971,3325735480,1662981429,1662982112,683,1997
3760047951,3305299292,1651838604,1651839220,616,471
3167716044,3235672444,1664477882,1664478880,998,10
3937445570,3671974600,1648284043,1648284323,280,2216
3329135548,3881956491,1657232856,1657233590,734,1540
3485995293,3756806050,1648251884,1648252508,624,2345
3077552507,3133902865,1644684208,1644684314,106,638
3396154732,3114863942,1643996011,1643996653,642,638
3801205465,3610239794,1644862182,1644862256,74,2233
3900101700,3991686619,1648349219,1648350003,784,161
3066588932,3112742999,1659338763,1659339604,841,650
3415020400,3452920322,1646154817,1646155147,330,1483
3641928180,3698706740,1666055178,1666055303,125,506
3817057878,3176526207,1648761212,1648761502,290,1797
3476728930,3544227988,1668494430,1668494677,247,647
3838851134,3050271924,1646407172,1646407476,304,1364
3038211411,3027295354,1652952834,1652953338,504,566
3673561332,3544133682,1647388425,1647388913,488,1482
3378814600,3440969146,1641554631,1641555061,430,979
3841170833,3342315965,1659431631,1659431808,177,2352
3960494982,3436198180,1661013964,1661013993,29,2112
3156210736,3169601604,1651568066,1651568983,917,609
3931677547,3809642935,1660708768,1660708897,129,788
3097501233,3672276184,1646477211,1646477856,645,1893
3702983168,3243831128,1646189188,1646190060,872,244
3127783768,3372471333,1665556235,1665557179,944,1516
3378791519,3679519826,1657066622,1657067410,788,1389
3435340439,3035158102,1664532152,1664532403,251,813
3113760926,3840659531,1662593722,1662594521,799,1308
3008417861,3297626110,1645645662,1645645894,232,186
3540735539,3798223043,1659768947,1659769935,988,1506
3058789362,3415917688,1653185235,1653186084,849,856
3571719140,3372334548,1667747982,1667748188,206,2158
3009365802,3211795832,1653850962,1653851634,672,957
3055603453,3347942747,1663421490,1663421760,270,300
3154553765,3323198594,1658745403,1658746311,908,624
3500152600,3579093901,1651239017,1651239739,722,916
3701214753,3660998516,1643296475,1643297172,697,909
3947521897,3647539125,1653069622,1653070248,626,2479
3991673197,3474315750,1652243996,1652244117,121,13
3539866422,3354200745,1663520778,1663521357,579,1718
3277810331,3352005808,1667982114,1667982841,727,1270
3313426081,3878943307,1658754496,1658755388,892,1487
3839688715,3436888201,1654521067,1654521704,637,1874
3969036937,3404563689,1657105935,1657106839,904,1623
3091275117,3564033398,1668089387,1668090320,933,2158
3556647439,3496921526,1658591576,1658592546,970,824
3422046745,3100402840,1641934396,1641934396,0,2171
3486442976,3651503901,1650184954,1650185633,679,724
3119702215,3112742999,1643082664,1643083396,732,2247
3456660113,3554275173,1645220965,1645221137,172,194
3767581542,3285225403,1661611499,1661611971,472,463
3604769442,3366845170,1660791137,1660791566,429,1371
3414748923,3866268396,1645428371,1645429053,682,1198
3579486534,3016508907,1646901378,1646901406,28,1055
3863827466,3106429728,1660684296,1660684322,26,1681
3380313835,3662526382,1646871356,1646871723,367,1260
3645523523,3604456101,1659535434,1659536330,896,785
3459115924,3882415224,1668297368,1668297486,118,307
3729475963,3435224460,1648512491,1648513331,840,1587
3553436680,3927657297,1647260372,1647260673,301,540
3488757134,3279239799,1664353824,1664354240,416,2100
3014975304,3921490578,1665137715,1665138379,664,2248
3226298244,3932077086,1654484064,1654484887,823,715
3980087695,3552494506,1647864354,1647865181,827,1266
3566693010,3387247558,1662351789,1662352294,505,1061
3408944120,3295262122,1662039002,1662039835,833,2258
3907713562,3963351842,1669666978,1669667566,588,355
3343059553,3894115655,1649481425,1649481895,470,1476
3936329512,3240324089,1663704100,1663704784,684,249
3869711224,3190035679,1643609897,1643610522,625,1584
3423909447,3942325631,1643589616,1643589622,6,1945
3404873411,3128805218,1666704269,1666704926,657,2273
3089844622,3080930599,1665417369,1665418202,833,144
3653069495,3707258240,1665103879,1665103899,20,2428
3237563954,3372544937,1667759733,1667759745,12,2031
3891235779,3070810251,1667187825,1667188259,434,1758
3686968293,3078231218,1646382860,1646383310,450,1108
3128248749,3980934555,1661877323,1661877548,225,24
3844966905,3205472801,1664633552,1664633846,294,1383
3327311623,3710331536,1666954645,1666955034,389,1225
3232285985,3664898256,1669531594,1669531690,96,1624
3184720975,3335565751,1663242913,1663243526,613,2140
3677965553,3239265546,1657121721,1657122702,981,2449
3802267458,3995868243,1651894515,1651895070,555,591
3518079213,3069353793,1655017393,1655017841,448,1691
3304973317,3773789419,1643411298,1643411432,134,265
3341694529,3973010524,1664924705,1664925680,975,1731
3570872297,3933607460,1652610930,1652611072,142,1286
3166521010,3586600196,1645847352,1645847765,413,246
3068913990,3533172784,1660432587,1660432774,187,461
3643637605,3145948160,1659691902,1659692169,267,292
3900241568,3097563397,1657223348,1657224042,694,1693
3279351560,3634624974,1651912233,1651912600,367,2092
3594173372,3154680228,1653407594,1653408132,538,2192
3407460146,3769391036,1665952649,1665953319,670,260
3060989519,3968076690,1657649076,1657649650,574,1190
3631587282,3450023391,1664384640,1664385139,499,2248
3240340462,3128571119,1649231247,1649231566,319,2005
3413300274,3253589940,1645106439,1645106556,117,2099
3310294122,3004870031,1659073866,1659074493,627,1827
3818028118,3999128559,1647466208,1647467112,904,2476
3069992620,3502316165,1653292542,1653292881,339,2044
3104009859,3277372807,1662031414,1662031984,570,1727
3964738114,3050434345,1648501285,1648502221,936,107
3532270724,3071667890,1644557611,1644558407,796,1756
3415768719,3933450798,1652444226,1652444648,422,2040
3909765076,3330048607,1657544282,1657545250,968,2377
3104902156,3098891437,1661099788,1661100159,371,2228
3887342054,3915206176,1655362734,1655362945,211,509
3761201412,3026209549,1644234873,1644235126,253,2145
3934914335,3258739109,1652865935,1652866391,456,1322
3074412412,3740236087,1654436804,1654436950,146,648
3081028310,3809965750,1663886844,1663886877,33,865
3125813072,3512631937,1647893830,1647894656,826,459
3180984174,3719785520,1651510451,1651511141,690,661
3625179175,3988337484,1657506965,1657507495,530,828
3043354217,3374174584,1645171510,1645171535,25,1067
3228277648,3531642816,1644401623,1644401855,232,2368
3309922968,3402426323,1664970349,1664971242,893,1195
3779998740,3994967281,1656042273,1656042303,30,632
3459018363,3687691090,1651507730,1651508077,347,1189
3269653223,3293865251,1666343104,1666343374,270,387
3632101943,3132486699,1645406406,1645407302,896,977
3207801201,3781268781,1642213315,1642213656,341,1981
3921816397,3163552496,1654809965,1654810126,161,1774
3522621112,3402439234,1666426167,1666427080,913,540
3400684585,3866534454,1646760649,1646761081,432,1063
3585982995,3301471485,1658698702,1658699580,878,2142
3661369487,3526197227,1651323101,1651323108,7,1373
3117230173,3729356619,1665932015,1665932432,417,1200
3383751042,3033029762,1661440408,1661440827,419,1701
3471085694,3003858315,1666210629,1666211060,431,1617
3595984663,3653881945,1662202462,1662203257,795,588
3037301537,3651286291,1645424059,1645424249,190,1637
3132611388,3798563042,1647140147,1647140266,119,367
3416196153,3206119800,1653713850,1653714609,759,2249
3541597384,3870877628,1658792844,1658793068,224,1653
3613730980,3005283650,1659244695,1659245386,691,58
3623620611,3990949387,1654967979,1654968624,645,352
3563407459,3660839110,1651064279,1651064670,391,1542
3343249545,3329449985,1642503927,1642504068,141,204
3795934256,3186371475,1665688632,1665688775,143,2040
3999390272,3194664110,1650111745,1650112125,380,987
3321818923,3997050001,1655365979,1655366037,58,2444
3434575449,3256648307,1642810451,1642810478,27,2247
3867126446,3183507473,1655202987,1655203576,589,1537
3424897066,3269966376,1646806982,1646807717,735,2244
3869293895,3094562402,1669613480,1669614285,805,1013
3301620813,3864249446,1645852504,1645853105,601,15
3369469616,3784629786,1655882935,1655883580,645,838
3371785046,3869794122,1653146772,1653147036,264,2136
3092292487,3957216784,1645036744,1645037073,329,1507
3543732655,3793996748,1660524961,1660525864,903,1536
3767912489,3248892530,1656177083,1656177216,133,2283
3471288672,3424584896,1643947597,1643948254,657,1990
3960772879,3240347468,1664569029,1664569511,482,106
3811308890,3120823401,1641274584,1641275230,646,1265
3875008839,3923683467,1663870898,1663871090,192,1077
3189396065,3316318605,1654324086,1654324626,540,2134
3919792223,3152036409,1655513777,1655514298,521,239
3471797400,3442354739,1647187702,1647187912,210,422
3877205464,3543239972,1646767081,1646767370,289,2190
3668625909,3310520005,1652953509,1652953779,270,1668
3158503756,3675366639,1656933360,1656933732,372,218
3470488588,3721340009,1659465351,1659466148,797,2181
3953768846,3798512184,1649835059,1649835969,910,1799
3271409183,3861247260,1648429239,1648429989,750,17
3539839307,3438130685,1643367754,1643368115,361,2302
3150793263,3470049551,1651056717,1651056731,14,382
3048296949,3260867614,1662063618,1662064238,620,1656
3014462663,3197352308,1642869329,1642869756,427,1015
3382974723,3330048607,1658894525,1658894791,266,315
3046707177,3446490643,1643669150,1643669193,43,1518
3752652141,3252021647,1644002749,1644003587,838,2092
3528505546,3154009016,1660102658,1660103408,750,1501
3947461796,3350345176,1657413352,1657413836,484,708
3581302872,3806664868,1649317149,1649317328,179,1678
3304589206,3861247260,1641087609,1641087694,85,1751
3846585557,3552494506,1663938425,1663939094,669,1922
3092800496,3361365460,1667071192,1667071546,354,1908
3097016405,3228277648,1668811015,1668811414,399,1157
3030290445,3687925631,1646728528,1646728671,143,2430
3404200815,3739420445,1641573430,1641574419,989,256
3749211785,3139035952,1669700030,1669700275,245,837
3925688803,3094125203,1662997057,1662997346,289,164
3163395401,3833110040,1650686780,1650687418,638,517
3975462879,3567906153,1646006882,1646006977,95,974
3550874434,3052789625,1648756367,1648756951,584,285
3095151362,3124964775,1650669397,1650669485,88,1915
3115029581,3710782213,1668907905,1668908108,203,453
3629797745,3332206707,1653182200,1653182727,527,328
3903886201,3287078889,1650157677,1650158036,359,1670
3101886383,3083791573,1651884236,1651885052,816,1226
3773742235,3902329320,1659105895,1659106636,741,983
3458389447,3500320805,1661671716,1661672521,805,2099
3791389559,3957216784,1644513317,1644513729,412,857
3804318840,3383686911,1651269570,1651270172,602,2076
3120092137,3911316683,1658665348,1658665563,215,2143
3653770219,3937429867,1649445099,1649446020,921,674
3911439857,3292365668,1648649790,1648650410,620,1265
3541157955,3069316815,1668450049,1668450136,87,2010
3785883615,3038630181,1654967872,1654968701,829,7
3499182342,3249252169,1654506643,1654506821,178,715
3896308173,3693925345,1662801496,1662802092,596,1222
3222282745,3041809783,1643051361,1643052293,932,2414
3673524018,3502690432,1659349862,1659349878,16,1097
3423971586,3149191705,1656831849,1656832068,219,1150
3085921604,3868427833,1661397140,1661397187,47,411
3332506866,3283447626,1642190445,1642190981,536,922
3531118058,3162836777,1655601161,1655601320,159,1469
3222563704,3944398168,1662454671,1662454983,312,1546
3749811473,3216243579,1663422821,1663423521,700,1700
3219575313,3118057575,1660064065,1660064281,216,2367
3079415495,3156538951,1656790818,1656791404,586,1067
3853163109,3336947163,1665437838,1665438826,988,1791
3013484024,3629824081,1664019789,1664020027,238,2228
3793503160,3745420516,1643346371,1643346685,314,556
3026769225,3503393955,1655804949,1655805326,377,916
3504641910,3169486525,1664547544,1664548116,572,1895
3548133562,3630982131,1664783496,1664784188,692,1091
3035737560,3361422449,1660108461,1660108844,383,1921
3030192990,3346948485,1666963456,1666964178,722,2028
3728224229,3823650698,1647796980,1647797859,879,668
3121932256,3838851134,1644748475,1644749037,562,1425
3375585327,3829971179,1657382186,1657382905,719,1960
3290860752,3164836342,1641392601,1641393198,597,247
3242622170,3528475061,1643879699,1643880231,532,940
3501962027,3573961768,1652226537,1652227433,896,621
3810823450,3350891476,1656633780,1656634491,711,1448
3664426298,3939755962,1647920211,1647920579,368,1172
3679522128,3900843323,1647653959,1647654004,45,329
3993580342,3180728306,1649087765,1649088626,861,1280
3166517941,3650342769,1651478823,1651479235,412,1938
3976223971,3585526520,1646078552,1646079053,501,1647
3072911780,3845886572,1647692112,1647692594,482,1515
3112739600,3664426298,1653547504,1653547568,64,1668
3301119536,3442244098,1654981080,1654981991,911,2425
3289061595,3667414511,1645726919,1645727912,993,1122
3959504618,3819405521,1643718840,1643719836,996,2480
3111965011,3461451325,1652080527,1652081385,858,2235
3191792012,3539510682,1652678372,1652678644,272,1928
3216243579,3243018622,1658538468,1658538484,16,189
3721870717,3828516865,1642195978,1642196033,55,898
3027287663,3192375486,1643876643,1643876685,42,1973
3555538922,3939469152,1666429510,1666430363,853,2479
3014354609,3962746969,1649240980,1649241041,61,2324
3804458349,3593988999,1669729075,1669729734,659,1521
3199395221,3018838603,1666927289,1666927542,253,229
3791279041,3876696308,1666874205,1666875132,927,1794
3671296032,3192005711,1659819160,1659819747,587,258
3399055713,3150817357,1648506730,1648506914,184,1596
3412109130,3790356065,1658664832,1658665052,220,180
3907705988,3260867614,1660474726,1660475226,500,539
3486096604,3445743049,1651849043,1651849433,390,384
3324611610,3154079557,1650835523,1650836088,565,799
3293237543,3316287541,1655891768,1655892123,355,1926
3594853846,3379756257,1666085287,1666086005,718,710
3384222838,3702439685,1658820900,1658821357,457,495
3150289965,3358156140,1663348694,1663349082,388,1901
3080214168,3141134453,1645991528,1645992463,935,316
3811472324,3406215034,1658684644,1658685536,892,2056
3344713569,3307033178,1667490446,1667491085,639,979
3125112685,3521944506,1653185276,1653186189,913,1639
3148284665,3844499309,1661628086,1661628309,223,1855
3052822229,3862138776,1652951792,1652952700,908,2449
3625611440,3446490643,1641609256,1641609762,506,2116
3125350196,3116777827,1646266560,1646267546,986,378
3044345094,3431000503,1647945460,1647946110,650,1620
3115177011,3541157955,1649208066,1649208125,59,1742
3362173874,3602891052,1650239932,1650240391,459,834
3190003253,3264281080,1651784238,1651784654,416,558
3206399216,3754795349,1668902139,1668902219,80,90
3580774207,3992909356,1666725054,1666725184,130,1295
3281562391,3290681709,1653952759,1653953418,659,910
3413056504,3520571883,1642725873,1642726196,323,165
3903779058,3902777743,1650913833,1650914658,825,327
3261255394,3305480485,1665982616,1665983369,753,2011
3427520419,3959261742,1658519214,1658519460,246,570
3825900664,3164355501,1659612048,1659612185,137,1455
3419415544,3244398882,1666062887,1666063188,301,530
3835202206,3599869347,1642695335,1642696229,894,261
3988337484,3439827305,1662676392,1662677026,634,552
3804145408,3262543891,1666637774,1666638031,257,156
3000890083,3423909447,1653710143,1653710641,498,1185
3104009859,3270919620,1645556967,1645557098,131,205
3180294141,3881519714,1651884502,1651884858,356,18
3760142759,3093146280,1643798724,1643799208,484,1772
3594682644,3801847517,1641364390,1641365168,778,275
3462743550,3551884757,1669466931,1669467120,189,1668
3749379310,3945397961,1650802217,1650802490,273,197
3431117217,3480905975,1653618462,1653618559,97,1672
3879322451,3523829341,1668820436,1668821102,666,1733
3043604048,3524109178,1644745555,1644746439,884,271
3547923552,3366583139,1644707243,1644707938,695,1606
3751588241,3590361712,1652159304,1652160201,897,1779
3420489464,3068239649,1658319655,1658319765,110,872
3307185651,3976984063,1655295359,1655296096,737,1262
3029374380,3726367604,1644362601,1644363437,836,1418
3590259850,3336551797,1649397434,1649398324,890,2336
3415041326,3234656999,1652761948,1652762156,208,896
3115343467,3412673526,1665920555,1665920594,39,1817
3618532396,3095124554,1642094239,1642094793,554,1421
3474376744,3924879744,1655421578,1655421786,208,2494
3975864053,3293504206,1663533786,1663534343,557,578
3925523737,3609043475,1643608059,1643608438,379,1279
3106276005,3748478851,1650157430,1650158320,890,543
3065482463,3352751731,1658923290,1658923712,422,945
3003941040,3004870031,1646046315,1646046838,523,1082
3491468798,3098290557,1643985572,1643985866,294,1105
3932613929,3662507847,1649136226,1649136509,283,1489
3014275222,3322083266,1642984963,1642985277,314,912
3796559738,3816935536,1649241463,1649241744,281,2215
3688758916,3161774382,1663069232,1663069333,101,768
3794715398,3263488499,1651505412,1651506073,661,595
3898603481,3156098708,1659733172,1659733404,232,567
3161412125,3083235668,1664913445,1664913735,290,1038
3195032074,3560977513,1642544850,1642545603,753,520
3642498039,3367685887,1661004171,1661004811,640,8
3378791519,3449395269,1657727471,1657728183,712,460
3973226891,3912014286,1667032945,1667033878,933,304
3553712893,3753596469,1642860406,1642860944,538,1798
3725465166,3292797747,1669640773,1669641614,841,2288
3961420550,3521944506,1643578672,1643578788,116,503
3371002443,3561113748,1648605419,1648605743,324,1694
3998987664,3943622737,1643931447,1643931789,342,248
3170292789,3016871175,1668987581,1668987833,252,1599
3466942824,3469600523,1661685712,1661685940,228,393
3407409307,3879787945,1663513322,1663513982,660,488
3492103801,3802325069,1653002109,1653002371,262,310
3693920541,3786148014,1657406607,1657407369,762,1159
3537787770,3741273371,1662635874,1662636171,297,1112
3888703674,3332458882,1647402644,1647403523,879,646
3360342048,3319446954,1664573749,1664574285,536,413
3806664868,3947105207,1644297086,1644297503,417,524
3739420445,3816567987,1641011579,1641012197,618,2091
3982210988,3890781778,1644839826,1644840047,221,134
3488280503,3477889008,1646408327,1646408793,466,1310
3752701792,3644128961,1648428599,1648429033,434,1615
3366189965,3327933393,1669387837,1669388065,228,238
3534218813,3372442199,1667460556,1667461351,795,2492
3265078616,3688790539,1668181247,1668181416,169,1816
3046707177,3271919876,1667113802,1667114790,988,2003
3388490960,3037844343,1658182821,1658183358,537,2186
3137829230,3478097925,1669015654,1669016309,655,1470
3310037244,3524109178,1655364400,1655365389,989,1159
3193403424,3522814184,1651708846,1651709456,610,716
3957430800,3975864053,1644289730,1644290489,759,591
3283211870,3395525819,1658727856,1658727971,115,262
3708777992,3829971179,1667028429,1667028608,179,792
3663985085,3079447248,1660389359,1660390141,782,1768
3867158050,3753659944,1661819357,1661819808,451,220
3447440058,3721374677,1656116123,1656116444,321,1003
3541372095,3469471892,1660784425,1660785423,998,2093
3837366084,3621969167,1667131592,1667132316,724,1447
3942520090,3319546209,1665756860,1665756997,137,2090
3090804084,3622062401,1659952288,1659952971,683,722
3785586097,3310262408,1642886407,1642886461,54,482
3824168840,3620006027,1658107531,1658107897,366,136
3369913868,3240369434,1662989758,1662990657,899,1202
3298044531,3915344164,1660186693,1660187631,938,1863
3368630986,3005231138,1650717710,1650718452,742,801
3367347813,3019631963,1661720773,1661721005,232,235
3474808421,3516410980,1651974882,1651974951,69,1559
3808604912,3512662328,1658814265,1658814988,723,2210
3546284533,3731206373,1660638151,1660638433,282,262
3961973688,3619704547,1646641241,1646641928,687,1003
3761218329,3190778281,1653206360,1653207067,707,1764
3403223215,3904874839,1658304229,1658305137,908,442
3895274115,3961903747,1641974258,1641975154,896,676
3442477300,3734534401,1650110751,1650111614,863,2015
3280046501,3603131487,1669183535,1669184411,876,1361
3086551217,3683246538,1650965073,1650965086,13,490
3973226891,3107865208,1661537179,1661537929,750,2359
3656674833,3757305418,1645678245,1645678539,294,2405
3282166903,3878925459,1666566503,1666566602,99,1074
3069353793,3653429754,1656751523,1656752379,856,1231
3073474496,3810823450,1667180942,1667181111,169,1417
3350387055,3162284444,1665446177,1665446540,363,1159
3027129249,3041385548,1659285819,1659286782,963,436
3548799053,3391441349,1649122185,1649122834,649,1164
3837366084,3304728211,1658528813,1658529682,869,2168
3209097023,3097128642,1652078389,1652079155,766,190
3688345244,3646797040,1665058187,1665058462,275,765
3340464785,3840694563,1645460783,1645460870,87,1961
3437109709,3389497658,1653687118,1653687288,170,1422
3277327180,3323834326,1665683371,1665684099,728,286
3772853715,3110691442,1667366379,1667367077,698,1148
3332206707,3506971803,1652956960,1652957247,287,2408
3300694030,3720941666,1650765368,1650765705,337,516
3423640116,3921490578,1655109265,1655109354,89,297
3111965011,3615359439,1651991095,1651991376,281,1786
3991673197,3843953645,1648256322,1648257045,723,2434
3328922333,3908209550,1664304194,1664304637,443,961
3246028948,3302113605,1646225717,1646226154,437,2364
3632156948,3851747907,1669547720,1669548067,347,1787
3026035554,3431000503,1662940773,1662941383,610,427
3516547882,3791460437,1661056466,1661056817,351,1349
3580901513,3244514632,1647136610,1647137500,890,1150
3096710771,3261463305,1657966625,1657966955,330,1721
3066956305,3283211870,1657090587,1657090975,388,1773
3473571389,3328737379,1650659594,1650660312,718,2103
3569743064,3982960576,1661351054,1661351230,176,1700
3474543664,3572224210,1662047112,1662047910,798,2013
3336991621,3948180125,1650977072,1650977135,63,710
3309799085,3159669419,1646293405,1646293539,134,1934
3620236387,3373566394,1643219141,1643219931,790,2170
3572746096,3147376468,1669605974,1669606436,462,2383
3926088173,3780885377,1652834823,1652835138,315,383
3092003105,3534545428,1643789081,1643789761,680,1467
3084592361,3318735194,1667034544,1667035196,652,1196
3194871172,3888856112,1653238633,1653239606,973,517
3278077270,3426753006,1652522909,1652522949,40,2343
3077346044,3628927796,1647187341,1647187351,10,2409
3139928298,3013064040,1650736524,1650737291,767,734
3257080734,3702439685,1662991856,1662992039,183,167
3150893774,3033079935,1644220397,1644220476,79,2360
3790964737,3108566218,1652764693,1652764883,190,1726
3516399207,3126417218,1641699232,1641699554,322,1558
3725848338,3776942930,1655780379,1655780948,569,257
3352634974,3058606856,1645204949,1645205119,170,638
3703615574,3130093617,1663007015,1663008014,999,1094
3455537522,3752669447,1643271152,1643271591,439,1222
3190969092,3136200575,1665658261,1665658796,535,1534
3762571799,3749308364,1666013859,1666014036,177,1152
3962045766,3391426421,1666654388,1666654964,576,1394
3795326002,3340837702,1660327043,1660327949,906,2195
3599604382,3865503383,1658449253,1658449537,284,2056
3419336769,3344891111,1652424089,1652424220,131,1304
3110016926,3180294141,1643480744,1643481680,936,1063
3900571767,3962773297,1665143416,1665144130,714,123
3357478199,3031816406,1660826559,1660826683,124,1582
3640765121,3927657297,1667895128,1667895452,324,1018
3689020840,3824353209,1646219975,1646220473,498,1595
3506143492,3662935617,1643549724,1643550223,499,1887
3434729931,3891518316,1659399608,1659399740,132,1222
3452248216,3059858458,1657573308,1657573481,173,1460
3459830291,3434363944,1651563167,1651563275,108,2010
3640949933,3772178120,1661825741,1661825844,103,1213
3298857826,3099559880,1667162234,1667162341,107,1162
3365134626,3437109709,1662476489,1662476981,492,966
3558312644,3500097822,1655061065,1655061342,277,1929
3035737560,3117322872,1656653433,1656653843,410,938
3842560828,3175706913,1658218048,1658218187,139,2058
3974804920,3328922333,1665234865,1665235019,154,2151
3956055955,3083020614,1644801125,1644801362,237,758
3615848654,3898603481,1666643862,1666644349,487,164
3554600361,3874913687,1652850916,1652851334,418,1274
3807576323,3165536332,1668920096,1668920879,783,33
3878683407,3559863065,1660577287,1660578083,796,1426
3098264219,3669874673,1654604269,1654604662,393,408
3574486853,3550261012,1666048673,1666048940,267,2000
3301994647,3213397142,1642032535,1642033182,647,72
3773830646,3158338043,1660712858,1660713842,984,2203
3309684706,3428142421,1660541897,1660542657,760,1738
3701501875,3534218813,1657679415,1657680224,809,926
3234141140,3346164838,1662277496,1662278385,889,1635
3380822514,3831009076,1669388461,1669389229,768,554
3124222667,3651812819,1657820533,1657821285,752,797
3786811867,3625611440,1643570936,1643571673,737,1093
3595144575,3046500774,1659918259,1659918631,372,848
3320272612,3520571883,1647475687,1647476420,733,318
3045016501,3497171741,1645269566,1645269813,247,1952
3798714576,3173034893,1668901049,1668901994,945,2040
3356154602,3914348680,1664180915,1664181802,887,2284
3775753518,3139928298,1662173513,1662174459,946,1254
3556000533,3155807587,1641190177,1641191129,952,1469
3695419353,3662788693,1652077582,1652077667,85,29
3023259214,3236132865,1668839794,1668839858,64,910
3585553252,3569557301,1656469016,1656469636,620,135
3555108136,3606270024,1665639025,1665639428,403,1533
3910712536,3674049704,1664027322,1664027373,51,1064
3344664961,3862371205,1659963923,1659964764,841,1613
3721226798,3447051833,1654473993,1654474115,122,855
3658428855,3299472791,1664220145,1664220978,833,1397
3841904297,3607959490,1667923560,1667923832,272,807
3150503842,3112602434,1657262206,1657262302,96,145
3253589940,3047001138,1668345496,1668345635,139,71
3546799061,3741134467,1665979724,1665980465,741,491
3123999917,3716137932,1642315504,1642315549,45,1218
3001302955,3094852425,1642479469,1642480444,975,310
3309053474,3045537893,1667649446,1667649713,267,35
3940391939,3395457102,1645913348,1645914274,926,2448
3853258306,3653218860,1667090183,1667090998,815,1327
3128248749,3449125023,1647860145,1647860798,653,1998
3370701718,3581207584,1664657153,1664658004,851,63
3528505546,3115245083,1668114307,1668114484,177,238
3015956370,3587633750,1650666808,1650667292,484,134
3068242755,3421875747,1649946922,1649946927,5,2255
3561336684,3349724698,1669429500,1669430268,768,2324
3931108765,3011459628,1646891075,1646891966,891,292
3937129101,3046080865,1642624936,1642625853,917,93
3561899633,3116684420,1651364722,1651364934,212,966
3770393539,3388814754,1647146762,1647147512,750,821
3944493334,3419336769,1662239100,1662239357,257,1376
3195148360,3281146609,1658991620,1658992389,769,1852
3748950684,3094414065,1650391809,1650392646,837,202
3057102903,3996381336,1641989287,1641989436,149,1115
3961677423,3634044438,1654825343,1654825572,229,1329
3108566218,3511397819,1663015325,1663016066,741,1509
3601690466,3312661854,1669734572,1669734856,284,2008
3369040211,3904907996,1666482454,1666483085,631,904
3225909236,3568614629,1667663361,1667663693,332,562
3127771930,3020446596,1644155499,1644155891,392,2093
3095151362,3661037098,1646399817,1646400557,740,886
3199797181,3883071832,1657925586,1657925761,175,2175
3348113823,3773505782,1643811971,1643812918,947,716
3043064916,3908997041,1658352106,1658352595,489,2187
3010713914,3691367177,1667382273,1667383079,806,1428
3907213401,3927388172,1668315415,1668315692,277,2376
3895274115,3356144129,1653787961,1653788382,421,2214
3278703976,3319128889,1665300521,1665300937,416,1773
3666268915,3629207282,1660184926,1660185082,156,60
3415917688,3878698797,1648152651,1648152813,162,2496
3728878635,3591264259,1642982920,1642983555,635,118
3148691436,3863448086,1661128718,1661128733,15,1458
3011686027,3534218813,1644610584,1644611528,944,341
3764173171,3406042920,1643092657,1643092979,322,1565
3701537998,3796504737,1652204780,1652205394,614,1081
3202187490,3885194706,1653537292,1653537800,508,1639
3003861546,3693920541,1663285268,1663286155,887,1781
3897421758,3282231108,1651817032,1651817914,882,1491
3920028342,3483827042,1641639695,1641640045,350,989
3963351842,3546290525,1648753159,1648753971,812,1230
3888312656,3107541952,1658036145,1658037078,933,2392
3264831577,3648257100,1654012112,1654012540,428,2188
3624298459,3614741796,1661722860,1661722875,15,2494
3171569619,3855223575,1648449275,1648450206,931,624
3114764410,3336947163,1655136710,1655137661,951,414
3929638122,3388844626,1647167136,1647167589,453,257
3241444105,3426617058,1642000292,1642000535,243,832
3098891437,3574394407,1654783287,1654783616,329,1731
3897491493,3132486699,1666440809,1666441084,275,2446
3957411858,3437707461,1643564707,1643564794,87,1760
3794926978,3663038239,1658610570,1658611437,867,422
3546486600,3279351560,1656520912,1656520915,3,920
3815779833,3626345917,1653566421,1653567008,587,1947
3329449985,3217857851,1651763587,1651764468,881,2321
3793996748,3729340640,1651744115,1651744432,317,1292
3134166826,3367915131,1658984398,1658984403,5,476
3847957207,3658295713,1662454251,1662454352,101,2166
3110482626,3379285136,1648425833,1648425870,37,339
3704568536,3424650360,1663386662,1663387434,772,2196
3771841105,3031209415,1647658999,1647659604,605,1537
3505417530,3267600229,1667766428,1667766506,78,479
3881861537,3671637527,1658670624,1658671249,625,1549
3572746096,3261419893,1668456677,1668457330,653,954
3746229411,3952282084,1652018633,1652019626,993,1169
3097128642,3068129646,1644249034,1644249637,603,1558
3275827194,3533936136,1652891776,1652892489,713,325
3044161404,3763317740,1668683344,1668684206,862,2264
3785721693,3974092782,1653719100,1653719862,762,1536
3550107804,3941783209,1655295271,1655295912,641,2478
3714188043,3750083020,1662058587,1662058935,348,554
3728419832,3916776869,1645181464,1645181874,410,1445
3521081470,3883864322,1643957709,1643958501,792,2174
3043047337,3443190053,1649796808,1649796826,18,2360
3048504189,3441680015,1658165891,1658166876,985,2160
3379285136,3855223575,1665991962,1665992013,51,1544
3834401696,3438474821,1651764359,1651765272,913,322
3478921948,3953444491,1655645130,1655645503,373,323
3050267205,3029849131,1646253073,1646253802,729,956
3316031407,3917684798,1642012810,1642013298,488,365
3762525964,3297949666,1655922256,1655922614,358,156
3756722426,3942656665,1659807390,1659808040,650,352
3713455058,3758577708,1641894723,1641895246,523,1888
3191414403,3491356699,1646399373,1646399431,58,1939
3629984961,3107713394,1654316897,1654316981,84,1513
3698989053,3677379196,1641311774,1641311966,192,295
3582138072,3665557228,1663291626,1663291944,318,952
3826502515,3185210514,1641571062,1641572051,989,2110
3885696227,3201213219,1649801835,1649801958,123,2461
3056267922,3746971515,1650353522,1650353652,130,1574
3095932716,3332914132,1650547206,1650547472,266,1072
3617453316,3853258306,1658481745,1658482579,834,705
3388159268,3478219461,1657103130,1657103712,582,839
3068982966,3279351366,1651193694,1651194657,963,2133
3461263871,3757499622,1661813559,1661813610,51,749
3269680998,3932077086,1654159407,1654159893,486,1744
3084969131,3276341369,1647186530,1647187174,644,1117
3847297747,3309684706,1644111993,1644112237,244,1912
3656846834,3382453510,1651394998,1651395857,859,2493
3757693725,3246028948,1653553328,1653554031,703,1589
3797259426,3644334498,1648315360,1648315675,315,247
3461108375,3140682569,1648869807,1648870252,445,654
3794074656,3840449491,1648352070,1648352201,131,636
3699730203,3632911091,1648417057,1648417790,733,614
3572325072,3965000413,1663596238,1663596955,717,555
3043656500,3869794122,1659242807,1659243294,487,1297
3086564112,3536421569,1665208464,1665209055,591,308
3651753987,3268821463,1644965554,1644965799,245,1189
3411272565,3125900419,1643177865,1643178745,880,2102
3814017798,3465229825,1655865995,1655866715,720,1449
3817057878,3443785253,1661864354,1661865177,823,2118
3874569616,3245354614,1648422360,1648422675,315,391
3382856674,3016568360,1667843618,1667844184,566,2359
3593967802,3223374226,1668050044,1668050441,397,1416
3899247202,3903550568,1653239320,1653240009,689,1327
3728498046,3021289375,1667980185,1667980764,579,86
3366321387,3986825518,1662659478,1662659677,199,2309
3241033604,3175478710,1667756854,1667757555,701,302
3020108220,3863697907,1654825856,1654826461,605,638
3980781580,3917601622,1649355603,1649356286,683,1982
3064831559,3729299306,1660718714,1660719416,702,838
3376552382,3046380642,1668961498,1668962122,624,1109
3199892178,3964690423,1646835613,1646835980,367,317
3702439685,3361514629,1652837567,1652838485,918,64
3271919876,3506971803,1659129228,1659129497,269,2338
3682747704,3976367014,1665990255,1665990585,330,2061
3316398180,3855563284,1662265250,1662265753,503,194
3513193858,3111817334,1652710014,1652710306,292,2451
3083388257,3339649448,1649744350,1649745079,729,1279
3784808734,3147336288,1668148268,1668148476,208,2192
3906964033,3530157274,1644495501,1644495654,153,808
3635854686,3275223689,1657052068,1657052930,862,1353
3273258651,3037301537,1658828822,1658829750,928,1977
3554832209,3628963667,1654956799,1654957080,281,1364
3421728246,3973853235,1650165808,1650166312,504,807
3487740667,3641185549,1659260405,1659261204,799,2143
3317614106,3370164589,1642122239,1642122749,510,634
3185985712,3645943439,1661260694,1661261620,926,291
3959081575,3569051470,1641366026,1641366444,418,26
3084430345,3492657889,1662299646,1662300566,920,516
3722726470,3516399207,1648075661,1648075820,159,1740
3867026366,3366643644,1664166585,1664166916,331,1797
3906309759,3975864053,1659162181,1659162339,158,1102
3450102071,3866158221,1662245071,1662245289,218,811
3220424979,3445689630,1642363332,1642363799,467,1843
3319782337,3381692213,1654175951,1654176285,334,661
3778575442,3791419861,1651066709,1651067529,820,2223
3888438556,3358968371,1649023707,1649024372,665,2454
3292368988,3797930164,1644605600,1644605756,156,677
3742005806,3994168332,1652730447,1652731323,876,1277
3202453519,3262864867,1652892895,1652893138,243,811
3537915144,3277978979,1653293788,1653294267,479,310
3522465860,3883497013,1648646720,1648647606,886,498
3888670009,3866268396,1655462985,1655463441,456,2006
3334207071,3773434774,1667641113,1667641326,213,2208
3807473345,3744788361,1661545963,1661546930,967,353
3429010148,3686240080,1668831494,1668832137,643,305
3316951862,3504258562,1643569090,1643569218,128,983
3906772132,3338376656,1660937910,1660938348,438,948
3447440058,3400434269,1644477422,1644477977,555,862
3774413169,3235245267,1665864881,1665865097,216,1556
3525751984,3554676369,1647665697,1647665794,97,847
3681993008,3313615371,1641876902,1641877013,111,1828
3884346810,3823650698,1643576646,1643577579,933,1988
3440324329,3540735539,1657072281,1657072552,271,2304
3267045921,3454754318,1649551529,1649551952,423,2253
3711100517,3043656500,1664958086,1664958173,87,2113
3846493363,3741983763,1650612690,1650613631,941,753
3726520685,3552101140,1665826264,1665826979,715,302
3400211665,3407331091,1650806386,1650807133,747,2106
3382159828,3551371020,1667469766,1667470683,917,1736
3543256939,3510634049,1643088267,1643089102,835,1442
3155320608,3703881738,1663304564,1663305317,753,141
3473170336,3801736024,1665552446,1665553446,1000,1622
3200978578,3180294141,1668195338,1668195952,614,1309
3432608968,3413781764,1652734041,1652734493,452,240
3420489464,3749308364,1667861908,1667861962,54,2123
3084066396,3648924087,1661846596,1661847340,744,1301
3278689627,3450294094,1652379713,1652379792,79,2026
3658113721,3411921561,1645364483,1645364893,410,461
3454392909,3466942824,1642975379,1642976252,873,1849
3686864492,3061461510,1668438173,1668438270,97,1565
3102760949,3469812263,1657333073,1657333093,20,1528
3246759301,3362388538,1653156807,1653157535,728,866
3524480094,3968795612,1657255328,1657255492,164,1939
3173034893,3773532257,1652935568,1652936285,717,1650
3582683989,3094596605,1653967353,1653967460,107,1550
3434729931,3871509767,1667935925,1667936913,988,1173
3234656999,3786194675,1665550641,1665551525,884,1724
3318735194,3139931020,1668476631,1668477147,516,21
3346484497,3003641311,1647122938,1647122942,4,589
3964637208,3521081470,1669073277,1669073404,127,2350
3844006658,3033692011,1646293716,1646293911,195,333
3097426944,3235992794,1652842605,1652842617,12,923
3263403144,3051776472,1658905280,1658905883,603,200
3177628377,3856474495,1648579288,1648579970,682,1669
3818453534,3133767042,1644200558,1644200976,418,2283
3424211722,3012152244,1651606504,1651607357,853,470
3034256232,3202187490,1651098327,1651098659,332,45
3241444105,3499272388,1653203652,1653204387,735,132
3183740417,3014535209,1667767834,1667768298,464,620
3499541432,3417328370,1666877050,1666877735,685,1108
3166206557,3529381895,1651872449,1651872772,323,569
3314028925,3840962989,1662458184,1662458626,442,242
3957210150,3639117164,1659337874,1659338798,924,1598
3553146922,3986003303,1656362684,1656363670,986,623
3646797040,3693581710,1665971064,1665972032,968,1898
3668753730,3524466015,1664843303,1664843567,264,45
3758323845,3554832209,1654003694,1654003995,301,39
3691925367,3377901268,1648115667,1648116535,868,99
3039893721,3562579840,1647817819,1647818236,417,2164
3816011687,3164462099,1649806980,1649807342,362,293
3423918005,3450689808,1663680105,1663680573,468,1940
3531842620,3282449988,1648318544,1648318574,30,712
3844499309,3397972687,1653317050,1653317204,154,1328
3916557399,3425548171,1641075941,1641076221,280,2177
3903068218,3875750764,1654188071,1654188203,132,909
3137092101,3786811867,1645703269,1645704124,855,1763
3863080370,3029403229,1658268707,1658269431,724,1238
3538039823,3372442199,1654654182,1654654834,652,2253
3154551351,3276118203,1644020231,1644020740,509,590
3364911803,3928212115,1654684585,1654685289,704,970
3900876329,3585989542,1650106665,1650106783,118,2237
3038244365,3153831709,1652321096,1652321100,4,1776
3829878263,3486442976,1651194991,1651195580,589,1770
3122246747,3204508195,1659027041,1659028011,970,452
3586025172,3897412947,1660763720,1660764286,566,1112
3844822083,3110649041,1646159140,1646160033,893,1591
3804824307,3752442248,1664737491,1664738420,929,635
3942393978,3020683788,1650611007,1650611206,199,512
3882603510,3224864814,1651229368,1651229442,74,492
3486096604,3281923852,1665800572,1665800759,187,115
3396149289,3657391976,1649632503,1649633497,994,1268
3262379384,3261195333,1653794827,1653795302,475,1181
3472603348,3456791834,1659858899,1659859452,553,890
3760432849,3520511256,1654188369,1654188892,523,614
3883265629,3091072272,1666981660,1666981981,321,2491
3109108614,3390416640,1649407508,1649407953,445,2022
3755580356,3245354614,1642440618,1642441578,960,1042
3680841490,3815507952,1663606205,1663606609,404,2052
3903108572,3564440153,1646203776,1646204397,621,238
3429052801,3450689808,1642704073,1642704642,569,1373
3936468941,3307730398,1645570620,1645571490,870,694
3200059644,3127419046,1667890216,1667891003,787,1032
3206198477,3344891111,1666197096,1666197771,675,776
3139126728,3929901413,1661579585,1661579939,354,433
3255182489,3328024680,1659753679,1659754620,941,2337
3243005694,3867857893,1666028020,1666028580,560,206
3061594355,3855984822,1653672890,1653673689,799,495
3537031182,3950428741,1653447106,1653447627,521,1422
3243502165,3263842575,1642723071,1642723648,577,1028
3806664868,3391540103,1663073310,1663073994,684,1568
3924559198,3290800332,1657875592,1657876172,580,177
3341241551,3669299007,1665095144,1665096061,917,17
3998329857,3313619618,1644303025,1644303951,926,1962
3823942349,3195214383,1646905868,1646906672,804,2491
3778402105,3772980352,1659251233,1659251498,265,1708
3821299576,3441541439,1642375424,1642376280,856,1982
3341573446,3481090623,1649011515,1649011659,144,2364
3176317370,3398785571,1650514929,1650514954,25,1543
3613700451,3175595669,1647321898,1647322168,270,504
3257865090,3586025172,1641315803,1641316134,331,1002
3228497776,3461505923,1661019802,1661020216,414,957
3936360658,3622933919,1649572601,1649572716,115,2324
3888392286,3984259471,1654293989,1654294976,987,909
3413918139,3710318693,1655983750,1655984549,799,1338
3900876329,3381846064,1651195595,1651196364,769,603
3514152633,3239575265,1662450653,1662451091,438,2383
3565278029,3875483766,1654967289,1654967946,657,162
3558912751,3266498789,1651115951,1651116271,320,2221
3015246686,3075780193,1656188706,1656189674,968,938
3998987664,3971648409,1658100484,1658101201,717,1460
3423043196,3650041115,1642311012,1642311696,684,2360
3216912897,3808415962,1648471768,1648472743,975,1031
3774722709,3996978717,1645319660,1645320572,912,585
3581399447,3218964640,1662941751,1662942292,541,941
3796343532,3424453686,1643318172,1643318835,663,878
3431595099,3762690279,1664244400,1664245367,967,142
3048405710,3562547940,1657318026,1657319012,986,1252
3465406980,3481072834,1660487193,1660487834,641,338
3839610928,3786322776,1660720159,1660720674,515,537
3430165544,3478771172,1656127558,1656128432,874,2210
3038849431,3945055663,1667202443,1667203281,838,476
3208220195,3152109348,1658526234,1658526782,548,1583
3328699609,3766274699,1655421793,1655422051,258,2445
3494990710,3537735224,1651005610,1651006288,678,1975
3366385571,3911671645,1660903509,1660903770,261,464
3525377731,3641959079,1657703729,1657703780,51,1058
3937758732,3156452001,1643796489,1643796715,226,866
3378791519,3122288373,1665012044,1665012173,129,813
3661507330,3936135558,1651950599,1651951490,891,1629
3401138486,3099984232,1657819225,1657819393,168,704
3977317498,3512502358,1652542752,1652543325,573,1967
3898946519,3106437492,1659490761,1659491566,805,631
3630448266,3373806425,1665460556,1665461116,560,2188
3269502320,3444149733,1649964331,1649965042,711,498
3258854274,3358968371,1666228851,1666229482,631,858
3095661578,3165973608,1659453762,1659454643,881,1198
3710851755,3664627036,1643161839,1643162211,372,1805
3903978752,3739719526,1642704783,1642704895,112,762
3075519908,3066531358,1664491646,1664491991,345,944
3079038995,3503842077,1642767491,1642768442,951,1542
3215819425,3329253794,1653096003,1653096878,875,1816
3744196402,3007328261,1655170370,1655171328,958,779
3307730398,3233920789,1642670408,1642670990,582,1896
3338020076,3411586996,1668954692,1668954809,117,1619
3794548376,3392395230,1644788805,1644789730,925,2088
3182982515,3450628929,1664289514,1664289580,66,124
3727801252,3624085921,1657266430,1657266827,397,834
3671974600,3623115966,1660556239,1660556752,513,1918
3562243381,3948743692,1646753734,1646754607,873,456
3293007803,3601240692,1644781230,1644781304,74,1343
3550908209,3342685325,1655401305,1655402283,978,1969
3048721189,3825900664,1663732307,1663732725,418,294
3220690215,3093387843,1652739242,1652739288,46,949
3354233805,3678340379,1644517435,1644518328,893,1909
3061299464,3467613173,1655663417,1655663546,129,452
3447077543,3036381764,1663180485,1663180823,338,2235
3352376449,3805928545,1644328286,1644328741,455,973
3840764880,3045981034,1651378144,1651379140,996,1903
3244599174,3103228367,1666323558,1666324385,827,1052
3729321195,3576317139,1651450657,1651451635,978,2497
3060121211,3337684100,1656641860,1656642496,636,2270
3582046255,3600955732,1663826271,1663826959,688,1521
3483666747,3734331528,1660915103,1660915809,706,939
3002631535,3489453670,1663934361,1663934597,236,2267
3307067721,3722078855,1657224362,1657224594,232,1569
3233375810,3116684420,1656816623,1656816778,155,2395
3729553337,3672524498,1642063791,1642064044,253,2061
3404394014,3717137928,1659961873,1659962803,930,1341
3892535771,3432864859,1649833898,1649834657,759,1805
3015715378,3377473764,1668319128,1668319267,139,1219
3946911182,3990379463,1655797981,1655798824,843,565
3325288212,3555966791,1658640440,1658641431,991,2314
3782752586,3057922933,1667485868,1667486857,989,395
3488813245,3739555068,1650586041,1650586886,845,1205
3079031370,3135579253,1663014817,1663015670,853,2275
3544965463,3227310314,1650865153,1650865931,778,124
3020729502,3300662625,1651298295,1651299226,931,375
3610782760,3689680251,1668779907,1668780333,426,1687
3117816089,3405155234,1661926680,1661926847,167,2494
3769836039,3001480546,1656420342,1656421310,968,945
3251409316,3618352797,1645349907,1645349907,0,2277
3692904228,3993572792,1648756583,1648756624,41,732
3348282881,3656654582,1665678003,1665678388,385,1254
3498461454,3740274448,1654741161,1654741673,512,2090
3861173090,3444174394,1668097136,1668097829,693,996
3880052402,3619800237,1641987236,1641988185,949,937
3526365568,3965563922,1663108803,1663109791,988,833
3148366567,3750192699,1658878847,1658879742,895,533
3069523420,3671147965,1658354165,1658354974,809,609
3432522125,3560020610,1654699412,1654699799,387,2258
3785721693,3475352970,1658233588,1658234579,991,637
3936607466,3636141899,1657052378,1657052479,101,1847
3505417530,3240249176,1655890019,1655890233,214,354
3369731959,3663814997,1660293161,1660293816,655,2287
3155807587,3914926954,1647450721,1647450884,163,636
3077552507,3732273041,1661726147,1661726322,175,1476
3936468941,3723780339,1655413318,1655413868,550,1066
3542129823,3077143208,1666601838,1666602643,805,1737
3105829075,3980675077,1669731555,1669732170,615,670
3556425071,3834401696,1641392837,1641393357,520,813
3543696190,3763912599,1651355065,1651355322,257,772
3338715388,3466282430,1651357684,1651358573,889,1951
3387938632,3098538909,1652845644,1652845985,341,52
3822816987,3400121632,1668533002,1668533760,758,1492
3456080836,3712443558,1647805538,1647806418,880,923
3075465136,3300380060,1656907745,1656908738,993,1513
3103417672,3806167216,1662569857,1662570079,222,1233
3341211432,3204735172,1657403492,1657404024,532,163
3044064258,3968143962,1665111270,1665111300,30,539
3581971425,3915942384,1667128549,1667129440,891,1747
3447257561,3280251149,1645871670,1645872622,952,684
3416196153,3889840253,1662432753,1662432925,172,2201
3256231811,3273059265,1652699982,1652700202,220,784
3442725932,3196009998,1645789205,1645789212,7,57
3661243199,3959408689,1665926896,1665927162,266,583
3297123407,3518202698,1657666576,1657666959,383,1827
3806652632,3501770020,1653860951,1653861361,410,507
3983113289,3871180604,1668942604,1668943593,989,1744
3806936803,3880835949,1644795920,1644796241,321,1340
3429101401,3777820691,1668995246,1668995645,399,472
3713006411,3591264259,1668811558,1668811930,372,638
3058064037,3007934266,1655442806,1655443722,916,1306
3838850701,3793344397,1645290972,1645291839,867,2372
3213169891,3682922389,1660822851,1660823798,947,816
3072720499,3223459561,1648620661,1648620867,206,1888
3905356323,3802816973,1649766968,1649767937,969,1777
3905744284,3461938856,1642657345,1642657668,323,1753
3253931464,3006603067,1660043201,1660043205,4,1650
3853056907,3822816987,1661120230,1661120770,540,2225
3346860393,3707552735,1656084106,1656084738,632,1265
3531898771,3184178717,1656397709,1656397947,238,1291
3682910702,3746229411,1648162599,1648163170,571,216
3070117232,3500097822,1649517577,1649517608,31,487
3454062338,3244918124,1666868319,1666868741,422,1466
3235086334,3895990286,1650107024,1650107367,343,1764
3194142427,3250566757,1656394002,1656394509,507,613
3011686027,3069818047,1644199021,1644199081,60,1873
3282166903,3133153956,1668204068,1668204719,651,180
3491718080,3349247221,1655605865,1655606328,463,63
3461508348,3548128446,1660614285,1660614692,407,1736
3311252249,3311529434,1650809821,1650810584,763,2039
3642377610,3963702135,1667079829,1667080633,804,2196
3055918856,3442447509,1652779320,1652779910,590,1155
3945397961,3790329301,1660317308,1660318106,798,1495
3684411297,3593603889,1647568418,1647568639,221,1338
3409034003,3740009683,1651190006,1651190794,788,1905
3470112947,3903193601,1641972055,1641972917,862,949
3742746848,3968412854,1646791199,1646791369,170,2041
3685665978,3544020942,1653962388,1653962898,510,1078
3286463125,3936821313,1651518247,1651518251,4,2272
3832243899,3569743064,1657116011,1657116808,797,1896
3709607250,3866431229,1656917156,1656917458,302,2428
3220750989,3501568597,1642223546,1642224068,522,1037
3697118662,3281907019,1663135952,1663136871,919,907
3651286291,3694618653,1666737391,1666737839,448,88
3936154124,3921317746,1655502445,1655503398,953,634
3867126446,3621938271,1644611215,1644611900,685,154
3373962186,3506273643,1663508187,1663508592,405,1438
3661016961,3415761431,1647608206,1647608810,604,1671
3739320901,3095743155,1662199734,1662200430,696,998
3106804099,3515460273,1655815352,1655816012,660,1875
3254592040,3080325374,1653548175,1653548737,562,769
3625938415,3569525429,1659529659,1659529865,206,1296
3570423127,3915206176,1646015571,1646015807,236,2042
3474543664,3086325930,1665199883,1665200080,197,1242
3979352608,3197323395,1648001281,1648001897,616,904
3507992647,3658017612,1660094748,1660095183,435,1640
3511593307,3217494787,1641116633,1641117125,492,1580
3526239660,3426004964,1654179861,1654179882,21,1377
3089574886,3399479391,1653272119,1653272221,102,947
3674037967,3556456137,1657356930,1657357602,672,75
3626216693,3268225181,1649275774,1649275781,7,589
3994388981,3854357910,1658581614,1658581664,50,654
3282079727,3346254669,1664242801,1664243430,629,330
3979845809,3882983178,1667148346,1667148992,646,531
3349626057,3649252503,1659712119,1659712469,350,2256
3344279346,3811389743,1667295515,1667296192,677,2315
3929307105,3291819950,1644553360,1644553846,486,646
3446952845,3083479870,1664354718,1664354744,26,2313
3298042916,3805845272,1659515649,1659515996,347,2368
3039972849,3819547274,1646973103,1646973879,776,1142
3895886228,3456285013,1667167886,1667168035,149,530
3964690423,3594254200,1669295507,1669296110,603,996
3250312962,3028643875,1667250631,1667251395,764,180
3537138552,3227951880,1668391489,1668392239,750,2266
3306460846,3194796707,1651225566,1651226068,502,528
3462072699,3774916473,1649598517,1649598569,52,1742
3832463052,3244997486,1641873354,1641873614,260,207
3957430800,3205543673,1659110837,1659111105,268,1549
3177036721,3385273825,1659428339,1659429263,924,1373
3377473764,3357048496,1668763548,1668764223,675,2068
3600334566,3309286736,1659888313,1659888926,613,1384
3752797217,3620303845,1650929345,1650930252,907,2167
3939725219,3212095735,1645932094,1645932444,350,669
3114744245,3788819111,1664320049,1664320347,298,2442
3352667302,3955825968,1642828038,1642828208,170,2477
3998641184,3423522480,1660449657,1660450347,690,823
3287988080,3569329621,1663630699,1663631642,943,1153
3825173498,3630982131,1666206296,1666206482,186,2000
3711314965,3188936143,1668422775,1668423181,406,1149
3744871116,3701979416,1642165721,1642166064,343,870
3716977635,3445530012,1657511809,1657512593,784,2316
3489380093,3771623134,1653844041,1653844722,681,1236
3864044700,3515460273,1650537174,1650537267,93,2485
3448866192,3689303525,1644735388,1644736320,932,264
3692095366,3540717336,1654250987,1654251857,870,628
3778894897,3613018005,1664898649,1664899045,396,1990
3154551351,3905999483,1641425467,1641425744,277,1447
3780182766,3991727598,1668275792,1668275889,97,1138
3692247556,3971180079,1661769063,1661769966,903,2169
3341890542,3128287586,1659633585,1659633779,194,966
3323698166,3153040217,1656304706,1656305146,440,828
3947158263,3348102929,1652893850,1652894206,356,2015
3760432849,3613730980,1659819046,1659819582,536,985
3710943716,3773505782,1643754405,1643754413,8,1110
3915344164,3701103798,1665298594,1665299501,907,2140
3194142427,3143318519,1651061253,1651061961,708,78
3325842490,3333339972,1667080951,1667081110,159,947
3933874233,3853258306,1654055227,1654055485,258,996
3956055955,3550329232,1645522085,1645522830,745,993
3596007538,3275027460,1649742853,1649743266,413,256
3704818655,3972441567,1662777226,1662777995,769,2066
3430638959,3808900684,1658168344,1658168380,36,1523
3840807781,3409502765,1668426035,1668426740,705,2477
3452275962,3140055258,1669562426,1669563145,719,482
3650444993,3923980052,1651220585,1651221171,586,488
3557559741,3056267922,1665768035,1665768206,171,379
3529681535,3541597384,1648098764,1648099550,786,1985
3072720499,3406239480,1641058760,1641059053,293,1808
3427937915,3419783275,1655617282,1655618059,777,269
3595144575,3461292351,1668303715,1668304027,312,444
3922341165,3444174394,1666361305,1666361393,88,141
3902777743,3470404771,1652261618,1652261824,206,494
3622950232,3196794099,1653899974,1653900700,726,1043
3515837186,3556620301,1664164049,1664164448,399,2277
3692247556,3696149430,1653393477,1653393704,227,2150
3364390232,3970444667,1641652093,1641652762,669,2486
3237807880,3580280923,1668077634,1668078308,674,1134
3295806447,3232835207,1645915033,1645915039,6,718
3786840082,3609104298,1659447107,1659447160,53,1870
3344553610,3085182687,1654746757,1654747308,551,1195
3936193189,3837877764,1641690631,1641690977,346,937
3385803617,3139455252,1659045457,1659045905,448,644
3265571367,3763317740,1660263110,1660263313,203,2463
3883176560,3903112291,1662842192,1662842803,611,1196
3608048838,3183079019,1662116445,1662116452,7,126
3847771650,3136564426,1642052523,1642052988,465,1288
3748085058,3179891006,1661890810,1661891510,700,133
3921451192,3496617169,1647641691,1647641714,23,845
3510416134,3337601088,1643460685,1643460890,205,1692
3791486887,3402349073,1658868047,1658868659,612,1620
3839642166,3031560160,1651843035,1651843064,29,1884
3198999623,3545150522,1647882364,1647883005,641,763
3451749535,3829084330,1668303602,1668304198,596,2357
3364199338,3100440036,1646729483,1646729677,194,1474
3937445570,3350446044,1665473639,1665474360,721,571
3746351822,3509999399,1664157750,1664158687,937,2131
3975405530,3013484024,1654422873,1654422971,98,2191
3622485921,3992927391,1643917908,1643918818,910,1534
3211047702,3703825153,1665783472,1665783667,195,1772
3987735792,3500595056,1643150555,1643150833,278,1801
3894175918,3660575608,1665444576,1665445510,934,2431
3960908616,3697291064,1647671043,1647671655,612,1272
3174373725,3179855785,1656491980,1656492662,682,983
3886720244,3716246985,1660317699,1660318477,778,1372
3080287966,3710202750,1658570481,1658571374,893,841
3956796805,3755513433,1641613301,1641613874,573,551
3592561930,3275827194,1662719489,1662719637,148,2288
3550677109,3491718080,1669751952,1669752285,333,1017
3052438592,3239517474,1665582586,1665582968,382,654
3040521946,3080007856,1665461907,1665462830,923,1970
3424650360,3141503682,1650165876,1650166029,153,563
3052279761,3921189235,1660721955,1660722600,645,1351
3236325866,3016568360,1648171513,1648171592,79,2409
3915154684,3734621671,1654361114,1654362036,922,878
3687278591,3987318292,1655754651,1655755628,977,2478
3570335491,3413948595,1646918107,1646918497,390,673
3732795074,3425720812,1668173153,1668173505,352,1550
3782741533,3126778118,1646227039,1646227991,952,909
3211003582,3086084685,1641132015,1641132750,735,1421
3233823273,3771588829,1662008940,1662009913,973,2091
3535631980,3772788087,1645533433,1645534211,778,2013
3379935974,3163326257,1646881873,1646882537,664,1448
3181048786,3880295026,1667352640,1667352702,62,182
3258050916,3127419046,1652656200,1652656778,578,2237
3339027368,3560756539,1657948218,1657948259,41,88
3885719823,3276350975,1643221701,1643222092,391,870
3371430360,3715766296,1645220133,1645220481,348,1875
3885719823,3150582711,1644865586,1644865810,224,468
3050229164,3570747542,1665883899,1665884364,465,1546
3334298803,3474666564,1647635690,1647635828,138,691
3584037261,3110016926,1663861963,1663862417,454,2247
3958050741,3836565798,1666618307,1666618538,231,1297
3028910693,3336423969,1664302913,1664303802,889,1790
3096471933,3585919417,1659887281,1659887528,247,2480
3154567629,3855261620,1650219092,1650219462,370,1205
3943836795,3381313507,1648652450,1648653190,740,2203
3261128926,3269502320,1655979813,1655980288,475,1016
3069225011,3998763119,1651572877,1651573616,739,1198
3329253794,3213376352,1647601970,1647602409,439,249
3682928814,3069225011,1650364821,1650365562,741,552
3193403424,3404785260,1647391543,1647392109,566,1920
3209288149,3964524277,1662116599,1662117196,597,1065
3623115966,3516140957,1663736152,1663736742,590,1490
3446699030,3720307988,1667233347,1667233629,282,714
3130612494,3705752007,1651236323,1651237022,699,1026
3237824925,3061299464,1669675547,1669675614,67,615
3992919381,3827461144,1656255383,1656255965,582,1577
3348006171,3883265629,1669245607,1669246308,701,1141
3480115115,3294357161,1662081375,1662081857,482,1804
3730533080,3771146763,1666811619,1666812017,398,756
3518583464,3804773972,1646180664,1646180771,107,1995
3305480485,3756722426,1653401680,1653402216,536,853
3608200385,3760432849,1654964876,1654965063,187,875
3388257945,3333037570,1648925581,1648925767,186,434
3538410031,3254174311,1661061616,1661061823,207,1234
3718684083,3960417596,1656001963,1656002022,59,623
3005809519,3031103174,1645070696,1645071268,572,350
3454753343,3272981808,1667732620,1667733419,799,1196
3496318579,3623620611,1642765669,1642766154,485,2035
3635921511,3650172161,1654678528,1654678957,429,507
3983610735,3015956370,1645944164,1645945110,946,1744
3524942512,3309468510,1656649440,1656649649,209,1439
3814851615,3312930717,1663447802,1663448392,590,2430
3270914746,3369913868,1649346746,1649347737,991,2122
3784808734,3858052316,1655761172,1655761573,401,1526
3183165788,3244198823,1648400039,1648400531,492,346
3026293367,3708654413,1650887677,1650887860,183,1814
3434224349,3273258651,1657165071,1657165984,913,756
3788688228,3486262024,1662730552,1662731365,813,781
3296895937,3384222838,1642440093,1642440226,133,1667
3118406319,3711847265,1651383666,1651384570,904,2479
3298676228,3770641398,1646801010,1646801771,761,266
3258782646,3664112134,1667651188,1667652031,843,259
3228574805,3688300477,1656569780,1656570633,853,1644
3834843479,3487778655,1663588750,1663588833,83,2271
3433768649,3108998670,1666326625,1666326729,104,2436
3301202561,3284630826,1661013041,1661013255,214,2179
3226052631,3415522797,1641538001,1641538400,399,1694
3619126886,3860745004,1643443844,1643444308,464,1245
3351245855,3421936592,1659732775,1659733212,437,1147
3548145086,3569525429,1658867649,1658867846,197,1709
3216470508,3021126829,1642678888,1642679522,634,2271
3970444667,3190972776,1656765786,1656766010,224,978
3360115986,3112389617,1652113803,1652114388,585,1344
3782377691,3625950355,1656473317,1656473993,676,369
3444349973,3074928223,1661605896,1661606448,552,205
3793086361,3204302089,1658655760,1658656106,346,454
3854995649,3610782760,1663845203,1663845606,403,1342
3972649318,3840807781,1665647224,1665648005,781,764
3809010705,3884798812,1656548080,1656548209,129,1197
3671154785,3135134317,1665336021,1665336122,101,484
3746971515,3573450428,1650338765,1650339417,652,1206
3439700326,3969241066,1657307892,1657308599,707,2201
3517992014,3310523513,1665554299,1665554547,248,1085
3576317139,3239418137,1646056889,1646057416,527,2416
3050867171,3035838196,1648094207,1648095116,909,394
3857400676,3827431944,1645843047,1645843345,298,1227
3855548589,3233507128,1656068141,1656069086,945,1086
3843953645,3786924052,1649987237,1649987458,221,1823
3068129646,3321293262,1645275020,1645275592,572,1084
3686704798,3610239794,1664252484,1664253328,844,1070
3530286335,3271201418,1652449315,1652450128,813,2440
3085001659,3432462167,1653197366,1653197737,371,1469
3337305693,3651847351,1650362498,1650363008,510,1743
3042739113,3992927391,1648747468,1648748298,830,1382
3957665117,3561881366,1651371673,1651371783,110,1521
3226280658,3034815361,1662214366,1662214616,250,933
3173322239,3039962870,1645335031,1645335855,824,1067
3939948508,3650205106,1652948448,1652948468,20,253
3024979152,3814851615,1650565856,1650566057,201,2422
3054639823,3279773317,1660053044,1660053540,496,2313
3577276558,3277577090,1642357988,1642358187,199,1501
3916290714,3138801114,1643797522,1643798088,566,1915
3250253670,3883874845,1658164737,1658165024,287,2270
3934848520,3315218003,1661089291,1661089385,94,1158
3715106063,3903015279,1657711425,1657711749,324,2297
3219292166,3889854774,1663162996,1663163975,979,898
3235825340,3520392773,1662412960,1662413700,740,2071
3762525964,3479401831,1657946436,1657946521,85,639
3681399132,3999128559,1645190063,1645190263,200,1055
3869930031,3663884600,1658202836,1658203104,268,1884
3604461797,3153518026,1649639759,1649640272,513,677
3423782681,3474242977,1667460843,1667461191,348,1319
3463800741,3178643457,1644508933,1644509549,616,1277
3526197227,3182097979,1656028232,1656028237,5,1290
3546943801,3329463543,1642651220,1642651730,510,1063
3935936621,3631732813,1643204801,1643204938,137,216
3211795832,3549703546,1653787263,1653788066,803,583
3887305908,3154139372,1656698692,1656699256,564,291
3930565588,3716626172,1663356165,1663356658,493,454
3074795505,3620006027,1643434046,1643434851,805,1744
3632763218,3636572173,1643711124,1643711287,163,1622
3704437148,3581449963,1643360413,1643360415,2,1326
3423965711,3211015636,1669464578,1669465023,445,2477
3973264936,3201933010,1665886047,1665886627,580,2473
3786480807,3714538351,1652088048,1652089005,957,704
3195138141,3709607250,1663383956,1663384099,143,2025
3829347049,3343543154,1668043740,1668044577,837,106
3617533561,3991390314,1656571019,1656571395,376,143
3989746763,3865200739,1644974667,1644975562,895,112
3367457506,3517149250,1658271431,1658271463,32,351
3417143667,3080200257,1644466337,1644466441,104,971
3109234948,3266666808,1657435161,1657436097,936,558
3111823829,3058606856,1646035212,1646036197,985,1885
3155797946,3341573446,1662445998,1662446500,502,1252
3872444916,3137942933,1668845152,1668845467,315,1189
3485801867,3692498377,1667152219,1667152269,50,544
3205864966,3544087053,1641890669,1641890694,25,2415
3099102864,3156261740,1662740908,1662741257,349,928
3346832945,3638847705,1652758302,1652759018,716,1068
3458971289,3904634428,1649129566,1649130019,453,2214
3721751204,3605412707,1650123599,1650123865,266,788
3913162487,3877090261,1667323312,1667323883,571,1948
3853178623,3450672463,1668684597,1668685038,441,1
3103743198,3672070606,1665779556,1665780377,821,863
3134872743,3363768036,1661890388,1661890407,19,2281
3541413511,3726117061,1645589975,1645590151,176,330
3359189419,3618101679,1653230697,1653231156,459,319
3113793993,3041897048,1664400749,1664401369,620,633
3933045461,3675061175,1668700132,1668701021,889,1720
3786516095,3280668606,1663898847,1663899781,934,1714
3133902865,3319782337,1661100616,1661101270,654,1497
3095834081,3925504452,1641695392,1641695933,541,324
3722422633,3968076690,1643935880,1643936815,935,2229
3879325408,3993580342,1663229897,1663230068,171,161
3306515955,3973948700,1659733490,1659734325,835,1257
3228574805,3142747577,1656552255,1656553106,851,1466
3319545220,3209150433,1659986582,1659987112,530,1824
3208802379,3469507401,1647051790,1647052371,581,1186
3601851578,3389443435,1646393031,1646393257,226,940
3068661794,3217857851,1642002089,1642003001,912,2093
3429010148,3749379310,1649431597,1649432416,819,107
3626216693,3867603056,1666561412,1666562404,992,1904
3680255689,3719965258,1659938459,1659939199,740,2266
3417143667,3078830914,1656308744,1656308833,89,755
3223374226,3599551667,1661584131,1661584295,164,231
3012272703,3948769271,1655372575,1655373483,908,159
3863652254,3241392393,1655595816,1655596292,476,354
3758115218,3798527829,1658304107,1658304713,606,2315
3575277293,3331554085,1644472517,1644473046,529,1812
3987567381,3369731959,1665929042,1665929450,408,1182
3149668198,3107482740,1652849567,1652849900,333,584
3764492400,3679867888,1653250419,1653251304,885,1559
3485578733,3304523843,1649896499,1649896880,381,1088
3039106188,3074044425,1657280692,1657280848,156,1335
3034147055,3242064640,1653020348,1653020949,601,1749
3216753609,3306871271,1656163764,1656164219,455,753
3660998516,3219509030,1665809125,1665809290,165,1352
3389926670,3418276734,1652405349,1652406285,936,2003
3005926074,3920261171,1663957285,1663957699,414,2103
3790549304,3501786397,1653903580,1653903767,187,1555
3129683689,3280668606,1654470850,1654471418,568,228
3295316821,3878698797,1663502921,1663503471,550,1726
3875008839,3544772636,1653533260,1653533504,244,352
3828890005,3173586762,1664222805,1664223789,984,2231
3470049551,3558848518,1642278854,1642279210,356,190
3644961840,3464983756,1652625041,1652625422,381,1067
3646908383,3979899306,1654498881,1654499119,238,2012
3621000186,3041385548,1641008212,1641008633,421,2236
3208770010,3711314965,1665715286,1665716084,798,1495
3289850617,3043656500,1648230033,1648230658,625,1904
3984977278,3696448766,1664758419,1664759298,879,1837
3865964859,3142765587,1669323961,1669324360,399,464
3405319002,3009688248,1656611521,1656611952,431,1541
3436916222,3487030175,1660026861,1660027696,835,1845
3235049473,3224455204,1658814841,1658815030,189,393
3125436993,3734518688,1648371454,1648372433,979,2148
3034807560,3952552328,1656449094,1656449550,456,1419
3000890083,3152200344,1644418747,1644419480,733,83
3856600876,3322083266,1646767794,1646768286,492,759
3058725687,3287082352,1646994669,1646995227,558,2334
3640613606,3635854686,1654218235,1654218949,714,1611
3946614568,3948710872,1656499926,1656500731,805,2290
3624103484,3790829012,1666481603,1666481656,53,122
3341573446,3747889498,1647433997,1647434472,475,1511
3579486534,3898603481,1655801130,1655801187,57,43
3047628685,3152438109,1666843401,1666844261,860,2305
3725989619,3032018734,1656706504,1656706835,331,2492
3149818961,3027478849,1657039715,1657040263,548,1074
3489538095,3556620301,1648652768,1648653240,472,35
3646687421,3174544371,1665479849,1665480098,249,2275
3768087701,3178090646,1668922718,1668923228,510,1665
3744563835,3685977300,1667926383,1667926743,360,873
3557087358,3384200089,1658626517,1658627202,685,2148
3936943386,3437259542,1645424930,1645425619,689,2054
3478404891,3609601814,1652059858,1652060044,186,1816
3599327423,3805953085,1645899949,1645900478,529,1240
3823761286,3978987003,1665137587,1665138216,629,1493
3700167321,3201276259,1663030350,1663030424,74,1179
3469783180,3348278635,1659472143,1659472217,74,342
3347152834,3219181477,1646499379,1646499708,329,1817
3017712081,3199635800,1644115161,1644116066,905,875
3589366986,3398116898,1662776881,1662777228,347,2186
3317411967,3986814631,1646754251,1646755077,826,2153
3725465166,3805283132,1662332515,1662333019,504,2068
3237824925,3276846453,1654714191,1654715014,823,2200
3184955498,3460572652,1642640547,1642641024,477,435
3985879853,3492773808,1642006139,1642006492,353,1326
3031299470,3974092782,1658530594,1658531432,838,2186
3804748811,3395670756,1664102944,1664103153,209,1300
3790964737,3115029581,1654341923,1654342874,951,2438
3667414511,3561572123,1656816183,1656816449,266,333
3178640485,3890159677,1666528700,1666529154,454,2045
3641752896,3444313610,1655397446,1655397794,348,510
3559489793,3680060067,1648801085,1648801719,634,1605
3448373235,3463875425,1662196331,1662196530,199,2205
3620939715,3687278591,1663350502,1663351389,887,920
3697291064,3918397944,1661385657,1661385816,159,1542
3668421848,3943184820,1664429579,1664430505,926,1693
3462862340,3906216789,1653145214,1653145475,261,1097
3175118084,3109702081,1657437331,1657438249,918,743
3492034029,3886780901,1665191895,1665191987,92,1295
3958539607,3005200951,1657509966,1657510582,616,1632
3225857817,3976095218,1642609784,1642610078,294,512
3315185864,3268182022,1662967136,1662968017,881,1978
3738761840,3057308926,1657220998,1657221768,770,1447
3105630699,3132207782,1664827303,1664827785,482,1042
3116777827,3033925963,1668848540,1668849445,905,1671
3395525819,3388490960,1663798224,1663799033,809,2012
3670154961,3058855369,1648704482,1648704910,428,469
3615137704,3411272565,1657925188,1657925496,308,1492
3818028118,3134425396,1643120139,1643120372,233,2050
3774945806,3191792012,1652432603,1652432916,313,1536
3111167324,3592906293,1652565787,1652566341,554,440
3098316380,3558232376,1654528872,1654529197,325,1265
3624139591,3450353368,1655182170,1655182706,536,440
3063520189,3451329310,1659446286,1659446881,595,1738
3640756400,3463540687,1666820694,1666820982,288,2391
3689680251,3666179764,1667263880,1667264623,743,1431
3156522255,3186584232,1644253651,1644254213,562,1909
3549752945,3163012662,1646440384,1646440722,338,161
3207407283,3136707992,1666555635,1666556083,448,464
3582267659,3968000691,1656299477,1656299512,35,66
3656092578,3037846389,1659168404,1659168919,515,346
3634010080,3333665805,1652102494,1652103424,930,1119
3881861537,3656829277,1655048893,1655049018,125,1356
3976223971,3403786938,1663401839,1663402533,694,915
3659752387,3573158941,1650382881,1650383514,633,575
3284380221,3365289656,1648278001,1648278319,318,550
3690349378,3133647753,1656856927,1656857340,413,1077
3793840002,3756778635,1656204364,1656205134,770,372
3751600788,3069881077,1666453998,1666454450,452,1955
3734754514,3244918124,1665106743,1665107251,508,699
3481548873,3273827707,1653022635,1653023533,898,1726
3580531210,3062464540,1669757884,1669758644,760,713
3042838406,3266867093,1648614933,1648614985,52,420
3425006843,3089699104,1646594294,1646594328,34,817
3973226891,3411636309,1654308502,1654309008,506,251
3456948150,3103943430,1656453174,1656454102,928,2202
3439303987,3688910009,1668688094,1668688681,587,1179
3036488445,3303815040,1649652867,1649652997,130,2403
3462714323,3537294800,1652621308,1652621678,370,1576
3655087982,3000890083,1663428377,1663428809,432,1999
3046080865,3865200739,1641526938,1641527712,774,226
3014438377,3841106350,1669738571,1669739330,759,1774
3900588986,3316978783,1663517704,1663517961,257,1400
3923692475,3653739025,1643589150,1643589919,769,416
3197323395,3883338335,1667314739,1667315078,339,2136
3543696190,3424584896,1656815161,1656815736,575,1669
3185611253,3015156809,1658893056,1658893328,272,176
3499739176,3651571335,1658644654,1658645063,409,2207
3467613173,3735081666,1657618109,1657618801,692,270
3873840731,3714909437,1668075388,1668075866,478,949
3016299339,3725480364,1667250743,1667251552,809,1308
3037940560,3683198772,1645254180,1645254416,236,42
3097982496,3920028342,1655457577,1655457942,365,1343
3830053941,3399235044,1649377361,1649377565,204,2392
3175295329,3171282160,1652522329,1652523065,736,2148
3151346211,3760972512,1669740361,1669740974,613,1468
3648370843,3678624517,1663842282,1663842880,598,2279
3355798436,3689518345,1655601610,1655601785,175,1408
3208464348,3965863452,1643894636,1643894744,108,556
3921189235,3243873593,1656866020,1656866937,917,1011
3591101388,3719445490,1665228807,1665229453,646,1982
3581570568,3285747162,1661024515,1661024890,375,2026
3657115450,3640756400,1646091384,1646092025,641,1871
3724806243,3131938458,1646087445,1646088032,587,1590
3406042920,3688790539,1652894974,1652894983,9,570
3069313994,3093178960,1645921893,1645922259,366,1465
3856080546,3303719777,1650432953,1650433746,793,312
3188468802,3122085251,1668186894,1668187841,947,361
3527349190,3048781539,1668029494,1668029562,68,1225
3665557228,3643615690,1654223637,1654223738,101,2134
3225616352,3203734562,1658719630,1658719841,211,666
3570335491,3619175296,1646733051,1646733921,870,1386
3718026583,3802694367,1657722458,1657722973,515,2355
3927920093,3525978019,1657033925,1657034514,589,715
3010790966,3110591514,1656499818,1656500414,596,1545
3759867623,3504446959,1653198846,1653199740,894,1178
3795326002,3456019436,1651578673,1651578761,88,1377
3395307809,3536118453,1668576832,1668577495,663,844
3142765587,3056252574,1651643707,1651644643,936,2383
3420137628,3864045087,1652064177,1652064735,558,1366
3843576243,3501946724,1645204367,1645205197,830,1899
3683993851,3972955608,1660847236,1660848168,932,1561
3505417530,3707578213,1651522700,1651523309,609,1697
3969110896,3514152633,1649721009,1649721972,963,536
3400121632,3022102664,1663360981,1663361386,405,71
3622259711,3289693932,1642823963,1642824596,633,2148
3714698686,3446914685,1642439325,1642439482,157,660
3733004020,3753985186,1656689122,1656689679,557,57
3931789231,3297477157,1653278382,1653278488,106,1232
3587508502,3804978604,1665180546,1665181194,648,1439
3118128782,3713062516,1653595939,1653596415,476,152
3409779636,3595612540,1656540947,1656541268,321,2300
3849725507,3999314182,1658268375,1658268566,191,1938
3663985085,3383686911,1642020743,1642020868,125,1707
3527269010,3104271824,1649875829,1649876085,256,945
3970753504,3437707461,1662449031,1662449934,903,2145
3031649001,3131131112,1653613806,1653613821,15,1812
3692904228,3707403309,1656728927,1656728947,20,443
3143689256,3493752989,1663708084,1663708325,241,1573
3368571252,3303358502,1644694107,1644694498,391,1414
3879766152,3694591547,1644257615,1644258615,1000,2119
3211064928,3624060457,1668210514,1668211250,736,2210
3153446106,3207757416,1654180639,1654180921,282,1623
3498685499,3568289450,1667562015,1667562053,38,321
3743860568,3124415148,1648329337,1648329748,411,2339
3108427765,3488151008,1645010727,1645011087,360,424
3830243698,3827810459,1656869223,1656869693,470,241
3772035177,3232141615,1653805735,1653805927,192,330
3690518174,3823650698,1650872797,1650872805,8,460
3125289160,3341573446,1646324839,1646325699,860,2429
3229060690,3037867406,1659482201,1659482768,567,680
3184916120,3005283650,1663478923,1663479294,371,409
3976984063,3009801123,1645860399,1645861163,764,195
3866532806,3704437148,1646285664,1646286570,906,259
3953258545,3760972512,1661340409,1661340467,58,1065
3636960130,3344143432,1654085793,1654086045,252,1227
3021289375,3089548621,1664713472,1664713982,510,527
3738591594,3271479070,1667484185,1667484380,195,1702
3668491789,3538863873,1650158190,1650158955,765,1845
3773488272,3031816406,1662109896,1662110790,894,351
3544353013,3264148498,1667661531,1667661576,45,2426
3333336166,3722220404,1643073597,1643074450,853,210
3853256957,3906903088,1654208101,1654208626,525,562
3728878635,3195274844,1643936008,1643936413,405,1120
3062789212,3955750752,1662141229,1662142097,868,2166
3113427537,3325842490,1645794577,1645795541,964,2499
3318654389,3054639823,1648692995,1648693311,316,1688
3141048645,3356144129,1647676189,1647677020,831,2347
3306460846,3092925867,1667635924,1667636399,475,2016
3790748869,3138662322,1661158609,1661158844,235,1833
3906903088,3544227988,1649609345,1649610178,833,1093
3799287196,3760224151,1643942064,1643942081,17,1895
3139376524,3642691052,1664900972,1664901659,687,842
3200875282,3240347468,1657251690,1657251833,143,170
3989550849,3726892870,1663911111,1663911120,9,242
3133427035,3157190919,1652469917,1652470221,304,1002
3708134798,3258050916,1648171250,1648171331,81,902
3103625074,3510634049,1662495286,1662495758,472,336
3294635633,3652765431,1653369323,1653369826,503,1844
3428299424,3202453519,1666092034,1666092130,96,2254
3437109709,3106465076,1658775914,1658776300,386,748
3053026624,3201276259,1657190900,1657191401,501,1589
3037577001,3413948595,1646364790,1646365591,801,1662
3690667222,3727794902,1669485941,1669486689,748,320
3603702697,3256648307,1654812136,1654812770,634,1597
3064758483,3391898268,1660713464,1660714145,681,427
3024268753,3816561204,1667545899,1667546851,952,788
3757499622,3778228977,1648767166,1648768114,948,1848
3740728884,3792027887,1646043913,1646044259,346,2130
3101854092,3297290662,1641636288,1641637102,814,985
3316625530,3106732056,1647581005,1647581474,469,929
3322287315,3067403592,1655532111,1655532596,485,259
3829201459,3020285623,1642925282,1642926133,851,783
3972195042,3717137928,1642050661,1642051031,370,443
3703825153,3733240502,1653717109,1653717623,514,913
3337624186,3246701704,1656890904,1656891075,171,2396
3338329823,3412927884,1663703112,1663703241,129,1494
3160061122,3901126730,1645206362,1645206833,471,2174
3058606856,3952283751,1641478402,1641479098,696,426
3358277498,3702965571,1662037510,1662037888,378,2350
3093178960,3351216955,1646172538,1646172960,422,861
3481672220,3121651540,1650352127,1650353124,997,2026
3755228064,3813034205,1666971841,1666972722,881,2432
3090910630,3947704522,1667760314,1667761113,799,2282
3692345317,3740728884,1646000903,1646001388,485,2163
3299607426,3132863382,1656742363,1656743003,640,1660
3469359731,3527013883,1652928625,1652928908,283,1786
3572896327,3118807144,1641023111,1641023925,814,1420
3790549304,3046380642,1648731022,1648731075,53,1156
3159950284,3382526428,1644757826,1644758686,860,1015
3885893310,3486832676,1656260494,1656260815,321,1619
3349718189,3745420516,1660763887,1660764744,857,1469
3884949094,3913288832,1656519320,1656519552,232,567
3766274699,3674335911,1642177323,1642177651,328,2193
3491022991,3784646522,1648442917,1648443130,213,2050
3031649001,3856474495,1661798218,1661798918,700,2386
3397910828,3748085058,1649489087,1649489607,520,1257
3983490056,3975380491,1666108186,1666109024,838,2000
3783064521,3153541916,1648564125,1648564477,352,934
3609274729,3622230392,1653053353,1653053664,311,1969
3281923852,3918812791,1667468735,1667469687,952,1676
3293865251,3906145952,1660479640,1660479915,275,1717
3828921434,3284940142,1668120283,1668120540,257,956
3205472801,3229080104,1658259712,1658260011,299,367
3025333750,3711016575,1664405258,1664405442,184,2188
3141480547,3272506285,1660659787,1660660181,394,2289
3010531134,3722078855,1657074225,1657074801,576,797
3153541916,3336336934,1644348770,1644349578,808,612
3502690432,3014438377,1648552957,1648553550,593,777
3402880726,3980824960,1648164892,1648165873,981,260
3695237310,3386628594,1646066984,1646067388,404,399
3235086334,3733649713,1665340277,1665341096,819,433
3182135067,3606643671,1641061557,1641062125,568,1551
3841672169,3949480596,1643524674,1643524902,228,196
3912183552,3113214024,1648117923,1648118335,412,358
3303973335,3299472791,1665644853,1665645234,381,1088
3319546209,3998763119,1666159097,1666159969,872,1708
3730533080,3722114463,1660272892,1660273430,538,1296
3080703553,3245354614,1647620006,1647620288,282,1474
3562875112,3591724433,1661095126,1661095183,57,1326
3009141852,3662023903,1657573069,1657574018,949,875
3486096604,3267968478,1654380163,1654380854,691,2293
3423073970,3531859919,1660163465,1660164069,604,1221
3471638565,3850392190,1662278178,1662278681,503,722
3786924052,3495798110,1658884337,1658884511,174,2196
3027829599,3089699104,1642309009,1642309774,765,2226
3666486477,3535941316,1643687362,1643687557,195,2379
3270273033,3204336699,1641943261,1641944223,962,177
3098083694,3933450798,1656969572,1656970472,900,805
3069318012,3260246509,1652507691,1652507793,102,2306
3868701805,3725439899,1652524466,1652524485,19,411
3227584428,3787714854,1645604803,1645605032,229,2271
3594173372,3849201069,1658217696,1658218555,859,704
3031241695,3274452346,1657913640,1657914528,888,448
3976730264,3002931773,1641122128,1641122943,815,2423
3029263333,3749619105,1643616755,1643617733,978,1541
3716415183,3369913868,1665946548,1665946832,284,611
3748360490,3128532251,1647025273,1647026103,830,2318
3578974875,3283155844,1656391628,1656392606,978,1566
3313782821,3515038349,1665018647,1665019020,373,1995
3512502358,3752701792,1663447842,1663447945,103,2369
3879605776,3935740815,1643150538,1643150675,137,783
3927660473,3564440153,1641629907,1641630055,148,2204
3610930903,3743835099,1643518829,1643519743,914,97
3425613329,3648305208,1659691863,1659692169,306,1658
3929901413,3764078507,1669646848,1669646901,53,188
3516140957,3886184659,1642107028,1642107615,587,1588
3598409790,3669864539,1646504576,1646504952,376,827
3219435736,3611777140,1668745891,1668745939,48,1854
3191970772,3370834194,1658096493,1658096602,109,1552
3997167780,3033692011,1668854118,1668854293,175,2436
3633730527,3423043196,1643760208,1643761065,857,68
3618397647,3956796805,1656763249,1656764166,917,960
3969650128,3174676733,1660616215,1660616433,218,2058
3115367011,3651753987,1643649658,1643649686,28,935
3686530724,3974481828,1651857161,1651857550,389,1693
3184000585,3844006658,1662092379,1662092978,599,212
3195504067,3584910336,1645784117,1645784758,641,2353
3037130270,3521302995,1643448900,1643449064,164,1286
3823161778,3984215552,1669455399,1669456220,821,501
3625938415,3284630826,1665771560,1665772450,890,1454
3328471090,3982736205,1662709641,1662709906,265,2442
3576862500,3722220404,1658690055,1658690116,61,787
3446987671,3590361712,1664571647,1664571960,313,1908
3332206707,3498770747,1650854348,1650855136,788,1233
3106630738,3076285457,1669459730,1669460603,873,1863
3335275571,3095503795,1659135766,1659136702,936,1501
3525377731,3596951808,1653288251,1653288885,634,276
3888141694,3862122399,1658852608,1658853106,498,842
3884798812,3365663032,1656329229,1656329473,244,1282
3265434991,3755413351,1668935980,1668936682,702,1779
3498758411,3939977057,1642703729,1642704204,475,1582
3963793916,3524508110,1666941235,1666941447,212,2220
3683460040,3907635993,1662258864,1662259243,379,905
3035737560,3683134571,1669378977,1669379368,391,658
3466156489,3551402272,1660435585,1660436235,650,218
3375125376,3419809319,1662188909,1662189229,320,863
3876696308,3608079336,1648309871,1648310332,461,1866
3939477257,3552282443,1667751751,1667752499,748,42
3840155828,3452564658,1668675094,1668676076,982,1140
3028267408,3816194055,1665979561,1665980534,973,1071
3565052722,3439700326,1662677984,1662678912,928,932
3690043318,3608775321,1664030408,1664030632,224,158
3659158165,3276771725,1646448485,1646448903,418,87
3152555864,3442330693,1661996012,1661996804,792,146
3098907787,3054979282,1652990105,1652990343,238,1938
3058141936,3391426421,1664233223,1664233649,426,886
3563488722,3014975304,1650674237,1650674565,328,1817
3750949753,3458478056,1664338178,1664338802,624,2093
3718176139,3720934127,1652515836,1652516722,886,436
3964738114,3052499026,1651844885,1651845192,307,805
3540735539,3293339453,1643428887,1643429373,486,1672
3687278591,3333347852,1667254349,1667255326,977,2050
3548133562,3614206353,1655175763,1655176497,734,1328
3973264936,3902543996,1651430182,1651430960,778,831
3694127985,3952889735,1643720660,1643721108,448,931
3993995217,3992927391,1661173135,1661173422,287,776
3696716300,3663038239,1663579860,1663580241,381,772
3377781677,3239792198,1651918398,1651918884,486,2082
3452843457,3298635617,1668578773,1668579014,241,2250
3867126446,3311921613,1643658987,1643659901,914,620
3000254515,3661016961,1644701497,1644702383,886,546
3976223971,3932786032,1659046336,1659046722,386,464
3054803754,3019750416,1645664852,1645665852,1000,1737
3420298161,3992909356,1654226641,1654227611,970,2197
3918397944,3042046828,1656123560,1656123597,37,1769
3095932716,3636879699,1651329582,1651329583,1,1095
3391622565,3295146156,1667283185,1667283794,609,1450
3564883937,3207258694,1645433269,1645433498,229,424
3567637602,3957053810,1648484429,1648485049,620,717
3658295713,3339185857,1641563737,1641564274,537,561
3643637605,3414370730,1666654618,1666655595,977,1035
3860422016,3775753518,1658816046,1658817043,997,2161
3041652512,3963134791,1663044704,1663045533,829,1471
3203734562,3886917024,1658059886,1658059887,1,1843
3345138946,3604376955,1661617547,1661618279,732,788
3597251704,3195451932,1649618265,1649618445,180,124
3700287335,3739731580,1657276490,1657277111,621,1174
3830541998,3300412448,1641350216,1641350564,348,1241
3436768933,3476405785,1652304486,1652305230,744,372
3390532209,3314823389,1667248680,1667248863,183,675
3823637809,3107530825,1669698148,1669698490,342,151
3562105236,3325981847,1656972158,1656972204,46,473
3882983178,3935822380,1668991021,1668991884,863,2463
3269357443,3241190614,1662723690,1662724178,488,138
3780039563,3706085200,1656426497,1656427432,935,868
3904874839,3756020689,1644477520,1644477879,359,1773
3732456028,3307949630,1668332874,1668332974,100,156
3492638245,3145438438,1652516010,1652516535,525,1987
3254503569,3832773624,1647484304,1647484641,337,1088
3122002940,3662300962,1657444066,1657444705,639,686
3705752007,3958507300,1665032121,1665032343,222,2307
3867353788,3543256939,1642239553,1642240459,906,1736
3408104715,3504911583,1652706342,1652706807,465,2143
3762538736,3732349114,1657043338,1657043704,366,927
3738624659,3016482005,1644720484,1644721299,815,2249
3397970538,3556577780,1664790131,1664791007,876,2068
3324073911,3938505582,1643788570,1643789062,492,2139
3215088423,3464653044,1664348375,1664348585,210,126
3333095694,3785883615,1669683274,1669683932,658,556
3229321048,3934848520,1651852580,1651853098,518,497
3173642675,3642377610,1643424529,1643424840,311,553
3714188043,3854995649,1657077966,1657078193,227,1605
3228737899,3737400101,1668023112,1668023246,134,2362
3780039563,3144551332,1647648034,1647648047,13,1605
3024431618,3068913990,1657363344,1657363391,47,154
3349247221,3273676719,1656751048,1656751945,897,1485
3371430360,3373962186,1645930139,1645930893,754,1666
3805665502,3268607924,1655468388,1655468766,378,1673
3712115076,3698906761,1648404668,1648404847,179,1467
3536080615,3407156969,1661253539,1661253909,370,345
3656000543,3644961840,1654177058,1654178029,971,833
3535763829,3768984387,1654838507,1654839445,938,2082
3585526520,3558312644,1645838810,1645839416,606,1028
3765962960,3124200545,1642723180,1642723894,714,594
3467810757,3112856155,1662046639,1662047208,569,216
3799287196,3623206706,1646467069,1646467376,307,394
3181236848,3254866960,1644958236,1644959046,810,1327
3447527130,3190454065,1641171545,1641171974,429,2059
3211965606,3481090623,1661574643,1661574647,4,1236
3862685266,3998329857,1659922325,1659922823,498,1137
3962031345,3165884724,1651658568,1651658929,361,1698
3912511626,3840026910,1669093774,1669094331,557,1448
3758622438,3834720743,1665315412,1665316037,625,731
3412053580,3680060067,1648706497,1648706702,205,517
3442967650,3520511256,1661541079,1661541318,239,139
3763270952,3697231480,1649217101,1649217241,140,1504
3273518390,3649252503,1654199608,1654200183,575,655
3091008161,3315569726,1651121769,1651122173,404,1969
3630123918,3581971425,1647334995,1647335841,846,1040
3162836777,3228805720,1651367700,1651368039,339,1992
3270325529,3315583401,1664908315,1664908922,607,432
3129138715,3216243579,1653709986,1653710267,281,1083
3444809495,3955750752,1658773360,1658773565,205,380
3389926670,3770393539,1652356314,1652356365,51,1644
3452067391,3841170833,1650246543,1650246651,108,396
3928930330,3052822229,1653113522,1653113798,276,997
3422046745,3217857851,1660110939,1660111407,468,1364
3546486600,3524831718,1652057096,1652058018,922,1514
3973959874,3156210736,1648174207,1648175197,990,827
3570050230,3683507812,1668168081,1668168359,278,1867
3898118371,3557751532,1641173320,1641174041,721,275
3984461468,3118754726,1665214152,1665215101,949,2475
3384307655,3018325807,1659307674,1659307905,231,55
3745960708,3200795190,1664846756,1664847739,983,1676
3089034472,3142923526,1668609743,1668610213,470,2086
3551170621,3097917804,1659600214,1659601086,872,1736
3079137127,3595670942,1657041139,1657042127,988,575
3469887287,3239265546,1645737359,1645738042,683,1517
3084592361,3637292465,1647577796,1647578686,890,1852
3428593255,3526747987,1654244772,1654245192,420,596
3418364050,3588936901,1650394276,1650394852,576,988
3644961840,3664381582,1660427610,1660427760,150,570
3281562391,3084730908,1663704154,1663704588,434,1404
3460687455,3188680599,1662004271,1662004898,627,2220
3055710852,3867126446,1655714659,1655715247,588,1843
3424897066,3222749852,1663328373,1663329189,816,1175
3319365305,3869355507,1644601684,1644602548,864,983
3329463543,3028886204,1666323438,1666323957,519,871
3140608489,3494680258,1649521392,1649522198,806,1835
3408529019,3161999632,1653309155,1653309396,241,2184
3081188307,3715894883,1654554289,1654554684,395,2154
3199255829,3610101662,1667464457,1667464467,10,1736
3561529281,3340366291,1666844730,1666845052,322,1878
3802816973,3894359262,1662586094,1662586753,659,2197
3115928790,3898641431,1658987798,1658988298,500,1058
3356317749,3536118453,1666430762,1666431247,485,943
3300983140,3324069408,1659781811,1659782108,297,1171
3417298701,3324394622,1657274396,1657275101,705,926
3113214024,3414700083,1658350754,1658351032,278,2216
3536954029,3740009683,1646539449,1646539879,430,2467
3271156755,3495691991,1642842612,1642843308,696,944
3261174036,3360436723,1655939877,1655940248,371,1395
3815235622,3274985034,1644478746,1644479135,389,1664
3902777743,3855113371,1662376944,1662377213,269,2220
3679522128,3573961768,1648378050,1648378138,88,616
3866260144,3816309635,1663506582,1663506602,20,665
3691021918,3875008839,1647382704,1647382774,70,1681
3651110510,3457451540,1665673412,1665673447,35,2204
3915986965,3054758455,1645647028,1645648023,995,2420
3358277498,3138801114,1654844520,1654845181,661,1199
3972886254,3626824650,1645908462,1645908806,344,2382
3713308621,3080007856,1660370722,1660371444,722,1403
3597485446,3830243698,1651480742,1651481453,711,2498
3591724433,3039255124,1664912263,1664912985,722,1095
3402349073,3511192827,1668484744,1668484781,37,26
3877090261,3974804920,1642952869,1642953570,701,1900
3310037244,3573961768,1648985063,1648985996,933,2040
3759008568,3978925529,1644859831,1644859938,107,1386
3774823325,3391711118,1663915666,1663916311,645,806
3088132769,3159525512,1659213610,1659213730,120,343
3021679982,3609104298,1666737320,1666737750,430,820
3041792624,3307033178,1642731859,1642732683,824,1301
3950047958,3284948113,1645622436,1645623126,690,89
3568645029,3485459472,1657299642,1657299989,347,1922
3417176290,3830975217,1667484563,1667484794,231,1116
3054865222,3213995449,1668302803,1668303145,342,691
3913288832,3272623699,1658622098,1658622150,52,896
3070640991,3446741935,1661218833,1661219128,295,736
3628556060,3595284541,1641805590,1641805810,220,1313
3985617701,3817667121,1662050921,1662051550,629,1106
3585042042,3210913409,1652134995,1652135257,262,212
3188567155,3143909362,1652349095,1652349451,356,196
3069881077,3528146911,1648872958,1648873539,581,2012
3902437090,3021218084,1644523484,1644524182,698,1228
3973059785,3045981034,1668716920,1668717862,942,1622
3915963591,3696607958,1657556407,1657557190,783,762
3955055535,3184615246,1654907853,1654908526,673,298
3433374325,3013433465,1647788773,1647789231,458,1508
3279538648,3191414403,1645297539,1645298282,743,1277
3118057575,3718182841,1667160629,1667161145,516,1304
3441680015,3892023630,1659146739,1659147655,916,1618
3370889279,3907872554,1648674262,1648675224,962,1596
3719507293,3788819111,1641867213,1641867421,208,1999
3910712536,3152537793,1658245169,1658245452,283,819
3734035375,3103351502,1648546833,1648547760,927,924
3692247556,3374134461,1669129853,1669130002,149,1108
3476060971,3579642249,1661819310,1661819819,509,1108
3646544919,3492657889,1655528434,1655528865,431,1751
3067641822,3547278175,1647364527,1647365211,684,1041
3398583773,3414857456,1666466938,1666467413,475,1206
3245522058,3000986440,1655510994,1655511856,862,1882
3202881162,3431175768,1662575245,1662575867,622,536
3713834683,3251372174,1661567884,1661568189,305,1287
3132258390,3916226073,1654629698,1654630002,304,281
3577878798,3936914064,1642695423,1642695521,98,990
3546866871,3392395230,1643814565,1643814820,255,208
3939973483,3016508907,1658285304,1658285624,320,230
3552101140,3100572176,1645132884,1645133829,945,867
3920875021,3413514902,1668610277,1668610945,668,1133
3360575138,3551810435,1669079600,1669080219,619,1358
3524217572,3204575281,1649537905,1649537915,10,130
3879182220,3485578733,1664445089,1664446068,979,119
3449622291,3230836206,1655328206,1655328966,760,553
3886368625,3320272612,1661365048,1661365512,464,54
3603214777,3947174877,1664336171,1664336200,29,552
3905999483,3671054235,1649777781,1649778444,663,963
3607580736,3566824993,1647844834,1647845161,327,1600
3516743828,3636237325,1646971479,1646972027,548,869
3357699960,3515845767,1649400631,1649400910,279,2393
3249642950,3823288349,1662314452,1662314707,255,134
3228794031,3143679923,1667008236,1667009112,876,1494
3491468798,3810952134,1668740147,1668740936,789,2288
3793086361,3665599335,1650913147,1650913458,311,1127
3942399353,3159240548,1655331333,1655331388,55,1925
3692498377,3432942151,1652468397,1652468722,325,1848
3289330422,3000254515,1645645164,1645645683,519,806
3014535209,3172773924,1658731420,1658732299,879,1456
3728224229,3164467795,1663077322,1663077754,432,1406
3729914869,3790648941,1652503226,1652503378,152,1190
3371785046,3788769219,1644420675,1644421415,740,1661
3914613880,3792834070,1650401485,1650401905,420,719
3913071555,3272250396,1643551513,1643551798,285,2236
3090179745,3824649355,1651824317,1651825289,972,2052
3109390601,3437109709,1645120036,1645120649,613,280
3059858458,3925754107,1666152930,1666153807,877,773
3537450451,3432059238,1653818078,1653818153,75,1250
3878512967,3205809646,1665098596,1665099190,594,2092
3097128642,3858876644,1667349775,1667350327,552,2304
3106732056,3942852295,1641985370,1641985965,595,2284
3658782272,3866260144,1658941247,1658941650,403,1206
3441581446,3051863550,1643584097,1643584503,406,500
3098667748,3200978578,1646649248,1646649409,161,1401
3003116947,3473505436,1668722233,1668722416,183,1909
3056053831,3137594486,1641096292,1641096449,157,152
3345186165,3396365443,1641641371,1641642293,922,17
3437603547,3297477157,1660995156,1660995931,775,2423
3307730398,3833342718,1667035748,1667036595,847,1374
3045691620,3534852421,1655074165,1655075139,974,2398
3470488588,3187561832,1641308443,1641309398,955,2036
3747621620,3413056504,1658746995,1658747844,849,653
3138662322,3029807207,1650388199,1650388450,251,782
3899788381,3094940809,1645630177,1645631037,860,454
3321441782,3507500782,1651573443,1651574076,633,1964
3590656592,3639376136,1656698348,1656698783,435,1032
3889840253,3323809275,1641306004,1641306713,709,1390
3559696066,3175676853,1665749572,1665750492,920,2264
3827195774,3274159957,1668057592,1668058131,539,1247
3126995401,3725989619,1643532806,1643533460,654,1078
3739338939,3277284318,1659954456,1659954570,114,1639
3445530012,3663718795,1647075861,1647076569,708,1212
3273219526,3796559738,1650706494,1650707197,703,1747
3938417195,3445095607,1651889096,1651889130,34,568
3177036721,3862122399,1662998107,1662999029,922,1268
3124574350,3270395343,1650749620,1650749840,220,2392
3555538922,3295278768,1645470438,1645470762,324,514
3474572698,3131548243,1644635946,1644636851,905,190
3708034201,3350345176,1643151156,1643152112,956,2485
3952286494,3270919620,1649711693,1649712138,445,573
3481149583,3104050460,1644506723,1644506961,238,1528
3582683989,3324073911,1654984117,1654984259,142,666
3717926703,3542824458,1660791824,1660792668,844,1269
3702932977,3912014286,1644988732,1644989349,617,1389
3098108231,3872444916,1662977355,1662977692,337,256
3059075236,3805742408,1651876414,1651877046,632,1403
3852673624,3099013723,1665518412,1665518921,509,2081
3315854812,3590656592,1643285931,1643286183,252,672
3066892936,3277298737,1656814305,1656814750,445,381
3879898101,3287901684,1644170227,1644170853,626,477
3217923322,3073474496,1664712413,1664712909,496,2126
3612973191,3123302108,1658842566,1658843392,826,1465
3180062640,3183867254,1660551255,1660551854,599,2332
3602238630,3020285623,1659257157,1659257802,645,1359
3267151775,3199117399,1655350254,1655351059,805,34
3163395401,3558492617,1665517695,1665517919,224,1692
3322337553,3905167655,1656658935,1656659589,654,974
3899301205,3428763205,1651756109,1651756412,303,1911
3930118877,3571576669,1641877823,1641878384,561,2033
3361870766,3218903379,1644731976,1644732192,216,1805
3216582576,3791486887,1667531643,1667532518,875,496
3105679045,3988466264,1666302075,1666302133,58,1712
3157821920,3067229796,1668714941,1668715563,622,915
3147298514,3201479561,1663941098,1663941762,664,1627
3956547336,3974804920,1645641500,1645641651,151,1294
3745289284,3280648157,1654688675,1654688773,98,501
3413056504,3569443529,1669240788,1669241509,721,2220
3120505983,3313292041,1663291771,1663292171,400,2466
3726892870,3924167113,1656029985,1656030182,197,2388
3870243569,3887036201,1646611965,1646612369,404,2424
3329449985,3616712503,1643962101,1643962147,46,1338
3304596274,3539402223,1662933153,1662933553,400,1583
3729356619,3390723607,1668751794,1668752665,871,376
3708809295,3215453691,1653112702,1653113271,569,652
3668235327,3939281989,1645753137,1645754106,969,265
3267479523,3259880338,1656869913,1656870178,265,1228
3862890852,3409662195,1646880553,1646880711,158,2291
3430387951,3934383056,1649238579,1649239499,920,1391
3352634974,3449115415,1652075997,1652076016,19,87
3612556887,3892848585,1656627849,1656628593,744,229
3943892886,3139551539,1656700568,1656700838,270,984
3318654389,3416196153,1655213564,1655214096,532,1121
3935022176,3269889273,1658856113,1658857047,934,75
3283211870,3628554134,1650649894,1650649932,38,1453
3097834756,3557734825,1653513556,1653514178,622,658
3918891410,3002316212,1667591899,1667592762,863,2404
3454135300,3429004715,1643659003,1643659289,286,45
3557409187,3153413554,1648269967,1648270792,825,2128
3127812666,3154567629,1661535300,1661535362,62,1122
3404043594,3658910038,1641085046,1641085193,147,1389
3865387894,3730702889,1660077638,1660078634,996,2243
3094125203,3849977339,1650882724,1650882957,233,1109
3990520153,3995365519,1654725313,1654726217,904,1132
3402878567,3481466662,1658001646,1658002093,447,920
3927649358,3112287858,1665049887,1665050663,776,829
3102753256,3634871077,1654471271,1654471937,666,2096
3048405710,3672070606,1663216185,1663216706,521,2014
3333347852,3030286864,1646158404,1646158661,257,1593
3961903747,3741024153,1665330919,1665331519,600,1038
3284137438,3044967578,1661337241,1661337537,296,442
3206248943,3885162740,1667386107,1667386400,293,1641
3191462400,3139551539,1668300711,1668300812,101,166
3706027798,3545730764,1660662307,1660662428,121,1553
3741978263,3841106350,1665269610,1665270134,524,1560
3693797946,3893671286,1650381049,1650381473,424,591
3749188570,3284630826,1655937806,1655938737,931,628
3375769320,3749308364,1647936268,1647936571,303,938
3695545980,3177943874,1650840255,1650840488,233,1983
3534218813,3090354216,1651527916,1651528789,873,1499
3162939277,3672699331,1661339206,1661339727,521,1677
3859164696,3445226012,1660325105,1660325215,110,370
3629984199,3057159511,1659667119,1659667980,861,2342
3696947299,3759393612,1665968332,1665969260,928,414
3634999231,3043180716,1653065228,1653065397,169,876
3313782821,3401382792,1666824140,1666824281,141,688
3210136888,3247980767,1652353483,1652354327,844,2008
3262098376,3620700244,1663194831,1663195056,225,755
3123441689,3402578446,1665611294,1665612267,973,1567
3537214664,3954297181,1646695797,1646696216,419,307
3075001202,3506307976,1656422990,1656423681,691,790
3334237477,3807538433,1651187651,1651188235,584,379
3062506508,3794103075,1647943906,1647944785,879,1712
3839200168,3580953063,1651185405,1651186109,704,1571
3953002004,3131820605,1662688348,1662688910,562,261
3561881366,3982916950,1654947038,1654947993,955,1165
3032888380,3044967578,1642274171,1642274314,143,481
3654344198,3758577708,1666473417,1666473749,332,781
3649298405,3035737560,1642666158,1642666989,831,213
3647951580,3263488499,1664769990,1664770863,873,2377
3629207282,3962034507,1668960134,1668960499,365,1705
3842844573,3516624109,1663065179,1663065795,616,47
3940387270,3798509385,1666932540,1666933161,621,1154
3761636372,3425856728,1656475132,1656475617,485,153
3284838720,3112856155,1668001407,1668002078,671,1947
3929497543,3121391240,1645997574,1645997601,27,2098
3055211808,3710189327,1650232981,1650233221,240,2288
3334207071,3247269367,1660293658,1660293745,87,1193
3653069495,3497045946,1660662327,1660662402,75,2184
3628956600,3715106063,1646251404,1646252080,676,86
3620522583,3713520914,1642295956,1642296854,898,1693
3965585706,3147210428,1667514191,1667515174,983,2483
3577627752,3409055122,1655698908,1655699899,991,1673
3143679923,3559023463,1662995824,1662996529,705,2248
3397940369,3451307942,1659298975,1659299904,929,796
3832640445,3080454518,1658698354,1658699272,918,1745
3156452001,3642946322,1667844261,1667845223,962,810
3401611149,3299472791,1663020560,1663020816,256,1355
3041652512,3660551283,1669114831,1669115264,433,1422
3046132590,3414224162,1643187827,1643188709,882,888
3056267922,3567126985,1641390448,1641390659,211,2247
3039081980,3079013365,1643705383,1643705436,53,1594
3932786032,3609274729,1656151215,1656151268,53,2052
3250253670,3997167780,1665336305,1665337221,916,1055
3344205602,3681170705,1666669197,1666669592,395,1587
3764298989,3683739941,1668113546,1668114393,847,95
3701196344,3313252249,1652417878,1652418143,265,324
3852633699,3081396297,1660510663,1660510838,175,157
3796065026,3198195956,1657322009,1657322599,590,1002
3625979408,3629593465,1663765087,1663765907,820,789
3295518987,3437254567,1664962621,1664962954,333,114
3220736075,3163030169,1650073131,1650073156,25,193
3173667762,3366321387,1649864981,1649865206,225,713
3799014776,3638595264,1648720225,1648720786,561,440
3864044700,3067985831,1669040658,1669041556,898,56
3604236901,3306188967,1669495846,1669495874,28,2492
3705943924,3655923753,1657415349,1657416037,688,1962
3778381574,3086530794,1653496241,1653497077,836,212
3597794683,3576386271,1664656698,1664656841,143,883
3949522552,3980283928,1666659498,1666659508,10,1212
3774413169,3915494041,1642625275,1642625443,168,564
3484710507,3463800741,1647491503,1647492172,669,2157
3478570785,3251106195,1645608450,1645609108,658,470
3745248673,3695558824,1641010517,1641010848,331,1236
3344957789,3650902153,1641539281,1641539289,8,1198
3687151281,3380303288,1647707277,1647707736,459,937
3972886254,3700412611,1667961310,1667961785,475,535
3656789430,3858121838,1651661238,1651661644,406,2205
3560756539,3289332257,1664754495,1664754704,209,2472
3934914335,3614206353,1652076019,1652077009,990,1985
3474975781,3722726470,1666725116,1666725951,835,684
3272250396,3521081470,1656359875,1656360197,322,589
3161999632,3414834461,1650020831,1650021791,960,1642
3313782821,3460552791,1661942634,1661943402,768,1222
3389497658,3626672801,1641665348,1641665733,385,2163
3658477943,3806015172,1660444645,1660445229,584,740
3447527130,3151938386,1659665280,1659665598,318,1544
3259344210,3102669962,1663202920,1663203434,514,2351
3667684695,3839200168,1654836183,1654836552,369,1031
3114348300,3072317138,1650728888,1650729427,539,1083
3194069746,3688405055,1646841848,1646842681,833,2435
3196975901,3572276937,1651733918,1651733998,80,19
3562116841,3129641154,1648955258,1648956240,982,451
3321346285,3823206701,1668983080,1668983089,9,2144
3917709571,3366643644,1651820991,1651821144,153,276
3871971681,3929988329,1647150146,1647150287,141,474
3765504986,3629797745,1663089413,1663089502,89,2100
3823419231,3180252962,1643962113,1643962651,538,1933
3471993716,3710202750,1662762544,1662762975,431,2094
3658451605,3343249545,1648292878,1648292931,53,802
3880835949,3070087815,1643101415,1643102387,972,1449
3948260526,3513180024,1665823544,1665824266,722,1210
3959081575,3643412582,1646107077,1646107518,441,120
3542927039,3479725709,1662825109,1662825455,346,177
3397376963,3090804084,1643836344,1643836849,505,243
3158209281,3617200235,1647557618,1647558024,406,1495
3340933137,3883286458,1647173751,1647174642,891,27
3596932196,3339480960,1665802808,1665803334,526,1036
3063955055,3514152633,1644396845,1644397641,796,588
3854219185,3489473144,1643684487,1643684797,310,1575
3863676573,3854390772,1647325093,1647326022,929,1295
3059447105,3482406705,1654633845,1654634108,263,794
3284940142,3618380884,1643108689,1643109366,677,713
3062261092,3075313832,1665739900,1665740609,709,1309
3101886383,3972649318,1647583201,1647584151,950,146
3603702697,3849028830,1656626514,1656626839,325,439
3493424957,3751826055,1665294744,1665295082,338,444
3350017208,3532021354,1659962949,1659963921,972,2317
3235049473,3541372095,1654771226,1654771609,383,893
3557734825,3031299470,1659641298,1659642169,871,700
3720934127,3404394014,1643395018,1643395588,570,74
3345186165,3336965818,1652701077,1652701886,809,354
3280046501,3034919553,1663875519,1663875800,281,1299
3612269633,3243086924,1652011071,1652011729,658,2121
3828219822,3367865740,1663193797,1663194236,439,2125
3920910995,3417176290,1641760961,1641761554,593,14
3966881800,3383110959,1655443089,1655443848,759,1396
3882438892,3012155922,1652194207,1652194355,148,2462
3811164522,3097128642,1643199638,1643200048,410,1072
3449114289,3774325139,1651024658,1651025027,369,634
3639352799,3702345362,1654589785,1654590257,472,673
3124574350,3964637208,1644345348,1644345520,172,402
3366822094,3981049957,1669191177,1669191801,624,1677
3913162487,3235825340,1643431517,1643432208,691,2166
3646433612,3982058383,1663128689,1663129433,744,1413
3425815854,3411636309,1657923686,1657924168,482,1106
3603853942,3348278635,1668076803,1668077115,312,2406
3249642950,3183640403,1664829034,1664829165,131,1152
3367768003,3093589416,1650909615,1650910551,936,310
3749379310,3766914780,1642814082,1642815014,932,779
3188588023,3013862518,1656270429,1656271041,612,1023
3375021204,3468654589,1646584831,1646585103,272,1718
3041809783,3640585545,1658854604,1658854790,186,1213
3636808827,3460687455,1667602344,1667603271,927,673
3480314503,3095559156,1665720039,1665721037,998,1235
3537787770,3538863873,1650242889,1650243475,586,1882
3949947697,3867158050,1641589330,1641589612,282,482
3380822514,3341890542,1655891361,1655891466,105,1284
3016340117,3026025743,1660005875,1660006295,420,1218
3079415495,3010673027,1668925357,1668926054,697,2382
3012152244,3786811867,1665705630,1665706272,642,1639
3020452542,3533740602,1668660771,1668661542,771,1527
3574985668,3531642816,1663206302,1663206493,191,1757
3756028002,3285019414,1645458798,1645458969,171,1051
3370867881,3889730114,1648511972,1648512206,234,514
3539839307,3331539245,1652318923,1652319385,462,1574
3070395663,3973959874,1656758680,1656759243,563,805
3570872297,3542927039,1661927271,1661928247,976,695
3312580754,3341241551,1645598516,1645599001,485,589
3576961863,3911621945,1667534652,1667535116,464,355
3367510444,3864301593,1655454713,1655454848,135,2030
3144993263,3781537659,1663622046,1663622454,408,1789
3470570814,3565381166,1655976315,1655976610,295,2012
3767983934,3554822566,1651241558,1651241682,124,1214
3971391515,3006953744,1647373676,1647374501,825,2471
3776419392,3904203375,1650211676,1650212100,424,1730
3913243283,3848740333,1654207949,1654208086,137,2125
3699152541,3844499309,1659002710,1659002975,265,1761
3424768768,3946911182,1664811313,1664812069,756,754
3863922323,3693797946,1659680555,1659680581,26,1402
3149181988,3469722588,1664339594,1664339878,284,1037
3068161140,3398278082,1661826681,1661827412,731,851
3250208944,3900755896,1645869076,1645869826,750,81
3002350398,3028063669,1662131028,1662131777,749,1931
3045925838,3960494982,1660189123,1660189808,685,1420
3572746096,3346261120,1660793259,1660793794,535,1862
3774264905,3428260922,1666001498,1666001990,492,784
3565278029,3442330693,1651985627,1651985825,198,2122
3492034029,3408903285,1657092690,1657093654,964,502
3768549498,3865387894,1658451368,1658451735,367,1108
3423073970,3819415032,1654164797,1654165666,869,1108
3429052801,3222749852,1655583378,1655584003,625,2172
3163395401,3079415495,1648909981,1648910540,559,60
3722483331,3652177742,1665636034,1665636794,760,1285
3879257961,3555187890,1650907143,1650907519,376,636
3557751532,3617533561,1641096578,1641096609,31,705
3805665502,3533954093,1654196504,1654197294,790,448
3389560959,3063744739,1648492119,1648492946,827,112
3260246509,3217173480,1651240011,1651240519,508,278
3556823098,3535631980,1660865651,1660866614,963,1752
3217923322,3887519119,1651700426,1651700466,40,954
3184455755,3368734939,1658156092,1658156585,493,635
3393406422,3358241145,1660617071,1660617344,273,1660
3729356619,3049579265,1649093734,1649094657,923,1518
3957695947,3189111071,1648152788,1648153029,241,401
3540717336,3328798665,1644263529,1644263640,111,84
3006456611,3911632634,1645712557,1645712576,19,497
3814608487,3766345791,1667279960,1667280696,736,1364
3111823829,3877049401,1661465780,1661466255,475,796
3103404280,3215870665,1655431727,1655432336,609,738
3649447383,3860883669,1648587870,1648587898,28,1666
3809387134,3543926712,1655975449,1655975733,284,1165
3267360802,3479738009,1656392008,1656392466,458,1487
3821039922,3095124554,1650101683,1650102500,817,96
3958375464,3586025172,1663620167,1663621053,886,42
3974318707,3783304213,1669570588,1669570807,219,1067
3993653521,3546006441,1642344137,1642344637,500,2377
3638595264,3563246157,1652506179,1652507081,902,926
3862122399,3104396432,1657911523,1657912491,968,1477
3454546723,3656000543,1652408086,1652408249,163,1041
3467933841,3047001138,1667803285,1667803409,124,2452
3992226673,3151323388,1658465578,1658466387,809,987
3314872000,3553146922,1661351288,1661351999,711,748
3029468613,3856587038,1642777394,1642777736,342,2208
3424994271,3495919793,1649495274,1649496267,993,2216
3029943531,3281445213,1642479944,1642480242,298,727
3407770585,3553096192,1651365370,1651365866,496,845
3293435801,3290359932,1660819475,1660819996,521,1522
3383751042,3066757468,1654009886,1654010568,682,523
3429052801,3984977278,1651500616,1651501520,904,2077
3435698448,3501962027,1660058557,1660058964,407,1926
3364409507,3433418040,1643420269,1643421240,971,679
3840422094,3614399988,1647554934,1647555815,881,851
3971524060,3746443510,1651839224,1651839976,752,951
3481149583,3447946570,1669039501,1669040073,572,941
3448734872,3379598529,1665289817,1665290742,925,1349
3428026242,3342685325,1658451881,1658451895,14,2321
3639352352,3368884196,1669663634,1669663756,122,66
3249512921,3710422072,1650888735,1650889344,609,950
3339312980,3957411858,1643112497,1643113443,946,378
3178490239,3936914064,1662136193,1662136670,477,2343
3722422633,3039864595,1649932636,1649933131,495,788
3772762015,3129176226,1646262986,1646263051,65,834
3293615945,3215423327,1646066294,1646066838,544,1041
3623802234,3285331142,1647312387,1647313083,696,85
3830866959,3891477592,1663492125,1663493067,942,2018
3850214790,3377774902,1669109004,1669109482,478,1720
3746550027,3502074085,1646369435,1646369483,48,53
3867398861,3693691265,1661322523,1661323437,914,1766
3481548873,3964738114,1666004149,1666004860,711,1054
3489273340,3885696227,1653304241,1653305224,983,2436
3042836639,3990849115,1645457144,1645457342,198,2299
3377855107,3583591867,1654599932,1654600737,805,2281
3284380221,3856080546,1656234796,1656234843,47,733
3531574623,3855900879,1641691482,1641691771,289,2367
3488962022,3702932977,1645365516,1645365682,166,1293
3393199571,3528271389,1656780338,1656781226,888,381
3450074680,3079137127,1665548499,1665548734,235,691
3784959270,3634089207,1641257892,1641257975,83,791
3097145374,3776128581,1666117051,1666117670,619,2224
3884959127,3767581542,1650975169,1650975930,761,729
3156261740,3545214789,1664452564,1664452703,139,1310
3604769442,3224864814,1643409963,1643409983,20,1426
3978690472,3822917630,1644595144,1644596134,990,813
3362647814,3247948931,1644755395,1644755515,120,700
3625034951,3377086230,1645257887,1645258561,674,280
3923635120,3740807524,1647590013,1647590770,757,259
3197362399,3348802129,1660943113,1660943855,742,1815
3012032774,3335565751,1657053711,1657053973,262,150
3287082352,3596179079,1646435601,1646436254,653,2292
3618352797,3702064029,1662411006,1662411995,989,619
3490087619,3738887934,1652863236,1652863396,160,1648
3557835284,3997038651,1644746142,1644746509,367,1857
3854535872,3688056726,1643948255,1643949023,768,2374
3887337385,3568965374,1664634842,1664635536,694,2456
3166754795,3054659800,1642175941,1642176622,681,640
3045925816,3503489321,1643785368,1643785852,484,608
3913071555,3204412545,1663450535,1663450739,204,1413
3960450011,3012845933,1657330690,1657331112,422,2026
3056267922,3664930564,1653608242,1653609184,942,1040
3141480547,3970820689,1656971569,1656971945,376,1662
3062789212,3005283650,1642302348,1642303306,958,1468
3223412894,3158554223,1659375245,1659376134,889,1723
3401463703,3656175066,1659537538,1659538097,559,1
3267045921,3227567293,1653142528,1653143162,634,583
3691830908,3699293407,1658329818,1658330583,765,1654
3885458258,3502554871,1664608146,1664608371,225,839
3082026010,3183740417,1659476298,1659476461,163,2197
3566874478,3003861871,1655110653,1655111128,475,528
3903193601,3957665117,1649199305,1649200031,726,1851
3153831709,3841106350,1666887583,1666888282,699,2196
3893709526,3235086334,1649723666,1649724374,708,351
3817000379,3065434950,1661850330,1661850476,146,449
3970820689,3815537815,1663380280,1663380280,0,1948
3246796194,3537214664,1661816026,1661816032,6,1895
3413056504,3590735151,1646902291,1646903221,930,1596
3908997041,3639121807,1667040135,1667040556,421,1422
3605412707,3379598529,1652772564,1652773215,651,1831
3744759130,3075001202,1658431883,1658432501,618,428
3406215034,3069332103,1666296707,1666297536,829,2036
3104405785,3644951156,1662755971,1662756241,270,1438
3211514286,3620616287,1666583318,1666583828,510,1736
3042034210,3844560489,1668239460,1668239608,148,1331
3402426323,3846585557,1648336458,1648337418,960,809
3834160941,3710756423,1665296895,1665297609,714,2270
3098179768,3115029581,1646313025,1646313845,820,940
3621938271,3227567293,1661856682,1661857601,919,1492
3878059612,3462744404,1653543360,1653544329,969,17
3934383056,3015253917,1647193522,1647193586,64,408
3147089920,3542129823,1668335700,1668336312,612,1818
3089325315,3096695477,1667512668,1667513102,434,1061
3304490341,3771460646,1652683412,1652683605,193,1596
3276763839,3758849561,1645026922,1645027524,602,798
3941548978,3545781567,1661026960,1661027642,682,1431
3399334455,3141392063,1668782099,1668782742,643,1202
3498685499,3057574793,1658434840,1658435129,289,1997
3865847882,3239020709,1646420438,1646420723,285,1137
3889498156,3617545187,1669344908,1669345418,510,721
3250253670,3920436432,1666991286,1666992270,984,268
3398865388,3411993487,1653260656,1653261121,465,402
3014646091,3298676228,1645863348,1645863701,353,764
3766274699,3301611102,1656173450,1656174345,895,1565
3533740602,3287175350,1648383575,1648384096,521,1818
3452683650,3241341174,1650650144,1650650706,562,1680
3118358674,3481689842,1653447991,1653448844,853,364
3660551283,3972649318,1662255694,1662256050,356,102
3574394407,3156522255,1665335807,1665336651,844,1864
3421178618,3760042128,1667637874,1667638431,557,67
3861123581,3790748869,1650995088,1650995455,367,1398
3803606691,3833046871,1663759145,1663760129,984,869
3786480807,3271689881,1641915765,1641916332,567,500
3828722911,3105449263,1666313646,1666313719,73,1991
3423825173,3108139225,1654688185,1654689001,816,1386
3768814245,3645850762,1662927669,1662928032,363,1262
3142230569,3555560595,1644844079,1644844319,240,1351
3062704523,3736681866,1650211919,1650212784,865,627
3138755786,3798563042,1663098763,1663099710,947,995
3049447132,3258782646,1665449619,1665449880,261,2431
3038067120,3925344243,1656115261,1656115603,342,773
3204333859,3322663101,1668320043,1668320343,300,1848
3917448920,3400233871,1665080991,1665081470,479,2389
3434351368,3119802700,1649812468,1649813303,835,2302
3170158934,3582138072,1650286938,1650287223,285,863
3868460834,3983988321,1648103484,1648104051,567,805
3906309759,3551884757,1654465591,1654466389,798,131
3477692188,3932077086,1663141663,1663142460,797,2398
3398257086,3984533628,1647090898,1647091847,949,1837
3774437189,3685665978,1641760622,1641760629,7,2398
3099976032,3379259059,1669529573,1669530224,651,790
3967425379,3325981847,1656329383,1656329999,616,1362
3596932196,3547672806,1658642482,1658643478,996,666
3478741068,3654922401,1652224349,1652225013,664,758
3390416640,3797270025,1668900093,1668900338,245,1796
3132863382,3299536518,1642386602,1642387531,929,2478
3896594746,3851540721,1644793922,1644794608,686,101
3214969929,3247758952,1661773473,1661773780,307,151
3958275419,3451167153,1663760892,1663761055,163,1216
3932803365,3634624974,1642002058,1642002990,932,2431
3243831128,3433835303,1662146068,1662146424,356,686
3889730114,3751588241,1652565089,1652565740,651,1218
3186371475,3783723078,1642254716,1642255251,535,102
3292454121,3582478882,1654833284,1654833972,688,1224
3230277243,3452773006,1651637347,1651637551,204,2140
3579093901,3662409391,1650609559,1650609885,326,2358
3677300151,3608071362,1655663829,1655664829,1000,253
3365094410,3223917351,1647777121,1647777735,614,1492
3635324805,3401611149,1659575139,1659575457,318,131
3367510444,3723780339,1664827184,1664828082,898,2035
3194379247,3785883615,1652984561,1652984911,350,1027
3012930968,3513193858,1666624815,1666624877,62,642
3857841054,3956796805,1664765120,1664765121,1,784
3767453896,3652029135,1650722438,1650722491,53,1835
3864133914,3552958954,1649420264,1649421130,866,768
3678720106,3846585557,1649989192,1649989531,339,2169
3945397961,3074886612,1644933553,1644934178,625,63
3345138946,3398116898,1668483864,1668484775,911,372
3327504995,3835612256,1658520298,1658520694,396,149
3790896269,3711490719,1645403011,1645403841,830,381
3054606477,3446914685,1644877851,1644878193,342,1222
3890875667,3374603408,1643649380,1643649861,481,57
3281146609,3942965206,1643254129,1643255057,928,1003
3910585793,3649252503,1666737622,1666738308,686,2202
3198195956,3767724034,1649435479,1649435820,341,193
3733102461,3508858140,1656116378,1656117374,996,1886
3991046503,3339027368,1649216252,1649216263,11,1358
3570152654,3051253299,1660994620,1660994920,300,292
3192472683,3675359399,1646485683,1646486211,528,2232
3718823049,3031827531,1656416488,1656416742,254,784
3279773317,3474315750,1644267514,1644268257,743,281
3104902156,3999390272,1653078860,1653079111,251,1328
3476283460,3502484697,1664631677,1664631836,159,333
3127565673,3692498377,1666924586,1666924994,408,1662
3048296949,3114627858,1666767184,1666767480,296,858
3257594028,3716757245,1647445149,1647445792,643,1144
3108230028,3474558723,1649856817,1649857328,511,750
3105829075,3381845607,1662967151,1662967458,307,1965
3379296882,3276763839,1660419817,1660420756,939,223
3002876565,3233222399,1669238013,1669238557,544,924
3315056551,3247590827,1644841017,1644841865,848,2165
3788688228,3087326516,1659681272,1659682101,829,1917
3317431311,3993653521,1665316950,1665317008,58,360
3067539427,3927273567,1652916602,1652916748,146,2469
3978987003,3373729748,1669533351,1669533782,431,139
3719785520,3313608055,1642942117,1642942779,662,547
3849902434,3725117905,1662186950,1662187353,403,2450
3515038349,3823951765,1646330243,1646331013,770,2331
3684883542,3452219424,1657815109,1657815587,478,145
3328146266,3678541527,1657871254,1657871512,258,2478
3920669948,3003402470,1641707332,1641708179,847,1658
3821039922,3284616898,1661898386,1661898959,573,1214
3248096339,3592453741,1668727841,1668728087,246,2022
3339633388,3975462879,1654850286,1654850828,542,2321
3068659940,3552494506,1641223391,1641223462,71,2246
3661369487,3799249782,1659614614,1659615451,837,867
3624748073,3260157601,1669159779,1669160706,927,1819
3740009683,3836089663,1641154365,1641155121,756,1641
3949620827,3763300182,1657395891,1657396657,766,2236
3156928973,3825462888,1661360376,1661361237,861,2042
3795609815,3299536518,1656727145,1656728113,968,373
3226052631,3411272565,1643331345,1643331364,19,1811
3697231480,3285516363,1647783372,1647783788,416,855
3461674303,3562104036,1655276606,1655277235,629,2450
3643185661,3918812791,1650279305,1650279822,517,434
3220750989,3927864902,1651864198,1651864629,431,688
3750765878,3278190233,1668547094,1668547331,237,2075
3961140276,3620522583,1662239917,1662240908,991,1307
3824625919,3180062640,1660159658,1660159972,314,1407
3335573495,3607717009,1653934876,1653935766,890,951
3787230225,3534200501,1648293210,1648293302,92,443
3064461314,3132349279,1641905354,1641905570,216,492
3292172583,3365708107,1660202651,1660203369,718,548
3794524447,3199635800,1645378025,1645378996,971,122
3858951131,3768814245,1652320488,1652320858,370,2104
3168983812,3969241066,1649794565,1649795502,937,116
3142274869,3106371588,1653795754,1653795964,210,2021
3455209070,3422728078,1667633698,1667634147,449,307
3975096180,3611982999,1654036286,1654036909,623,1030
3047001138,3827954829,1655968688,1655969102,414,2223
3099682661,3162641272,1645337535,1645337983,448,2452
3434182192,3093534312,1661054820,1661055044,224,321
3187982526,3168535205,1659988190,1659989147,957,1451
3300694030,3835842311,1652195586,1652195991,405,2042
3481466662,3228277648,1662841091,1662841314,223,585
3598841094,3994721189,1650602010,1650602383,373,1922
3290710394,3194721041,1661456822,1661457460,638,2106
3167494570,3540799664,1647132952,1647133480,528,602
3662788693,3143689256,1646799540,1646800483,943,775
3420520626,3683460040,1662032155,1662032522,367,905
3875440466,3314901091,1658344511,1658344808,297,875
3170325894,3620395885,1644645843,1644646275,432,2258
3889705477,3797769846,1642024726,1642025486,760,1914
3362647814,3177879837,1667287600,1667287770,170,1628
3229448014,3982268438,1649413291,1649413608,317,298
3232160942,3718026583,1645955962,1645956794,832,1993
3086835861,3241584825,1643729382,1643730182,800,1173
3260783577,3832370690,1643937495,1643938461,966,2371
3135951344,3668471634,1654988635,1654988766,131,1109
3365316758,3623206706,1654995209,1654996162,953,1533
3824083602,3749811473,1646013666,1646014437,771,2395
3281753784,3650902153,1664551301,1664552092,791,1648
3785638958,3977008878,1644373504,1644374152,648,1598
3925754107,3997162156,1651046231,1651047133,902,440
3031249180,3630744377,1646150948,1646151213,265,453
3868873330,3211015636,1646382253,1646382855,602,2070
3360115986,3960816300,1663358811,1663359061,250,932
3755962729,3343729897,1661672772,1661673595,823,1079
3600573063,3194603908,1653197479,1653197973,494,1486
3976858724,3283171763,1642869155,1642869281,126,854
3904881288,3293387588,1644398221,1644398956,735,1481
3510166785,3097161771,1657239141,1657239470,329,258
3730684727,3118358674,1652910445,1652911322,877,353
3295020761,3284616898,1660784727,1660785362,635,382
3890033502,3466642935,1658669170,1658669368,198,1131
3776429592,3834268660,1652724855,1652725024,169,271
3344394548,3705943924,1666420821,1666420997,176,1195
3523631626,3109465057,1641943383,1641943612,229,1121
3722859316,3701537998,1653781886,1653782025,139,728
3786322776,3515933745,1644842817,1644843563,746,636
3645666563,3476558133,1642027887,1642028817,930,273
3047713943,3510247235,1650639202,1650640176,974,1540
3929638122,3178090646,1648457806,1648458592,786,2009
3103158328,3321819030,1647465084,1647465712,628,2248
3278566573,3557087358,1647580819,1647581417,598,138
3382840804,3745960708,1665165311,1665166275,964,2208
3203153576,3258098890,1665604043,1665604690,647,2318
3652304615,3863190883,1644937762,1644938164,402,1142
3222870125,3465406980,1667856727,1667857299,572,718
3368571252,3276142713,1663518613,1663518823,210,201
3420205343,3105733809,1646216301,1646217030,729,516
3322083266,3739865914,1645038614,1645038728,114,1366
3062410888,3715894883,1660606335,1660607290,955,271
3749897140,3559489793,1656016851,1656017230,379,1809
3820585135,3533172784,1651930047,1651930129,82,1425
3020729502,3885084129,1658544446,1658545094,648,1075
3488878461,3021679982,1663913014,1663913465,451,1948
3319965397,3388844626,1662075483,1662076362,879,933
3241500636,3136810446,1658794425,1658795416,991,2037
3664267954,3916557399,1655934312,1655934322,10,2012
3177943874,3845122668,1669513131,1669513298,167,136
3820374377,3079905449,1660107806,1660108163,357,208
3934141269,3364911803,1647572220,1647572528,308,143
3131629372,3844964880,1653918361,1653918793,432,1594
3370889279,3262596597,1661829067,1661829281,214,211
3191414403,3840801648,1644473037,1644473375,338,2321
3742275397,3992226673,1647528409,1647528880,471,215
3762890946,3857081560,1647329646,1647330367,721,473
3036346251,3782266220,1658856802,1658857175,373,744
3254174311,3751300388,1650404709,1650405362,653,1266
3298676228,3937129101,1659433931,1659434157,226,325
3010649870,3992226673,1644116674,1644117554,880,1254
3920910995,3165835560,1655670425,1655670785,360,597
3405110319,3045537893,1667086088,1667086146,58,2086
3735855753,3072741474,1650427741,1650427876,135,2224
3734565675,3569761806,1661599552,1661600297,745,1885
3059322626,3250852254,1658749279,1658750201,922,1543
3637412110,3869618249,1643019441,1643020280,839,110
3054606477,3936135558,1650384761,1650384795,34,718
3304559201,3679065090,1643496347,1643496892,545,1660
3135406478,3764318951,1651067291,1651068242,951,45
3855734814,3034750166,1668512089,1668512633,544,1853
3640585545,3385760763,1655752936,1655753754,818,708
3216439052,3031249180,1652574881,1652575608,727,794
3830303170,3606368289,1652086917,1652087136,219,420
3498685499,3308877364,1650298803,1650299275,472,1063
3396453607,3784828021,1664698551,1664698942,391,2194
3522365623,3113938510,1651231904,1651232078,174,61
3985620157,3307185651,1652979268,1652979666,398,333
3192142540,3129899259,1665050302,1665050957,655,1770
3165492854,3207309302,1651807775,1651808436,661,1231
3149336644,3312656348,1646350078,1646350110,32,1446
3503842077,3637686903,1661161403,1661161848,445,752
3023025075,3801038758,1642701052,1642701648,596,831
3739233756,3844822083,1662622496,1662622695,199,2328
3408048729,3145312014,1662574271,1662574650,379,1880
3406979800,3844666457,1663735504,1663736187,683,23
3705996677,3796348557,1649201725,1649202707,982,919
3264879958,3316952075,1667942074,1667942921,847,1846
3804749299,3284829365,1663935148,1663935308,160,1340
3311860866,3231496949,1661222940,1661223909,969,452
3693102953,3213169891,1648237630,1648238186,556,1399
3329825235,3712211736,1651378772,1651379709,937,1974
3330749303,3528505546,1643921981,1643922077,96,1366
3445689630,3862456223,1668582718,1668583557,839,2007
3571991159,3761636372,1668755142,1668755356,214,1000
3505295000,3819415032,1654828012,1654828149,137,1965
3797079865,3917500425,1666344069,1666344799,730,880
3562472924,3209288149,1644648754,1644649477,723,499
3510634049,3232285985,1663926820,1663927610,790,346
3047477485,3224455204,1656361614,1656361808,194,1978
3629593465,3400211756,1668156627,1668156884,257,897
3243005694,3666338218,1649111813,1649112621,808,119
3557751532,3975198652,1661753246,1661753636,390,631
3019302226,3226298244,1662328065,1662328651,586,152
3936179181,3880353584,1658391291,1658392018,727,2402
3317382420,3429074631,1668503606,1668503929,323,2134
3620939715,3084940745,1661564462,1661565184,722,603
3080195715,3948710872,1647643892,1647644179,287,2019
3136707992,3800460824,1666647159,1666647762,603,2058
3156980878,3805845272,1660745165,1660746086,921,1098
3762690279,3639121807,1657284483,1657285116,633,995
3244502667,3158871377,1667203584,1667204446,862,2237
3353722089,3508108339,1646337670,1646338127,457,783
3436916222,3257187145,1648370152,1648370558,406,406
3868397809,3787230225,1655240964,1655241098,134,519
3347896915,3404008086,1652329768,1652329952,184,365
3567703076,3245491745,1647890135,1647890902,767,41
3795508879,3852184769,1669689387,1669689432,45,1401
3631732813,3315185864,1643159290,1643160038,748,1536
3160135389,3104902156,1648525114,1648526090,976,2139
3563259493,3187644022,1644371735,1644372402,667,2463
3326882521,3431411171,1642186822,1642187530,708,414
3023075779,3420298161,1655986535,1655987421,886,892
3052951476,3660548799,1647738307,1647738889,582,2088
3790748869,3567637602,1656131373,1656132024,651,339
3076285457,3205809646,1644408544,1644409205,661,1057
3831255967,3638281686,1661248318,1661249053,735,913
3223374226,3897976617,1647641205,1647641959,754,2340
3683793217,3292739128,1652821920,1652822343,423,676
3543732655,3065350513,1655123142,1655124134,992,1079
3595336393,3997353499,1669304926,1669305688,762,569
3548511640,3080195715,1653982602,1653982755,153,2288
3461674303,3011686027,1657740591,1657740857,266,161
3594777411,3606270024,1656270952,1656271793,841,449
3937628057,3292636621,1668883760,1668884254,494,1423
3584704567,3306378570,1648473290,1648473815,525,2458
3105299236,3656092578,1643688754,1643689072,318,1665
3736085476,3595500034,1667232128,1667232552,424,1366
3186371475,3365289656,1652171772,1652172414,642,1345
3639659256,3344337283,1661010232,1661010813,581,240
3965563922,3177915558,1656188996,1656189724,728,440
3185469541,3390532209,1668522576,1668523158,582,145
3336300808,3583918364,1666369639,1666370164,525,698
3553436680,3636237325,1649952278,1649953197,919,698
3835976086,3046190454,1656566988,1656567655,667,1196
3205153391,3553725082,1651893215,1651893274,59,1502
3708337100,3476566118,1660257809,1660257953,144,987
3855261620,3416196153,1662745652,1662746279,627,627
3929887239,3442408044,1660821766,1660822196,430,617
3554822566,3016992122,1667945193,1667945845,652,1449
3236325866,3680100111,1660859577,1660859669,92,1398
3904012023,3617533561,1647068831,1647069331,500,1143
3607385542,3467211844,1653370882,1653371665,783,2087
3432209746,3371536214,1669420347,1669421257,910,742
3634539557,3557325531,1649474645,1649475378,733,724
3419117613,3090103866,1653065312,1653065619,307,349
3066067288,3943221472,1659497356,1659497444,88,2148
3720475877,3604236901,1646153731,1646154311,580,1917
3108288045,3471376255,1664864741,1664865354,613,1236
3439799907,3170036337,1655617858,1655617910,52,2386
3536633962,3753998489,1646937588,1646938508,920,1416
3702178313,3590627159,1653296093,1653296708,615,245
3917956140,3849977339,1654863586,1654864100,514,1553
3935383578,3452683650,1650875819,1650875911,92,1851
3502599631,3611763388,1657831393,1657831847,454,1358
3671748544,3592561930,1669237233,1669238167,934,885
3994130271,3044226207,1666916382,1666917193,811,2025
3582478882,3469648387,1665688637,1665689491,854,953
3217719618,3354479032,1645597401,1645597446,45,2343
3938416139,3041652512,1645027426,1645027765,339,983
3979550486,3282275875,1664687090,1664687200,110,890
3965434074,3967517584,1660593648,1660594344,696,2408
3168625610,3603965318,1648134283,1648134561,278,205
3996587507,3282168599,1666522112,1666522197,85,598
3489811088,3070984953,1641443381,1641443922,541,1778
3451167153,3964637208,1656318973,1656319474,501,1479
3076285457,3516140957,1667915297,1667916271,974,971
3224792502,3132592220,1651865100,1651865495,395,2212
3118533471,3940115951,1668191421,1668192187,766,2403
3195138141,3382015551,1656839586,1656840014,428,1452
3166492454,3623782659,1648549254,1648549333,79,981
3985159412,3201479561,1660077880,1660078143,263,1695
3341573446,3933196862,1651530916,1651531031,115,481
3311113773,3211541773,1645383443,1645383860,417,300
3900451371,3644100988,1651818570,1651819493,923,2392
3878695242,3233938614,1648823391,1648824019,628,953
3164789962,3072985971,1663013056,1663013181,125,768
3104902156,3826823415,1653046050,1653046817,767,1682
3500097822,3854351732,1660517375,1660517859,484,1153
3291324812,3534223960,1654354088,1654354912,824,237
3233040662,3104405785,1663304109,1663305044,935,69
3800201060,3602891052,1661147509,1661147548,39,1715
3607959490,3884750087,1663956200,1663956220,20,2015
3108288045,3159897010,1646361483,1646361534,51,1027
3832719894,3292956980,1662454272,1662454734,462,2079
3541423460,3100535469,1651546804,1651546889,85,541
3275223689,3230277243,1657201026,1657201379,353,1291
3882748527,3847638658,1647012334,1647012696,362,2115
3280405059,3398242179,1641770397,1641770775,378,102
3288329354,3062844769,1642987420,1642987799,379,1208
3115343467,3070237620,1651421186,1651421921,735,1609
3941548978,3048896097,1649086616,1649087121,505,2384
3013314607,3486727273,1653816975,1653817198,223,1317
3129927926,3461508348,1646256557,1646257190,633,732
3792527009,3157496248,1663719221,1663719543,322,1835
3202745117,3389472671,1641834026,1641834252,226,577
3678149544,3702983168,1663868213,1663868869,656,1492
3171906034,3619714539,1649980768,1649981421,653,147
3868427833,3700167321,1667211384,1667212328,944,2329
3445666899,3139455252,1648550160,1648550419,259,567
3363125076,3553725082,1649136928,1649137213,285,1188
3607622692,3446547180,1648120577,1648120643,66,451
3905999483,3184615246,1656931847,1656932005,158,1359
3360575138,3353956873,1642478935,1642479347,412,895
3532355049,3982960576,1663068632,1663068641,9,2067
3403323839,3223154180,1666073137,1666073868,731,626
3223159718,3032747459,1653581336,1653581864,528,862
3711847265,3167121088,1647100813,1647101446,633,1197
3389161785,3000275416,1655694103,1655694343,240,1043
3233920789,3661507330,1654222906,1654223836,930,2330
3112270906,3088854267,1644934699,1644935560,861,1428
3481466662,3600977488,1650454306,1650455286,980,2042
3246260241,3858911279,1647682414,1647683190,776,2415
3310935085,3623782659,1654401068,1654401163,95,1081
3142869544,3622259711,1664339353,1664339703,350,587
3060121211,3600067650,1660727955,1660728623,668,1974
3417798594,3891477592,1669568382,1669568945,563,1615
3044226207,3610480358,1657329845,1657330543,698,143
3074837048,3562021711,1645273748,1645274346,598,2125
3166274990,3602340127,1664239024,1664239509,485,2318
3176526207,3862122399,1651884088,1651884951,863,204
3667028828,3429010148,1650626892,1650627581,689,1066
3060989519,3154833958,1657729263,1657729958,695,2465
3887002610,3693102953,1650524763,1650525346,583,961
3578002057,3148549210,1669024710,1669025179,469,725
3997312356,3195032074,1645046669,1645047187,518,2070
3534224607,3508108339,1661063522,1661063568,46,1753
3441206388,3131548243,1657176873,1657177798,925,2178
3748950684,3471221302,1649603165,1649603426,261,1105
3631587282,3131025611,1667959135,1667959865,730,1159
3658428855,3442854678,1662516521,1662517387,866,1240
3254367735,3487972666,1651399790,1651399929,139,1602
3707362025,3303719777,1666258079,1666258629,550,802
3011459628,3414488975,1666985636,1666986626,990,1966
3273243249,3037984397,1656560508,1656561331,823,1808
3721060604,3166521010,1652267082,1652267471,389,990
3062844769,3014185506,1656800409,1656800743,334,433
3806737055,3572792752,1662226582,1662227360,778,1675
3735943539,3075288965,1648843930,1648844465,535,2124
3447203087,3553328177,1655396802,1655397010,208,593
3516676045,3614741796,1653567026,1653567063,37,1826
3468654589,3486541605,1645566524,1645567161,637,1778
3866921322,3319782337,1654423321,1654424166,845,1043
3954185607,3871971681,1647326069,1647326605,536,2027
3037583613,3575457804,1659968611,1659969246,635,1333
3312661854,3549671217,1643673748,1643673833,85,2373
3086653619,3579093901,1662744599,1662744967,368,77
3892686083,3714105777,1666573698,1666574282,584,1785
3264081641,3040742963,1663113986,1663114884,898,2272
3359722926,3474808421,1666927198,1666928148,950,1960
3870574001,3941642636,1658837988,1658838071,83,478
3161774382,3931679805,1669265459,1669265579,120,1259
3331904172,3233425442,1669758667,1669758894,227,2411
3254030842,3456295243,1659423168,1659423623,455,1036
3834826280,3317411967,1653370647,1653371192,545,1980
3878698797,3633544934,1662842937,1662843629,692,1817
3442799166,3284616898,1658341258,1658341605,347,2411
3152036409,3780546851,1641941360,1641941456,96,357
3172825605,3272535116,1658039679,1658040316,637,460
3234861737,3940948395,1657590345,1657590647,302,273
3003195362,3420298161,1653651269,1653651974,705,1717
3507952797,3808415962,1651166511,1651166807,296,1127
3250312962,3537457982,1655126366,1655126394,28,426
3598645736,3169688960,1656165004,1656165005,1,1306
3990264315,3292507015,1656483873,1656484534,661,854
3629824081,3106804099,1652868981,1652869766,785,1114
3536118453,3389773271,1660795209,1660795726,517,1299
3145220460,3014535209,1669668292,1669668455,163,156
3964738114,3929901413,1659898679,1659898819,140,1677
3055390520,3512935575,1663315200,1663315941,741,1778
3562875112,3383686911,1651376841,1651376927,86,956
3356302136,3985308319,1662378012,1662378108,96,845
3595270507,3821049069,1662137098,1662137328,230,2254
3351218513,3761587047,1651710629,1651710804,175,2346
3189085834,3816538946,1641620104,1641620124,20,951
3292368988,3150817357,1661363396,1661363962,566,491
3851982179,3337684100,1651770017,1651770357,340,1607
3615666134,3272879760,1650466772,1650467681,909,725
3595499905,3652765431,1665641041,1665642037,996,1269
3770388331,3209097023,1644012090,1644012979,889,337
3055211808,3395457102,1658887801,1658887918,117,2417
3181388502,3735946925,1664799931,1664800858,927,2430
3386490201,3996469603,1667589822,1667590509,687,2152
3392918310,3351218513,1656592993,1656593099,106,369
3985879853,3061461510,1652874383,1652874678,295,2040
3980867331,3271919876,1659153979,1659154882,903,23
3449993526,3287988080,1643089023,1643089422,399,2145
3238270210,3682922389,1662470947,1662471515,568,877
3901736828,3086325930,1667331723,1667331773,50,2054
3436975295,3547749057,1644923267,1644923299,32,695
3308015697,3489915638,1664832006,1664832912,906,819
3733649713,3351218513,1661521922,1661522306,384,1070
3339611423,3216912897,1649211332,1649212082,750,1451
3749188570,3261866390,1651886625,1651887062,437,108
3609274729,3431614426,1659837058,1659837304,246,558
3899585675,3733849983,1668657710,1668657796,86,1648
3510323514,3690665509,1643018632,1643018988,356,126
3175706913,3722817789,1667018593,1667018802,209,723
3373656201,3339633388,1650582564,1650582912,348,2281
3897421758,3573450428,1644769219,1644769983,764,408
3862389429,3171569619,1646901113,1646901195,82,178
3455040603,3081005801,1669550958,1669551571,613,258
3531118058,3719503327,1645099072,1645099204,132,695
3112622637,3940067834,1647820163,1647821122,959,377
3011985525,3086076310,1645041130,1645041721,591,2
3757624193,3611982999,1647520322,1647521213,891,1933
3869692733,3309405529,1649523358,1649523757,399,1264
3547358965,3263350346,1662697655,1662698406,751,10
3094277549,3787333178,1648440201,1648440637,436,1772
3323198594,3749980168,1650578317,1650578888,571,1258
3103215750,3523394395,1650272644,1650273488,844,43
3122288373,3572276937,1644973212,1644973546,334,1487
3811235183,3050267205,1648298239,1648298667,428,723
3553471050,3141480547,1655294148,1655294622,474,557
3852212988,3029578425,1646251316,1646251851,535,1005
3254083367,3439827305,1650142433,1650142552,119,1866
3382133724,3570230022,1641444117,1641444256,139,78
3774724683,3214068022,1661697446,1661698149,703,972
3891235779,3774945806,1658117085,1658117513,428,1530
3937728696,3188126815,1655975871,1655976252,381,2081
3368860003,3554275173,1644469540,1644469660,120,1378
3671699977,3623206706,1663899909,1663900129,220,1910
3344285047,3354233805,1655079263,1655080021,758,543
3349030618,3112739600,1669376400,1669376693,293,1274
3374603408,3500320805,1646462886,1646463301,415,493
3798447157,3705996677,1645473240,1645474017,777,1404
3887337385,3428482789,1653961675,1653962154,479,819
3721541321,3841174974,1649060525,1649061114,589,955
3174676733,3882748527,1649369558,1649370127,569,499
3289108426,3243133485,1647878975,1647879233,258,182
3080703553,3415686543,1660933028,1660933301,273,1163
3916680089,3098083694,1643894837,1643895637,800,1766
3624662198,3959629367,1655962866,1655963496,630,575
3893475632,3615137704,1669211497,1669212429,932,2255
3298042916,3570747542,1665843833,1665844389,556,1181
3900843323,3548145086,1669298728,1669299161,433,1282
3582033850,3292797747,1645352525,1645352751,226,1398
3177433990,3709665583,1646545407,1646545460,53,801
3347226466,3549145976,1656433875,1656434210,335,1427
3198731476,3557215676,1641726060,1641726812,752,621
3075519908,3414502284,1653302881,1653303467,586,995
3296478783,3716137932,1647231694,1647232281,587,250
3920028342,3172352127,1646701309,1646702217,908,510
3827170233,3483445976,1645470615,1645470846,231,2473
3713455058,3290176410,1648489572,1648489576,4,1021
3809041613,3196304056,1644907372,1644907982,610,542
3547749057,3927646653,1650229123,1650229445,322,1834
3072741474,3308028752,1651933123,1651933357,234,2308
3678340379,3317961564,1662325939,1662326377,438,260
3150884811,3451823359,1668416205,1668416857,652,828
3304726864,3137200123,1660224677,1660224813,136,888
3935379393,3497990894,1666631619,1666631818,199,308
3362298218,3643412582,1653393651,1653394561,910,451
3315321131,3087326516,1657159260,1657159812,552,1396
3105558193,3114764410,1656532003,1656532758,755,1307
3177433990,3237224664,1642030619,1642030811,192,839
3298993308,3991299369,1650782236,1650783187,951,365
3182982515,3277343126,1661598859,1661599254,395,243
3167737446,3492638245,1658084469,1658084695,226,876
3964434363,3816026938,1648440863,1648441016,153,392
3975379893,3089138601,1645089402,1645090009,607,1285
3295020761,3929305160,1651786192,1651786318,126,864
3918121469,3085455498,1645134471,1645134821,350,873
3426491499,3462088604,1665758494,1665759416,922,168
3228794031,3191414403,1650236674,1650237272,598,1941
3130594039,3284832227,1650300124,1650300671,547,554
3175676853,3910760009,1643967475,1643967564,89,2147
3100572176,3654344198,1641626795,1641627221,426,650
3790648941,3692568210,1642826790,1642827074,284,1733
3328993418,3210071519,1644042692,1644043658,966,1661
3317241023,3954255558,1641511952,1641512383,431,1181
3200933791,3907700603,1662523964,1662524138,174,43
3070087815,3409779636,1646979316,1646979509,193,1307
3484710507,3438084709,1646584721,1646585126,405,2004
3749811473,3941266037,1656474996,1656475932,936,2107
3929497543,3994913668,1666739728,1666739820,92,2253
3844666457,3103215750,1665332068,1665332989,921,1664
3104271824,3066426534,1650884563,1650885075,512,1096
3817000379,3044483301,1667527912,1667528080,168,823
3313265862,3556819852,1652143491,1652143492,1,1597
3047402472,3066168441,1644765347,1644765446,99,145
3403786938,3872928406,1650481754,1650482376,622,2140
3554832209,3526798607,1650998268,1650998803,535,372
3823692648,3570423127,1648696719,1648697665,946,132
3186367687,3645860854,1644931375,1644932040,665,1046
3248733503,3763912599,1667468842,1667468973,131,2233
3635988688,3486727273,1665393670,1665394182,512,626
3207801201,3310462353,1641495103,1641495485,382,299
3335355155,3426666423,1660193638,1660194551,913,1227
3149143223,3649442188,1646587567,1646588443,876,1671
3890448806,3064574238,1656352167,1656352888,721,2038
3405388298,3507431231,1665376406,1665376802,396,1973
3848740333,3787673872,1646183199,1646183497,298,1023
3595284541,3177762456,1656440104,1656440513,409,2021
3629225227,3281369687,1668788417,1668789133,716,1436
3398412701,3784123884,1649554540,1649554648,108,1016
3368987950,3936292699,1663866623,1663867428,805,967
3480314503,3606643671,1664993367,1664994282,915,1135
3625586912,3724770746,1668277626,1668277638,12,433
3415124478,3887743057,1643281291,1643282218,927,1716
3373656201,3867554012,1644808535,1644808638,103,1331
3283211870,3269699819,1666334991,1666335982,991,1742
3415917688,3822187489,1669231301,1669231670,369,2209
3898494020,3150893774,1654193905,1654193909,4,330
3426585956,3294357161,1647507007,1647507356,349,1666
3991477345,3739439527,1659222254,1659222781,527,1246
3041563987,3785725492,1665118257,1665119219,962,2212
3612612273,3536156667,1642368343,1642368857,514,1713
3604260104,3380822514,1644472256,1644472995,739,693
3652765431,3878876305,1659258198,1659258678,480,866
3220577762,3007339106,1658170041,1658170829,788,224
3268570857,3430145466,1658210879,1658211301,422,1783
3646544919,3977078930,1668622957,1668623867,910,667
3205359825,3640605424,1646538342,1646538986,644,1614
3112314644,3292869706,1649017510,1649018393,883,1617
3974326867,3218903379,1646335693,1646336171,478,1459
3989208740,3884802599,1656214883,1656215197,314,1427
3036470049,3165470497,1667747105,1667747435,330,1885
3895277580,3334207071,1654472185,1654472435,250,2496
3400211756,3443084089,1665523317,1665523460,143,1567
3025223556,3338882756,1657413638,1657414081,443,479
3170292789,3965960711,1655334529,1655334878,349,253
3147047674,3020452542,1662468564,1662469034,470,2111
3469437983,3637663893,1645874058,1645874590,532,2283
3058837915,3648305208,1659129357,1659129526,169,371
3505272067,3800014504,1654385950,1654386103,153,1161
3928989640,3911891369,1657833212,1657833836,624,603
3798527829,3807323401,1647942929,1647943683,754,642
3878943307,3012032774,1667851331,1667851555,224,1347
3814017798,3237224664,1654656015,1654656804,789,1014
3410261725,3056721560,1663171276,1663172073,797,305
3666148943,3611062566,1645850976,1645851505,529,746
3856474495,3788769219,1652983383,1652984007,624,1757
3427860415,3050800748,1665669649,1665670357,708,267
3980139195,3002350398,1658786213,1658786946,733,1367
3398814666,3176941664,1659760682,1659760802,120,1705
3551371020,3696448766,1663482039,1663482640,601,353
3246024635,3854184537,1643408928,1643409260,332,2425
3777091595,3878573707,1653384738,1653385181,443,2198
3767508362,3248167631,1666970536,1666970957,421,1804
3908895548,3999228111,1653288500,1653288899,399,1341
3633856416,3177628377,1658105383,1658106184,801,2360
3263372197,3582531330,1648293902,1648294118,216,1304
3206248943,3339719117,1641608440,1641609436,996,412
3266681677,3634936481,1646745867,1646746835,968,70
3229871774,3835612256,1666342180,1666342290,110,724
3171731237,3194069746,1662630315,1662630658,343,393
3765617850,3608200385,1668776917,1668777481,564,1843
3021253966,3556620301,1660977135,1660977629,494,301
3085455498,3151386327,1657841401,1657841418,17,196
3734579045,3195813968,1652473433,1652474248,815,1337
3163551629,3036046331,1668156161,1668156261,100,1802
3945266221,3045016501,1663021117,1663021477,360,2463
3334792271,3776783076,1657193611,1657194263,652,2355
3782708820,3625979408,1655643133,1655643660,527,397
3874664424,3895196680,1648064366,1648065365,999,1169
3002931773,3062789212,1646593748,1646594128,380,2407
3744386868,3125436993,1653903336,1653903676,340,1745
3764078507,3335818403,1666164177,1666164411,234,713
3463003824,3814608487,1642151979,1642152240,261,1838
3600247537,3511397819,1645174819,1645175282,463,1238
3143293050,3464653044,1668888994,1668889161,167,2191
3880295026,3998209085,1656255893,1656255950,57,656
3958710935,3400684585,1664544272,1664545175,903,1145
3289153734,3944914500,1645863210,1645863756,546,276
3872574112,3398278082,1668810418,1668811119,701,50
3831770571,3952663430,1650879552,1650880514,962,2166
3757518149,3355429456,1667372673,1667372882,209,1401
3556819852,3285516363,1650509973,1650510211,238,878
3418662987,3626020948,1665908622,1665909299,677,1093
3954799831,3679617161,1649753297,1649754070,773,1998
3629984199,3968683220,1653698603,1653699543,940,1571
3314901091,3473852885,1644736880,1644737721,841,1944
3197739962,3438553592,1667004972,1667005934,962,1131
3852704822,3452564658,1662200496,1662200774,278,1996
3899247202,3957053810,1662205793,1662206057,264,1066
3070810251,3486061006,1651222377,1651223028,651,1887
3650675743,3877483900,1654558164,1654558732,568,273
3176410131,3145393304,1652088932,1652089144,212,1094
3048402049,3510634049,1662319529,1662320308,779,238
3049567508,3875750764,1655383953,1655384379,426,1535
3487778655,3553960271,1655298375,1655298441,66,788
3284829365,3608485872,1651341736,1651342324,588,62
3576317139,3641542734,1667408802,1667409191,389,913
3743934334,3663884600,1660284358,1660284560,202,321
3451329310,3229495084,1660980312,1660980590,278,1926
3223412894,3570955260,1664049676,1664050423,747,1860
3616803531,3260085949,1658937296,1658937417,121,373
3817548425,3489380093,1664599742,1664600090,348,1666
3534133715,3175706913,1669508796,1669509718,922,2127
3566919425,3816863310,1659097750,1659097896,146,1583
3185985712,3400154631,1659163038,1659163830,792,1248
3295905536,3032747459,1646070594,1646071519,925,398
3943947223,3257187145,1668506437,1668507432,995,1448
3687919265,3913680174,1659661136,1659661828,692,43
3129677855,3713129998,1656647016,1656647857,841,1834
3863190883,3938583443,1642564325,1642564381,56,2275
3668645457,3113321914,1645106410,1645106903,493,823
3964664117,3038630181,1652640452,1652640522,70,1760
3619714539,3506971803,1659399189,1659400029,840,2184
3211401798,3957798687,1668635695,1668635826,131,757
3932161358,3537107415,1662010173,1662010676,503,1047
3549122378,3386724007,1651077708,1651077925,217,398
3888312656,3486208738,1661394026,1661394275,249,138
3201446016,3299821745,1656463343,1656463525,182,1871
3258854274,3344787204,1660450336,1660451259,923,1720
3697322167,3011459628,1645374643,1645375451,808,2227
3233938614,3924969388,1667411046,1667411865,819,1483
3556061704,3744196402,1643056037,1643056386,349,2285
3518864357,3099976032,1644798641,1644798654,13,572
3160242179,3243873593,1661814958,1661815714,756,467
3267319115,3673935826,1669389605,1669389640,35,187
3636621583,3581449963,1663774336,1663774622,286,715
3728974462,3402543059,1651262574,1651262670,96,1515
3741494242,3806936803,1666124361,1666124915,554,1860
3818453534,3968076690,1651993854,1651994768,914,2254
3422374987,3916244157,1654354905,1654355452,547,1408
3414898500,3772034355,1662905286,1662906253,967,887
3335573495,3557556781,1654162768,1654163223,455,597
3940387270,3421600026,1658513026,1658513091,65,1623
3784828021,3001803326,1663614455,1663614513,58,1672
3607385542,3522621112,1659986405,1659987007,602,741
3677574672,3024431618,1668012014,1668012366,352,1138
3918383192,3468682335,1666440074,1666440092,18,1348
3113207421,3600856738,1652582934,1652583091,157,242
3844416504,3981191978,1653586891,1653587275,384,1012
3073969560,3794926978,1650046906,1650047130,224,1602
3112287858,3057348673,1645681676,1645681874,198,373
3324394622,3414193650,1650823122,1650823485,363,1850
3284892894,3124051904,1666252060,1666252086,26,2127
3487104766,3743934334,1661527690,1661527919,229,2202
3980139195,3262098376,1647201129,1647201384,255,1061
3763991129,3034014975,1649981274,1649982029,755,1285
3747929255,3421772590,1649794322,1649795192,870,222
3637663893,3810952134,1653084389,1653085371,982,344
3531820891,3711710728,1664306058,1664306292,234,1318
3980934555,3762208346,1668691053,1668691237,184,731
3526315797,3867543887,1664795974,1664796471,497,1262
3576315042,3935809720,1654920928,1654921291,363,886
3642339062,3338749992,1657450057,1657450303,246,2080
3678197665,3759656646,1659484280,1659485046,766,1931
3722220404,3003134699,1656804836,1656805068,232,219
3543239972,3789999187,1656753687,1656754479,792,883
3762856505,3004964162,1655310009,1655310940,931,2281
3483553551,3622656083,1665805631,1665806552,921,1972
3794103075,3785657136,1649971435,1649971707,272,532
3340125949,3086871623,1642123186,1642124009,823,1900
3046085814,3012339110,1649458163,1649459028,865,1911
3069353793,3469524230,1645946127,1645946144,17,1855
3678541527,3555571916,1650576837,1650577621,784,453
3428501033,3345905539,1641083795,1641084501,706,2491
3108500091,3563428558,1664610731,1664611127,396,1242
3950666008,3874626130,1641648976,1641649383,407,1422
3032431944,3385246088,1641787396,1641787869,473,1931
3571576669,3492215792,1643658007,1643658816,809,2072
3584668339,3905744284,1643261400,1643261877,477,1845
3617533561,3904625406,1644985678,1644986177,499,9
3018612279,3939281989,1649551708,1649551734,26,81
3776862606,3349724698,1645768334,1645768613,279,1409
3863427189,3731437059,1661610749,1661611206,457,1744
3419465829,3199472785,1653857076,1653857210,134,2272
3601604629,3220577762,1658091957,1658092153,196,2480
3387568587,3651803323,1658317748,1658318052,304,1919
3021769525,3739420445,1648438180,1648438840,660,360
3257690557,3939281989,1664949723,1664950097,374,2366
3270935026,3553146922,1651345141,1651345883,742,233
3315544584,3453511353,1659418236,1659418570,334,1380
3600796487,3502554871,1650523772,1650524389,617,755
3766186320,3364661787,1666868081,1666868996,915,945
3876127195,3143741876,1655579898,1655580871,973,1346
3157308488,3442735570,1655722162,1655722601,439,584
3660548799,3961189789,1659507542,1659507650,108,2140
3721110937,3415686543,1667818847,1667819698,851,200
3116281998,3855521057,1664858461,1664858538,77,1371
3563972468,3349879521,1669128179,1669128699,520,1066
3909523201,3021679982,1657583063,1657583638,575,4
3255182489,3996963058,1654060903,1654061084,181,1256
3174722772,3765827886,1659454028,1659454377,349,1864
3022453107,3790298140,1657081559,1657082503,944,1998
3800451074,3684537058,1664780260,1664780622,362,155
3546954605,3350017208,1667603917,1667604343,426,211
3880580622,3364888618,1642715323,1642716039,716,1584
3622848449,3457108498,1661037775,1661038547,772,1339
3113005024,3624090791,1641843392,1641844186,794,443
3186897818,3923635120,1647134219,1647135059,840,1027
3468682335,3154009016,1669100053,1669100657,604,1697
3639059199,3174705393,1642439769,1642439871,102,777
3006953744,3388004574,1659413670,1659414018,348,622
3897030063,3930591160,1646320546,1646320669,123,1286
3254083367,3140064319,1665000079,1665001071,992,1426
3321202962,3969728585,1649911278,1649911903,625,277
3850427038,3393406422,1667363364,1667363778,414,517
3838160976,3796504737,1667491429,1667491875,446,1329
3467383586,3561692706,1666596545,1666596574,29,1322
3030551637,3184000585,1642982226,1642983143,917,904
3404200815,3332506866,1643983151,1643984073,922,2251
3700813458,3769391036,1646046414,1646047092,678,1008
3319334426,3596841713,1657774505,1657775370,865,674
3952654862,3775753518,1662608014,1662608523,509,2495
3886709661,3460842972,1647137093,1647137402,309,402
3802614854,3434662490,1664353837,1664354414,577,2011
3433937560,3968683220,1662607077,1662607696,619,778
3234851871,3480100868,1662978884,1662979679,795,782
3913680174,3456433627,1656759107,1656759116,9,1192
3784646522,3244997486,1645370969,1645371121,152,1953
3927657297,3506971803,1648894396,1648894685,289,2080
3052438592,3122293667,1653915444,1653916090,646,2162
3531345844,3792834070,1652429707,1652429709,2,1953
3693041370,3945397961,1649444016,1649444649,633,2330
3054171550,3124384203,1645381352,1645381692,340,179
3226220903,3178529360,1668410473,1668411138,665,1717
3713693431,3154553765,1655421661,1655422343,682,1636
3988790434,3284948113,1665297963,1665298837,874,104
3178490239,3566825897,1658815921,1658816859,938,275
3306188967,3052951476,1668176775,1668176998,223,849
3515837186,3468324129,1648389057,1648389394,337,1613
3201957142,3251372174,1643446543,1643446924,381,315
3556456137,3576661425,1646955718,1646956038,320,1173
3094414065,3477363517,1649367166,1649367350,184,1655
3105733809,3073966897,1660083070,1660083379,309,2008
3364893066,3824478322,1643664344,1643665057,713,2244
3298748343,3080454518,1656044538,1656045520,982,919
3913162487,3724770746,1653920570,1653920741,171,349
3779299713,3558493130,1657827153,1657828088,935,1894
3038529026,3728797277,1657592817,1657593582,765,2352
3515480973,3971020365,1656498996,1656499325,329,353
3182752768,3484699376,1669481227,1669481353,126,984
3543696190,3199315199,1662735167,1662735312,145,179
3733619028,3094125203,1644908405,1644908852,447,88
3195716414,3716626172,1668156775,1668157565,790,1565
3051654064,3243231806,1650598349,1650598764,415,2070
3895274115,3155797946,1647019746,1647020163,417,359
3741978230,3036846628,1651414428,1651414910,482,964
3331977197,3431614426,1647998108,1647998689,581,1417
3055390520,3620616287,1653415721,1653416546,825,1652
3423028100,3679939578,1651714977,1651715605,628,1365
3998316020,3946409673,1653346829,1653347761,932,2374
3896091695,3823761286,1654418808,1654419124,316,1461
3334102064,3502316165,1656151021,1656151489,468,911
3625651694,3768814245,1663379764,1663380492,728,2168
3850427038,3675359399,1645056969,1645057133,164,213
3382943055,3106371588,1662908796,1662908950,154,368
3159562411,3147047674,1647824367,1647824478,111,138
3154009016,3313079052,1654121332,1654121991,659,1012
3907872554,3380303288,1654861117,1654862064,947,864
3521271030,3233375810,1647786912,1647787605,693,88
3555108136,3542215276,1649778710,1649779693,983,1806
3527995096,3019750416,1652959047,1652959463,416,297
3277883706,3090354216,1664025093,1664025438,345,2090
3313292041,3759867623,1666124860,1666125787,927,501
3353878603,3042739113,1648951922,1648952103,181,480
3297434061,3828921434,1653749911,1653750364,453,230
3276617814,3741983763,1653392423,1653392467,44,578
3463121212,3045981034,1653977470,1653978151,681,444
3669744444,3128401376,1657851903,1657852082,179,703
3012929490,3028679133,1656920084,1656920704,620,2019
3461628724,3995299995,1641803466,1641803785,319,1624
3783325820,3102992210,1642613124,1642613176,52,2483
3019750416,3137412000,1655572427,1655572949,522,239
3201479561,3409352040,1662994580,1662994721,141,1622
3403925711,3136707992,1662059184,1662060051,867,78
3573961768,3832334966,1669315398,1669315572,174,1899
3137195290,3977987504,1655915542,1655915597,55,464
3806570797,3271318708,1658955106,1658955295,189,1405
3362812887,3190859932,1663827456,1663828233,777,310
3726520685,3037048394,1651424634,1651425116,482,685
3783622486,3342082281,1650172303,1650172914,611,966
3177651100,3678482446,1661792495,1661793446,951,1642
3421875747,3283922234,1659822315,1659822722,407,1907
3829149174,3485815053,1662562113,1662562566,453,1712
3313431689,3533279961,1651089043,1651089398,355,1101
3428482789,3124004516,1653865537,1653865641,104,175
3368630986,3685665978,1647118483,1647119303,820,1581
3565278029,3694618653,1660804944,1660805385,441,12
3473505436,3011015055,1651321929,1651321944,15,860
3604435641,3522861132,1668220938,1668221374,436,690
3142777936,3429887771,1645855390,1645855709,319,160
3930591160,3793901427,1657650540,1657650871,331,995
3293865251,3492134379,1651388098,1651388304,206,2122
3442194248,3643939596,1662052598,1662053385,787,1243
3321752938,3796990042,1664912616,1664913590,974,1855
3310512172,3407909365,1654641563,1654641661,98,651
3000383745,3035838196,1665040740,1665041518,778,2010
3726367604,3978728021,1665447968,1665448214,246,2325
3889126069,3176653619,1663999387,1663999444,57,1140
3031103174,3420676198,1663149272,1663150140,868,1517
3105558193,3056982737,1653343147,1653343589,442,137
3747302768,3209748014,1648471703,1648472609,906,1855
3139035952,3714897535,1668593334,1668593992,658,1618
3780117215,3562365612,1651371631,1651372145,514,2049
3362298218,3248892530,1664056645,1664056840,195,514
3976757440,3437593879,1651893046,1651893839,793,1977
3885458258,3439660528,1653800162,1653800853,691,1327
3869692733,3639695113,1664242473,1664243384,911,1619
3605316405,3161784330,1667718740,1667718863,123,1272
3074477991,3185360566,1655911858,1655912782,924,875
3271039091,3112742999,1641979423,1641980370,947,1025
3356728242,3474625275,1647016604,1647017583,979,781
3721226798,3788769219,1667861788,1667861821,33,530
3295518987,3123166182,1663168203,1663169000,797,439
3132349279,3451227417,1655067249,1655068021,772,1985
3473505436,3949133704,1657438301,1657438886,585,273
3894247542,3480375415,1657067365,1657067822,457,1321
3886720244,3470287808,1656310460,1656310636,176,634
3606994517,3619704547,1661713691,1661714162,471,2141
3147298514,3533936136,1657608446,1657608953,507,1032
3750756562,3672274616,1664156416,1664157277,861,1076
3508858140,3858121838,1654793785,1654794777,992,1634
3166521010,3184344401,1667025801,1667026319,518,1730
3470482542,3869991101,1662242014,1662242804,790,1817
3600247537,3027651085,1662665233,1662665377,144,2300
3816995343,3300412448,1644197223,1644197738,515,1439
3293387588,3980501547,1649703346,1649703995,649,2000
3752773975,3088587729,1660958321,1660958902,581,2338
3320435078,3499272388,1655223033,1655224016,983,790
3541060382,3791547480,1652046247,1652047139,892,1941
3839454838,3528271389,1652645230,1652645917,687,1398
3748950684,3526491245,1654484604,1654484748,144,1883
3829856490,3955064333,1666090073,1666090081,8,1213
3423028100,3614952111,1657501442,1657502139,697,457
3841108033,3267411650,1661210388,1661211194,806,1614
3272535116,3981210682,1661603743,1661604203,460,1385
3462862340,3875483766,1657160562,1657161239,677,667
3397910828,3156980878,1662530661,1662531439,778,1511
3362812887,3304958701,1654994495,1654994602,107,1422
3359722926,3237245622,1648374893,1648375779,886,856
3120092137,3280668606,1662811635,1662812224,589,1040
3153750267,3927329503,1643096679,1643097041,362,2395
3282168599,3821064356,1658839117,1658839384,267,771
3716257088,3433439185,1661941807,1661942214,407,1620
3646151081,3361482296,1654509530,1654509800,270,756
3052861028,3097016405,1662334613,1662335131,518,929
3625651694,3658113721,1641584268,1641584435,167,1717
3438961567,3487992433,1654698843,1654699784,941,326
3618545572,3399055713,1650619951,1650619961,10,133
3563738755,3092118254,1655716328,1655716864,536,1287
3424884440,3066956305,1663869129,1663869672,543,1331
3502587181,3161412125,1652748263,1652748341,78,768
3199375921,3463003824,1662392530,1662393530,1000,537
3933752482,3884256882,1653170284,1653170616,332,1218
3797484306,3784594026,1644084979,1644085668,689,600
3009141852,3417798594,1665020961,1665021879,918,1252
3457108498,3620223775,1641521354,1641521673,319,1231
3443084089,3929975862,1652452829,1652453182,353,2384
3403933668,3425613329,1642306542,1642307157,615,972
3993923271,3621571402,1669431287,1669432250,963,456
3040563913,3599007187,1647917508,1647917678,170,1986
3817960208,3495420849,1652610887,1652611609,722,304
3411347712,3171307709,1657271639,1657271664,25,1350
3353878603,3886736668,1651122770,1651122977,207,2106
3002438521,3878083942,1649848251,1649849155,904,1819
3059176048,3902437090,1645092470,1645093047,577,814
3501508123,3441680015,1659132808,1659133575,767,1092
3325944344,3134166826,1651234643,1651234756,113,2481
3163326257,3134337442,1662450130,1662450631,501,1048
3005480994,3891477592,1668812766,1668812998,232,575
3309053474,3681170705,1650564337,1650565290,953,2235
3949713678,3701214753,1653063304,1653064248,944,1362
3170519162,3309242036,1660566922,1660566979,57,1835
3552958954,3183256246,1649406716,1649406895,179,2475
3524508110,3418998927,1659005334,1659005799,465,1981
3026035554,3799036179,1645182938,1645183497,559,318
3904907996,3107501731,1644654806,1644655224,418,1257
3761584126,3153831709,1648647658,1648647876,218,200
3384200089,3936042616,1651501474,1651501821,347,8
3550107804,3624872846,1663208370,1663209006,636,1103
3392535031,3642771281,1650252582,1650252717,135,227
3981348782,3175478710,1650302086,1650302839,753,1729
3106371588,3576411084,1664029517,1664029808,291,1183
3183256246,3191970772,1666354334,1666354661,327,2318
3967250644,3898012654,1663171238,1663171399,161,2402
3129792187,3196794099,1654234360,1654234733,373,469
3382983805,3790650118,1652620079,1652621052,973,2425
3788819111,3676634608,1667089427,1667089697,270,2297
3335210480,3359722926,1663754561,1663755000,439,2294
3210422873,3829878263,1649935501,1649935827,326,912
3748812993,3359046521,1664167986,1664168570,584,848
3831585514,3124964775,1657976447,1657976866,419,2339
3038424212,3799249782,1664634399,1664634641,242,964
3542215276,3140407144,1662805523,1662806329,806,2349
3565278029,3534218813,1663857532,1663857637,105,1835
3039864595,3174499556,1648476753,1648477050,297,2266
3672274616,3967972556,1663854830,1663855726,896,1907
3027129249,3444174394,1651895324,1651896047,723,1272
3638803969,3660046291,1650570013,1650570467,454,324
3773505782,3537294800,1648688030,1648688045,15,1852
3153446106,3679519826,1649295132,1649295414,282,190
3258577325,3323834326,1663686449,1663687127,678,2195
3766196716,3354579861,1660081063,1660081675,612,1815
3405373154,3671869525,1662896201,1662896924,723,1932
3567614002,3149818961,1661050012,1661050400,388,797
3192940759,3068242755,1668461786,1668462186,400,314
3077238667,3624748073,1653427809,1653428071,262,1443
3462714323,3783916284,1665632143,1665632914,771,1608
3635324805,3883176560,1669115761,1669116681,920,1192
3029451399,3651798658,1647536580,1647536718,138,1192
3347776562,3285381118,1649856649,1649857366,717,963
3840502377,3645860854,1656608387,1656608956,569,1319
3558312644,3294635633,1646362555,1646362730,175,677
3043736420,3522103750,1667758678,1667758811,133,2290
3612649935,3593704176,1642519097,1642519214,117,1473
3497045946,3173788210,1650139478,1650139805,327,1362
3300063136,3358277498,1641282663,1641283614,951,108
3930242126,3034288673,1650350343,1650351070,727,513
3164355501,3392105056,1658285386,1658286213,827,882
3063782933,3172619193,1667124521,1667124613,92,1559
3800201060,3153391276,1666738812,1666739348,536,278
3938505582,3886709661,1643116463,1643117359,896,2479
3581011004,3423043196,1660321011,1660321912,901,723
3228497776,3633111737,1654474596,1654474963,367,765
3799117805,3906065558,1652595786,1652595947,161,1098
3659285822,3452773006,1645743998,1645744342,344,880
3921317746,3259880338,1644802213,1644802410,197,833
3234861737,3340366291,1651908796,1651909724,928,226
3231701470,3661135703,1644782714,1644783490,776,2412
3869618249,3198999623,1659183711,1659184282,571,531
3780833571,3668471634,1645733353,1645734347,994,2244
3977139394,3630123918,1666684966,1666685481,515,1309
3539364028,3767453896,1663054098,1663054315,217,885
3978925529,3048405710,1643356312,1643356995,683,2155
3862138776,3802018450,1644510935,1644511871,936,2264
3256807270,3574740304,1656775069,1656775125,56,2172
3319605191,3195032074,1644404585,1644405391,806,2150
3445530012,3944247629,1651738411,1651738503,92,677
3138958890,3010649870,1662184736,1662185259,523,1446
3442725932,3951692395,1652201747,1652202609,862,1823
3657251975,3379935974,1660577932,1660578171,239,802
3157600969,3047402472,1666988794,1666989552,758,1553
3386809097,3283301166,1651865503,1651865800,297,2385
3396453607,3989991456,1649183067,1649183337,270,2196
3006085284,3306619417,1669305622,1669306389,767,710
3352262794,3526968501,1646995986,1646996007,21,1948
3599714580,3092003105,1648662155,1648662187,32,152
3438130685,3883846613,1662629548,1662629989,441,716
3320742371,3043180716,1659496345,1659496962,617,2297
3509999399,3894115655,1649484996,1649485957,961,69
3009141852,3079031370,1653137417,1653137800,383,103
3398840886,3140407144,1667268577,1667268790,213,28
3864301593,3466459383,1666841119,1666841378,259,1015
3946919028,3431883681,1661651976,1661652242,266,1609
3480905975,3237807880,1665931774,1665932690,916,2386
3766186320,3941528766,1653144194,1653144451,257,329
3550741990,3250867562,1669629796,1669630232,436,943
3793967785,3065298582,1654246203,1654246546,343,2273
3612720177,3897212070,1658708884,1658709764,880,2461
3221685249,3672276184,1649273755,1649274441,686,1855
3975075818,3344455273,1644129482,1644129918,436,627
3708654413,3844822083,1652343074,1652343967,893,67
3156483651,3397779824,1657362879,1657363728,849,2127
3605492251,3181047536,1649345435,1649346217,782,2077
3357247840,3808191596,1658014944,1658014947,3,1090
3091112554,3795934256,1643098351,1643098388,37,1156
3735277639,3084007689,1647279751,1647279790,39,2248
3605587138,3404563689,1667227509,1667227780,271,1631
3657587705,3833618667,1649065764,1649066156,392,2022
3115303809,3980781580,1651492103,1651492173,70,906
3598572594,3948754212,1663325440,1663325525,85,1235
3938776287,3282079727,1669427242,1669427282,40,701
3762422234,3427225872,1654209856,1654210593,737,362
3888670009,3094147044,1643427836,1643428075,239,1667
3214558994,3580594125,1667635511,1667636193,682,539
3553960271,3653780780,1666709177,1666709764,587,2021
3231899706,3205601088,1641824427,1641825162,735,1570
3841314189,3392569339,1652191770,1652192510,740,2437
3860422016,3144068102,1644895164,1644896118,954,1302
3974326867,3833333678,1664323946,1664324453,507,1680
3948515015,3431892611,1644047943,1644048171,228,1984
3833572466,3041296119,1647275370,1647276320,950,2428
3725117905,3863448086,1662161065,1662161532,467,702
3880298832,3046132590,1664377797,1664378151,354,1434
3402878567,3516399207,1658355000,1658355896,896,1381
3894359262,3423522480,1657638058,1657638257,199,1682
3329496705,3281753784,1643687641,1643688150,509,1913
3410261725,3407150254,1647687444,1647687777,333,130
3956878212,3180101007,1642706742,1642707205,463,1016
3664337365,3442854678,1657515161,1657515301,140,1252
3928212115,3375585327,1665678142,1665678484,342,16
3011863548,3106781266,1647797340,1647798059,719,2460
3446289365,3315283904,1667044769,1667045445,676,2358
3155835978,3061840033,1660784390,1660785030,640,2262
3554676369,3988957478,1669131089,1669131296,207,1050
3776148003,3684883542,1657866624,1657867072,448,1179
3085931016,3537443088,1652401289,1652401612,323,1587
3393606099,3499481051,1653732666,1653732679,13,594
3110691442,3091817310,1646252048,1646252453,405,556
3509328343,3185444969,1668365775,1668365877,102,1755
3507564472,3233146767,1661488045,1661488802,757,306
3801205465,3264993323,1646108558,1646109510,952,1880
3739453348,3050607996,1648414077,1648414917,840,163
3174705393,3696856656,1650508745,1650508905,160,875
3744726408,3146645864,1666512585,1666512729,144,467
3398412701,3814577253,1664328587,1664329321,734,2139
3848272906,3852818295,1651558951,1651559242,291,1973
3100402840,3736885329,1662157103,1662158068,965,1377
3532756620,3381313507,1664769586,1664769839,253,1269
3179180919,3784105182,1645882191,1645883023,832,1462
3528069102,3800337461,1643079770,1643080720,950,498
3556968717,3312203382,1655956945,1655957329,384,7
3001302955,3785813162,1662667552,1662668242,690,407
3105460297,3967147343,1641176357,1641176752,395,736
3733004020,3095772004,1659109660,1659109818,158,2048
3767249449,3018325807,1651855962,1651856912,950,268
3448726123,3137350861,1667670258,1667670832,574,2407
3169012590,3800201060,1653468359,1653469078,719,2377
3942134694,3655923753,1649528484,1649528591,107,843
3703881738,3400786498,1662095406,1662096066,660,1507
3293201387,3086530794,1656987640,1656987855,215,1864
3942862085,3673743780,1665411241,1665412234,993,2412
3622334419,3003872692,1646529856,1646530222,366,513
3625651694,3000600578,1653101961,1653102699,738,2404
3635616513,3288490513,1665108106,1665108513,407,1431
3154435614,3782377691,1655616610,1655617459,849,1574
3620725243,3633830454,1661724765,1661725492,727,603
3132584801,3816647849,1641119883,1641120264,381,1292
3480314503,3655135775,1668356336,1668357195,859,2162
3722247979,3348113823,1669131306,1669131816,510,1884
3659701814,3433374325,1655485539,1655486136,597,2232
3010767150,3215088423,1660359377,1660359812,435,1320
3718882981,3614399988,1653753135,1653753322,187,340
3106436957,3641185549,1642979096,1642979984,888,750
3541060382,3313782821,1657129487,1657129642,155,1521
3944914500,3089525434,1657254863,1657255842,979,72
3217857851,3995868243,1661102040,1661102654,614,6
3092564684,3233146767,1659567259,1659567891,632,20
3817000379,3776862606,1666408023,1666408731,708,2336
3278843111,3771841105,1646557594,1646558174,580,1104
3853178623,3681170705,1641830601,1641830616,15,67
3033438220,3453884967,1656413637,1656413986,349,1031
3697571838,3895422097,1666985174,1666985513,339,1577
3338154846,3161243271,1641888075,1641888631,556,2272
3135139573,3985734621,1648556384,1648556570,186,1213
3768558350,3396154732,1645713627,1645714000,373,903
3333037570,3775146250,1657433956,1657434955,999,1281
3129993467,3923980052,1648748664,1648749383,719,1817
3558493130,3918988651,1658928400,1658928418,18,1746
3523236646,3747889498,1663306185,1663306709,524,649
3052789625,3228277648,1663938065,1663938607,542,2031
3897976617,3969435749,1664125907,1664126795,888,1430
3538039823,3931229167,1663578766,1663579174,408,318
3081701001,3285303154,1657363922,1657363931,9,1737
3695292102,3953927472,1663010343,1663011012,669,2071
3608512295,3237697952,1663234319,1663234616,297,510
3699730203,3095661578,1654921592,1654921860,268,2205
3502554871,3451479071,1660838348,1660838408,60,1072
3243502165,3260246509,1646761371,1646762285,914,1216
3629090721,3239162274,1646823729,1646824073,344,1914
3371970996,3766205598,1645425912,1645426034,122,1524
3800014504,3738981251,1667156229,1667156951,722,1282
3127447356,3450689808,1646427871,1646428084,213,1196
3550677109,3023576817,1665410630,1665410912,282,1462
3713126710,3777929700,1646230808,1646231666,858,2232
3553467860,3590361712,1665102480,1665103048,568,1293
3845338893,3699533383,1652990856,1652991383,527,425
3054828202,3456435173,1663192954,1663193369,415,288
3608535655,3215088423,1651688865,1651689562,697,2151
3154729703,3554261399,1643292496,1643292896,400,315
3702671465,3500152600,1658447111,1658447804,693,1896
3752347758,3820585135,1656036333,1656036393,60,2090
3254592040,3637518238,1643667666,1643667822,156,2184
3347942747,3190544941,1661559643,1661560087,444,2399
3174712961,3244763805,1641668311,1641668662,351,1018
3355942761,3759008568,1653582653,1653583295,642,1374
3642318884,3174712961,1651251998,1651252704,706,1080
3463509445,3645860854,1648164614,1648164751,137,1898
3169265310,3297477157,1665017513,1665018194,681,1525
3763455710,3089548621,1652709057,1652709641,584,731
3025223556,3558493130,1665037921,1665038510,589,1859
3832640445,3278792522,1660248347,1660249021,674,371
3994844749,3618013844,1652757636,1652758496,860,1105
3261169929,3616890026,1651697678,1651698450,772,740
3210136888,3172018366,1649709108,1649709942,834,480
3190508233,3857211245,1646237511,1646238296,785,1022
3928930330,3844348081,1653806459,1653807166,707,2355
3319037937,3052376951,1645400684,1645401346,662,1467
3752701792,3306457934,1656327678,1656328241,563,2128
3014363081,3280251149,1641348118,1641348705,587,478
3425490548,3893601176,1663574048,1663574571,523,1487
3261333996,3112859411,1649705819,1649705874,55,879
3905581902,3377847710,1666382050,1666382887,837,1425
3749379449,3073969560,1651283886,1651284538,652,280
3419809319,3648072719,1660536754,1660537251,497,475
3983158937,3560053389,1647466644,1647466994,350,918
3132376039,3532021354,1662419438,1662420418,980,1359
3295806447,3533497399,1648712057,1648712304,247,2011
3671296032,3193890426,1643948924,1643949923,999,2166
3903091311,3750698244,1645685853,1645686485,632,1207
3176536531,3806520351,1661002291,1661002533,242,534
3067539427,3043598133,1657525064,1657525930,866,608
3936292699,3389448374,1653907668,1653908059,391,1513
3319365305,3537862606,1661716978,1661717975,997,2299
3608071362,3878573707,1659909194,1659909911,717,1852
3547365303,3433576059,1654260127,1654261069,942,954
3099224416,3903947013,1656583044,1656583105,61,260
3775501779,3564599618,1646257554,1646258370,816,2338
3504641910,3102669962,1647254467,1647255313,846,147
3339385127,3752297066,1654780534,1654781226,692,1597
3312580754,3635487786,1654784811,1654785741,930,360
3638822670,3751694809,1660099737,1660100447,710,1208
3339962549,3601690466,1657521177,1657521730,553,1152
3578075354,3239792198,1643421521,1643421982,461,1273
3521217476,3046991819,1643399710,1643400483,773,829
3811389743,3271759672,1655104893,1655105115,222,1641
3696243779,3752653418,1646107365,1646107542,177,1117
3528439013,3266666808,1658020876,1658021610,734,1401
3658659669,3686025670,1650459218,1650459840,622,1320
3813666053,3601604629,1650030906,1650031114,208,718
3368630986,3433937560,1653824853,1653825559,706,2356
3114348300,3917526154,1641053202,1641053390,188,2275
3522211010,3729768092,1666577810,1666578502,692,1588
3476903669,3463003824,1650018007,1650018351,344,116
3288496623,3706215600,1669493978,1669494285,307,1597
3831660488,3215088423,1642839856,1642839891,35,2343
3707767360,3778405053,1651970514,1651970792,278,459
3831426674,3818353360,1662676338,1662677221,883,1029
3102588374,3391441349,1653011360,1653011766,406,1198
3602497998,3982644241,1656331926,1656332369,443,726
3576386271,3905922866,1656235320,1656235589,269,905
3593244627,3707604534,1668226045,1668226125,80,2284
3004100055,3173809486,1641504047,1641504868,821,1105
3594903436,3582544512,1655836411,1655837324,913,508
3670550887,3537443088,1645056104,1645056410,306,1445
3239162274,3145344208,1666200937,1666201510,573,401
3779319466,3244946730,1647018105,1647019085,980,2391
3794074656,3501568597,1650733471,1650733969,498,1496
3536903033,3357692565,1654784821,1654785396,575,1464
3305299292,3186371475,1646477566,1646477723,157,1270
3267151775,3893709526,1648177501,1648177942,441,2293
3024611625,3854184537,1660532680,1660533169,489,1428
3127412666,3377781677,1665358736,1665359248,512,997
3111639847,3967727550,1651608128,1651608714,586,1828
3892535771,3422728078,1667369913,1667369940,27,150
3470287808,3115669693,1664953532,1664954116,584,2309
3614952111,3879157400,1648752883,1648753413,530,1198
3640949933,3621462507,1661974475,1661974672,197,698
3776944992,3160938941,1665295226,1665295296,70,132
3661372760,3187779586,1648298983,1648299095,112,0
3201587444,3645073300,1663299785,1663300437,652,1367
3384222838,3419336769,1662914456,1662914602,146,936
3845511281,3185373368,1652112006,1652112805,799,780
3661369487,3710782213,1655478833,1655479051,218,1903
3535941316,3801410751,1647902678,1647902768,90,1001
3553301078,3884959127,1655423915,1655424695,780,704
3404008086,3861764050,1646134790,1646135727,937,204
3165835560,3520825972,1654751094,1654751689,595,1695
3605195406,3322663101,1657917919,1657918907,988,221
3675341264,3725903222,1666674752,1666674957,205,1359
3664408598,3004708023,1667348919,1667348965,46,2396
3479322514,3009801123,1653968263,1653968497,234,702
3485459472,3132959520,1660340644,1660340673,29,1701
3072276713,3529381895,1655443266,1655444081,815,767
3526687041,3289061595,1657550887,1657551233,346,2140
3134166826,3164391025,1654799672,1654799887,215,429
3881861537,3228565452,1645595191,1645595957,766,1123
3439364410,3655498745,1667799815,1667800278,463,1524
3111817334,3085311533,1658761813,1658762451,638,1393
3383754736,3715540162,1664451847,1664452606,759,1358
3964434363,3580178697,1662772210,1662772393,183,624
3111965011,3974318707,1660120493,1660120951,458,325
3892336923,3504796283,1647984519,1647985430,911,1166
3396063880,3461674303,1658933739,1658933767,28,2229
3272250396,3675359399,1647934515,1647935488,973,1656
3173969437,3757499622,1666708258,1666708833,575,407
3202225412,3113427537,1645323460,1645323539,79,217
3118533471,3788034142,1641460811,1641460926,115,1468
3184669033,3911364139,1645652722,1645653068,346,1847
3267968478,3411495833,1666871475,1666872308,833,2236
3882603510,3115367011,1659311947,1659312795,848,1506
3244969283,3719507293,1657176267,1657176416,149,654
3780117215,3482148686,1666641807,1666642341,534,1892
3384452997,3908312889,1663528176,1663528582,406,958
3978893578,3127616448,1664440629,1664441519,890,2215
3683507812,3205282165,1668839464,1668839811,347,758
3548670552,3013314607,1653943217,1653943222,5,1051
3247758952,3133788020,1661353224,1661353716,492,1623
3914613880,3049592624,1648966546,1648967545,999,2003
3839642166,3119477442,1659353436,1659353990,554,822
3855261620,3374688375,1649432775,1649433435,660,1534
3296556189,3087603397,1654327965,1654328669,704,1961
3111167324,3674729672,1662331850,1662332158,308,2353
3094291821,3683134571,1646457049,1646457755,706,192
3055944630,3766966794,1642536215,1642536964,749,1082
3079137127,3222282745,1664819911,1664820810,899,111
3513576000,3044854518,1652504027,1652504895,868,1902
3178728299,3062423981,1660940760,1660940948,188,1545
3645868952,3771931468,1642445098,1642445784,686,1128
3616803531,3608450611,1666825775,1666826118,343,83
3475352970,3986003303,1653135025,1653135667,642,2113
3256807270,3518246885,1648050196,1648050473,277,1629
3061594029,3450353368,1667461181,1667462164,983,1136
3434324683,3145045320,1642087398,1642087482,84,752
3526166184,3070676307,1663391603,1663391861,258,963
3851780195,3202881162,1642468047,1642468551,504,370
3202984277,3599007187,1652163876,1652164337,461,2295
3212095735,3206106614,1664380812,1664381366,554,2341
3528288695,3185745995,1657413124,1657413128,4,81
3898603481,3395525819,1652767815,1652767846,31,223
3281061177,3893475632,1645258571,1645259434,863,1908
3126746702,3476826459,1659274753,1659275339,586,1574
3624911947,3870998298,1654700969,1654701435,466,920
3528069102,3097033729,1664833735,1664834335,600,1941
3996587507,3837447685,1666496405,1666496473,68,285
3254930364,3642771281,1660663555,1660663894,339,1313
3662935617,3643132014,1665034615,1665035444,829,38
3749529134,3375404573,1659898704,1659899696,992,1087
3350783192,3611777140,1654365463,1654365767,304,1453
3081188307,3975065378,1666467768,1666468402,634,32
3057837723,3159950284,1645754978,1645755081,103,1016
3920277028,3869355507,1666109376,1666109617,241,1827
3603092087,3654899608,1641831772,1641832734,962,1430
3011459628,3876696308,1645068388,1645069111,723,665
3638297718,3707406950,1648618051,1648618665,614,1344
3280648157,3439325479,1641697042,1641697930,888,1361
3208243335,3983727854,1644367496,1644368193,697,1259
3569443529,3602497998,1649201366,1649202227,861,2000
3936135558,3101669976,1668365062,1668365452,390,1060
3436199937,3211003582,1656239717,1656240628,911,1871
3204412545,3760972512,1644254548,1644254947,399,2447
3343162937,3278792522,1665661065,1665661559,494,1620
3709075485,3492657889,1653089393,1653089865,472,1307
3635921511,3179180919,1668957364,1668957948,584,1695
3323217825,3348282881,1667389630,1667390603,973,1959
3393911160,3198338148,1648970536,1648971078,542,1783
3104902156,3460572652,1647952519,1647953302,783,1651
3019512245,3708337100,1646588353,1646588754,401,1884
3224792502,3306439333,1645730951,1645731719,768,1189
3706085200,3397169008,1643755694,1643755694,0,1529
3014462663,3617757019,1646935524,1646935958,434,2331
3066854514,3902739418,1669158149,1669159066,917,343
3840558415,3933892798,1651088592,1651089493,901,1575
3924838447,3400211756,1649055991,1649056930,939,2136
3308435698,3514013878,1649530310,1649531285,975,771
3888505889,3181032246,1666257197,1666257340,143,914
3534192041,3062464540,1647146399,1647146692,293,2272
3771528397,3282275875,1654006855,1654007740,885,231
3364925703,3641185549,1663716034,1663716348,314,2056
3509328343,3988913212,1654223304,1654223894,590,1534
3448866192,3375177760,1649545632,1649545648,16,748
3644100988,3456948150,1664741454,1664742225,771,1314
3668456327,3234355426,1664634276,1664634356,80,1984
3660046291,3015814199,1663285082,1663285449,367,1652
3804145408,3377457710,1657601792,1657602178,386,2326
3106276005,3103871966,1656489113,1656489972,859,436
3241444105,3774413169,1668948788,1668949764,976,285
3471703914,3046380642,1651111441,1651112367,926,1371
3752669447,3154009016,1669671804,1669672738,934,2276
3042739113,3325313312,1668178524,1668178971,447,2432
3088562105,3295278768,1642345499,1642346157,658,706
3587497382,3257865090,1652331103,1652331951,848,776
3026769225,3113938510,1652873860,1652874674,814,1123
3118305321,3099818927,1669755596,1669755899,303,2200
3841318125,3455808094,1669498597,1669498840,243,1762
3885194706,3762856505,1650678441,1650678648,207,2493
3134436515,3683038464,1649061822,1649062343,521,1962
3309219121,3460704532,1645543160,1645544043,883,78
3879898101,3780039563,1657187594,1657188133,539,944
3348234563,3976223971,1651144375,1651144757,382,2443
3647255060,3257690557,1648305723,1648306194,471,2243
3563967528,3279671068,1647673547,1647674070,523,699
3753180150,3332592315,1641178696,1641179607,911,2497
3735098036,3952670371,1659861751,1659862108,357,382
3735691730,3834166808,1666222060,1666222320,260,1390
3291324812,3972052329,1653888098,1653888894,796,1173
3989392973,3661507330,1669449175,1669449964,789,1572
3479385096,3245773600,1659964341,1659964442,101,243
3775146250,3008850935,1662059534,1662060073,539,1396
3007686100,3515941468,1662378539,1662379222,683,2144
3695935038,3911891369,1655003002,1655003006,4,107
3726892870,3149191705,1647853697,1647854280,583,2388
3257187145,3553096192,1658128100,1658128615,515,530
3208106743,3404020970,1649022883,1649022992,109,2422
3165700370,3790329301,1641651486,1641651935,449,1261
3065810858,3948710872,1643796720,1643797492,772,532
3944476586,3589441972,1657742067,1657742902,835,1745
3048781539,3525442421,1645032733,1645032938,205,768
3478280943,3582076532,1656154034,1656154926,892,1841
3870998298,3872170030,1645863774,1645863978,204,2094
3850427038,3689518345,1653792375,1653793323,948,912
3829546967,3995299995,1661494995,1661495499,504,2348
3973853235,3682793223,1652462804,1652462880,76,2213
3031649001,3192612662,1647626592,1647626995,403,619
3181912863,3375927053,1643903376,1643904099,723,54
3947158263,3267360802,1641131176,1641131662,486,123
3680703930,3863676573,1641859513,1641859816,303,854
3615362859,3432722823,1641982850,1641983091,241,2035
3524831718,3894030912,1665076954,1665077247,293,2064
3984274810,3306753571,1659058211,1659059114,903,1312
3355429456,3145344208,1646580028,1646580753,725,1409
3587497382,3142454040,1657874570,1657875538,968,1703
3804329236,3688196978,1651461590,1651461822,232,2443
3350067994,3925504452,1663808561,1663809141,580,375
3320272612,3316237227,1656677621,1656677762,141,1221
3776063818,3230836206,1666693013,1666693483,470,2047
3615137704,3880011397,1642738404,1642738575,171,2268
3143324065,3392469094,1645001131,1645001209,78,979
3107482740,3961189789,1650651373,1650652064,691,929
3888015355,3469462520,1645905516,1645905553,37,1350
3832703867,3828555703,1660679957,1660680784,827,8
3032747459,3252790120,1641122837,1641123170,333,831
3889537515,3952282084,1659502284,1659502679,395,687
3271409183,3867554012,1667823193,1667823505,312,2246
3304596274,3366896849,1658374572,1658374886,314,1392
3312336013,3115344578,1657328093,1657328292,199,612
3088854267,3074395717,1650891398,1650892300,902,1499
3178749877,3504919226,1643781621,1643782381,760,482
3628583147,3761775611,1664121523,1664122004,481,2293
3880298832,3583169906,1648877638,1648877883,245,623
3627981146,3391056146,1666412538,1666412909,371,163
3143318519,3057837723,1664425653,1664426553,900,627
3915817603,3195504067,1653481136,1653481964,828,1147
3181912863,3433768649,1645466086,1645466370,284,1190
3099785790,3173108957,1647196357,1647196682,325,2142
3405155234,3693888320,1650875227,1650876057,830,1112
3321752938,3429004715,1668957013,1668957139,126,259
3967015655,3366192341,1662459315,1662460302,987,1618
3153413554,3465238210,1664083781,1664084013,232,1634
3311871585,3435340439,1667111948,1667112640,692,1511
3713520914,3443161524,1650394191,1650394754,563,2386
3779192515,3221276652,1669571461,1669571922,461,1479
3412675211,3029481461,1642926373,1642926914,541,592
3206198477,3223313152,1643002031,1643002652,621,1505
3599915754,3508224327,1663005502,1663006136,634,1145
3527291464,3168084964,1654536655,1654536801,146,2168
3336551797,3513847916,1668372948,1668373227,279,640
3095430228,3882619512,1652939593,1652940241,648,1370
3034470773,3090179745,1656543204,1656543431,227,1524
3677893619,3785725492,1663215660,1663216236,576,95
3409962434,3528069102,1666961859,1666962012,153,805
3812481438,3818039978,1665711130,1665711784,654,1272
3902739418,3933742178,1657210495,1657211341,846,2215
3423298470,3435253366,1660373205,1660373975,770,1058
3992226673,3960772879,1647755420,1647755746,326,373
3962031345,3867554012,1661980635,1661981320,685,340
3363651899,3722323538,1669240506,1669241387,881,865
3017005264,3190035679,1652561667,1652562534,867,332
3915206176,3252070101,1649838212,1649838952,740,1983
3282275875,3760047951,1657736978,1657737528,550,1172
3171569619,3019854226,1647526528,1647526648,120,1102
3463540687,3336494171,1644785451,1644786394,943,2217
3016482005,3691062084,1663936712,1663937537,825,171
3657758228,3133601374,1646084298,1646084906,608,2224
3906236028,3243018622,1657379852,1657379880,28,13
3030174879,3836823852,1656575953,1656575953,0,88
3636446257,3278397100,1660440379,1660440660,281,2238
3201957142,3392569339,1654104752,1654105506,754,83
3209544947,3777820691,1660557091,1660557496,405,457
3975096180,3564883937,1642512381,1642513335,954,1907
3348102929,3374940485,1662303877,1662304779,902,618
3097834756,3385246088,1668958461,1668959312,851,780
3847561511,3639307843,1657026451,1657027192,741,868
3127403665,3699625300,1658085965,1658086733,768,1002
3995288261,3256873642,1654023680,1654023955,275,2417
3049567508,3745737102,1644299347,1644300203,856,1932
3468436735,3151697582,1657033720,1657034720,1000,621
3746550027,3082434177,1662540269,1662540547,278,2363
3180973124,3012152244,1648381258,1648382025,767,1090
3269622220,3772035177,1649652696,1649653696,1000,356
3270240132,3698965715,1657599548,1657599839,291,874
3722422633,3855900879,1650820212,1650820989,777,265
3796504737,3929408680,1644633689,1644634657,968,1672
3505480563,3361482296,1667500979,1667501903,924,628
3554676369,3265655534,1662062675,1662063630,955,1949
3611353561,3318717113,1643610387,1643611373,986,236
3809965750,3689303525,1667212456,1667212808,352,2080
3927952722,3608048838,1655285363,1655286279,916,439
3862122399,3325735498,1651123291,1651123535,244,2079
3437983939,3528467648,1646902305,1646903229,924,1769
3579404607,3907635993,1645795873,1645796360,487,352
3631568439,3939469152,1656971664,1656972270,606,528
3673597203,3110121278,1660315532,1660315570,38,469
3234559565,3812800144,1656116353,1656116759,406,1656
3556450605,3649774117,1660277302,1660278005,703,779
3474666564,3878512967,1656621749,1656622704,955,333
3108230028,3725480364,1657421485,1657421985,500,958
3662876111,3307636200,1662811387,1662811506,119,2208
3468682335,3414719919,1651169359,1651169595,236,167
3304499678,3368294774,1648503177,1648503214,37,451
3044450059,3787920743,1644204786,1644204801,15,1237
3195598526,3836597583,1657452517,1657453076,559,543
3637092038,3426666423,1665902523,1665902702,179,350
3369175849,3696512728,1662512449,1662512784,335,550
3748511559,3889544424,1647574734,1647575218,484,2092
3245723038,3388844626,1646498486,1646498845,359,1460
3634735892,3723784545,1644849524,1644849728,204,1812
3249512921,3092800496,1663160916,1663161800,884,1302
3678778706,3387785849,1648207906,1648208521,615,112
3318227153,3360436723,1669079142,1669079380,238,1838
3375359100,3735855753,1660258363,1660258378,15,614
3830579550,3128805218,1641908079,1641908290,211,1247
3611100286,3669324531,1642381257,1642381638,381,2353
3094562402,3320179826,1649027498,1649027917,419,692
3891053268,3411128747,1665020685,1665021006,321,2082
3994130271,3389546736,1667860361,1667861203,842,1741
3869505474,3692904228,1654059695,1654060459,764,2097
3457895283,3953258545,1660386724,1660387226,502,1445
3412927884,3660998516,1644227796,1644228150,354,2026
3146634302,3419430775,1666386320,1666387041,721,1186
3508858140,3832252723,1641512399,1641513172,773,357
3530278315,3044390847,1653447864,1653448664,800,728
3895990286,3270177744,1665689924,1665690058,134,653
3823761286,3102760949,1663277024,1663277473,449,369
3886368625,3885084129,1647017557,1647018036,479,74
3542827244,3653850140,1658480734,1658481342,608,615
3469648387,3406509436,1646440610,1646440781,171,2177
3743682237,3339349217,1662694730,1662695077,347,931
3515332061,3630744403,1669529441,1669529824,383,929
3419117613,3364855872,1664525804,1664526235,431,1893
3454276568,3518079213,1665089551,1665090198,647,2326
3490087619,3490286406,1658341047,1658341332,285,379
3653577731,3028910693,1642426005,1642426697,692,2224
3775565964,3266666808,1663068405,1663068929,524,1945
3707892765,3976970303,1665410878,1665411044,166,2011
3724455974,3660046291,1642029417,1642029816,399,820
3646536668,3925364546,1659190216,1659190815,599,813
3589984222,3157821920,1666716148,1666716200,52,832
3262645455,3795494127,1666425999,1666426333,334,1058
3137412000,3102760949,1666784253,1666785101,848,582
3170325894,3218136112,1650982125,1650983101,976,2165
3511569871,3389926670,1667011439,1667011979,540,1759
3068161140,3401463703,1660066018,1660066467,449,727
3696243779,3832265812,1654592144,1654592473,329,1409
3036488445,3373962186,1646036258,1646036494,236,2284
3929774793,3930852270,1666886234,1666886790,556,1928
3458493864,3618352797,1647264961,1647265574,613,2493
3540279517,3397779824,1648686243,1648686402,159,1039
3862122399,3893018254,1649941032,1649941603,571,1200
3696448766,3112739600,1669135802,1669135907,105,577
3346860393,3442927979,1646128501,1646128839,338,2037
3255978821,3878180077,1651481236,1651481379,143,228
3332914132,3271201418,1650489192,1650489876,684,2391
3397052856,3065434950,1655443862,1655444482,620,776
3568965374,3365939940,1645896403,1645896843,440,820
3315321131,3620311248,1660746394,1660746727,333,1355
3309684706,3127412666,1641592887,1641593527,640,1761
3991477345,3861123581,1669108358,1669108408,50,1551
3555903175,3697028552,1654972601,1654973513,912,155
3073762858,3664242822,1653539970,1653540227,257,1001
3832265812,3819770312,1660694115,1660694164,49,1459
3854357910,3448952875,1648791562,1648791757,195,6
3449136061,3196822601,1645173646,1645174101,455,1321
3864930473,3334743610,1658582682,1658583497,815,865
3744645350,3547278175,1658385699,1658386634,935,2169
3316855337,3400163448,1653760179,1653760371,192,1968
3893849847,3218903379,1650061939,1650062449,510,206
3219181477,3024611625,1651479209,1651479655,446,1598
3787230225,3452181736,1653247734,1653248613,879,2040
3599160097,3894667761,1648791081,1648791546,465,385
3170844702,3722726470,1661086625,1661086630,5,83
3087123320,3976267689,1656720097,1656721017,920,622
3580310329,3628963667,1655067740,1655067865,125,412
3596454426,3921816397,1669455373,1669455815,442,2482
3124964775,3991299369,1657680151,1657680264,113,858
3242897765,3315539995,1655864544,1655864903,359,1852
3510528970,3346978275,1651410806,1651411654,848,644
3006388757,3118419220,1656346653,1656346975,322,974
3750277600,3448135160,1668115215,1668116036,821,1820
3996587507,3463669049,1658204834,1658205331,497,32
3946569604,3983711613,1643792685,1643792806,121,1113
3046991819,3147896698,1665265478,1665265832,354,197
3911619189,3915637706,1667664269,1667664625,356,2257
3353878603,3680841490,1652406008,1652406706,698,34
3397972687,3450628929,1649995545,1649996358,813,1565
3570429285,3630982131,1648209912,1648210617,705,261
3324395012,3688776786,1663018599,1663019328,729,306
3192836427,3785883615,1669415133,1669415601,468,1475
3530157274,3329848036,1659182016,1659182501,485,940
3688405055,3964636806,1649206387,1649206446,59,2204
3974804920,3546954605,1642150180,1642150639,459,62
3621379912,3927886349,1642654228,1642654264,36,941
3006738164,3176526207,1648360786,1648361579,793,1136
3149545838,3490415118,1659643983,1659644287,304,901
3812231046,3323834326,1656603641,1656603712,71,2065
3527164294,3394220993,1650696388,1650696782,394,2230
3798708209,3436888201,1658259647,1658259940,293,1427
3317411967,3556647439,1654506353,1654507353,1000,726
3760304580,3369175849,1658848156,1658848232,76,1903
3750698244,3337305693,1658050220,1658050412,192,1188
3932002704,3948695100,1655634121,1655634933,812,2359
3796198742,3170924487,1651667851,1651668315,464,1337
3992818695,3442477300,1642420594,1642420991,397,1736
3659204779,3728950700,1649647299,1649647540,241,1778
3559863065,3734534401,1667189139,1667189383,244,803
3898188404,3707070213,1654972474,1654973066,592,1364
3673950693,3814809809,1669090800,1669091753,953,1036
3442927979,3465064732,1657386232,1657386935,703,884
3250253670,3362395200,1648061366,1648061571,205,1288
3947369111,3678305236,1660940198,1660940856,658,2466
3073969560,3081803809,1664683954,1664684279,325,1575
3659771853,3449125023,1644715402,1644716275,873,87
3102027139,3489453670,1668181751,1668181761,10,1553
3256374123,3681489851,1665933443,1665934041,598,624
3646908383,3136200575,1657125734,1657126571,837,1997
3012845933,3734754514,1643847461,1643847979,518,2194
3879967963,3235825340,1665465705,1665466566,861,1473
3270919620,3702064029,1650762561,1650762708,147,2465
3109806852,3515856480,1667815325,1667815553,228,1702
3356144129,3440969146,1650160266,1650160524,258,100
3773196864,3113321914,1650388513,1650389495,982,618
3978720869,3879157400,1648838348,1648838963,615,2495
3994168332,3553048423,1657515513,1657515999,486,1480
3647539125,3063791472,1657225677,1657225687,10,2149
3112074335,3589366986,1658170854,1658170896,42,1843
3066546417,3027651085,1660916478,1660916805,327,353
3456433627,3935809720,1663698813,1663699135,322,674
3573915559,3072317138,1650588273,1650588394,121,1979
3555186812,3048361071,1668647804,1668648640,836,1051
3260246509,3129792187,1662500386,1662500850,464,723
3205543673,3978330638,1665316956,1665317362,406,216
3263403144,3913680174,1654585246,1654586045,799,926
3670709726,3823682564,1650130706,1650131057,351,1176
3045879019,3566825897,1662886149,1662886599,450,1568
3913071406,3938583443,1664353163,1664353332,169,110
3375847073,3390445291,1657064416,1657064781,365,1435
3346631744,3926815435,1661323400,1661323952,552,1783
3199717052,3879182220,1644725332,1644726097,765,2254
3356590035,3304490341,1656366589,1656367512,923,1610
3884802599,3284137438,1659204593,1659205469,876,2094
3222749852,3553939893,1648233996,1648234621,625,1826
3045302814,3380313835,1650112221,1650112941,720,1751
3317961564,3122246747,1657436534,1657436786,252,482
3878059612,3666338218,1661719920,1661720011,91,1739
3883257601,3227652803,1658935428,1658935589,161,1826
3109959336,3377457710,1664719771,1664720266,495,1215
3057314040,3993365296,1668229453,1668230155,702,1646
3784959270,3542153652,1650665621,1650665649,28,2077
3151386327,3810823450,1648517596,1648517954,358,1303
3697338181,3100716894,1646728853,1646729653,800,192
3040742963,3539866422,1651404192,1651404763,571,2174
3196009998,3844499309,1647723517,1647724448,931,1667
3896960517,3525261242,1658114462,1658114655,193,1356
3701151902,3410513846,1656531976,1656532694,718,2426
3536633962,3721977473,1649535801,1649535814,13,1542
3404904674,3852506516,1661023855,1661024719,864,2342
3515367610,3831346903,1655752534,1655752675,141,2124
3622596133,3457895283,1651489302,1651489438,136,1446
3897030063,3278038835,1647520020,1647520058,38,247
3397779824,3768846820,1657903329,1657903695,366,1992
3597904540,3699183333,1667911931,1667912204,273,2106
3866431229,3809458973,1648648462,1648649403,941,920
3509999399,3405799068,1665862035,1665862839,804,1923
3173788210,3247787797,1649615158,1649615473,315,138
3148366567,3853163109,1653196461,1653197112,651,29
3855063597,3947879014,1663642375,1663642488,113,952
3930591160,3900401259,1646565631,1646566498,867,1413
3629207282,3915637706,1644084015,1644084086,71,529
3915772795,3623115966,1655774844,1655775789,945,1353
3653850140,3994927164,1666472657,1666473443,786,711
3569578952,3906236028,1654079226,1654079677,451,1685
3567126985,3772910484,1646778871,1646779240,369,2082
3652898768,3282079727,1655768286,1655768695,409,909
3090506589,3287082352,1661494300,1661495029,729,2312
3594269515,3814608487,1655343499,1655343500,1,1476
3664381582,3395609056,1649257787,1649258770,983,788
3835784338,3293761762,1662722466,1662723052,586,544
3587727278,3530376538,1650235973,1650236415,442,143
3798714576,3463135439,1664594076,1664594781,705,1796
3949947697,3129792187,1652152314,1652153285,971,205
3679867888,3692498377,1666674327,1666675061,734,1831
3518179871,3775948778,1664895886,1664896472,586,1672
3793117012,3939768853,1668250911,1668251471,560,407
3832296106,3483553551,1643287683,1643287795,112,359
3797237179,3120984531,1658078694,1658079251,557,1644
3943413233,3502599631,1655446173,1655447151,978,2108
3533403208,3924167113,1658697258,1658697401,143,1583
3368322774,3622984488,1654845539,1654845995,456,657
3197282936,3389546736,1641184193,1641184611,418,2045
3948769271,3459188746,1646569021,1646569248,227,349
3017715856,3338882756,1649158386,1649159308,922,212
3106465076,3344549344,1647416352,1647417299,947,2295
3547483148,3083144170,1666350231,1666351041,810,596
3790996735,3551111997,1658818208,1658819168,960,1148
3243231806,3932002704,1668531811,1668532353,542,1412
3240249176,3347317107,1649467756,1649468382,626,1401
3573961768,3515550503,1664027009,1664027167,158,1324
3115928790,3425720812,1648218924,1648219126,202,2075
3813854723,3414748923,1664203744,1664203867,123,614
3698156103,3823942349,1667327516,1667327888,372,73
3993756491,3401738714,1651328724,1651329304,580,2284
3310512172,3661976391,1669248419,1669248421,2,682
3790635482,3690539115,1654502789,1654503247,458,302
3254866960,3524109178,1646773238,1646774186,948,620
3412109130,3083791573,1647629306,1647629887,581,123
3296066748,3848936636,1667345754,1667346115,361,808
3831770571,3358194777,1650656608,1650657405,797,1521
3752297066,3634735892,1642510364,1642511341,977,1027
3531820891,3512720372,1652403225,1652404185,960,624
3294703062,3833987128,1656751436,1656752157,721,1013
3495858842,3914796719,1665095030,1665095436,406,406
3391056146,3532569602,1661518585,1661518646,61,555
3294635633,3974065082,1657031395,1657032258,863,1005
3470286872,3882329817,1650561470,1650562017,547,362
3218869856,3452564658,1648677436,1648677498,62,424
3678305236,3532063469,1665248092,1665248351,259,632
3549671217,3532450192,1653156111,1653156222,111,1920
3239578622,3103215750,1655508074,1655508161,87,1807
3586489382,3065530519,1648881933,1648882403,470,2469
3527201198,3948577391,1663423560,1663423821,261,1305
3177491349,3420298161,1648190962,1648191505,543,2191
3981846169,3189038779,1648887545,1648888188,643,2427
3514218549,3931677547,1648127804,1648128518,714,1174
3179855785,3256374123,1645022129,1645022173,44,1040
3252843201,3126455934,1661707880,1661708816,936,881
3169394495,3341300979,1642497479,1642498290,811,538
3050607996,3839688715,1648021246,1648021573,327,78
3868116298,3418662987,1653114614,1653115224,610,1347
3027064938,3566257032,1663937116,1663937587,471,867
3048896097,3391622565,1664835204,1664835737,533,868
3922358932,3474975781,1649276222,1649276706,484,101
3032018734,3455808094,1653754618,1653755192,574,740
3600334566,3902705203,1669650361,1669650507,146,1773
3759472039,3414930462,1647940535,1647940854,319,1119
3070395663,3977699882,1663870960,1663871434,474,1652
3415686543,3171214894,1654435975,1654436885,910,2051
3616173127,3297963936,1666925488,1666926473,985,1487
3366410496,3686944200,1649521270,1649521453,183,1882
3570955260,3046127876,1652434978,1652435103,125,698
3253436330,3406042920,1658499154,1658499630,476,403
3621379912,3701537998,1647144789,1647145143,354,312
3041296119,3303025505,1645990572,1645990811,239,2295
3526239660,3057028614,1654808375,1654808484,109,839
3124384203,3141048645,1641940258,1641940343,85,454
3752858965,3439799907,1665052112,1665052441,329,728
3744002702,3708101315,1657742798,1657743291,493,2028
3657115450,3994383813,1644156194,1644156850,656,465
3282231108,3364600825,1642825452,1642825912,460,2468
3176432386,3372471333,1652413351,1652414256,905,48
3454753343,3086950119,1663313626,1663314570,944,2443
3557751532,3022916032,1650394711,1650395680,969,447
3474742534,3682006274,1651411118,1651411315,197,1230
3714897535,3766196716,1656029511,1656030011,500,683
3357478199,3204081712,1657569861,1657570278,417,717
3515044837,3915175620,1649497434,1649498345,911,1045
3556450605,3772749656,1657162194,1657163093,899,1212
3802816973,3018946311,1659468539,1659468611,72,2241
3548670552,3095221133,1647926375,1647926693,318,600
3515845767,3972052329,1666351589,1666351621,32,390
3882415224,3823206701,1666486153,1666486896,743,556
3159645889,3301901497,1660639570,1660640489,919,1978
3334965309,3636960130,1649501869,1649502173,304,2307
3147089920,3458335460,1659645717,1659646042,325,1829
3424562136,3035476619,1667911118,1667911449,331,1519
3643132014,3527291464,1642880355,1642881259,904,935
3967425379,3421645346,1668030738,1668031162,424,1604
3790180006,3534450842,1664640146,1664641133,987,1067
3534133715,3257821708,1650417243,1650418170,927,379
3122288373,3534218813,1659873386,1659874300,914,292
3000650426,3551771231,1651900722,1651901477,755,1629
3014392598,3467215587,1655434318,1655434387,69,2388
3408048729,3510281371,1649545086,1649545799,713,1576
3183299670,3203691315,1652696598,1652697059,461,919
3526218972,3325334543,1653821441,1653821847,406,1594
3358968371,3351691261,1643623671,1643624462,791,1463
3358571434,3695161514,1653403881,1653404840,959,114
3760535935,3152176779,1647127274,1647128216,942,665
3708777992,3199717052,1664695864,1664696627,763,1890
3383179408,3757370089,1647128130,1647128348,218,2052
3990233750,3445647826,1668497358,1668497679,321,1716
3460704532,3084592361,1642595252,1642596066,814,622
3351803423,3661705197,1660159285,1660159951,666,265
3047372637,3867640062,1642623513,1642623654,141,526
3868215944,3489225147,1648360213,1648360232,19,2313
3463135439,3169688960,1661942609,1661943547,938,200
3816194055,3355266666,1649023313,1649023855,542,358
3630966486,3778675824,1648779457,1648780208,751,2006
3153541916,3532569602,1644582089,1644582438,349,397
3731828976,3137412000,1642284738,1642285140,402,1647
3959497834,3959093613,1650957673,1650957707,34,60
3243873593,3604755020,1659834817,1659835501,684,412
3644127860,3836762535,1646912538,1646913332,794,1279
3266991557,3642498039,1664185046,1664185283,237,2224
3845131231,3853448159,1655039469,1655040252,783,1554
3782377691,3086530794,1648661388,1648662350,962,896
3275298041,3207013037,1644959944,1644960508,564,311
3834826280,3911671645,1643553180,1643553570,390,1452
3328922333,3917956140,1663356238,1663356882,644,1530
3623869570,3348234563,1650732531,1650733232,701,2202
3672482112,3385273825,1648768694,1648768922,228,798
3356144129,3390441234,1657045674,1657045684,10,188
3055169776,3489538095,1646159007,1646159882,875,1405
3463875425,3347942747,1666222099,1666222991,892,1360
3499787925,3636621583,1662802087,1662802738,651,1480
3956500972,3703548595,1663445763,1663445798,35,1911
3804748811,3126778118,1650968382,1650968997,615,882
3644334498,3890181496,1644313397,1644313489,92,2272
3912106632,3939973483,1651238283,1651238502,219,285
3371026826,3137412000,1644313788,1644314246,458,2047
3936468941,3042034210,1658826816,1658827396,580,1323
3011593291,3247590827,1653175518,1653176010,492,1891
3183672525,3225857817,1656419917,1656420541,624,278
3219265850,3038630181,1669633804,1669633860,56,41
3206386504,3316485303,1666368525,1666369037,512,1423
3604596822,3677674125,1655734229,1655735193,964,877
3264079501,3423298470,1667077472,1667078271,799,2031
3761218329,3149181988,1666028689,1666029402,713,2373
3714259747,3649660430,1669301681,1669302258,577,85
3849910709,3516743828,1648692838,1648693339,501,397
3723957807,3899788381,1655221648,1655222039,391,1603
3901736828,3136174856,1663402937,1663403846,909,1205
3198999623,3315056551,1650070270,1650071058,788,2205
3143962586,3086530794,1648361840,1648361985,145,278
3094361527,3112859411,1667656815,1667657006,191,2222
3662507847,3079905449,1660772189,1660772351,162,2209
3271314900,3219181477,1642803687,1642804282,595,1122
3641983006,3387311534,1657553060,1657553801,741,926
3495420849,3934326645,1660770786,1660771644,858,122
3241549340,3616429615,1652205483,1652206305,822,2118
3512631937,3546006441,1650187628,1650187852,224,1868
3825645806,3867868879,1660769987,1660770270,283,2286
3887564578,3547429967,1658713049,1658713980,931,984
3603131487,3546824914,1647545624,1647546330,706,986
3052376951,3499787925,1654915331,1654915336,5,1755
3268225181,3509582460,1667370018,1667370541,523,1132
3295518987,3143620816,1649823951,1649824694,743,1373
3951216492,3258399411,1659560880,1659561028,148,2167
3726883867,3035803277,1659574205,1659574935,730,291
3952185527,3546284533,1663544776,1663544827,51,485
3700419429,3927273567,1663083343,1663084013,670,609
3096076350,3725042810,1660130642,1660130906,264,252
3893829650,3295402408,1669538466,1669539402,936,2005
3347942747,3249554278,1644979707,1644980146,439,1807
3891400237,3437665905,1665423980,1665424552,572,1626
3179547560,3465229825,1655854470,1655855134,664,1324
3461505923,3115177011,1662030413,1662030477,64,1040
3275649997,3772792062,1644820171,1644820315,144,1216
3314872000,3213115605,1657504593,1657504839,246,143
3782730026,3468803992,1642462634,1642463578,944,1066
3914926954,3302917137,1661368445,1661369093,648,158
3160544934,3088155289,1660456102,1660457045,943,1444
3677306151,3629225227,1668883223,1668883719,496,2188
3343543154,3011593291,1661175556,1661175669,113,2141
3162524259,3354574342,1650761728,1650762673,945,406
3196009998,3520385284,1669466685,1669467415,730,2428
3611657912,3164410972,1667429281,1667430238,957,2188
3038832798,3450806791,1649738432,1649738641,209,368
3671869525,3109465057,1642916151,1642916792,641,779
3836535079,3642318884,1650832834,1650832993,159,1833
3618545572,3342315965,1643209396,1643209662,266,844
3709665583,3653069495,1656686995,1656687934,939,2478
3696359426,3790964737,1651881953,1651882426,473,2226
3933450798,3183867254,1657097431,1657097788,357,898
3558492617,3030641135,1659088330,1659088990,660,1155
3580330506,3981657344,1662816520,1662817499,979,102
3811337280,3998850502,1664153566,1664154156,590,2009
3686240080,3320767438,1651451836,1651452683,847,93
3670267009,3175976694,1652707311,1652707519,208,710
3506090868,3952670371,1662431757,1662432412,655,796
3625869317,3706560099,1655813563,1655814347,784,1156
3250584606,3911439857,1659468938,1659469121,183,735
3703534908,3711059561,1667780859,1667781573,714,1723
3286466102,3264339209,1650693446,1650694079,633,1758
3617715231,3842738399,1642552462,1642552489,27,2158
3388004574,3368294774,1647756222,1647756381,159,1584
3902543996,3955750752,1662040651,1662041613,962,691
3917984429,3193344217,1668713622,1668714490,868,948
3268745445,3037786726,1667426988,1667427821,833,686
3832072924,3232141615,1647602941,1647603834,893,1561
3217719618,3880476189,1650910819,1650911162,343,1652
3124063685,3257187145,1658982366,1658983252,886,951
3941266037,3603965318,1644909476,1644910050,574,2172
3762890946,3571766829,1664154482,1664155177,695,697
3596179079,3759668586,1661368195,1661369046,851,1670
3121651540,3125314664,1647991347,1647991954,607,870
3320488617,3854184537,1649632652,1649633316,664,1459
3505322684,3695558824,1659098549,1659098944,395,654
3404959548,3802614854,1649889512,1649889628,116,752
3979203926,3647539125,1642203595,1642204246,651,416
3482826953,3995270744,1654918219,1654918970,751,337
3185985712,3106465076,1668624651,1668625065,414,345
3473728186,3413369567,1662272435,1662273158,723,508
3957695947,3420266147,1660932276,1660933100,824,1482
3340511048,3470482542,1652309364,1652309505,141,1455
3709681519,3565083183,1649789891,1649790436,545,147
3467933841,3054803754,1668862652,1668863626,974,120
3004160380,3855537172,1653071254,1653071646,392,2059
3526815452,3128248749,1653606647,1653606884,237,1853
3767409219,3693453006,1641348885,1641349222,337,1308
3178235505,3603096793,1664281044,1664281946,902,1546
3875748779,3832072924,1646881610,1646881834,224,2413
3961672171,3583585259,1665515572,1665515895,323,2243
3572325072,3456386287,1661278333,1661278779,446,1083
3123795999,3336535934,1657011953,1657012673,720,390
3207801201,3071602516,1665098984,1665099626,642,564
3101669976,3981019442,1662341756,1662342666,910,1255
3748360490,3208464777,1647866248,1647866902,654,1460
3877483900,3379285136,1668492892,1668493615,723,1947
3197693984,3546943801,1648745116,1648745656,540,384
3211015636,3214969929,1642120149,1642120846,697,2457
3875343154,3614741796,1645877468,1645878230,762,1187
3677893619,3865847882,1642586368,1642586494,126,2079
3487387362,3196304056,1650302886,1650303192,306,345
3442593383,3798223043,1667120691,1667121574,883,1905
3410972917,3158962971,1641435227,1641435662,435,1938
3194204306,3196822601,1646544342,1646544522,180,1130
3098891437,3676634608,1649152707,1649152735,28,267
3108427765,3952283751,1657723827,1657724733,906,866
3526061797,3295262122,1644977749,1644978362,613,1326
3876097800,3804749299,1662964340,1662964909,569,409
3539364028,3988935369,1662659800,1662660223,423,2124
3282839568,3208490048,1647583098,1647583989,891,1245
3200795190,3777684793,1646847693,1646848474,781,2426
3723944830,3215040043,1650567235,1650567579,344,1571
3870032753,3770948247,1659876482,1659877262,780,1662
3748478851,3922728266,1641336858,1641337561,703,1917
3287175350,3293339453,1644160493,1644160650,157,166
3661016961,3547758342,1646980911,1646981595,684,1205
3034643506,3232497890,1663485595,1663486566,971,1708
3041385548,3195504067,1666881197,1666881676,479,1923
3294783182,3605316405,1669734884,1669735656,772,561
3665668423,3898188404,1644830460,1644830807,347,1247
3723944830,3739555068,1652031581,1652031581,0,949
3249554278,3701103798,1660371549,1660372006,457,1608
3546284533,3935259918,1661508102,1661508561,459,729
3445743049,3453143238,1659302091,1659303001,910,1557
3801579775,3037867406,1666938593,1666938767,174,1258
3722078855,3280668606,1665819701,1665819764,63,1494
3215423327,3156331863,1651170730,1651171215,485,1869
3276666399,3403223215,1651182541,1651183471,930,1942
3878177076,3387568587,1658181489,1658182037,548,967
3358156140,3807478002,1648272365,1648273017,652,925
3080325374,3458389447,1667137054,1667137726,672,22
3438756008,3344143432,1663571130,1663571683,553,1749
3826573375,3668677061,1650673929,1650674459,530,945
3630982131,3775501779,1654463831,1654464448,617,1656
3900241568,3499182342,1646144324,1646144771,447,78
3431498601,3755228064,1650416576,1650417527,951,1445
3134425396,3711048943,1665687834,1665688300,466,2206
3438474821,3070984953,1645764902,1645765020,118,1528
3526747987,3046640828,1641058196,1641058771,575,294
3667414511,3447555067,1665293636,1665294171,535,2228
3753483202,3164789962,1666887358,1666887826,468,334
3843078363,3307067721,1641043209,1641043737,528,321
3360575138,3272623699,1646948992,1646949886,894,1894
3223518905,3228110844,1661961633,1661961853,220,2190
3502599631,3762816561,1642702650,1642703476,826,950
3252157235,3051903509,1647822447,1647822811,364,55
3270395343,3013457125,1642443585,1642444282,697,1255
3201213219,3580594125,1662924131,1662925036,905,1023
3405749286,3382526428,1657050198,1657051001,803,73
3593967802,3558539337,1649792351,1649792440,89,4
3447926518,3901360663,1644582044,1644582363,319,715
3229080104,3743682237,1649654731,1649654964,233,591
3886158471,3446652020,1658784643,1658785001,358,2398
3587171844,3894382679,1651362797,1651363172,375,2100
3848963466,3576315042,1645298787,1645299304,517,1055
3398412701,3734099449,1669226826,1669227086,260,2301
3314872000,3862829462,1646834216,1646834572,356,308
3677539420,3267151775,1665517579,1665518296,717,624
3090731052,3077683954,1663845885,1663846142,257,1180
3965863452,3661642309,1647697643,1647698338,695,2244
3149668198,3102332016,1668042494,1668043409,915,1990
3933845116,3219899577,1648625393,1648626254,861,1522
3426017820,3463135439,1645535853,1645536222,369,826
3923692475,3698633384,1651349380,1651350314,934,800
3790406016,3976453338,1661583588,1661584114,526,624
3928951547,3820254686,1645379253,1645379642,389,1372
3467686942,3666494756,1644156752,1644157497,745,2075
3046526062,3629412022,1648885409,1648885510,101,1117
3197693984,3661243199,1663146748,1663147559,811,1502
3510166785,3289017659,1646556303,1646556634,331,268
3133655192,3244997486,1658962248,1658962657,409,1371
3738571497,3983536056,1644037273,1644037379,106,102
3894359262,3311871585,1641303051,1641303424,373,67
3799776825,3755413351,1658611638,1658612542,904,989
3053026624,3852344377,1641028535,1641028815,280,403
3003641311,3878876305,1645715240,1645715985,745,1802
3866922475,3948310967,1644988424,1644988814,390,2309
3205554156,3482483232,1650481914,1650482486,572,2341
3654841867,3664989774,1641578715,1641579219,504,234
3166518187,3925690262,1659876379,1659876410,31,1563
3216667034,3596839317,1644110537,1644111479,942,2120
3209544947,3021492589,1643064140,1643064718,578,1097
3722323538,3274452346,1667572241,1667572469,228,1750
3857013729,3936179181,1657540982,1657541631,649,1000
3774958505,3416521015,1661873797,1661874492,695,2155
3947712728,3744759130,1648431807,1648432703,896,2317
3884256882,3796348557,1648029105,1648029785,680,1566
3073969560,3721977473,1652931005,1652931984,979,1883
3244763805,3681719344,1661340424,1661340693,269,1224
3893227652,3056267922,1663710738,1663710853,115,1041
3272912522,3073924620,1649745249,1649745320,71,2311
3106788261,3413781764,1654441084,1654441084,0,2466
3476903669,3236975783,1655153941,1655154889,948,1453
3133601374,3016568360,1644660921,1644660992,71,1426
3749619105,3491468798,1648003566,1648004112,546,934
3390532209,3558733181,1667970969,1667971076,107,1039
3555186812,3879520142,1645049463,1645050093,630,783
3304589206,3329825462,1652967001,1652967392,391,732
3771263439,3741344192,1662503876,1662504185,309,435
3624103484,3759787118,1647811215,1647811234,19,938
3376673600,3612642897,1651746570,1651747151,581,1337
3642318884,3548609816,1660714741,1660715152,411,1951
3662526382,3840155828,1666088241,1666089045,804,454
3303561746,3672371563,1661264912,1661265513,601,1373
3680429293,3092956442,1663456892,1663457415,523,1998
3258854274,3047477485,1651553716,1651554276,560,1808
3448135160,3125459736,1649240473,1649241199,726,1602
3768482482,3742145726,1668081115,1668081666,551,2252
3570050230,3158871377,1655380610,1655381228,618,984
3109702081,3381060534,1644755774,1644756201,427,1208
3132486699,3435698448,1653857432,1653857840,408,687
3641703512,3445469609,1646540420,1646540994,574,1038
3270111894,3071971535,1661096665,1661097098,433,2462
3692498377,3662355477,1650021971,1650022693,722,722
3898959510,3858052316,1666957172,1666957417,245,1630
3567614002,3432209746,1659718988,1659719954,966,698
3215423327,3869930031,1665927007,1665927208,201,1798
3929988329,3645860854,1651938181,1651938276,95,878
3872306673,3476820014,1660300222,1660300568,346,512
3931624174,3827851972,1656031353,1656031848,495,2071
3627981146,3713062516,1644944893,1644945051,158,103
3215040043,3562243381,1664198024,1664198907,883,544
3680255689,3404394014,1655596954,1655597935,981,1627
3284628242,3740102481,1645242442,1645243099,657,2328
3986963711,3118533471,1662021417,1662021536,119,257
3254083367,3446547180,1659211839,1659212460,621,1579
3656027442,3001794280,1668631106,1668631961,855,1219
3679141266,3637609349,1646787606,1646787676,70,1642
3574205549,3327311623,1662130263,1662130681,418,1241
3536118453,3747302768,1668908852,1668909162,310,1277
3156483651,3308454699,1641445363,1641446008,645,349
3145378445,3095594016,1658038488,1658039053,565,2402
3004964162,3731257404,1654226673,1654227336,663,1865
3652728312,3292172583,1658666485,1658666556,71,1256
3717334493,3738591594,1654684907,1654685736,829,2284
3081803809,3124964775,1662796709,1662797461,752,469
3917448920,3598841094,1643860515,1643861357,842,1720
3741929805,3143679923,1669090226,1669090605,379,1607
3917709571,3406042920,1662580955,1662581439,484,1414
3454297726,3313295291,1652320782,1652321610,828,1039
3954988798,3400542216,1657749427,1657749625,198,195
3582471153,3641911946,1663072549,1663072607,58,2098
3963547295,3365939940,1659607762,1659608075,313,978
3981379416,3993513856,1653156772,1653157309,537,2413
3516140957,3320841904,1655569748,1655569881,133,509
3186367687,3223917351,1668552575,1668553016,441,1984
3036801405,3401677898,1665235725,1665236008,283,2410
3578002057,3610480358,1661748951,1661749858,907,1266
3250926786,3277327180,1665364034,1665364378,344,1470
3213124781,3275494433,1668727937,1668728741,804,443
3541560120,3593967802,1653866896,1653867540,644,645
3516488694,3776944992,1663652232,1663652585,353,549
3854219185,3650367155,1662164372,1662164792,420,341
3022453107,3602238630,1652169620,1652170474,854,96
3136172164,3018756378,1654052249,1654052848,599,1968
3175478710,3420520626,1656142792,1656143750,958,55
3264753140,3398735443,1647439604,1647440540,936,1049
3890054358,3465433147,1655401058,1655401169,111,377
3447051833,3139882519,1654410928,1654411493,565,583
3113938510,3051642574,1659339829,1659340601,772,995
3564296836,3312805786,1656397787,1656398627,840,55
3932803365,3058789362,1664890721,1664891420,699,1636
3340511048,3050434345,1665518633,1665519478,845,2165
3947369111,3874913687,1657668983,1657669039,56,2339
3283211870,3564198089,1652704717,1652705094,377,1699
3101669976,3019572992,1665015021,1665015470,449,619
3891053268,3106371588,1665208653,1665208654,1,584
3096475097,3599551667,1641495170,1641495353,183,765
3574957979,3233823273,1660602859,1660603385,526,778
3345410681,3513169935,1643290058,1643290889,831,1583
3896982954,3374174584,1648387803,1648388800,997,2161
3105299236,3034159032,1662703905,1662704166,261,49
3247163175,3240839516,1652533872,1652534829,957,475
3185611253,3546034581,1655655220,1655656067,847,1053
3327795374,3443131930,1657506572,1657507211,639,1829
3748360490,3854859043,1641664146,1641664859,713,1113
3297826818,3885926991,1646892845,1646893652,807,1326
3252421501,3439827305,1660596400,1660597226,826,1150
3574240169,3949771162,1655824002,1655824979,977,408
3346484497,3130434426,1641245956,1641246176,220,2115
3198195956,3649774117,1654332509,1654333435,926,2329
3300159475,3357034260,1662631301,1662631401,100,1701
3229321048,3980781580,1661471370,1661471822,452,469
3717406689,3559267449,1660152163,1660152708,545,1921
3242622170,3991673197,1641783800,1641784727,927,2231
3240839516,3810798932,1667895797,1667895938,141,197
3911439857,3052681277,1655386447,1655386736,289,1402
3164942448,3028780744,1651430853,1651431358,505,1546
3821594953,3945881377,1643645044,1643645759,715,331
3009365802,3319224567,1646444309,1646444988,679,2476
3682274097,3417049317,1642818044,1642818266,222,1893
3643382802,3040897601,1662728575,1662729135,560,352
3844499309,3150582711,1659448901,1659449697,796,875
3298676228,3828857457,1664391904,1664392398,494,321
3224800126,3276010368,1649633878,1649633890,12,471
3116281998,3046991819,1660287622,1660287783,161,162
3160242179,3836089663,1667837141,1667837358,217,1722
3795342940,3355195985,1655608157,1655608858,701,583
3844939526,3527995096,1656586643,1656587159,516,2026
3090057747,3719929552,1648791377,1648791576,199,576
3260695363,3263328793,1663955197,1663955604,407,1016
3256859026,3534910343,1650023633,1650023784,151,1800
3312661854,3590228003,1663686919,1663687219,300,1031
3285303154,3235245267,1644985897,1644986733,836,994
3743860568,3591264259,1653064527,1653065332,805,1941
3560756539,3087876190,1642170945,1642171734,789,2199
3880948714,3356499294,1645661544,1645661960,416,2019
3024611625,3255978821,1656267454,1656267594,140,2331
3250312962,3137350861,1649300603,1649300871,268,1592
3790407401,3985239597,1645094539,1645095412,873,124
3645778086,3505417530,1655695119,1655695128,9,814
3744234480,3021769525,1658967993,1658968849,856,1276
3142869544,3204333859,1651939813,1651940592,779,1155
3688056726,3400121632,1658274470,1658275053,583,1412
3495919793,3097475982,1646153947,1646154478,531,1274
3820885067,3547672806,1656100041,1656100307,266,2400
3411495833,3963787394,1642336977,1642337155,178,764
3311871585,3139376524,1655624004,1655624587,583,401
3371745136,3751600788,1647967303,1647967988,685,706
3173586762,3661559275,1669712543,1669713410,867,968
3987813210,3642339062,1662595533,1662596501,968,1018
3581083030,3038606123,1650688087,1650688613,526,2448
3978330638,3022388087,1650853525,1650854509,984,1776
3666782310,3210422873,1655467237,1655467376,139,1843
3014535209,3259039915,1655553856,1655554340,484,2300
3341890542,3460572652,1667315388,1667316145,757,1846
3842738399,3148284665,1654102927,1654103006,79,2343
3429074631,3053855376,1665825250,1665826144,894,543
3012930953,3788785252,1657333432,1657333834,402,1521
3855984822,3450503481,1662570394,1662570544,150,2355
3647597870,3330058679,1659554369,1659554965,596,2300
3882603510,3567703076,1642385814,1642386406,592,1263
3776862606,3547672806,1650558384,1650558717,333,1177
3513399148,3175295329,1646836404,1646836674,270,1982
3311252249,3854737938,1649686149,1649686577,428,1056
3283037458,3715231431,1655230050,1655230961,911,1919
3512575951,3561529281,1644973123,1644973233,110,6
3617453316,3573969593,1663201071,1663201735,664,1723
3095772004,3361016803,1659744441,1659745183,742,2156
3700896206,3085412399,1649267841,1649268608,767,760
3881956491,3428595992,1645649561,1645650120,559,2451
3964830238,3624188526,1648012040,1648012318,278,583
3508398331,3165208023,1646167040,1646167387,347,819
3562104036,3539303536,1643180076,1643180454,378,1163
3125019722,3223064733,1663235477,1663235843,366,777
3887290680,3282231108,1644571701,1644572652,951,790
3361016803,3309286736,1642965188,1642965678,490,2123
3100027110,3604596896,1641770508,1641771209,701,2321
3690646467,3177433990,1661094708,1661095430,722,2036
3354055639,3848936636,1662450311,1662450472,161,913
3991673197,3592264904,1647619335,1647619558,223,1533
3251808759,3730428171,1657363750,1657363941,191,2239
3671907089,3901616267,1667678886,1667679524,638,1599
3752653418,3841660750,1642356354,1642356949,595,880
3157821920,3218780941,1667680270,1667681264,994,2378
3622933919,3629942160,1664119891,1664119900,9,2158
3048788442,3341042744,1646291762,1646292147,385,1855
3888312656,3018756378,1666656701,1666656883,182,866
3937628057,3879898101,1648047195,1648047839,644,2446
3400163448,3046043182,1644252410,1644252869,459,1158
3808900684,3092360885,1669597434,1669597481,47,2475
3198338148,3964636806,1651971767,1651971869,102,2061
3930118877,3219575313,1645635136,1645635524,388,569
3475897333,3385246088,1651986925,1651987361,436,912
3501962027,3167716044,1668780916,1668781772,856,110
3478288963,3374603408,1663427174,1663427578,404,99
3689232908,3732585972,1666895250,1666895888,638,839
3524482926,3310951639,1654517053,1654517535,482,462
3969046292,3862854265,1654673435,1654674058,623,1344
3841660750,3408108471,1653865618,1653865946,328,2036
3924559198,3197466224,1646496917,1646497614,697,2114
3085429140,3133319209,1652285454,1652286250,796,337
3288441459,3233222399,1667504922,1667505540,618,2088
3213115605,3251409316,1668625119,1668625917,798,2063
3316625530,3953768846,1644330319,1644330758,439,2369
3391324219,3888834059,1641004928,1641005588,660,2088
3126038266,3906244265,1652113913,1652114779,866,226
3070984953,3818028118,1666801907,1666802178,271,1938
3075088680,3779192515,1644180072,1644180434,362,1329
3976757440,3511192827,1667714039,1667714493,454,1350
3263328793,3926699428,1647130289,1647131193,904,1605
3269502320,3774816472,1652343320,1652343804,484,2027
3861496190,3381398230,1654193729,1654194072,343,1134
3938615588,3922728266,1643774245,1643774995,750,2232
3155797946,3648305208,1654578428,1654578983,555,1088
3409352040,3587324906,1647405708,1647406122,414,431
3845338893,3714105777,1662471121,1662471184,63,1303
3961830711,3610056283,1644898388,1644898613,225,2238
3486061006,3229497695,1652529746,1652530201,455,464
3705601482,3757624193,1650752666,1650753196,530,1582
3678541527,3817960208,1669203567,1669203661,94,324
3843157491,3080007856,1647822687,1647823451,764,2457
3232781077,3879322451,1641982704,1641983239,535,54
3275810322,3880948714,1649095273,1649095628,355,735
3915494041,3728974462,1667593267,1667594031,764,1355
3521081470,3831660488,1643074413,1643074681,268,2009
3649447383,3647640857,1654354038,1654354430,392,909
3331295538,3871137970,1668439659,1668440651,992,663
3546605941,3089574886,1660715199,1660715286,87,1715
3815236635,3887586447,1664010469,1664010644,175,1368
3306871271,3966881800,1659200603,1659200993,390,2106
3366262960,3454062338,1658878905,1658879019,114,1915
3164550059,3506952427,1655112076,1655112285,209,406
3789314517,3547758342,1654240540,1654240843,303,1056
3457417743,3112074335,1652029941,1652030636,695,768
3734381035,3453431236,1669161217,1669161227,10,993
3597403559,3297963936,1652381359,1652381396,37,1576
3558312644,3787058440,1660971829,1660972811,982,759
3458389447,3467233007,1664963099,1664963810,711,776
3267650986,3885849262,1659278456,1659279439,983,1816
3239020709,3860745004,1668010497,1668010806,309,69
3997810649,3050800748,1655568185,1655568382,197,1565
3884798812,3927666827,1642862677,1642862842,165,1080
3929407612,3814899146,1649009117,1649009747,630,2301
3876344592,3038035861,1657050392,1657050711,319,1527
3702284586,3558232376,1648209188,1648210036,848,833
3008372630,3115236500,1652459744,1652460681,937,1850
3496369924,3089962675,1656345776,1656346727,951,1226
3763449384,3347397074,1654538482,1654538872,390,1265
3594795944,3817252660,1646400682,1646401264,582,1493
3817667121,3768814245,1659427892,1659428554,662,1994
3515161257,3592520398,1652929581,1652930310,729,559
3018013930,3199288675,1654924253,1654924598,345,1669
3623092479,3092564684,1659774736,1659775650,914,599
3625393284,3932786032,1649509809,1649509838,29,56
3218746999,3125436993,1663752478,1663752772,294,80
3001037251,3490435539,1667930164,1667930891,727,1800
3927660473,3740236087,1654965458,1654966007,549,2117
3810798932,3691830908,1658239978,1658240439,461,1548
3520872962,3985308319,1643469629,1643469662,33,281
3001803326,3205383513,1665106391,1665106550,159,2041
3406042920,3022388087,1642805733,1642806431,698,1258
3990109853,3563840007,1664363523,1664364249,726,191
3920261171,3194617168,1645146802,1645146988,186,958
3623736661,3460229906,1658562807,1658563161,354,2435
3986353377,3970288014,1650993102,1650993166,64,1593
3079038995,3443161524,1668267247,1668268064,817,601
3592596587,3367865740,1651848497,1651849305,808,238
3215870665,3797484306,1653060665,1653061410,745,619
3366822094,3084007689,1656796597,1656797200,603,2242
3740728884,3854995649,1643334040,1643334422,382,1319
3122293667,3865200739,1656015482,1656015504,22,1272
3347990376,3878573707,1666209594,1666210499,905,5
3205809646,3208770010,1658271193,1658272143,950,1651
3703825153,3035838196,1663974333,1663974774,441,759
3735946925,3328798665,1655199193,1655199619,426,2199
3036346251,3481672220,1662150909,1662151033,124,284
3961189789,3463003824,1647746822,1647747163,341,2388
3603786519,3036488445,1653680584,1653680761,177,2016
3870384331,3666931632,1657742339,1657742460,121,933
3968076690,3841672169,1668416687,1668417044,357,258
3037984397,3929407612,1646820136,1646820217,81,2314
3061362091,3760975208,1649179377,1649179942,565,860
3931229167,3480308437,1667431006,1667431454,448,1996
3905969199,3341591226,1647940673,1647941280,607,867
3355184225,3837877764,1667588163,1667588415,252,991
3866431229,3805665502,1666313646,1666314566,920,152
3046043182,3156189187,1662838145,1662838919,774,991
3408529019,3028841213,1655168355,1655168480,125,943
3373566394,3946911182,1661215743,1661216126,383,1280
3664273227,3316951862,1665687496,1665687941,445,1152
3772035177,3862138776,1644743709,1644744116,407,781
3707892765,3793344397,1666757308,1666757817,509,392
3415185806,3766193314,1642595214,1642595488,274,1953
3624060457,3695360424,1662900724,1662901043,319,2493
3960204629,3459188746,1648144282,1648144476,194,841
3610930903,3261128926,1659930153,1659930953,800,373
3535631980,3208464777,1648917620,1648918218,598,845
3319782337,3688196978,1643212382,1643213109,727,2106
3721110937,3927066139,1664236325,1664236790,465,1820
3454753343,3787333178,1656268479,1656269111,632,35
3866532806,3300983140,1647070587,1647071078,491,200
3772035177,3734754514,1643443340,1643443742,402,1271
3397940369,3046006152,1663924146,1663924805,659,305
3860745004,3133647753,1664711420,1664712165,745,1964
3785638958,3548145086,1652313291,1652313556,265,245
3139604406,3241444105,1653808975,1653809884,909,26
3162947685,3941903445,1642787590,1642788300,710,2347
3599299457,3692954946,1655118259,1655118997,738,1931
3252421501,3357029840,1652432512,1652432980,468,12
3681399132,3623974243,1656618469,1656618624,155,1453
3200827648,3616651934,1655520763,1655521430,667,566
3639117164,3709788465,1656907900,1656908731,831,1110
3236132865,3562547940,1660047638,1660047870,232,2499
3285757325,3373729748,1668275556,1668276254,698,982
3546859493,3938949913,1669308689,1669308939,250,2476
3034159032,3694244943,1663014327,1663015098,771,205
3335976452,3959228076,1667772421,1667772888,467,496
3683793217,3654922401,1665957203,1665957836,633,2407
3785256634,3599604382,1657365137,1657365847,710,2142
3164789962,3232781077,1665795480,1665796428,948,1935
3012917381,3273827707,1651300012,1651300898,886,1962
3602340127,3812239613,1649789494,1649789714,220,1246
3080829502,3364409507,1660513281,1660513377,96,2424
3287175350,3185469541,1667682926,1667683028,102,2349
3488757134,3023448006,1654595823,1654596378,555,2352
3270325529,3995850572,1643782831,1643782968,137,914
3835922991,3327873529,1645263926,1645264828,902,1772
3804749299,3375279811,1654477268,1654477839,571,2335
3211965606,3595713931,1652161328,1652161544,216,515
3168329235,3574460900,1661192198,1661192920,722,437
3949841652,3729325351,1641840719,1641841558,839,938
3175478710,3623869570,1668933315,1668933780,465,2207
3475835420,3430638959,1669675439,1669675912,473,2279
3838851134,3450535254,1661973009,1661973890,881,313
3963257683,3856985099,1641059864,1641060049,185,2062
3290359932,3911891369,1644882141,1644882728,587,929
3350783192,3636446257,1642742342,1642742596,254,479
3246159564,3639059199,1667071679,1667072170,491,1745
3899301205,3075288965,1668915492,1668915730,238,1600
3086575348,3885719823,1650023040,1650023069,29,47
3463540687,3109702081,1655844692,1655845388,696,2048
3086534991,3078231218,1666770690,1666771497,807,1408
3491272857,3711048943,1648002471,1648003047,576,1673
3597557082,3262543891,1668668472,1668669253,781,705
3315402916,3865282317,1657233848,1657234536,688,437
3624872846,3719884534,1660003108,1660003990,882,2300
3844964880,3347942747,1651398857,1651398976,119,1329
3804948415,3739338939,1654750602,1654750604,2,1324
3994168332,3047400344,1641164003,1641164821,818,1731
3070186247,3596500107,1658661466,1658662093,627,2386
3879967963,3250381378,1645290556,1645291239,683,715
3959408689,3011567148,1656284531,1656285116,585,181
3983113289,3208220195,1658134077,1658134929,852,2443
3683198772,3475612329,1667472613,1667473394,781,1945
3207210781,3842273000,1643091701,1643091817,116,248
3392293203,3727859047,1650035835,1650036672,837,210
3248096339,3096386556,1659684620,1659684671,51,1448
3257594028,3497911447,1669731788,1669732265,477,826
3308071201,3130993420,1654164092,1654164461,369,2195
3129993467,3592264904,1655425128,1655425330,202,1636
3211641180,3569686431,1653044139,1653044536,397,1713
3767581542,3564839908,1654939285,1654939621,336,2269
3052951476,3093387843,1665846452,1665846690,238,2221
3938417195,3797778150,1665169061,1665169506,445,185
3722220404,3598117343,1655087949,1655088526,577,1964
3708032127,3115029581,1657494534,1657495234,700,668
3855900879,3520523282,1649980220,1649980225,5,649
3745248673,3253913009,1659070371,1659070688,317,704
3655250241,3726883867,1646440419,1646440658,239,1217
3638233110,3750069283,1665857032,1665857428,396,885
3272250396,3625651694,1654044884,1654045044,160,111
3155320608,3794408677,1658676724,1658676958,234,1275
3657340310,3746979257,1650331058,1650331927,869,207
3449395269,3428325312,1669144906,1669145835,929,2269
3527221438,3521160717,1641514756,1641515699,943,618
3858225831,3197545162,1669479282,1669479475,193,943
3108805085,3239575265,1654947767,1654948715,948,1411
3210422873,3815718297,1664006795,1664007312,517,1755
3944247629,3536903033,1663153034,1663153697,663,296
3943413233,3151938386,1663972671,1663973331,660,1269
3788819111,3313975664,1655480451,1655481240,789,621
3817252660,3021338974,1656467279,1656468232,953,1531
3399334455,3828342380,1646642442,1646642528,86,859
3449504551,3482933937,1664572301,1664572573,272,2204
3854184537,3170740142,1659400542,1659400760,218,1543
3167494570,3506273643,1669311388,1669311514,126,1762
3216657133,3630123918,1668635158,1668635307,149,947
3020683788,3719785520,1645508672,1645509193,521,436
3922341165,3941548978,1656949942,1656950745,803,306
3434608050,3950763153,1645095516,1645095814,298,1827
3268349855,3696437293,1668361050,1668361444,394,590
3619704547,3765504986,1652960846,1652961392,546,938
3963370859,3585218766,1664832277,1664832547,270,1339
3068296722,3160071792,1654959559,1654959747,188,1825
3006738164,3993076833,1665303607,1665303676,69,2008
3662935617,3943947223,1645528725,1645528880,155,21
3439700326,3641959079,1655984703,1655985103,400,883
3310882037,3564592902,1664107304,1664107823,519,2477
3277926691,3364059276,1653634043,1653634557,514,1238
3115494713,3822736402,1668702940,1668703891,951,2028
3444668733,3368204842,1648557893,1648558634,741,2285
3206197726,3984533628,1647820051,1647820503,452,1798
3801107936,3580330506,1662138299,1662139207,908,78
3689375835,3885194706,1656879874,1656880287,413,38
3013247537,3996978717,1642829205,1642829829,624,1490
3624484272,3752133167,1660816563,1660817514,951,654
3133902865,3080829502,1662461828,1662461838,10,920
3894175918,3120737114,1668509218,1668509941,723,373
3547672806,3191414403,1657145646,1657146337,691,1629
3487778655,3199797181,1654092102,1654092332,230,259
3708034201,3957411858,1666876242,1666877190,948,2275
3089613411,3962031345,1646315488,1646315807,319,1558
3792708367,3934848520,1662417787,1662417967,180,939
3909292537,3964738114,1668684445,1668685053,608,457
3223917351,3310512172,1648245749,1648245798,49,844
3712443558,3901459563,1658480330,1658480598,268,183
3243831128,3200059644,1652210021,1652210287,266,1712
3468682335,3856467502,1643392346,1643392882,536,1790
3016299339,3122624322,1658619734,1658620612,878,439
3043153412,3797484306,1668989797,1668989846,49,2128
3264673951,3017715856,1643421669,1643422068,399,2448
3907635993,3058606856,1651812198,1651812515,317,837
3257034858,3618352797,1656781123,1656781694,571,254
3164410972,3627981146,1643515604,1643516111,507,93
3365676412,3938370016,1669499500,1669500011,511,660
3858052316,3445647826,1666943689,1666943691,2,1277
3315182095,3229497695,1648515424,1648515935,511,1499
3554409625,3827954829,1646369467,1646370403,936,2214
3972294801,3746155501,1648741837,1648742216,379,704
3558539337,3203128336,1653492541,1653492691,150,52
3569006301,3141635102,1646800724,1646801356,632,223
3196704660,3252421501,1666959901,1666960200,299,1390
3306144283,3711100517,1642386858,1642387525,667,2060
3202625372,3556823098,1652383468,1652383961,493,2423
3567959060,3369356299,1656765949,1656766633,684,640
3558848518,3635697777,1648809901,1648810813,912,1913
3463405011,3663985085,1651114052,1651114771,719,2046
3105460297,3689375835,1657367201,1657367218,17,1667
3054659800,3349847682,1661270267,1661270612,345,975
3725903222,3904907996,1646744070,1646744230,160,706
3351361711,3035464149,1663799594,1663800021,427,70
3790180006,3827867076,1649459260,1649459664,404,831
3469783180,3480115115,1647612750,1647612810,60,1728
3170579908,3625504025,1664108417,1664108720,303,1086
3235049473,3346012606,1647493189,1647493807,618,1568
3286078112,3108230028,1646108613,1646108736,123,2409
3454448670,3822736402,1661116262,1661116896,634,1919
3101609490,3062464540,1645262454,1645263276,822,246
3877483900,3141997314,1657056693,1657057225,532,1156
3167716044,3571576669,1647586326,1647586609,283,2245
3240839516,3311244386,1654519969,1654520047,78,194
3460027343,3259039915,1668804077,1668804630,553,1166
3841672169,3489811088,1657075927,1657076702,775,24
3577798894,3879898101,1659495612,1659495679,67,1856
3469740343,3404945581,1667067741,1667068708,967,663
3848607936,3280372392,1659884310,1659884526,216,2376
3893709526,3833230225,1642312065,1642312916,851,1022
3867026366,3352005808,1662836568,1662837533,965,2103
3601690466,3378522829,1659208407,1659208713,306,2001
3939469152,3559301819,1644352326,1644353086,760,1633
3843331100,3716461226,1656326107,1656326929,822,2119
3889079063,3154309446,1665118762,1665118924,162,2123
3533898881,3697291064,1651714960,1651715391,431,1393
3695360424,3437309077,1667878228,1667878394,166,2449
3054979282,3362298218,1644460369,1644460827,458,1351
3048388831,3547923552,1662191989,1662192793,804,838
3540104512,3277883706,1649907460,1649908264,804,1639
3012119082,3856386170,1649003478,1649004319,841,779
3031209415,3952185527,1667651308,1667652253,945,877
3671147965,3989563375,1645820193,1645820662,469,2193
3553721378,3258854274,1659816850,1659817533,683,1728
3391540103,3184455727,1668482375,1668482859,484,2085
3771788181,3681719344,1661418266,1661418493,227,127
3106395050,3205359825,1663895477,1663896296,819,1785
3937445570,3053134032,1665471034,1665471512,478,1127
3880011397,3840962989,1654016143,1654016489,346,380
3284892894,3739453348,1664827057,1664827605,548,2001
3055644463,3526088150,1665165723,1665166131,408,392
3279239799,3581570568,1660281232,1660281266,34,2100
3880011397,3611139716,1648962858,1648963184,326,2385
3402259490,3660489961,1650974438,1650974927,489,929
3421728246,3335565751,1648661760,1648662269,509,543
3650199111,3760975208,1667928738,1667928958,220,1889
3465064732,3052822229,1645943348,1645944287,939,2093
3370771897,3541920859,1655792466,1655792470,4,1520
3617746688,3677574672,1660535551,1660535620,69,1513
3295146156,3010673027,1654216405,1654216784,379,1100
3043753185,3127616448,1651006266,1651007013,747,1905
3554778587,3393528919,1669626948,1669627362,414,2354
3891477592,3531842620,1669182191,1669182402,211,1351
3453511353,3451823359,1666709990,1666710865,875,2249
3270919620,3551111997,1650272202,1650272324,122,2041
3300694030,3476403398,1643931286,1643931797,511,1850
3535325513,3489225147,1651592132,1651592680,548,2024
3797930164,3534450842,1668088317,1668088649,332,1030
3346631744,3066168441,1650068334,1650068959,625,136
3107541952,3767249449,1662452667,1662453008,341,2238
3007686100,3294276727,1647345602,1647346133,531,1862
3445714649,3721340009,1650363411,1650363520,109,1595
3123999917,3247163175,1657016335,1657017062,727,157
3681631482,3944914500,1651811057,1651811883,826,2498
3034750166,3792834070,1654547460,1654547576,116,132
3598117343,3641455530,1658532564,1658533060,496,2424
3948969420,3736260750,1657363834,1657364356,522,912
3195598526,3334483625,1645585462,1645585980,518,303
3062423981,3982929088,1654944109,1654944826,717,1982
3046500774,3216171635,1648274849,1648275525,676,2005
3173535458,3748837929,1669638738,1669639253,515,35
3400000869,3776906254,1644400555,1644401317,762,1180
3774958505,3203734562,1644926281,1644927082,801,1393
3569478966,3022283384,1663348754,1663349126,372,2285
3962536480,3482268698,1652948601,1652948956,355,2154
3143962586,3004517047,1656268485,1656268862,377,2384
3948833001,3965585706,1642698650,1642698916,266,1606
3693102953,3280818938,1661687024,1661687097,73,863
3345138946,3336965818,1647413062,1647413415,353,379
3290844621,3447257561,1643145012,1643145346,334,544
3849977339,3507431231,1665838713,1665839248,535,2105
3685977300,3241021396,1667826325,1667826789,464,728
3954297181,3155835978,1644595360,1644595851,491,1353
3790829012,3035464149,1652350551,1652351037,486,2204
3199395221,3268446099,1643175948,1643176259,311,365
3129860388,3469524230,1668239647,1668240541,894,830
3894801934,3608893234,1656197013,1656197755,742,1984
3375404573,3830330372,1666536710,1666537460,750,154
3254227672,3866541862,1664766687,1664766799,112,1585
3639352799,3200116756,1644225156,1644225703,547,2112
3907705988,3623869570,1652160333,1652160937,604,1809
3114605564,3339962549,1660568853,1660569401,548,1773
3387170357,3199892178,1648275435,1648275453,18,600
3995358434,3962261300,1641453042,1641453908,866,2204
3352005808,3895861447,1661697082,1661697409,327,702
3361290885,3858876644,1641954776,1641955390,614,406
3863676573,3172293659,1649713648,1649713766,118,61
3182097979,3120505983,1659455162,1659455448,286,1942
3941783209,3237697952,1650289229,1650289672,443,2301
3470112947,3549475344,1641929934,1641930584,650,2331
3151346211,3074795505,1663314313,1663314483,170,97
3098955230,3369469616,1655552011,1655552501,490,1680
3074477991,3000165786,1653420134,1653421007,873,921
3668552386,3963995256,1657290535,1657291267,732,1787
3442354739,3431595099,1668761586,1668762437,851,734
3704818655,3537592483,1647562875,1647563170,295,1705
3108139225,3622984488,1655655553,1655655840,287,1911
3087333030,3920875021,1667017637,1667017662,25,218
3178732875,3821979869,1658188372,1658188625,253,587
3216665855,3991963732,1646279596,1646279651,55,2394
3798369315,3894382679,1647288275,1647289229,954,164
3895991710,3596500107,1656245702,1656246522,820,1794
3106705860,3011459628,1667453715,1667453720,5,686
3347152834,3271648296,1653942947,1653943626,679,2273
3797484306,3520943619,1645679757,1645680426,669,579
3214711870,3289330422,1668468535,1668468857,322,1241
3976095218,3746890721,1650822574,1650823518,944,2390
3867640062,3657340310,1648415641,1648415682,41,1215
3612649935,3547758342,1664796039,1664796256,217,155
3828485006,3172619193,1669382716,1669383368,652,1621
3140971443,3570423127,1648319597,1648320073,476,350
3273518390,3163552496,1655561284,1655561290,6,1330
3549549632,3368423726,1666333593,1666333652,59,905
3142313032,3118057575,1655054890,1655055174,284,2143
3192505750,3261477798,1664760708,1664760828,120,787
3742647803,3634010080,1659164595,1659165481,886,2021
3492376573,3981331110,1653026963,1653027798,835,1645
3251382188,3008062664,1669444985,1669445075,90,283
3881851624,3347646218,1662794206,1662794434,228,1928
3617324068,3181032246,1663881216,1663882112,896,1162
3808022912,3354479032,1645457403,1645458200,797,1963
3630614328,3489915638,1651616097,1651616817,720,1854
3179405209,3071341023,1645004836,1645005768,932,1848
3462825977,3469812263,1665967427,1665967752,325,1513
3891477592,3749897140,1642553819,1642553969,150,1802
3869618249,3594682644,1654121195,1654121367,172,2376
3963257683,3210913409,1661237533,1661238346,813,1297
3975663862,3914888679,1663176487,1663177244,757,114
3038424212,3941489594,1651929757,1651930389,632,1172
3013247537,3269690639,1641248964,1641249003,39,1745
3070241461,3588684575,1656050662,1656051536,874,256
3819468348,3331866261,1664041213,1664041935,722,790
3180252962,3875008839,1667888787,1667888843,56,608
3479087219,3067539427,1648766977,1648767410,433,233
3321074447,3722569299,1659319057,1659319485,428,1867
3064574238,3960494982,1651079360,1651080356,996,1410
3031827531,3671054235,1659458364,1659459230,866,1377
3933332705,3369731959,1663314591,1663315320,729,979
3431909978,3599551667,1644080862,1644081480,618,5
3916674515,3425815854,1646918051,1646918967,916,1326
3582076532,3965863452,1650816583,1650817575,992,1918
3506937925,3622230392,1648312339,1648312942,603,2382
3312580754,3335573495,1662451806,1662451994,188,271
3053005521,3284550954,1656544058,1656544886,828,1597
3731399462,3029956642,1664933450,1664934200,750,2432
3177762456,3003145369,1649426076,1649427066,990,2041
3202424407,3250584606,1666196281,1666197192,911,1540
3765617850,3690665509,1645374942,1645375871,929,807
3463734539,3117141664,1665157392,1665157501,109,2314
3819380768,3515480973,1665241044,1665241759,715,2482
3009365802,3034919553,1656426852,1656427097,245,1601
3287784262,3172310061,1669587806,1669588377,571,1420
3790406016,3991087724,1643667427,1643668199,772,506
3902739418,3972955608,1646519535,1646520426,891,311
3572594221,3868701805,1645836426,1645837129,703,1639
3811308890,3515460273,1666279832,1666280639,807,1716
3445422843,3377774902,1663256094,1663256748,654,83
3975504102,3988935369,1665192003,1665192865,862,47
3907635993,3143962586,1652617985,1652618569,584,1106
3807473345,3494746675,1655047625,1655048578,953,382
3684926586,3451167153,1661880269,1661881004,735,707
3807576323,3175929512,1657206909,1657207640,731,451
3382133724,3210913409,1647697677,1647698495,818,446
3254083367,3887409378,1649136130,1649136439,309,1144
3270914746,3637412110,1656628158,1656628171,13,235
3159525512,3534715157,1650165669,1650166343,674,1134
3784594026,3728224229,1642900397,1642901257,860,1537
3943836795,3757624193,1643735749,1643736201,452,2387
3727859047,3331335383,1643000259,1643000270,11,1607
3421505883,3173791920,1654078836,1654078999,163,317
3499481975,3708777992,1655161939,1655162790,851,2491
3343741687,3952389962,1654071100,1654071224,124,1273
3631424312,3526197227,1656463318,1656463868,550,1586
3609601814,3056501932,1663488636,1663489406,770,157
3671748544,3795990774,1644822452,1644823048,596,1538
3969178712,3895976556,1665848008,1665848602,594,1320
3821391381,3112217806,1669168857,1669169516,659,682
3680694926,3379259059,1648086976,1648087531,555,2233
3639659256,3964565126,1649863589,1649864293,704,1722
3129927926,3351843519,1662259967,1662260455,488,1154
3035838196,3834166808,1650997147,1650997646,499,1405
3804978604,3859164696,1653841360,1653841633,273,1692
3685977300,3041809783,1654716300,1654716426,126,1685
3445226012,3536128186,1654083046,1654083482,436,1899
3346948485,3912106632,1649693202,1649694143,941,1017
3820585135,3911849911,1651340802,1651341383,581,1720
3794524447,3456546904,1645800670,1645800966,296,2154
3272563093,3583591867,1668322081,1668322476,395,125
3223313152,3956491451,1656317181,1656317727,546,2132
3679867888,3913984749,1667363624,1667364480,856,1343
3643185661,3608597242,1645004532,1645005331,799,841
3026935493,3880196075,1648324697,1648325160,463,1444
3456546904,3852555743,1646814335,1646815188,853,139
3568614629,3134380066,1668216502,1668217493,991,887
3520571883,3209288149,1646291711,1646292026,315,1130
3670291498,3151697582,1643992985,1643993618,633,1708
3312888621,3247787797,1657583234,1657583522,288,2413
3136810446,3596454426,1658933531,1658934328,797,23
3262377052,3428482789,1645486721,1645487259,538,1022
3152555864,3445558523,1669508705,1669509309,604,554
3987431029,3163973134,1652505424,1652505698,274,75
3417298701,3870998298,1660348935,1660349693,758,2312
3501820222,3721751204,1665208688,1665209495,807,538
3393911160,3734099449,1652754240,1652754764,524,1363
3464653044,3583591867,1646552594,1646553140,546,1157
3909859344,3725465166,1653749812,1653749917,105,1237
3929497543,3563103144,1656330062,1656330493,431,312
3915336029,3691062084,1666379115,1666379647,532,462
3211064928,3630966486,1649079480,1649079833,353,1669
3139087074,3197661010,1668666220,1668666931,711,290
3123302108,3518864357,1663699673,1663700320,647,1134
3501287522,3403925711,1667467353,1667467535,182,2393
3325944344,3768814245,1642077619,1642078579,960,1392
3376552382,3505322684,1669697596,1669698210,614,225
3426753006,3471651838,1665675184,1665675443,259,191
3406042920,3962211697,1651127527,1651128211,684,361
3493040979,3719503327,1664262197,1664262393,196,703
3440598942,3424650360,1665335217,1665335975,758,1245
3608597242,3336525489,1653562247,1653562701,454,626
3499091436,3131331478,1667830092,1667830386,294,2010
3007087811,3617795950,1658131444,1658131690,246,294
3125479535,3504893701,1642067194,1642067306,112,1226
3423640116,3175478710,1654884655,1654884665,10,1525
3150551034,3845130884,1668197880,1668198184,304,223
3009835115,3068659940,1665871601,1665871905,304,1521
3666338218,3874913687,1653875693,1653875769,76,555
3114733025,3042838406,1653179295,1653179789,494,1435
3022348535,3276010368,1642770801,1642771014,213,806
3379076226,3536421569,1661741497,1661741732,235,2206
3746229411,3823802882,1663902133,1663902409,276,1986
3880608911,3669299007,1646398972,1646399287,315,238
3425282516,3764298989,1655506761,1655507504,743,1967
3030286864,3627730665,1666744074,1666744108,34,1520
3247959785,3237807880,1658467483,1658468175,692,528
3066007042,3952620083,1645469623,1645470519,896,181
3838823979,3647295073,1657425688,1657426623,935,1120
3507644528,3622485921,1657795671,1657796204,533,1970
3634492534,3572276937,1651710992,1651711414,422,2409
3253931464,3583985803,1651984487,1651984882,395,1629
3736885329,3304252236,1655284234,1655285220,986,670
3035946381,3093146280,1659439619,1659440545,926,2430
3819235768,3649442188,1641469117,1641469193,76,388
3549209951,3912858275,1658484022,1658484452,430,347
3635697777,3202187490,1660704490,1660704768,278,2045
3715994986,3487387362,1645794986,1645795365,379,1711
3567926021,3397779824,1651302442,1651303081,639,1794
3983610735,3175478710,1658378542,1658378867,325,1202
3206061644,3395236647,1664222121,1664222321,200,512
3668625909,3526491245,1645090700,1645091295,595,1504
3498989393,3158873070,1662338265,1662339215,950,355
3427860415,3663554395,1642976522,1642977289,767,910
3145045320,3046787822,1644270728,1644271110,382,1639
3466642935,3651110510,1669733795,1669733924,129,2315
3662040060,3045427279,1643013363,1643013934,571,2226
3992345499,3655566080,1656896474,1656896612,138,2348
3135134317,3854184537,1668832529,1668833090,561,81
3220577762,3033438220,1667314029,1667314274,245,1340
3691925367,3109806852,1655020780,1655021525,745,1703
3701196344,3342260000,1662706486,1662707107,621,1533
3939281989,3045570288,1658596252,1658597052,800,1827
3554089401,3580310329,1645402039,1645402416,377,1710
3406357109,3090441115,1651683205,1651684081,876,769
3439827305,3459115924,1648023832,1648024075,243,1599
3974318707,3560053389,1649115381,1649115952,571,472
3324455158,3988674966,1651901464,1651901839,375,729
3045427279,3817667121,1663506373,1663506496,123,321
3909330778,3153831709,1650054093,1650054656,563,349
3671637527,3732349114,1641048172,1641049160,988,1447
3228073924,3573961768,1651875332,1651876300,968,1622
3573939226,3896281957,1649902941,1649903295,354,116
3696947299,3081725518,1664560428,1664561398,970,2109
3597485446,3567906153,1653542190,1653542761,571,1701
3567906153,3780182766,1664994555,1664994737,182,132
3929975862,3554862003,1643233466,1643234015,549,688
3319422840,3622848449,1641037327,1641037376,49,1445
3537787770,3224792502,1645409682,1645409855,173,1422
3003972844,3592026567,1665628778,1665629202,424,2228
3456603950,3256615260,1661030014,1661030549,535,612
3672123230,3816493730,1647944049,1647944572,523,933
3253568318,3575277293,1665654123,1665655110,987,1340
3791406454,3796504737,1665437911,1665438831,920,892
3848740333,3446490643,1644558928,1644558999,71,2371
3505100409,3717926703,1658973738,1658974463,725,996
3899618702,3964524277,1643695313,1643696052,739,1003
3188726102,3636930993,1641798652,1641799546,894,865
3816863310,3951354982,1655190978,1655190983,5,1520
3288347905,3561037966,1652056891,1652057514,623,365
3490430582,3299536518,1641394408,1641395407,999,6
3821979869,3125314664,1647508665,1647509513,848,739
3494179125,3605706184,1666859770,1666859823,53,296
3753998489,3084334078,1660814162,1660814548,386,283
3862918742,3615262736,1649972451,1649973123,672,2247
3473055855,3350017208,1669233829,1669234217,388,634
3623936873,3507871733,1661304351,1661305178,827,1473
3855476133,3541579882,1662021186,1662021855,669,449
3501287522,3451285207,1666819393,1666819466,73,1504
3993066194,3896910823,1669722185,1669722586,401,2024
3122818832,3206399216,1646105746,1646105881,135,1246
3827122083,3920277028,1666353061,1666353663,602,2100
3471587065,3063714742,1667695316,1667695599,283,1480
3317241023,3546799061,1656594956,1656595345,389,2432
3550741990,3944914500,1661683818,1661684482,664,1767
3003617799,3557734825,1654445369,1654445620,251,2281
3883874845,3729914869,1666941003,1666941187,184,2200
3890218641,3033438220,1667734573,1667734645,72,650
3328148239,3012032774,1660367875,1660368703,828,1293
3835601308,3157496248,1656116505,1656117044,539,2025
3133030435,3645850762,1653811343,1653811918,575,1375
3095661578,3313975664,1663580117,1663580958,841,2205
3460704532,3048405710,1669401185,1669401292,107,1930
3821180393,3148259657,1649968059,1649968870,811,1353
3335040022,3069353793,1662107654,1662108190,536,1249
3783622486,3242406857,1643449835,1643450797,962,1824
3326882521,3298436959,1660434701,1660434790,89,794
3096386556,3512720372,1653107248,1653107733,485,1818
3349030618,3041385548,1662038907,1662039138,231,1004
3046085814,3386868280,1654331408,1654332021,613,803
3621462507,3122818832,1657608344,1657609012,668,1570
3838082378,3401582775,1647675454,1647675831,377,1202
3170102962,3371536214,1643279405,1643280196,791,1159
3703534908,3413984037,1658432559,1658433119,560,2091
3378168172,3448459810,1648315041,1648315306,265,47
3881002245,3660577882,1645692955,1645693501,546,2129
3848272906,3582060994,1658981268,1658981529,261,183
3118526217,3830850007,1647492928,1647493834,906,1146
3664426298,3811827366,1650824325,1650824903,578,712
3515837186,3637663893,1666421019,1666421857,838,95
3916557399,3436578278,1649826119,1649827118,999,1260
3166518187,3978690472,1665998157,1665998770,613,1317
3721571243,3356590035,1646971154,1646971611,457,1243
3489695411,3973264936,1664822288,1664822996,708,2387
3936607466,3922697372,1655329767,1655330506,739,318
3381821132,3505480563,1665227435,1665228303,868,2300
3331426472,3767453896,1659577850,1659578178,328,1251
3165129580,3314583046,1664588118,1664588654,536,1076
3600692380,3592453741,1666839447,1666840213,766,394
3247980767,3617795950,1643977790,1643978184,394,268
3004708023,3106395050,1655030892,1655031605,713,620
3374174584,3900309643,1668339542,1668340475,933,1738
3054171550,3868215944,1661997688,1661998182,494,1871
3082885404,3494746675,1650107815,1650107826,11,1094
3029956642,3653780780,1658006576,1658006796,220,744
3658113721,3143909362,1641003524,1641003925,401,1998
3399180008,3128449335,1659741607,1659742603,996,169
3401597507,3498314038,1665955347,1665955755,408,151
3671154785,3773408264,1653728939,1653729702,763,1844
3696096099,3059176048,1647831875,1647832767,892,2006
3023421632,3485801867,1654776269,1654777151,882,1927
3469462520,3407150254,1653839157,1653839607,450,455
3586770678,3670158499,1662616225,1662616631,406,1821
3456602518,3834011879,1662932224,1662932234,10,2421
3662578193,3820855275,1652362580,1652363554,974,469
3841318125,3466942824,1645433659,1645433838,179,1516
3708809295,3384200089,1646466280,1646466714,434,336
3584704567,3118518203,1668148106,1668148972,866,2156
3980283928,3021006721,1652441312,1652442281,969,2310
3938416139,3154139372,1647326076,1647326898,822,1431
3159562411,3778625091,1646818800,1646819198,398,2076
3823650698,3435340439,1658345125,1658345294,169,459
3578068647,3787048351,1659649438,1659649806,368,639
3167557703,3484634326,1664280867,1664281410,543,807
3156928973,3267045921,1666646063,1666646190,127,37
3942862085,3119036139,1644614151,1644614380,229,515
3913243283,3138001926,1651411341,1651411802,461,363
3715118659,3321346285,1663008108,1663008297,189,671
3300456889,3058725687,1654393377,1654394293,916,1581
3300694030,3811337280,1665501485,1665501621,136,2112
3769391036,3702965571,1667815041,1667815977,936,486
3533403208,3768211591,1666808754,1666808754,0,1287
3406953156,3204083684,1659354588,1659354965,377,18
3567906153,3924141950,1663602161,1663602525,364,1364
3273752842,3131753608,1663084727,1663084987,260,2078
3530806404,3870998298,1652572024,1652572339,315,1269
3129677855,3993332175,1660571239,1660571747,508,879
3137195290,3272535116,1647880921,1647881658,737,156
3432942151,3808397193,1651190144,1651190346,202,1107
3104303534,3985243519,1647247512,1647248497,985,177
3095743155,3107530825,1669062530,1669063379,849,2149
3921560605,3336336934,1667952309,1667953275,966,2266
3428593255,3785883615,1649741711,1649742469,758,1785
3273701051,3499541432,1641577870,1641578700,830,2450
3479608671,3463509445,1659159658,1659160147,489,286
3680100111,3885493402,1647823470,1647824371,901,93
3235245267,3093178960,1663736802,1663736866,64,1472
3526061797,3545067538,1656387898,1656388697,799,35
3719785520,3729299306,1647746083,1647746630,547,684
3532307372,3908209550,1646533198,1646533210,12,1291
3069225011,3540104512,1666688449,1666688928,479,1223
3549482615,3291324812,1665602581,1665602903,322,1278
3236819846,3095743155,1641801490,1641802035,545,2477
3456080836,3603702697,1658336043,1658336573,530,1304
3400121632,3999228111,1659961388,1659961782,394,2498
3316951862,3056982737,1646234094,1646234618,524,311
3149046961,3751694809,1655133135,1655133191,56,2431
3985617701,3832370690,1654625457,1654625836,379,1944
3154250720,3909292537,1647163488,1647163966,478,415
3146555014,3790883274,1641678019,1641678483,464,409
3938025728,3393606099,1653716240,1653716481,241,1425
3457341479,3089613411,1666787197,1666788062,865,963
3718375865,3781537659,1647326117,1647326918,801,1721
3595713931,3753180150,1650403776,1650404609,833,309
3049147900,3132210207,1643994782,1643994997,215,708
3903560788,3126499590,1661673222,1661673298,76,546
3044345094,3829971179,1654356983,1654357696,713,2379
3329496705,3375655129,1642439270,1642440165,895,106
3594682644,3710782213,1655595199,1655595962,763,1346
3348390759,3154823834,1661985334,1661986302,968,977
3500948971,3097426944,1643135132,1643135392,260,1692
3473037406,3342082281,1653180929,1653181190,261,860
3649036403,3641542734,1665983159,1665984088,929,292
3857434991,3304958701,1652957081,1652957438,357,795
3561573044,3479401831,1645048569,1645049278,709,1715
3383006906,3004624310,1660596255,1660596721,466,541
3633544934,3403512366,1654559430,1654559528,98,152
3265181921,3402880726,1651193713,1651194548,835,794
3092564684,3681719344,1645266310,1645266667,357,320
3096274177,3873840731,1657097931,1657098063,132,397
3990343743,3763385597,1654671291,1654671885,594,2443
3469583371,3169601604,1660169063,1660169193,130,317
3828890005,3900588986,1643881380,1643881387,7,1524
3886736668,3033159477,1650837656,1650838216,560,1434
3334965309,3659563225,1646827247,1646827256,9,912
3582076532,3668174777,1668557062,1668557407,345,416
3458116043,3843157491,1656598516,1656599341,825,1249
3890580849,3711059561,1664236552,1664236854,302,1614
3821979869,3854848967,1665005629,1665005858,229,2453
3351906355,3397376963,1659890455,1659890565,110,1208
3893601176,3330924198,1644143853,1644144850,997,1970
3600501749,3671437138,1664018845,1664019056,211,457
3049447132,3372442199,1662190350,1662190373,23,581
3097982496,3583029647,1651498420,1651499110,690,547
3630744403,3050229164,1654719942,1654720791,849,800
3929975862,3712630492,1650771483,1650772020,537,946
3280818938,3962773297,1665973808,1665974160,352,1522
3195629628,3526327974,1650919704,1650919985,281,2035
3215514672,3268225181,1646459121,1646459641,520,287
3361167735,3587727278,1652162281,1652163191,910,832
3336535934,3975198652,1644634690,1644635281,591,1444
3094418033,3527291464,1665262314,1665262693,379,489
3473394094,3536931244,1649778301,1649778394,93,1831
3106490071,3647210250,1656801842,1656801842,0,1014
3586025172,3986885276,1664904461,1664904774,313,1407
3379366812,3540279517,1648113853,1648113928,75,467
3428176980,3761147252,1654071757,1654072546,789,2023
3973050834,3899315309,1641941476,1641941742,266,541
3795264165,3149602037,1644822877,1644823473,596,796
3525192232,3908443461,1659441133,1659441825,692,765
3109941959,3048402049,1647999624,1647999813,189,1998
3714203425,3996381336,1661980550,1661981094,544,1194
3191811632,3382396122,1659925449,1659925911,462,1299
3876097800,3866222795,1648361222,1648361859,637,716
3913162487,3949771162,1662203653,1662204057,404,1408
3061594355,3611777140,1651280404,1651280966,562,1666
3769786489,3716415183,1649291038,1649291572,534,2381
3117816089,3153446106,1665598251,1665599054,803,2012
3439462043,3366155048,1649914509,1649915442,933,783
3744645350,3711576021,1664096457,1664097260,803,887
3839967647,3674037967,1669696010,1669696564,554,1830
3339480960,3549671217,1658411766,1658411846,80,1324
3899315309,3292782964,1669325579,1669325903,324,341
3062015697,3383754736,1664256084,1664256596,512,762
3682910702,3343249545,1650694964,1650694985,21,826
3168329235,3298676228,1652330644,1652330963,319,479
3355976871,3578974875,1660680502,1660680581,79,1970
3205162065,3795326002,1658729980,1658730035,55,128
3985037610,3855762650,1656593044,1656593981,937,894
3482576542,3129899259,1669606722,1669607408,686,2347
3995288261,3754706912,1654515298,1654515582,284,361
3477522732,3906964033,1654295425,1654295763,338,2285
3948695100,3375125376,1667326296,1667327034,738,1738
3159562411,3210071519,1661051090,1661051841,751,335
3049913617,3379613190,1650413033,1650413854,821,2237
3384794661,3182982515,1657700831,1657700919,88,745
3270395343,3037090215,1663058308,1663058674,366,2203
3586524207,3482166014,1652222033,1652222528,495,1757
3953118937,3554261399,1657500029,1657500655,626,132
3371745136,3657203747,1655119459,1655120163,704,2248
3950225483,3499281518,1641171134,1641171774,640,2264
3785728567,3880608911,1658479771,1658480275,504,1103
3529576659,3112742999,1657063102,1657063654,552,1306
3036527901,3971180079,1641102504,1641102972,468,2241
3657101592,3866222795,1667592249,1667593138,889,306
3319037937,3543257848,1652459594,1652459964,370,1786
3267089074,3827851972,1669263712,1669263761,49,2454
3059176048,3098955230,1641855936,1641856777,841,2404
3479738009,3327857419,1662148361,1662149014,653,1364
3319334426,3919792223,1669119468,1669119952,484,2497
3696947299,3712115076,1648402932,1648402991,59,463
3230277243,3603399306,1658970435,1658971229,794,1108
3666931632,3103421893,1668744482,1668745298,816,206
3823161778,3391898268,1648267699,1648268097,398,688
3721541321,3267360802,1642820905,1642821712,807,1909
3067641822,3240249176,1653022423,1653022978,555,2086
3094277549,3243873593,1661689054,1661689514,460,2407
3388490960,3942134694,1651406148,1651406328,180,755
3184178717,3489811088,1660627991,1660628310,319,59
3654381548,3911621945,1649209503,1649210139,636,2073
3965585706,3911290843,1666552529,1666553001,472,995
3683440211,3876888791,1650992575,1650993218,643,2214
3830015015,3736118442,1667966085,1667966606,521,1627
3924865492,3994130271,1646938663,1646938689,26,1181
3300203056,3118807144,1647831323,1647831586,263,96
3191632331,3623351962,1653530362,1653530943,581,1713
3122002940,3418635865,1654927302,1654927566,264,711
3879967963,3386846556,1654791102,1654791533,431,1664
3977317498,3304497399,1667947195,1667947446,251,2381
3437215040,3468803992,1652706535,1652707241,706,851
3055944630,3582046255,1664649201,1664650009,808,978
3794481759,3048328762,1661133651,1661134225,574,2131
3947229430,3550107804,1656037785,1656037915,130,1850
3118754726,3526797183,1667910245,1667910520,275,2162
3611353561,3834401696,1666296705,1666297172,467,1292
3777684793,3892206642,1657099382,1657099562,180,1711
3558492617,3957803611,1647896976,1647897720,744,800
3236308141,3335462055,1657394811,1657394930,119,949
3149545838,3451370887,1646952280,1646952349,69,43
3939281989,3710782213,1654738817,1654739410,593,534
3928852706,3033438220,1662558688,1662558768,80,1688
3831770571,3132207782,1647765363,1647766255,892,684
3543696190,3456603950,1658454265,1658454448,183,342
3915206176,3392569339,1656077810,1656078331,521,359
3003195362,3421728246,1664673234,1664673732,498,600
3051876837,3106490071,1648649605,1648649662,57,2335
3292010262,3448734872,1647662046,1647663043,997,1504
3255485773,3919489244,1658678703,1658679159,456,1352
3211521816,3118807144,1642102947,1642103211,264,2177
3407746149,3680453323,1646025695,1646026213,518,931
3985617701,3619126886,1669506547,1669507463,916,883
3365381632,3294094629,1662391182,1662391278,96,941
3707940691,3345458354,1641760326,1641760378,52,270
3309684706,3569525429,1665803325,1665803925,600,741
3982715838,3922925129,1646392912,1646393148,236,359
3353295219,3846007471,1652141838,1652142054,216,901
3833333678,3132592220,1660974847,1660975407,560,237
3586025172,3269573550,1655676318,1655676875,557,274
3655498745,3388218000,1661630881,1661631120,239,1406
3978893578,3963995256,1641316361,1641316377,16,1568
3565052722,3558139345,1649594754,1649594972,218,1514
3160135389,3474081200,1653450145,1653451077,932,1267
3584037261,3000986440,1667436552,1667437331,779,122
3912803496,3524466015,1644630793,1644631423,630,618
3956491451,3324618357,1653653107,1653653942,835,1032
3690539115,3656027442,1665769517,1665770505,988,1380
3018838603,3807440065,1659988114,1659988969,855,413
3947158263,3864044700,1661175726,1661176626,900,2433
3687938178,3511593307,1665973681,1665973907,226,17
3027129249,3311252249,1665191056,1665191363,307,301
3383110959,3985825297,1657664679,1657665216,537,752
3375290121,3734381035,1650017612,1650018277,665,153
3586950573,3038849431,1656774528,1656775355,827,354
3213836945,3003134699,1664817820,1664818115,295,1980
3934386586,3451206797,1654468991,1654469039,48,2425
3643372353,3693270664,1644218203,1644218991,788,1294
3282561101,3143689256,1665736347,1665736813,466,961
3587727278,3495691991,1660895702,1660896701,999,1659
3909765076,3121391240,1646616336,1646616479,143,2375
3091112554,3254262388,1669475140,1669476006,866,2176
3722945080,3072277927,1657172517,1657172692,175,1967
3403512366,3454851350,1644142086,1644142487,401,2069
3307067721,3678197665,1644951671,1644952373,702,369
3766160943,3860745004,1648658542,1648659333,791,10
3882415224,3233425442,1657748144,1657748968,824,1998
3340837702,3237987905,1648606062,1648606665,603,1030
3879257961,3924577071,1657866772,1657867182,410,1967
3240435560,3050867171,1652218618,1652219131,513,49
3721340009,3368630986,1647916105,1647916840,735,2491
3845801721,3392918310,1658740377,1658741290,913,2304
3450893865,3244071979,1643461506,1643462283,777,665
3070810251,3704498751,1648532235,1648532837,602,1372
3957824946,3905356323,1663401905,1663402616,711,528
3657340310,3175498635,1668420408,1668420812,404,2322
3375359100,3269573550,1665937679,1665938408,729,209
3898959510,3242406857,1641731228,1641731358,130,2273
3915986965,3456435173,1645189667,1645190260,593,239
3321202962,3301994647,1663885409,1663885837,428,2222
3059870015,3304282571,1660057013,1660057092,79,509
3373684030,3284840023,1658753460,1658753470,10,494
3625201370,3582046255,1645573617,1645574216,599,2145
3500097822,3894149054,1657369096,1657369429,333,1253
3804773972,3345875910,1661844819,1661845572,753,988
3671296032,3637292465,1659901343,1659901656,313,74
3689453273,3748478851,1669174359,1669174691,332,2313
3119345995,3814899146,1668769201,1668769609,408,2314
3884798812,3890194122,1641681928,1641682130,202,2014
3324455158,3557325531,1663822305,1663823262,957,2087
3275494433,3542293606,1664314199,1664314773,574,388
3986247608,3982644241,1645363292,1645363371,79,2054
3470404771,3098369438,1647769282,1647769380,98,1794
3797079865,3784105182,1650565024,1650566005,981,610
3714122939,3583585259,1663362618,1663362685,67,4
3095559156,3728224229,1662804495,1662804707,212,1823
3701979416,3358277498,1652000623,1652001361,738,1634
3156261740,3889705477,1659384113,1659384333,220,1886
3233282653,3672070606,1644983249,1644983482,233,1468
3032834107,3516624109,1652183310,1652184054,744,83
3051876837,3419117613,1651062861,1651063364,503,2495
3720248207,3013433465,1645723101,1645723365,264,800
3611286809,3241500636,1656946903,1656947398,495,563
3158894896,3776398060,1660429569,1660429619,50,1966
3408108471,3861499264,1646309380,1646310267,887,1131
3414606604,3414700083,1654947836,1654947971,135,2421
3606749014,3860879385,1649171243,1649171517,274,367
3360436723,3442293538,1663674199,1663675023,824,1910
3584910336,3844416504,1642485994,1642486826,832,1930
3654899608,3348006171,1650079068,1650079956,888,2461
3633856416,3398257086,1668180049,1668180115,66,2029
3612460883,3601499230,1646813460,1646814088,628,724
3980934555,3082912574,1647067148,1647068123,975,1998
3079516653,3618095446,1663633122,1663633804,682,217
3634624974,3594269515,1649116358,1649116658,300,1313
3282231108,3915772795,1641812600,1641813453,853,648
3515856480,3295850908,1649680908,1649681439,531,2183
3593861215,3724157579,1667660387,1667660805,418,385
3693797946,3261477798,1668110250,1668110324,74,2340
3933045461,3746351822,1650891325,1650891456,131,1031
3791406454,3315759953,1662784202,1662784943,741,128
3645523523,3997353499,1643305163,1643305935,772,2283
3423825173,3059447105,1669149350,1669149584,234,2408
3949841652,3620013325,1646776911,1646777583,672,923
3798509385,3542369467,1668067800,1668068606,806,1320
3404908537,3744788361,1647759777,1647759863,86,1351
3044854518,3925481419,1656147153,1656148037,884,701
3798527829,3948862720,1652462735,1652463284,549,90
3385264040,3963370859,1662922056,1662923004,948,2379
3591290407,3633830454,1661023468,1661023675,207,552
3461108375,3619309272,1649011152,1649011561,409,863
3331604266,3941528766,1654033361,1654033654,293,1761
3649442188,3798714576,1660010233,1660010491,258,2320
3759867623,3089962675,1664272033,1664272101,68,2251
3798369315,3381060534,1662464666,1662464795,129,198
3377855107,3713520914,1647126514,1647126982,468,202
3232333937,3339312980,1659313080,1659313677,597,1529
3681001652,3278612503,1656177642,1656178058,416,2488
3879325408,3336535934,1663869686,1663869788,102,718
3450806791,3887519119,1662685625,1662686092,467,1918
3745737102,3852184769,1663741989,1663742512,523,1385
3034040451,3402426323,1642661073,1642661251,178,1179
3897421758,3245491745,1666682444,1666682824,380,1639
3492909923,3583307819,1668956772,1668957427,655,1609
3570050230,3163551629,1647034152,1647034777,625,366
3993066194,3540550798,1668117727,1668118121,394,1965
3308877364,3097501233,1667536762,1667536890,128,745
3562875112,3543150979,1648345222,1648346026,804,718
3343279177,3587171844,1668234642,1668234643,1,992
3934988354,3437707461,1668465865,1668466787,922,2407
3435224460,3520943619,1644368606,1644369133,527,691
3812231046,3124222667,1657071000,1657071124,124,536
3278397100,3462072699,1662987406,1662987419,13,852
3469359731,3829597039,1658175485,1658175754,269,1780
3719273348,3807576323,1658551594,1658552348,754,2010
3407409307,3351786927,1659765695,1659766372,677,587
3935210171,3559267449,1649806835,1649807708,873,1822
3279239799,3384460816,1642122335,1642123256,921,1515
3008609242,3892800106,1659717913,1659718062,149,2037
3865503383,3765660727,1663284564,1663285235,671,802
3911619189,3944198123,1651636133,1651637009,876,811
3798563042,3348406323,1668535462,1668535580,118,2342
3768311968,3178981589,1659115211,1659115663,452,964
3595560993,3343033950,1653370467,1653371318,851,1033
3287082352,3970886019,1664005634,1664006578,944,991
3696448766,3938416139,1642560321,1642560955,634,1357
3853912096,3413898378,1665161533,1665162207,674,178
3220800349,3790329301,1642085705,1642086248,543,811
3458252541,3043180716,1648848030,1648848914,884,224
3400163448,3885719823,1646038169,1646038747,578,1122
3525751984,3965164080,1658765238,1658765279,41,806
3188567155,3688133320,1659031170,1659031757,587,290
3916290714,3356765270,1655563540,1655564083,543,974
3200116756,3262864867,1651529542,1651529780,238,2070
3162405135,3508718004,1655888797,1655889101,304,1939
3087612913,3447555067,1659527508,1659527969,461,1533
3584910336,3321971009,1654334379,1654334496,117,596
3839200168,3154309446,1654708833,1654709110,277,1858
3571576669,3941528766,1657253158,1657253871,713,2303
3228366627,3597904540,1643324453,1643325194,741,964
3734893217,3382777450,1642672089,1642672557,468,663
3460504628,3012892515,1651528268,1651528993,725,2150
3344279346,3884949094,1664375357,1664375666,309,1332
3545214789,3274208430,1656493797,1656494202,405,932
3878698797,3666148943,1656457138,1656458098,960,862
3169898520,3708809295,1666558648,1666559011,363,142
3216657133,3295316821,1658787597,1658788514,917,1872
3335040022,3198240429,1645403045,1645403662,617,2350
3467613173,3634089207,1664901933,1664902037,104,810
3120056957,3026025743,1658976909,1658977386,477,1462
3651803323,3865239822,1643438639,1643439079,440,2480
3288490513,3626505512,1659941223,1659941830,607,1967
3739731580,3181236848,1665238928,1665239117,189,2456
3362796099,3546486600,1658892047,1658892223,176,1685
3676228617,3936914064,1644965805,1644966085,280,624
3579404607,3335565751,1658350994,1658351104,110,1098
3290176410,3165423009,1666246841,1666247209,368,1715
3999788546,3427127427,1643803667,1643804547,880,69
3252535116,3894382679,1645399639,1645400164,525,1517
3896789438,3231899706,1663706342,1663706394,52,1605
3241549340,3671789954,1667775546,1667775981,435,1031
3144993263,3448409263,1655546758,1655547518,760,853
3266828046,3690015481,1641026561,1641027479,918,1450
3150551034,3042052031,1641516546,1641516731,185,904
3532063469,3944476586,1661017794,1661018073,279,350
3848860153,3962536480,1659888700,1659889419,719,113
3735943539,3822213532,1645871182,1645872002,820,394
3946015739,3832144696,1644626936,1644627058,122,1261
3388971461,3563407459,1656546590,1656547028,438,1489
3506090868,3679939578,1643743228,1643744183,955,1017
3924583665,3543239972,1650068150,1650068317,167,1440
3348406323,3738981251,1665267747,1665268679,932,1744
3150730013,3314901091,1666666033,1666666666,633,148
3726367604,3641682706,1641566676,1641567536,860,812
3085851145,3957824946,1654682660,1654683378,718,1388
3860879385,3470482542,1658557348,1658558101,753,2191
3087333030,3732456028,1660504038,1660504323,285,783
3780182766,3738761840,1663934939,1663935731,792,356
3527869582,3733486808,1643948955,1643949650,695,2422
3010546611,3658113721,1641795841,1641796588,747,2402
3987567381,3657587705,1643021999,1643022170,171,845
3871321308,3442967650,1652211893,1652212525,632,2485
3705943924,3232285985,1648058253,1648059224,971,231
3314240169,3780014272,1652957495,1652958357,862,577
3346631744,3895422097,1649930606,1649931237,631,1838
3143226144,3309106486,1650253131,1650253905,774,2367
3174722772,3672482112,1662389945,1662390144,199,1517
3449915970,3046132590,1644984116,1644984659,543,65
3476820014,3357579618,1659276629,1659277362,733,1719
3739613077,3501786397,1654823803,1654823834,31,1315
3990379463,3063674428,1641693406,1641693781,375,2090
3656789430,3258739109,1664872159,1664872864,705,2090
3710786724,3535325513,1654634204,1654634378,174,921
3878698797,3743934334,1641992898,1641993227,329,2254
3676132016,3881942272,1652886603,1652886912,309,1623
3829597039,3789727449,1650052466,1650052809,343,769
3967506765,3674005769,1666421480,1666421894,414,1490
3252790120,3847297747,1646540141,1646540257,116,118
3796784054,3533172784,1660601324,1660601752,428,1803
3788911315,3683038464,1665189400,1665189830,430,2206
3539303536,3167290048,1655860549,1655860645,96,310
3123458167,3394695318,1642930574,1642931090,516,243
3335242048,3861496190,1648312057,1648312443,386,95
3713520914,3871180604,1656818425,1656819024,599,2034
3324041559,3226451761,1661119212,1661119932,720,1489
3124562368,3250528764,1669506667,1669506703,36,1018
3442209140,3679939578,1668782707,1668783065,358,226
3716524134,3052822229,1641216461,1641217375,914,529
3886720244,3274208430,1667473913,1667474035,122,926
3348406323,3809965750,1663747420,1663748063,643,2080
3287714636,3945881377,1667009664,1667010551,887,389
3154435614,3570335491,1659757992,1659758947,955,1263
3094418033,3751022139,1648211879,1648212391,512,1769
3438130685,3520344153,1664084380,1664085243,863,2126
3478570785,3104210284,1657814120,1657814647,527,960
3296519089,3600977488,1659828498,1659829115,617,1537
3670063835,3461505923,1665257307,1665258132,825,146
3541560120,3492134379,1665563774,1665564486,712,2271
3790748869,3458116043,1658505596,1658505728,132,446
3670112572,3504911583,1665406668,1665407338,670,845
3773830646,3394220993,1667825523,1667826204,681,2418
3678404361,3983536056,1662750298,1662750533,235,218
3316952075,3657753711,1667783335,1667784312,977,2344
3183740417,3011225738,1652959706,1652960381,675,606
3011458038,3984461468,1655241864,1655242538,674,1985
3666174374,3275649997,1667867945,1667868154,209,1150
3146378665,3282425868,1664643594,1664644251,657,1210
3351087116,3014363081,1660743935,1660744754,819,1005
3819468348,3290176410,1645553042,1645553504,462,1013
3927388172,3574205549,1642319499,1642320028,529,1759
3555108136,3941512307,1669293827,1669294430,603,563
3308454699,3951845301,1663113243,1663114140,897,1340
3978690472,3956796805,1661157084,1661157739,655,752
3420266147,3450503481,1664515572,1664516228,656,780
3396406579,3382916211,1666577567,1666577783,216,969
3060633640,3682803273,1651494706,1651495095,389,1662
3809387134,3980971387,1669349526,1669349609,83,1138
3312805786,3586101932,1656018193,1656018817,624,771
3040037607,3857590396,1657498899,1657499543,644,1920
3408108471,3831683294,1651184394,1651185030,636,1771
3346631744,3322287315,1667026355,1667026712,357,1787
3769944434,3683326795,1665659093,1665659104,11,940
3135951344,3882983178,1668092196,1668093145,949,1376
3867026366,3959504618,1649836185,1649836885,700,992
3995299995,3804094924,1646498344,1646498350,6,1699
3811730419,3006508919,1650138152,1650138779,627,1714
3240324089,3615666134,1660637977,1660638727,750,212
3611657912,3013484024,1653606025,1653606557,532,2467
3029807207,3058750967,1648269149,1648269273,124,1644
3248250292,3439827305,1661468889,1661469880,991,2164
3283155844,3746050591,1668707155,1668707333,178,1145
3414700083,3390919111,1660509779,1660510721,942,2144
3697322167,3937429867,1641642895,1641643380,485,1275
3443385652,3163551629,1661902398,1661902914,516,2112
3063714742,3210536820,1648087045,1648087887,842,341
3202922076,3362388538,1663189860,1663190063,203,1710
3455040603,3947704522,1659563534,1659563906,372,2129
3016995357,3169601604,1653400162,1653400990,828,507
3232794733,3324473595,1651201148,1651202110,962,818
3585674939,3068723030,1659166031,1659166112,81,80
3351490739,3250926786,1641188956,1641189812,856,2070
3107982351,3269726483,1648567864,1648568079,215,809
3266991557,3975075818,1667061644,1667061713,69,2396
3802823421,3535575355,1643871155,1643871698,543,1845
3487030175,3823682564,1642842697,1642843650,953,904
3418364050,3014993252,1643624773,1643624917,144,2388
3569177433,3476882609,1653201461,1653202230,769,1908
3591724433,3749379310,1653082692,1653083624,932,2474
3014511835,3889840253,1642851164,1642851958,794,2016
3086575348,3344787204,1656005191,1656005566,375,429
3476903669,3467391664,1651288355,1651289026,671,2437
3153858233,3409949315,1654979649,1654980159,510,455
3945199219,3289693932,1641805554,1641805873,319,219
3349879521,3327795374,1667212096,1667212929,833,1195
3600901232,3323198594,1641869934,1641869981,47,1397
3147210428,3976970303,1663240594,1663240857,263,1382
3339349217,3562104036,1659216386,1659217035,649,1303
3974481828,3512502358,1661742645,1661742826,181,2060
3154729703,3208802379,1655477969,1655478198,229,961
3040528605,3695478448,1647608890,1647608910,20,1940
3939244771,3508809990,1659403470,1659403521,51,791
3764343778,3392105056,1666000731,1666001183,452,2257
3194618871,3917526154,1665961359,1665961639,280,425
3915439541,3445863766,1649841085,1649842047,962,1799
3553712893,3365939940,1654141685,1654141885,200,1133
3491306285,3563134874,1651934616,1651935068,452,1597
3390723607,3056982737,1642050705,1642051686,981,1591
3969435749,3030192990,1654037553,1654038129,576,2086
3910427189,3322656350,1649436197,1649436543,346,445
3250528764,3262203147,1652269535,1652269597,62,170
3431909978,3576862500,1643372059,1643372421,362,636
3697028552,3039972849,1667584988,1667585182,194,1627
3038067120,3072720499,1650105946,1650106899,953,1515
3573450428,3649465172,1668175738,1668176483,745,444
3057574793,3093716530,1642479811,1642480398,587,4
3429328367,3537107415,1662069994,1662070035,41,569
3343232841,3415888174,1664664817,1664664978,161,1884
3783064521,3937618865,1669399764,1669399963,199,212
3569401888,3052789625,1644570486,1644571231,745,2344
3887002610,3304087986,1657459915,1657460079,164,959
3066956305,3332056702,1661589292,1661590256,964,158
3420180743,3526088150,1657065664,1657065809,145,2389
3730920499,3913680174,1643973965,1643974915,950,1398
3681001652,3297123407,1662023898,1662023945,47,989
3478219461,3090103866,1661113297,1661113906,609,1490
3660162411,3007087811,1657597265,1657597875,610,348
3983694493,3833594316,1648800673,1648800696,23,1490
3160061122,3817513264,1660422624,1660423583,959,1830
3471463543,3862102577,1651031518,1651031743,225,447
3769767823,3061366261,1649807790,1649808405,615,370
3408396410,3221685249,1649507384,1649507995,611,2026
3299607426,3294319716,1649454033,1649454450,417,313
3613021322,3100535469,1645290490,1645290895,405,180
3131156982,3091072272,1649562062,1649562159,97,1367
3210080881,3557556781,1656604007,1656604602,595,743
3319224567,3188588023,1650468782,1650468920,138,2382
3335565751,3952389962,1658657931,1658658088,157,1734
3633382140,3518932161,1663347007,1663347879,872,2258
3110691442,3921560605,1650907172,1650908153,981,66
3986003303,3134890095,1665178870,1665179229,359,1002
3686025670,3833618667,1658945196,1658945359,163,1169
3745532894,3195451932,1647310671,1647311300,629,1638
3300983140,3656158144,1647820199,1647820582,383,1729
3586101932,3367279073,1649815933,1649816266,333,273
3905581902,3813290629,1662070900,1662071723,823,2149
3022102664,3267248595,1645324823,1645325143,320,1721
3437259542,3514218549,1661567367,1661567794,427,1507
3972424804,3191632331,1649278895,1649279310,415,303
3776954666,3287210562,1665438388,1665438729,341,506
3227310314,3435319506,1656245584,1656246113,529,532
3613801852,3340933137,1662234721,1662234944,223,1237
3345186165,3589984222,1667487504,1667488309,805,514
3319224567,3562021711,1666314956,1666315242,286,374
3692441467,3529898997,1642393905,1642394679,774,315
3173909495,3121651540,1669639213,1669640002,789,2048
3711442352,3436768933,1645357530,1645358182,652,1497
3975405530,3505272067,1644752029,1644752727,698,1109
3980108258,3217384934,1663352671,1663353020,349,1256
3839454838,3362249024,1653880016,1653880510,494,362
3968564476,3574773588,1650283310,1650283708,398,1197
3146378665,3513180024,1646352713,1646353150,437,906
3186483050,3623020544,1667841694,1667842421,727,1680
3274588728,3722972444,1647371948,1647372362,414,1013
3200116756,3765962960,1643505328,1643506059,731,932
3532270724,3784629786,1660896947,1660897879,932,178
3325288212,3377457710,1657714202,1657714997,795,1930
3213397142,3410865372,1661987199,1661987215,16,133
3702755503,3972649318,1650049978,1650050730,752,1163
3204346356,3952425376,1646072479,1646072614,135,2099
3073332785,3623685885,1662667230,1662667943,713,530
3656789430,3204336699,1647189773,1647190413,640,1392
3734533600,3090588645,1665822721,1665823710,989,864
3932786032,3289108426,1658177649,1658177844,195,173
3240452269,3228073924,1656155528,1656155964,436,158
3207309302,3556197400,1653695582,1653696225,643,1177
3148366567,3307305290,1658262826,1658262984,158,182
3928020650,3477522732,1665799488,1665799695,207,385
3003972844,3098513510,1669369009,1669369941,932,698
3738359725,3562859716,1645398487,1645398756,269,2426
3192612662,3708032127,1654774041,1654774135,94,532
3062410888,3597794683,1669071658,1669072377,719,277
3960450011,3501786397,1667581884,1667582252,368,464
3153902371,3894193367,1653136759,1653137243,484,519
3013457125,3228805720,1657004217,1657004504,287,2051
3831770571,3363902315,1656546545,1656546858,313,1872
3642946322,3233823273,1651356131,1651356249,118,396
3210913409,3644100988,1648402146,1648402858,712,1411
3131735006,3397910828,1647112924,1647113734,810,712
3938417195,3154435614,1655035525,1655036313,788,725
3307225202,3319583055,1655172524,1655172863,339,1335
3929774793,3486541605,1648642167,1648643021,854,1431
3010819705,3106276005,1665332568,1665332593,25,2429
3356689959,3221276652,1661135650,1661136433,783,2262
3252961062,3693862073,1658954249,1658954706,457,1105
3821312248,3607608267,1660718959,1660719035,76,633
3795794957,3474808421,1654179895,1654179911,16,2380
3216540367,3946815972,1659935472,1659935821,349,427
3142106289,3150817357,1662988205,1662988609,404,2193
3534223960,3926467866,1665737219,1665737387,168,2098
3841108033,3821049069,1651492426,1651492518,92,1430
3730270448,3468682335,1649022969,1649023578,609,1760
3716257088,3384222838,1655945150,1655945538,388,1659
3735081666,3976817467,1652610470,1652610806,336,868
3832438123,3886780901,1643546093,1643547065,972,2012
3704437148,3593967802,1655324235,1655325155,920,909
3601690466,3683793217,1654630690,1654631203,513,2477
3127403665,3405749286,1666939158,1666939623,465,2313
3571477883,3561899633,1643763875,1643764255,380,655
3997162156,3552305242,1645633226,1645633685,459,77
3604762599,3572325072,1661439596,1661440520,924,328
3397910828,3945055663,1667353558,1667354256,698,2434
3364600825,3845334081,1645588711,1645588719,8,1009
3122624322,3438553592,1658945366,1658946115,749,1558
3211047702,3312336013,1660283167,1660283433,266,1491
3283171763,3991686619,1668097390,1668098165,775,143
3209288149,3210071519,1647092164,1647092292,128,1787
3106788261,3927952722,1662731771,1662732338,567,1565
3889840253,3623092479,1659823946,1659824217,271,102
3223459561,3428595992,1661162241,1661162611,370,76
3237563954,3150503842,1656731921,1656732180,259,1532
3569600936,3972441567,1644166526,1644166851,325,2364
3593988999,3979696807,1657771770,1657772155,385,164
3612778107,3994007098,1659015512,1659016430,918,131
3721977473,3454851350,1663180586,1663181084,498,2276
3104793032,3192940759,1649928033,1649929024,991,2249
3463875425,3977078930,1648085502,1648085518,16,302
3887409378,3443785253,1646015821,1646015920,99,1717
3294703062,3547334414,1664202474,1664203154,680,1874
3092118254,3407778626,1660437153,1660437645,492,2367
3294635633,3633544934,1643377048,1643377692,644,1906
3739420445,3095170532,1641321948,1641322788,840,2148
3072599295,3327427782,1652366073,1652366523,450,1818
3802749978,3260802289,1648515766,1648516363,597,2480
3186787984,3636930993,1643258804,1643259312,508,1816
3537107415,3890821469,1665367888,1665368425,537,2490
3093254727,3546290525,1662066368,1662066450,82,28
3896091695,3204963755,1651429765,1651430039,274,1097
3454276568,3333665805,1663484751,1663484897,146,1258
3370350588,3247980767,1643442640,1643442944,304,559
3957798687,3175118084,1659380973,1659381505,532,85
3832703867,3261403182,1645985127,1645985537,410,889
3210071519,3630966486,1644161122,1644162030,908,1080
3790783685,3438188875,1662849280,1662849712,432,657
3699152541,3927657297,1666028059,1666028343,284,1430
3280491285,3489453670,1646994574,1646994779,205,544
3991340294,3647539125,1651605820,1651606519,699,445
3177951035,3055211808,1666163028,1666163955,927,2397
3923137418,3035635016,1655858794,1655859682,888,1536
3220424979,3606111278,1649844128,1649844856,728,2498
3319782337,3729389785,1645679726,1645679931,205,1605
3864143186,3977107209,1642987922,1642988811,889,1237
3736681866,3232469999,1667109225,1667109789,564,2278
3258854274,3469879706,1663176639,1663177251,612,1176
3037301537,3385846184,1654625271,1654625276,5,2359
3744788361,3617545187,1668671445,1668672409,964,1469
3030174879,3706027798,1649430615,1649431083,468,1564
3293339453,3804145408,1664607719,1664608468,749,1369
3929925771,3581026789,1667972353,1667972395,42,309
3176252124,3392121294,1654267983,1654268695,712,1818
3624103484,3302992244,1647789687,1647790366,679,444
3654899608,3045127324,1659513284,1659514253,969,1211
3329825235,3790180006,1668119282,1668120121,839,1705
3651271289,3952252601,1657668214,1657668618,404,1210
3526315797,3865239822,1649221120,1649221849,729,342
3744147238,3237563954,1652120860,1652121693,833,1560
3482509515,3398508681,1641924332,1641924909,577,916
3947788644,3194617168,1641167238,1641168072,834,2452
3693028654,3895274115,1665295956,1665296451,495,295
3696856656,3015876104,1652275774,1652276001,227,297
3037048394,3573915559,1668962097,1668962115,18,54
3138539283,3331539245,1657502663,1657503250,587,1770
3136174856,3231501792,1656492206,1656492309,103,1758
3603092087,3818508802,1659233315,1659233548,233,2284
3388814364,3241847877,1662292029,1662292546,517,2131
3887743057,3508858140,1659780960,1659781693,733,600
3276771725,3407778626,1644901148,1644901607,459,647
3718182841,3762856505,1666774288,1666775078,790,535
3163202728,3313295291,1665329576,1665330204,628,593
3768984387,3928212115,1652454604,1652455394,790,1860
3483254795,3742344076,1662041811,1662042779,968,1150
3692247556,3338376656,1656897628,1656898428,800,1271
3745419810,3377798373,1654888287,1654889144,857,2395
3146529279,3690646467,1642165839,1642166244,405,726
3015593061,3103871966,1647188608,1647189367,759,1978
3348113823,3901360663,1652333561,1652334234,673,462
3404317985,3114812192,1641013774,1641014194,420,175
3935740815,3537443088,1665729398,1665729812,414,1980
3279773317,3366192341,1668683372,1668684251,879,292
3639117164,3960494982,1660739854,1660740605,751,1512
3792117640,3135951344,1648159412,1648160146,734,302
3556823098,3649774117,1667081219,1667082186,967,571
3627981146,3706797905,1652152746,1652153185,439,2269
3989550849,3714535860,1663716088,1663716639,551,2460
3712581685,3593553797,1668357284,1668358096,812,1845
3876127195,3993332175,1641946226,1641947159,933,682
3761587047,3315854812,1665142386,1665142851,465,1756
3847104925,3615359439,1663377011,1663377925,914,1081
3778381574,3621000186,1657377204,1657377505,301,1614
3145045320,3518202698,1643528731,1643529454,723,1276
3149135097,3676893681,1655076793,1655077386,593,2176
3563407459,3312344118,1666681511,1666682448,937,1719
3922358932,3548128446,1658821937,1658822811,874,2016
3153750267,3010819705,1663635436,1663636020,584,183
3407909365,3793966136,1655142576,1655143225,649,1093
3217137285,3202187490,1641848716,1641849042,326,220
3127549843,3986631065,1664155863,1664156313,450,1685
3363651899,3615897427,1654767708,1654768200,492,382
3996993457,3154158203,1655218578,1655219256,678,294
3357474960,3416521015,1657848175,1657848993,818,952
3957216784,3150551034,1666300481,1666300575,94,918
3157155319,3462543040,1665801483,1665801615,132,2006
3276618988,3176252124,1649353391,1649353704,313,87
3313292041,3334298803,1643409722,1643409899,177,2352
3785657136,3700968228,1668213657,1668214477,820,234
3472706088,3099546139,1648010659,1648011528,869,690
3849977339,3745737102,1651423129,1651423163,34,1300
3431614426,3150793263,1664558724,1664558997,273,517
3202881162,3242948145,1648094611,1648094768,157,2359
3401382792,3332458882,1658596672,1658596953,281,569
3365939940,3735286926,1641971473,1641972325,852,1261
3411128747,3801736024,1655787183,1655787289,106,161
3472855930,3707258240,1646649337,1646650294,957,1396
3414277030,3953655387,1660906305,1660906768,463,973
3242622170,3409055122,1662790445,1662791059,614,826
3125378100,3836565798,1655500709,1655500860,151,518
3165039316,3447926518,1668121677,1668122155,478,615
3936980618,3983490056,1643925383,1643925714,331,1243
3792834070,3663871563,1668393902,1668394003,101,1231
3797769846,3462280366,1661564710,1661565188,478,2211
3121651540,3080200257,1668127840,1668128014,174,2338
3335573495,3069992620,1656894356,1656894770,414,689
3854357910,3325735498,1652778152,1652778825,673,268
3694210631,3190969092,1651226660,1651227068,408,1056
3474259908,3225616352,1641435666,1641435971,305,2451
3770061469,3231537700,1641646057,1641646414,357,293
3007702341,3529576659,1656402824,1656403688,864,128
3318345517,3639804787,1649782189,1649782561,372,850
3141392063,3451749535,1644623505,1644624314,809,245
3740376361,3751780241,1667236857,1667237042,185,1046
3095559156,3994651874,1643263353,1643264274,921,856
3153391276,3274159957,1662884661,1662885266,605,289
3391426421,3689303525,1648377374,1648378112,738,133
3456433627,3390329949,1666359657,1666360508,851,1328
3080007856,3990343743,1667865804,1667866758,954,1782
3739406554,3297826818,1667410752,1667411028,276,2321
3625950355,3510318605,1663385608,1663385618,10,1228
3048721189,3649660430,1652033845,1652033976,131,2214
3937729247,3070640991,1642367180,1642367576,396,956
3046500774,3124363805,1644626655,1644627050,395,2448
3797930164,3611025093,1643997976,1643998231,255,1820
3671907089,3708754161,1658980226,1658980393,167,578
3286463125,3423028100,1657819188,1657819621,433,1170
3906145952,3853256957,1661970758,1661970903,145,1376
3600725106,3615897427,1661539018,1661539214,196,2302
3909859344,3822213532,1662644585,1662645040,455,1695
3478921948,3984050382,1659547934,1659548533,599,986
3956547336,3143226144,1656558416,1656559107,691,213
3680804477,3153541916,1642851604,1642852081,477,1144
3239162274,3855777399,1652174886,1652175006,120,1523
3455808094,3706605056,1644205866,1644205967,101,484
3422374987,3933742178,1652301327,1652301381,54,867
3064961160,3686424169,1656172535,1656172993,458,1052
3103743198,3237224664,1641645991,1641646068,77,131
3478741068,3729914869,1669010311,1669010756,445,1733
3809010705,3278038835,1644768902,1644769090,188,138
3688133320,3975504102,1669459979,1669460022,43,2264
3744347272,3403024728,1660281487,1660282042,555,1637
3188162412,3698025795,1653911908,1653912505,597,885
3541920859,3884878006,1659083591,1659084317,726,406
3177879837,3785657136,1665615588,1665616172,584,2365
3707578213,3593988999,1647509111,1647509237,126,2442
3154680228,3761775611,1658586304,1658586559,255,2083
3804824307,3315321131,1667306448,1667306658,210,864
3561692706,3704871253,1646542252,1646543005,753,1657
3478741068,3172352127,1654182562,1654183458,896,1569
3199892178,3664267954,1658762997,1658763199,202,491
3629824081,3118976994,1647984280,1647984848,568,1657
3590243603,3927646653,1649040015,1649040298,283,1556
3825173498,3799624292,1652360675,1652361566,891,1937
3083182515,3572896327,1641315762,1641316157,395,1078
3410613004,3170325894,1656852890,1656853064,174,734
3747929255,3957430800,1645457523,1645458510,987,1197
3811930283,3471707938,1650369191,1650369533,342,1829
3714575918,3235155985,1641040753,1641041452,699,123
3569686431,3907665331,1654064656,1654065554,898,73
3604514331,3362091170,1641254055,1641254211,156,1341
3419430775,3142274869,1663919804,1663920372,568,1765
3759867623,3851864688,1654412788,1654413727,939,1772
3639819433,3334171572,1662008582,1662009019,437,2218
3883497013,3626345917,1662528759,1662529005,246,1147
3319601888,3350566867,1657045780,1657046299,519,1729
3018149057,3661559275,1647769840,1647770442,602,1801
3271919876,3686424169,1653772456,1653773050,594,1285
3953258545,3530495336,1655841759,1655842285,526,382
3200897172,3662289637,1662157644,1662158612,968,1718
3748478851,3979899306,1654034341,1654035278,937,194
3746969288,3574285791,1668780466,1668781196,730,2383
3694127985,3499841500,1657343098,1657343516,418,1903
3507338655,3395307809,1658556827,1658557802,975,1502
3916226073,3359901981,1657439508,1657439586,78,1153
3362812887,3655498745,1658574333,1658575051,718,628
3518607253,3371536214,1656255027,1656255882,855,1265
3786924052,3604852600,1641531711,1641532701,990,2219
3389812297,3802694367,1666459052,1666459231,179,1266
3626672801,3831426674,1645579131,1645579157,26,1640
3649252503,3525442421,1659250710,1659251587,877,395
3774823325,3672751607,1641952973,1641953579,606,1080
3086076310,3713231806,1658070400,1658070756,356,817
3928810650,3362972722,1654153238,1654153308,70,1744
3294984880,3626552836,1641381599,1641382529,930,1516
3389443435,3854848967,1650582743,1650583175,432,675
3485695895,3094596605,1641857501,1641858495,994,1659
3554832209,3855777399,1656876828,1656877154,326,522
3664242822,3202745117,1642006216,1642007186,970,1812
3459090367,3620236387,1656799957,1656800741,784,627
3673735088,3046617108,1668069241,1668070206,965,303
3450102071,3985308319,1669750671,1669750955,284,675
3268225181,3336376139,1646092282,1646093191,909,2406
3884750087,3280372392,1650940326,1650940912,586,350
3242948145,3965629952,1651474229,1651474679,450,1047
3336551797,3274452346,1669160826,1669161167,341,2384
3816170686,3320435078,1666693554,1666694155,601,957
3029758309,3306515955,1669461720,1669461972,252,2449
3424621981,3420489464,1644056011,1644056637,626,1132
3552282443,3762525964,1649732000,1649732123,123,1687
3164550059,3319128889,1660169781,1660170414,633,1830
3266991557,3363944559,1649858679,1649859393,714,1424
3014517714,3479087219,1651302610,1651302738,128,1819
3402019498,3411272565,1661415856,1661416470,614,333
3366896849,3032431944,1651886426,1651886672,246,1098
3152988371,3181778467,1656384549,1656384684,135,2489
3261376049,3667528236,1644828788,1644829382,594,2229
3051776472,3644951156,1645385586,1645385899,313,88
3948942044,3818713435,1664427323,1664428302,979,1210
3299607426,3365615023,1655380363,1655381174,811,2342
3407409307,3437707461,1647569020,1647569813,793,2386
3237563954,3556968717,1642706050,1642706709,659,1939
3846493363,3958050741,1654227233,1654227392,159,73
3218738751,3957586219,1647159616,1647159793,177,1468
3910029798,3883703576,1642114952,1642115519,567,2168
3815718297,3963547295,1663150232,1663150952,720,492
3755294305,3186569725,1668808381,1668808420,39,512
3106371588,3760042128,1664630923,1664631112,189,637
3468922263,3927886349,1651045704,1651045804,100,2068
3250566757,3883537438,1648386502,1648386752,250,95
3408300554,3168600862,1653772591,1653773536,945,738
3041652512,3957695947,1651030981,1651031661,680,426
3225068874,3646687421,1648393755,1648393854,99,2060
3026095831,3166521010,1643303701,1643304411,710,1883
3139551539,3917500425,1642579283,1642579914,631,1790
3313252249,3065350513,1655396521,1655397257,736,613
3450811740,3331604266,1658251669,1658252279,610,1714
3695411154,3882412784,1642623295,1642624007,712,1744
3018325807,3834160941,1661512348,1661513008,660,1283
3962617141,3504457520,1660438051,1660438070,19,1301
3394220993,3047643464,1656061645,1656062423,778,1244
3974326867,3364888618,1665609234,1665610076,842,2097
3879157400,3665591394,1650126692,1650127557,865,358
3397987502,3335210480,1656605280,1656605368,88,2176
3661369487,3233536885,1656448605,1656449255,650,2383
3351218513,3504919226,1643678134,1643678612,478,381
3242180365,3151288415,1650329013,1650329234,221,620
3280717680,3037042091,1641727399,1641727634,235,1879
3976335280,3903560788,1656066386,1656067116,730,478
3356728242,3216582576,1649790856,1649790998,142,1475
3105679045,3011686027,1652829091,1652829470,379,1097
3602924213,3516140957,1656772698,1656773609,911,1757
3414700083,3719785520,1666104141,1666104903,762,2336
3861153303,3519375692,1642135797,1642135823,26,1178
3710769510,3893475632,1647548040,1647548934,894,735
3087394554,3346978275,1668303944,1668304645,701,2313
3194721041,3984215552,1669070852,1669070960,108,1961
3522715448,3224364206,1652366428,1652366991,563,644
3710844932,3331539245,1666369515,1666370072,557,181
3317241023,3659620596,1654620610,1654620739,129,364
3137529896,3028063669,1641531969,1641532034,65,45
3980824960,3553146922,1642692408,1642692847,439,1910
3666179764,3211956216,1648491192,1648491640,448,1491
3841904297,3876377964,1665291235,1665291896,661,262
3907713562,3145328663,1645830190,1645831107,917,96
3329463543,3042052031,1658816878,1658816961,83,887
3790298140,3661016961,1656659449,1656660421,972,1383
3045127324,3560756539,1646964992,1646965189,197,1207
3997312356,3857013729,1668700163,1668700575,412,2406
3650431460,3053134032,1641383091,1641383256,165,166
3694206371,3776939860,1653619288,1653619719,431,2374
3603594711,3282166903,1644431452,1644432322,870,690
3579684205,3798512184,1654129365,1654130353,988,2174
3650041115,3514458890,1657940642,1657940956,314,1113
3678340379,3962773297,1643789643,1643789856,213,985
3687151281,3870475008,1642711399,1642711805,406,845
3198195956,3625651694,1663603841,1663603862,21,193
3347152834,3798714576,1653924994,1653925560,566,128
3844006658,3331554085,1654638821,1654638995,174,2062
3285030317,3984050382,1660876422,1660876813,391,83
3824168840,3479725709,1651389266,1651389346,80,1325
3696512728,3311113773,1665934707,1665935706,999,543
3620236387,3764724451,1645765681,1645766488,807,637
3191462400,3149313426,1667348452,1667349368,916,104
3318735194,3225500469,1645671409,1645671729,320,1804
3288529545,3978691513,1644438922,1644439704,782,467
3817548425,3977860015,1646354838,1646355018,180,184
3741978230,3737603669,1642154705,1642155235,530,1456
3361167735,3121128511,1644850494,1644851176,682,929
3031827531,3872170030,1657771678,1657772026,348,1726
3241210215,3439221238,1660972458,1660972857,399,707
3286466102,3243873593,1653193197,1653193206,9,1766
3788034142,3479401831,1647613309,1647613615,306,1555
3417049317,3136798128,1652929218,1652929436,218,906
3894508827,3715231431,1653412436,1653413383,947,2179
3386868280,3374688375,1662187223,1662187346,123,2427
3223313152,3064804156,1655866174,1655866624,450,1325
3797484306,3391056146,1642817849,1642817851,2,1013
3672751607,3777091595,1659901860,1659902730,870,1265
3496369924,3963370859,1647292493,1647292796,303,1413
3022102664,3014185506,1651739269,1651740035,766,2488
3513169935,3755243698,1654091665,1654092005,340,2320
3824649355,3353500391,1650305394,1650305643,249,1440
3550677109,3679045431,1653116398,1653117345,947,1290
3557643641,3862389429,1645169674,1645170638,964,1544
3582267659,3959504618,1668174630,1668174807,177,2365
3952316985,3170325894,1648229218,1648229876,658,1989
3176432386,3315391438,1651712871,1651713499,628,1997
3777316167,3953118937,1656089141,1656089663,522,2249
3486059916,3821979869,1663124754,1663125269,515,417
3911960681,3778824939,1651088579,1651089446,867,1906
3208220195,3364404145,1645706124,1645706315,191,1601
3625179175,3324473595,1641138256,1641138443,187,260
3006507589,3885393767,1644553611,1644553953,342,981
3186584232,3100113266,1658312404,1658313190,786,2151
3103417672,3609043475,1663526581,1663527545,964,2078
3856756422,3804329236,1648292995,1648293954,959,2261
3478959759,3397779824,1669432749,1669432944,195,2392
3970444667,3208757755,1653024944,1653025609,665,314
3672070606,3442477300,1658060827,1658061100,273,1975
3233536885,3432608968,1666520733,1666521507,774,373
3910839994,3840801648,1664039386,1664039885,499,741
3898403925,3506143492,1651224504,1651225092,588,1319
3479087219,3183259139,1644110927,1644111699,772,1528
3725283025,3599869347,1653982210,1653982799,589,732
3460027343,3764078507,1665808417,1665808444,27,795
3223518905,3417143667,1643125461,1643126433,972,294
3372334548,3695558824,1651137929,1651138025,96,2376
3887305908,3182502852,1668980557,1668981438,881,2200
3949201468,3019512245,1658203240,1658203756,516,465
3797270025,3898118371,1645018780,1645019093,313,1167
3887054161,3145220460,1642379366,1642379761,395,1536
3344787204,3884878006,1653413250,1653414061,811,1269
3476566118,3425720812,1643392523,1643392848,325,122
3551344746,3194379247,1665796290,1665796435,145,776
3936154124,3567656858,1648892569,1648893376,807,2172
3868630067,3802790977,1652826503,1652826548,45,2057
3404200815,3011593291,1661020061,1661020734,673,2218
3707362025,3446987671,1662332918,1662333008,90,1946
3814572709,3447887397,1662873591,1662874378,787,706
3717334493,3171734482,1652210767,1652211322,555,2404
3951592432,3026244912,1663141283,1663142154,871,1018
